"","sampleID","actor","subject","crowd","displace","total.DC"
"1","sample001","BBB","GGG",1,1,2
"2","sample001","BBB","RRG",1,0,1
"3","sample001","BBG","BBB",1,1,2
"4","sample001","BBG","BRB",1,1,2
"5","sample001","BBG","GBG",2,1,3
"6","sample001","BBG","GGB",2,2,4
"7","sample001","BBG","GGG",4,4,8
"8","sample001","BBG","GRG",1,3,4
"9","sample001","BBG","RRG",1,0,1
"10","sample001","BGG","RBG",1,0,1
"11","sample001","BGG","RRR",1,0,1
"12","sample001","BRR","BGB",1,0,1
"13","sample001","GBB","BBB",12,6,18
"14","sample001","GBB","BRB",1,2,3
"15","sample001","GBB","BRR",1,1,2
"16","sample001","GBB","GGG",7,9,16
"17","sample001","GBB","GGR",1,1,2
"18","sample001","GBB","RBG",3,0,3
"19","sample001","GBB","RBR",1,0,1
"20","sample001","GBB","RGG",1,0,1
"21","sample001","GBB","RGR",2,0,2
"22","sample001","GBB","RRR",1,0,1
"23","sample001","GBG","BRB",1,2,3
"24","sample001","GBG","BRR",1,0,1
"25","sample001","GBG","GGG",4,3,7
"26","sample001","GBG","RBB",1,0,1
"27","sample001","GBG","RGR",1,1,2
"28","sample001","GBG","RRG",1,1,2
"29","sample001","GGB","BBB",3,1,4
"30","sample001","GGB","BBR",1,1,2
"31","sample001","GGB","BRR",1,5,6
"32","sample001","GGB","GBG",1,0,1
"33","sample001","GGB","GGG",13,5,18
"34","sample001","GGB","RGG",1,0,1
"35","sample001","GGB","RRG",1,1,2
"36","sample001","GGB","RRR",1,1,2
"37","sample001","GGG","BBB",8,3,11
"38","sample001","GGG","BGG",1,2,3
"39","sample001","GGG","BRB",1,0,1
"40","sample001","GGG","GGB",5,0,5
"41","sample001","GGG","GGR",1,1,2
"42","sample001","GGG","RBB",1,1,2
"43","sample001","GGG","RGR",1,2,3
"44","sample001","GGG","RRG",1,1,2
"45","sample001","GGR","BRR",1,0,1
"46","sample001","GGR","GRR",1,0,1
"47","sample001","GRG","BBB",3,0,3
"48","sample001","GRG","GGB",2,2,4
"49","sample001","GRG","GGG",3,1,4
"50","sample001","GRG","RGR",1,0,1
"51","sample001","GRG","RRG",2,1,3
"52","sample001","GRR","BGB",1,0,1
"53","sample001","RBG","BBB",2,0,2
"54","sample001","RBG","RBB",1,1,2
"55","sample001","RBR","BGB",2,0,2
"56","sample001","RBR","BRB",1,0,1
"57","sample001","RBR","BRR",1,0,1
"58","sample001","RBR","GRR",4,0,4
"59","sample001","RBR","RGG",2,3,5
"60","sample001","RBR","RGR",1,0,1
"61","sample001","RGG","BBR",1,0,1
"62","sample001","RGR","BBB",2,0,2
"63","sample001","RGR","BBR",1,0,1
"64","sample001","RGR","BGB",2,0,2
"65","sample001","RGR","BGG",2,1,3
"66","sample001","RGR","BRR",1,0,1
"67","sample001","RGR","GGB",2,2,4
"68","sample001","RGR","RGG",1,0,1
"69","sample001","RRG","BBB",2,5,7
"70","sample001","RRG","BGB",1,1,2
"71","sample001","RRG","BRB",2,13,15
"72","sample001","RRG","BRR",1,1,2
"73","sample001","RRG","GGG",2,4,6
"74","sample001","RRG","GRG",1,0,1
"75","sample001","RRG","GRR",3,3,6
"76","sample001","RRG","RBB",1,0,1
"77","sample001","RRR","BBR",1,0,1
"78","sample001","RRR","BGB",2,1,3
"79","sample001","RRR","BGG",1,0,1
"80","sample001","RRR","BRB",1,0,1
"81","sample001","RRR","BRR",1,0,1
"82","sample001","RRR","RBB",1,1,2
"83","sample001","RRR","RGR",1,0,1
"84","sample001","RRR","RRG",2,0,2
"85","sample001","BBG","GRR",0,1,1
"86","sample001","BBG","RBB",0,1,1
"87","sample001","BBG","RRR",0,1,1
"88","sample001","BGB","BBB",0,1,1
"89","sample001","BGB","RRG",0,1,1
"90","sample001","BRB","BBB",0,3,3
"91","sample001","BRR","BBB",0,1,1
"92","sample001","GBB","GBG",0,1,1
"93","sample001","GBB","GGB",0,2,2
"94","sample001","GBB","GRG",0,1,1
"95","sample001","GBB","RRG",0,1,1
"96","sample001","GBG","BBB",0,1,1
"97","sample001","GBG","GGB",0,1,1
"98","sample001","GGB","BGB",0,3,3
"99","sample001","GGB","GGR",0,2,2
"100","sample001","GGB","GRR",0,1,1
"101","sample001","GGB","RBB",0,1,1
"102","sample001","GGG","GRR",0,2,2
"103","sample001","GGG","RBR",0,5,5
"104","sample001","GGG","RRR",0,1,1
"105","sample001","GGR","BBB",0,1,1
"106","sample001","GGR","BBR",0,1,1
"107","sample001","GRG","GBG",0,1,1
"108","sample001","GRG","GGR",0,1,1
"109","sample001","GRG","RBG",0,1,1
"110","sample001","GRG","RBR",0,1,1
"111","sample001","GRR","BGG",0,2,2
"112","sample001","GRR","BRB",0,1,1
"113","sample001","GRR","BRR",0,1,1
"114","sample001","RBG","GRR",0,1,1
"115","sample001","RBG","RBR",0,1,1
"116","sample001","RBR","BBB",0,3,3
"117","sample001","RBR","GGB",0,2,2
"118","sample001","RGG","GGG",0,1,1
"119","sample001","RGG","GGR",0,1,1
"120","sample001","RGG","GRR",0,3,3
"121","sample001","RGR","GGR",0,1,1
"122","sample001","RGR","RRG",0,3,3
"123","sample002","BBB","GGG",1,1,2
"124","sample002","BBB","RRG",1,0,1
"125","sample002","BBG","BBB",1,1,2
"126","sample002","BBG","BRB",1,4,5
"127","sample002","BBG","GBG",2,1,3
"128","sample002","BBG","GGB",2,4,6
"129","sample002","BBG","GGG",4,9,13
"130","sample002","BBG","GRG",1,2,3
"131","sample002","BBG","RRG",1,0,1
"132","sample002","BGG","RBG",1,0,1
"133","sample002","BGG","RRR",1,0,1
"134","sample002","BRR","BGB",1,0,1
"135","sample002","GBB","BBB",12,7,19
"136","sample002","GBB","BRB",1,1,2
"137","sample002","GBB","BRR",1,1,2
"138","sample002","GBB","GGG",7,10,17
"139","sample002","GBB","GGR",1,0,1
"140","sample002","GBB","RBG",3,3,6
"141","sample002","GBB","RBR",1,0,1
"142","sample002","GBB","RGG",1,0,1
"143","sample002","GBB","RGR",2,0,2
"144","sample002","GBB","RRR",1,3,4
"145","sample002","GBG","BRB",1,0,1
"146","sample002","GBG","BRR",1,0,1
"147","sample002","GBG","GGG",4,1,5
"148","sample002","GBG","RBB",1,0,1
"149","sample002","GBG","RGR",1,0,1
"150","sample002","GBG","RRG",1,0,1
"151","sample002","GGB","BBB",3,2,5
"152","sample002","GGB","BBR",1,0,1
"153","sample002","GGB","BRR",1,2,3
"154","sample002","GGB","GBG",1,0,1
"155","sample002","GGB","GGG",13,9,22
"156","sample002","GGB","RGG",1,1,2
"157","sample002","GGB","RRG",1,1,2
"158","sample002","GGB","RRR",1,0,1
"159","sample002","GGG","BBB",8,6,14
"160","sample002","GGG","BGG",1,2,3
"161","sample002","GGG","BRB",1,0,1
"162","sample002","GGG","GGB",5,0,5
"163","sample002","GGG","GGR",1,2,3
"164","sample002","GGG","RBB",1,2,3
"165","sample002","GGG","RGR",1,2,3
"166","sample002","GGG","RRG",1,3,4
"167","sample002","GGR","BRR",1,0,1
"168","sample002","GGR","GRR",1,0,1
"169","sample002","GRG","BBB",3,3,6
"170","sample002","GRG","GGB",2,2,4
"171","sample002","GRG","GGG",3,1,4
"172","sample002","GRG","RGR",1,0,1
"173","sample002","GRG","RRG",2,0,2
"174","sample002","GRR","BGB",1,0,1
"175","sample002","RBG","BBB",2,1,3
"176","sample002","RBG","RBB",1,0,1
"177","sample002","RBR","BGB",2,1,3
"178","sample002","RBR","BRB",1,0,1
"179","sample002","RBR","BRR",1,1,2
"180","sample002","RBR","GRR",4,0,4
"181","sample002","RBR","RGG",2,0,2
"182","sample002","RBR","RGR",1,0,1
"183","sample002","RGG","BBR",1,0,1
"184","sample002","RGR","BBB",2,0,2
"185","sample002","RGR","BBR",1,0,1
"186","sample002","RGR","BGB",2,0,2
"187","sample002","RGR","BGG",2,0,2
"188","sample002","RGR","BRR",1,0,1
"189","sample002","RGR","GGB",2,1,3
"190","sample002","RGR","RGG",1,0,1
"191","sample002","RRG","BBB",2,6,8
"192","sample002","RRG","BGB",1,0,1
"193","sample002","RRG","BRB",2,9,11
"194","sample002","RRG","BRR",1,1,2
"195","sample002","RRG","GGG",2,3,5
"196","sample002","RRG","GRG",1,0,1
"197","sample002","RRG","GRR",3,3,6
"198","sample002","RRG","RBB",1,0,1
"199","sample002","RRR","BBR",1,0,1
"200","sample002","RRR","BGB",2,0,2
"201","sample002","RRR","BGG",1,0,1
"202","sample002","RRR","BRB",1,0,1
"203","sample002","RRR","BRR",1,0,1
"204","sample002","RRR","RBB",1,0,1
"205","sample002","RRR","RGR",1,0,1
"206","sample002","RRR","RRG",2,0,2
"207","sample002","BBG","BGG",0,1,1
"208","sample002","BBG","GBB",0,1,1
"209","sample002","BBG","RBG",0,1,1
"210","sample002","BBG","RGR",0,1,1
"211","sample002","BGB","RRG",0,1,1
"212","sample002","BGG","BBB",0,1,1
"213","sample002","BGG","RGG",0,1,1
"214","sample002","BGG","RGR",0,1,1
"215","sample002","BRB","BBB",0,2,2
"216","sample002","BRB","BRR",0,1,1
"217","sample002","BRB","RBB",0,1,1
"218","sample002","BRB","RBG",0,1,1
"219","sample002","BRR","BBB",0,2,2
"220","sample002","GBB","GGB",0,4,4
"221","sample002","GBB","GRG",0,2,2
"222","sample002","GBB","RBB",0,1,1
"223","sample002","GBG","BBB",0,2,2
"224","sample002","GBG","BBR",0,1,1
"225","sample002","GGB","GGR",0,3,3
"226","sample002","GGB","GRR",0,1,1
"227","sample002","GGB","RBG",0,1,1
"228","sample002","GGB","RGR",0,1,1
"229","sample002","GGG","BRR",0,2,2
"230","sample002","GGG","RBG",0,1,1
"231","sample002","GGG","RBR",0,1,1
"232","sample002","GGR","RBB",0,1,1
"233","sample002","GRG","BRB",0,1,1
"234","sample002","RBB","BRB",0,1,1
"235","sample002","RBG","RBR",0,1,1
"236","sample002","RBR","BBB",0,1,1
"237","sample002","RBR","GGB",0,1,1
"238","sample002","RBR","RBB",0,1,1
"239","sample002","RGG","BBB",0,1,1
"240","sample002","RGG","GRR",0,3,3
"241","sample002","RGR","GGG",0,1,1
"242","sample002","RRG","RGG",0,1,1
"243","sample003","BBB","GGG",1,0,1
"244","sample003","BBB","RRG",1,0,1
"245","sample003","BBG","BBB",1,0,1
"246","sample003","BBG","BRB",1,4,5
"247","sample003","BBG","GBG",2,4,6
"248","sample003","BBG","GGB",2,2,4
"249","sample003","BBG","GGG",4,4,8
"250","sample003","BBG","GRG",1,0,1
"251","sample003","BBG","RRG",1,1,2
"252","sample003","BGG","RBG",1,0,1
"253","sample003","BGG","RRR",1,0,1
"254","sample003","BRR","BGB",1,0,1
"255","sample003","GBB","BBB",12,5,17
"256","sample003","GBB","BRB",1,2,3
"257","sample003","GBB","BRR",1,0,1
"258","sample003","GBB","GGG",7,12,19
"259","sample003","GBB","GGR",1,0,1
"260","sample003","GBB","RBG",3,3,6
"261","sample003","GBB","RBR",1,0,1
"262","sample003","GBB","RGG",1,0,1
"263","sample003","GBB","RGR",2,1,3
"264","sample003","GBB","RRR",1,0,1
"265","sample003","GBG","BRB",1,1,2
"266","sample003","GBG","BRR",1,0,1
"267","sample003","GBG","GGG",4,1,5
"268","sample003","GBG","RBB",1,0,1
"269","sample003","GBG","RGR",1,0,1
"270","sample003","GBG","RRG",1,1,2
"271","sample003","GGB","BBB",3,0,3
"272","sample003","GGB","BBR",1,0,1
"273","sample003","GGB","BRR",1,4,5
"274","sample003","GGB","GBG",1,0,1
"275","sample003","GGB","GGG",13,3,16
"276","sample003","GGB","RGG",1,1,2
"277","sample003","GGB","RRG",1,2,3
"278","sample003","GGB","RRR",1,1,2
"279","sample003","GGG","BBB",8,3,11
"280","sample003","GGG","BGG",1,1,2
"281","sample003","GGG","BRB",1,2,3
"282","sample003","GGG","GGB",5,0,5
"283","sample003","GGG","GGR",1,0,1
"284","sample003","GGG","RBB",1,1,2
"285","sample003","GGG","RGR",1,2,3
"286","sample003","GGG","RRG",1,6,7
"287","sample003","GGR","BRR",1,0,1
"288","sample003","GGR","GRR",1,0,1
"289","sample003","GRG","BBB",3,0,3
"290","sample003","GRG","GGB",2,3,5
"291","sample003","GRG","GGG",3,1,4
"292","sample003","GRG","RGR",1,2,3
"293","sample003","GRG","RRG",2,0,2
"294","sample003","GRR","BGB",1,0,1
"295","sample003","RBG","BBB",2,1,3
"296","sample003","RBG","RBB",1,0,1
"297","sample003","RBR","BGB",2,0,2
"298","sample003","RBR","BRB",1,0,1
"299","sample003","RBR","BRR",1,1,2
"300","sample003","RBR","GRR",4,1,5
"301","sample003","RBR","RGG",2,0,2
"302","sample003","RBR","RGR",1,0,1
"303","sample003","RGG","BBR",1,1,2
"304","sample003","RGR","BBB",2,1,3
"305","sample003","RGR","BBR",1,0,1
"306","sample003","RGR","BGB",2,0,2
"307","sample003","RGR","BGG",2,1,3
"308","sample003","RGR","BRR",1,0,1
"309","sample003","RGR","GGB",2,1,3
"310","sample003","RGR","RGG",1,1,2
"311","sample003","RRG","BBB",2,4,6
"312","sample003","RRG","BGB",1,3,4
"313","sample003","RRG","BRB",2,7,9
"314","sample003","RRG","BRR",1,4,5
"315","sample003","RRG","GGG",2,1,3
"316","sample003","RRG","GRG",1,0,1
"317","sample003","RRG","GRR",3,1,4
"318","sample003","RRG","RBB",1,1,2
"319","sample003","RRR","BBR",1,0,1
"320","sample003","RRR","BGB",2,0,2
"321","sample003","RRR","BGG",1,0,1
"322","sample003","RRR","BRB",1,1,2
"323","sample003","RRR","BRR",1,0,1
"324","sample003","RRR","RBB",1,1,2
"325","sample003","RRR","RGR",1,0,1
"326","sample003","RRR","RRG",2,0,2
"327","sample003","BBB","GRR",0,1,1
"328","sample003","BBB","RRR",0,1,1
"329","sample003","BBG","BGG",0,1,1
"330","sample003","BBG","RBG",0,1,1
"331","sample003","BBG","RRR",0,1,1
"332","sample003","BGG","BBB",0,1,1
"333","sample003","BRB","BBB",0,2,2
"334","sample003","BRB","RBG",0,1,1
"335","sample003","GBB","BGG",0,1,1
"336","sample003","GBB","GGB",0,2,2
"337","sample003","GBB","GRG",0,2,2
"338","sample003","GBB","RBB",0,1,1
"339","sample003","GBG","BBB",0,1,1
"340","sample003","GGB","BGG",0,3,3
"341","sample003","GGB","BRB",0,1,1
"342","sample003","GGB","GRR",0,3,3
"343","sample003","GGB","RBB",0,2,2
"344","sample003","GGB","RBR",0,2,2
"345","sample003","GGG","BRR",0,2,2
"346","sample003","GGG","RBG",0,1,1
"347","sample003","GGG","RBR",0,3,3
"348","sample003","GGR","RBB",0,1,1
"349","sample003","GRG","BGG",0,1,1
"350","sample003","GRG","BRB",0,1,1
"351","sample003","GRG","GGR",0,1,1
"352","sample003","GRR","BRR",0,1,1
"353","sample003","RBB","BBB",0,1,1
"354","sample003","RBG","RGR",0,1,1
"355","sample003","RBR","BBB",0,1,1
"356","sample003","RBR","BBR",0,1,1
"357","sample003","RBR","BGG",0,2,2
"358","sample003","RGG","BBB",0,1,1
"359","sample003","RGG","GGR",0,1,1
"360","sample003","RGG","GRR",0,1,1
"361","sample003","RGR","RBB",0,1,1
"362","sample003","RRG","BBR",0,2,2
"363","sample003","RRG","GGR",0,2,2
"364","sample003","RRG","RGG",0,1,1
"365","sample003","RRG","RGR",0,1,1
"366","sample003","RRR","GRR",0,1,1
"367","sample003","RRR","RBR",0,1,1
"368","sample004","BBB","GGG",1,0,1
"369","sample004","BBB","RRG",1,1,2
"370","sample004","BBG","BBB",1,0,1
"371","sample004","BBG","BRB",1,3,4
"372","sample004","BBG","GBG",2,0,2
"373","sample004","BBG","GGB",2,1,3
"374","sample004","BBG","GGG",4,8,12
"375","sample004","BBG","GRG",1,1,2
"376","sample004","BBG","RRG",1,0,1
"377","sample004","BGG","RBG",1,0,1
"378","sample004","BGG","RRR",1,0,1
"379","sample004","BRR","BGB",1,0,1
"380","sample004","GBB","BBB",12,3,15
"381","sample004","GBB","BRB",1,1,2
"382","sample004","GBB","BRR",1,0,1
"383","sample004","GBB","GGG",7,13,20
"384","sample004","GBB","GGR",1,0,1
"385","sample004","GBB","RBG",3,3,6
"386","sample004","GBB","RBR",1,0,1
"387","sample004","GBB","RGG",1,0,1
"388","sample004","GBB","RGR",2,1,3
"389","sample004","GBB","RRR",1,0,1
"390","sample004","GBG","BRB",1,0,1
"391","sample004","GBG","BRR",1,0,1
"392","sample004","GBG","GGG",4,1,5
"393","sample004","GBG","RBB",1,0,1
"394","sample004","GBG","RGR",1,1,2
"395","sample004","GBG","RRG",1,0,1
"396","sample004","GGB","BBB",3,4,7
"397","sample004","GGB","BBR",1,0,1
"398","sample004","GGB","BRR",1,3,4
"399","sample004","GGB","GBG",1,0,1
"400","sample004","GGB","GGG",13,4,17
"401","sample004","GGB","RGG",1,0,1
"402","sample004","GGB","RRG",1,1,2
"403","sample004","GGB","RRR",1,1,2
"404","sample004","GGG","BBB",8,5,13
"405","sample004","GGG","BGG",1,0,1
"406","sample004","GGG","BRB",1,1,2
"407","sample004","GGG","GGB",5,0,5
"408","sample004","GGG","GGR",1,0,1
"409","sample004","GGG","RBB",1,2,3
"410","sample004","GGG","RGR",1,2,3
"411","sample004","GGG","RRG",1,3,4
"412","sample004","GGR","BRR",1,0,1
"413","sample004","GGR","GRR",1,0,1
"414","sample004","GRG","BBB",3,2,5
"415","sample004","GRG","GGB",2,2,4
"416","sample004","GRG","GGG",3,1,4
"417","sample004","GRG","RGR",1,0,1
"418","sample004","GRG","RRG",2,0,2
"419","sample004","GRR","BGB",1,0,1
"420","sample004","RBG","BBB",2,0,2
"421","sample004","RBG","RBB",1,1,2
"422","sample004","RBR","BGB",2,0,2
"423","sample004","RBR","BRB",1,0,1
"424","sample004","RBR","BRR",1,2,3
"425","sample004","RBR","GRR",4,0,4
"426","sample004","RBR","RGG",2,3,5
"427","sample004","RBR","RGR",1,0,1
"428","sample004","RGG","BBR",1,1,2
"429","sample004","RGR","BBB",2,0,2
"430","sample004","RGR","BBR",1,1,2
"431","sample004","RGR","BGB",2,0,2
"432","sample004","RGR","BGG",2,0,2
"433","sample004","RGR","BRR",1,1,2
"434","sample004","RGR","GGB",2,3,5
"435","sample004","RGR","RGG",1,0,1
"436","sample004","RRG","BBB",2,3,5
"437","sample004","RRG","BGB",1,3,4
"438","sample004","RRG","BRB",2,3,5
"439","sample004","RRG","BRR",1,3,4
"440","sample004","RRG","GGG",2,2,4
"441","sample004","RRG","GRG",1,0,1
"442","sample004","RRG","GRR",3,1,4
"443","sample004","RRG","RBB",1,0,1
"444","sample004","RRR","BBR",1,0,1
"445","sample004","RRR","BGB",2,0,2
"446","sample004","RRR","BGG",1,0,1
"447","sample004","RRR","BRB",1,0,1
"448","sample004","RRR","BRR",1,0,1
"449","sample004","RRR","RBB",1,0,1
"450","sample004","RRR","RGR",1,1,2
"451","sample004","RRR","RRG",2,0,2
"452","sample004","BBB","RBG",0,1,1
"453","sample004","BBG","BGG",0,1,1
"454","sample004","BBG","RRR",0,1,1
"455","sample004","BGB","BBB",0,1,1
"456","sample004","BGG","BBB",0,2,2
"457","sample004","BRB","BBB",0,5,5
"458","sample004","BRB","BRR",0,2,2
"459","sample004","BRB","GGR",0,1,1
"460","sample004","BRR","BBB",0,5,5
"461","sample004","BRR","BGG",0,1,1
"462","sample004","GBB","BGG",0,1,1
"463","sample004","GBB","GBG",0,1,1
"464","sample004","GBB","GGB",0,2,2
"465","sample004","GBB","GRG",0,1,1
"466","sample004","GBB","RBB",0,1,1
"467","sample004","GBB","RRG",0,1,1
"468","sample004","GBG","GGB",0,1,1
"469","sample004","GGB","BGB",0,1,1
"470","sample004","GGB","BGG",0,1,1
"471","sample004","GGB","GBB",0,1,1
"472","sample004","GGB","RBB",0,1,1
"473","sample004","GGB","RBG",0,2,2
"474","sample004","GGB","RGR",0,1,1
"475","sample004","GGG","BGB",0,1,1
"476","sample004","GGG","BRR",0,2,2
"477","sample004","GGG","RBG",0,1,1
"478","sample004","GGG","RBR",0,3,3
"479","sample004","GGG","RGG",0,1,1
"480","sample004","GGR","BBB",0,1,1
"481","sample004","GRG","BBR",0,1,1
"482","sample004","GRG","BRB",0,1,1
"483","sample004","GRG","BRR",0,1,1
"484","sample004","GRG","GGR",0,1,1
"485","sample004","GRR","BRR",0,1,1
"486","sample004","RBB","RGG",0,1,1
"487","sample004","RBG","GRR",0,1,1
"488","sample004","RBR","GGB",0,2,2
"489","sample004","RGG","BBB",0,1,1
"490","sample004","RGG","BRR",0,1,1
"491","sample004","RGG","GGG",0,1,1
"492","sample004","RGG","GRR",0,1,1
"493","sample004","RGR","GGR",0,1,1
"494","sample004","RRG","BBR",0,1,1
"495","sample004","RRG","BGG",0,1,1
"496","sample004","RRG","GGR",0,1,1
"497","sample004","RRG","RGG",0,1,1
"498","sample004","RRG","RGR",0,1,1
"499","sample004","RRR","RBR",0,1,1
"500","sample005","BBB","GGG",1,0,1
"501","sample005","BBB","RRG",1,0,1
"502","sample005","BBG","BBB",1,1,2
"503","sample005","BBG","BRB",1,1,2
"504","sample005","BBG","GBG",2,1,3
"505","sample005","BBG","GGB",2,3,5
"506","sample005","BBG","GGG",4,8,12
"507","sample005","BBG","GRG",1,0,1
"508","sample005","BBG","RRG",1,0,1
"509","sample005","BGG","RBG",1,0,1
"510","sample005","BGG","RRR",1,0,1
"511","sample005","BRR","BGB",1,1,2
"512","sample005","GBB","BBB",12,7,19
"513","sample005","GBB","BRB",1,2,3
"514","sample005","GBB","BRR",1,0,1
"515","sample005","GBB","GGG",7,15,22
"516","sample005","GBB","GGR",1,1,2
"517","sample005","GBB","RBG",3,1,4
"518","sample005","GBB","RBR",1,0,1
"519","sample005","GBB","RGG",1,0,1
"520","sample005","GBB","RGR",2,1,3
"521","sample005","GBB","RRR",1,1,2
"522","sample005","GBG","BRB",1,2,3
"523","sample005","GBG","BRR",1,0,1
"524","sample005","GBG","GGG",4,1,5
"525","sample005","GBG","RBB",1,0,1
"526","sample005","GBG","RGR",1,1,2
"527","sample005","GBG","RRG",1,1,2
"528","sample005","GGB","BBB",3,5,8
"529","sample005","GGB","BBR",1,0,1
"530","sample005","GGB","BRR",1,2,3
"531","sample005","GGB","GBG",1,0,1
"532","sample005","GGB","GGG",13,8,21
"533","sample005","GGB","RGG",1,1,2
"534","sample005","GGB","RRG",1,0,1
"535","sample005","GGB","RRR",1,0,1
"536","sample005","GGG","BBB",8,5,13
"537","sample005","GGG","BGG",1,0,1
"538","sample005","GGG","BRB",1,1,2
"539","sample005","GGG","GGB",5,0,5
"540","sample005","GGG","GGR",1,0,1
"541","sample005","GGG","RBB",1,2,3
"542","sample005","GGG","RGR",1,2,3
"543","sample005","GGG","RRG",1,6,7
"544","sample005","GGR","BRR",1,0,1
"545","sample005","GGR","GRR",1,0,1
"546","sample005","GRG","BBB",3,0,3
"547","sample005","GRG","GGB",2,0,2
"548","sample005","GRG","GGG",3,2,5
"549","sample005","GRG","RGR",1,0,1
"550","sample005","GRG","RRG",2,1,3
"551","sample005","GRR","BGB",1,0,1
"552","sample005","RBG","BBB",2,2,4
"553","sample005","RBG","RBB",1,1,2
"554","sample005","RBR","BGB",2,0,2
"555","sample005","RBR","BRB",1,0,1
"556","sample005","RBR","BRR",1,1,2
"557","sample005","RBR","GRR",4,0,4
"558","sample005","RBR","RGG",2,0,2
"559","sample005","RBR","RGR",1,0,1
"560","sample005","RGG","BBR",1,0,1
"561","sample005","RGR","BBB",2,1,3
"562","sample005","RGR","BBR",1,0,1
"563","sample005","RGR","BGB",2,0,2
"564","sample005","RGR","BGG",2,0,2
"565","sample005","RGR","BRR",1,0,1
"566","sample005","RGR","GGB",2,0,2
"567","sample005","RGR","RGG",1,0,1
"568","sample005","RRG","BBB",2,4,6
"569","sample005","RRG","BGB",1,2,3
"570","sample005","RRG","BRB",2,6,8
"571","sample005","RRG","BRR",1,2,3
"572","sample005","RRG","GGG",2,1,3
"573","sample005","RRG","GRG",1,0,1
"574","sample005","RRG","GRR",3,3,6
"575","sample005","RRG","RBB",1,0,1
"576","sample005","RRR","BBR",1,0,1
"577","sample005","RRR","BGB",2,0,2
"578","sample005","RRR","BGG",1,0,1
"579","sample005","RRR","BRB",1,1,2
"580","sample005","RRR","BRR",1,0,1
"581","sample005","RRR","RBB",1,0,1
"582","sample005","RRR","RGR",1,1,2
"583","sample005","RRR","RRG",2,0,2
"584","sample005","BBB","GRR",0,2,2
"585","sample005","BBG","RRR",0,1,1
"586","sample005","BGG","BBB",0,2,2
"587","sample005","BGG","RGG",0,1,1
"588","sample005","BRB","BBB",0,2,2
"589","sample005","BRB","GGG",0,1,1
"590","sample005","BRR","RBB",0,1,1
"591","sample005","GBB","GGB",0,4,4
"592","sample005","GBB","RRG",0,1,1
"593","sample005","GGB","BGB",0,1,1
"594","sample005","GGB","GGR",0,1,1
"595","sample005","GGB","RBG",0,2,2
"596","sample005","GGB","RBR",0,1,1
"597","sample005","GGG","BRR",0,3,3
"598","sample005","GGG","RBR",0,5,5
"599","sample005","GGG","RRR",0,1,1
"600","sample005","GRG","GGR",0,2,2
"601","sample005","GRR","BRR",0,1,1
"602","sample005","GRR","GGR",0,1,1
"603","sample005","RBR","BBB",0,5,5
"604","sample005","RBR","BGG",0,2,2
"605","sample005","RBR","GGB",0,2,2
"606","sample005","RBR","RBB",0,1,1
"607","sample005","RGG","BBB",0,2,2
"608","sample005","RGG","GGR",0,1,1
"609","sample005","RGR","GGG",0,1,1
"610","sample005","RGR","RRG",0,1,1
"611","sample005","RRG","BBR",0,1,1
"612","sample005","RRG","BGG",0,1,1
"613","sample005","RRG","GGR",0,1,1
"614","sample005","RRR","RBR",0,1,1
"615","sample006","BBB","GGG",1,0,1
"616","sample006","BBB","RRG",1,1,2
"617","sample006","BBG","BBB",1,2,3
"618","sample006","BBG","BRB",1,6,7
"619","sample006","BBG","GBG",2,0,2
"620","sample006","BBG","GGB",2,3,5
"621","sample006","BBG","GGG",4,6,10
"622","sample006","BBG","GRG",1,1,2
"623","sample006","BBG","RRG",1,1,2
"624","sample006","BGG","RBG",1,0,1
"625","sample006","BGG","RRR",1,0,1
"626","sample006","BRR","BGB",1,0,1
"627","sample006","GBB","BBB",12,9,21
"628","sample006","GBB","BRB",1,1,2
"629","sample006","GBB","BRR",1,0,1
"630","sample006","GBB","GGG",7,14,21
"631","sample006","GBB","GGR",1,0,1
"632","sample006","GBB","RBG",3,2,5
"633","sample006","GBB","RBR",1,0,1
"634","sample006","GBB","RGG",1,0,1
"635","sample006","GBB","RGR",2,0,2
"636","sample006","GBB","RRR",1,1,2
"637","sample006","GBG","BRB",1,1,2
"638","sample006","GBG","BRR",1,0,1
"639","sample006","GBG","GGG",4,1,5
"640","sample006","GBG","RBB",1,0,1
"641","sample006","GBG","RGR",1,0,1
"642","sample006","GBG","RRG",1,0,1
"643","sample006","GGB","BBB",3,0,3
"644","sample006","GGB","BBR",1,0,1
"645","sample006","GGB","BRR",1,3,4
"646","sample006","GGB","GBG",1,0,1
"647","sample006","GGB","GGG",13,7,20
"648","sample006","GGB","RGG",1,2,3
"649","sample006","GGB","RRG",1,1,2
"650","sample006","GGB","RRR",1,0,1
"651","sample006","GGG","BBB",8,4,12
"652","sample006","GGG","BGG",1,2,3
"653","sample006","GGG","BRB",1,0,1
"654","sample006","GGG","GGB",5,0,5
"655","sample006","GGG","GGR",1,1,2
"656","sample006","GGG","RBB",1,2,3
"657","sample006","GGG","RGR",1,3,4
"658","sample006","GGG","RRG",1,5,6
"659","sample006","GGR","BRR",1,0,1
"660","sample006","GGR","GRR",1,0,1
"661","sample006","GRG","BBB",3,0,3
"662","sample006","GRG","GGB",2,2,4
"663","sample006","GRG","GGG",3,2,5
"664","sample006","GRG","RGR",1,0,1
"665","sample006","GRG","RRG",2,0,2
"666","sample006","GRR","BGB",1,0,1
"667","sample006","RBG","BBB",2,1,3
"668","sample006","RBG","RBB",1,0,1
"669","sample006","RBR","BGB",2,2,4
"670","sample006","RBR","BRB",1,0,1
"671","sample006","RBR","BRR",1,1,2
"672","sample006","RBR","GRR",4,0,4
"673","sample006","RBR","RGG",2,2,4
"674","sample006","RBR","RGR",1,0,1
"675","sample006","RGG","BBR",1,0,1
"676","sample006","RGR","BBB",2,1,3
"677","sample006","RGR","BBR",1,0,1
"678","sample006","RGR","BGB",2,0,2
"679","sample006","RGR","BGG",2,1,3
"680","sample006","RGR","BRR",1,1,2
"681","sample006","RGR","GGB",2,2,4
"682","sample006","RGR","RGG",1,0,1
"683","sample006","RRG","BBB",2,5,7
"684","sample006","RRG","BGB",1,2,3
"685","sample006","RRG","BRB",2,5,7
"686","sample006","RRG","BRR",1,0,1
"687","sample006","RRG","GGG",2,3,5
"688","sample006","RRG","GRG",1,0,1
"689","sample006","RRG","GRR",3,2,5
"690","sample006","RRG","RBB",1,0,1
"691","sample006","RRR","BBR",1,0,1
"692","sample006","RRR","BGB",2,1,3
"693","sample006","RRR","BGG",1,0,1
"694","sample006","RRR","BRB",1,1,2
"695","sample006","RRR","BRR",1,0,1
"696","sample006","RRR","RBB",1,0,1
"697","sample006","RRR","RGR",1,0,1
"698","sample006","RRR","RRG",2,1,3
"699","sample006","BBB","RBG",0,1,1
"700","sample006","BBB","RRR",0,1,1
"701","sample006","BBG","GBB",0,1,1
"702","sample006","BBG","RRR",0,1,1
"703","sample006","BGG","BBB",0,2,2
"704","sample006","BRR","BBB",0,3,3
"705","sample006","BRR","BGG",0,1,1
"706","sample006","BRR","RBB",0,1,1
"707","sample006","GBB","GGB",0,3,3
"708","sample006","GBB","GRG",0,1,1
"709","sample006","GBG","RBG",0,1,1
"710","sample006","GGB","BGG",0,1,1
"711","sample006","GGB","GGR",0,3,3
"712","sample006","GGB","GRR",0,1,1
"713","sample006","GGG","RBG",0,1,1
"714","sample006","GGG","RBR",0,2,2
"715","sample006","GGG","RGG",0,1,1
"716","sample006","GRG","BGG",0,1,1
"717","sample006","GRG","BRB",0,1,1
"718","sample006","GRG","GGR",0,2,2
"719","sample006","GRR","BBB",0,1,1
"720","sample006","GRR","BGG",0,1,1
"721","sample006","GRR","BRB",0,1,1
"722","sample006","GRR","BRR",0,1,1
"723","sample006","RBB","BBR",0,1,1
"724","sample006","RBG","GBB",0,1,1
"725","sample006","RBR","BBB",0,1,1
"726","sample006","RBR","GGB",0,3,3
"727","sample006","RBR","RRR",0,1,1
"728","sample006","RGG","GRR",0,1,1
"729","sample006","RRG","BBR",0,2,2
"730","sample006","RRG","GGR",0,2,2
"731","sample006","RRR","GRR",0,1,1
"732","sample007","BBB","GGG",1,0,1
"733","sample007","BBB","RRG",1,1,2
"734","sample007","BBG","BBB",1,0,1
"735","sample007","BBG","BRB",1,1,2
"736","sample007","BBG","GBG",2,0,2
"737","sample007","BBG","GGB",2,3,5
"738","sample007","BBG","GGG",4,3,7
"739","sample007","BBG","GRG",1,0,1
"740","sample007","BBG","RRG",1,0,1
"741","sample007","BGG","RBG",1,0,1
"742","sample007","BGG","RRR",1,0,1
"743","sample007","BRR","BGB",1,0,1
"744","sample007","GBB","BBB",12,4,16
"745","sample007","GBB","BRB",1,1,2
"746","sample007","GBB","BRR",1,0,1
"747","sample007","GBB","GGG",7,17,24
"748","sample007","GBB","GGR",1,0,1
"749","sample007","GBB","RBG",3,1,4
"750","sample007","GBB","RBR",1,0,1
"751","sample007","GBB","RGG",1,0,1
"752","sample007","GBB","RGR",2,0,2
"753","sample007","GBB","RRR",1,1,2
"754","sample007","GBG","BRB",1,0,1
"755","sample007","GBG","BRR",1,0,1
"756","sample007","GBG","GGG",4,2,6
"757","sample007","GBG","RBB",1,0,1
"758","sample007","GBG","RGR",1,1,2
"759","sample007","GBG","RRG",1,1,2
"760","sample007","GGB","BBB",3,1,4
"761","sample007","GGB","BBR",1,0,1
"762","sample007","GGB","BRR",1,2,3
"763","sample007","GGB","GBG",1,0,1
"764","sample007","GGB","GGG",13,15,28
"765","sample007","GGB","RGG",1,0,1
"766","sample007","GGB","RRG",1,0,1
"767","sample007","GGB","RRR",1,2,3
"768","sample007","GGG","BBB",8,5,13
"769","sample007","GGG","BGG",1,1,2
"770","sample007","GGG","BRB",1,1,2
"771","sample007","GGG","GGB",5,0,5
"772","sample007","GGG","GGR",1,0,1
"773","sample007","GGG","RBB",1,0,1
"774","sample007","GGG","RGR",1,2,3
"775","sample007","GGG","RRG",1,6,7
"776","sample007","GGR","BRR",1,0,1
"777","sample007","GGR","GRR",1,0,1
"778","sample007","GRG","BBB",3,0,3
"779","sample007","GRG","GGB",2,2,4
"780","sample007","GRG","GGG",3,3,6
"781","sample007","GRG","RGR",1,0,1
"782","sample007","GRG","RRG",2,0,2
"783","sample007","GRR","BGB",1,0,1
"784","sample007","RBG","BBB",2,3,5
"785","sample007","RBG","RBB",1,0,1
"786","sample007","RBR","BGB",2,0,2
"787","sample007","RBR","BRB",1,0,1
"788","sample007","RBR","BRR",1,1,2
"789","sample007","RBR","GRR",4,1,5
"790","sample007","RBR","RGG",2,0,2
"791","sample007","RBR","RGR",1,0,1
"792","sample007","RGG","BBR",1,0,1
"793","sample007","RGR","BBB",2,2,4
"794","sample007","RGR","BBR",1,0,1
"795","sample007","RGR","BGB",2,0,2
"796","sample007","RGR","BGG",2,1,3
"797","sample007","RGR","BRR",1,0,1
"798","sample007","RGR","GGB",2,0,2
"799","sample007","RGR","RGG",1,0,1
"800","sample007","RRG","BBB",2,4,6
"801","sample007","RRG","BGB",1,3,4
"802","sample007","RRG","BRB",2,8,10
"803","sample007","RRG","BRR",1,4,5
"804","sample007","RRG","GGG",2,3,5
"805","sample007","RRG","GRG",1,0,1
"806","sample007","RRG","GRR",3,2,5
"807","sample007","RRG","RBB",1,0,1
"808","sample007","RRR","BBR",1,0,1
"809","sample007","RRR","BGB",2,1,3
"810","sample007","RRR","BGG",1,0,1
"811","sample007","RRR","BRB",1,0,1
"812","sample007","RRR","BRR",1,0,1
"813","sample007","RRR","RBB",1,0,1
"814","sample007","RRR","RGR",1,0,1
"815","sample007","RRR","RRG",2,0,2
"816","sample007","BBG","BGB",0,1,1
"817","sample007","BBG","BGG",0,1,1
"818","sample007","BBG","GBB",0,1,1
"819","sample007","BBG","RGR",0,1,1
"820","sample007","BBG","RRR",0,1,1
"821","sample007","BGB","BBB",0,1,1
"822","sample007","BGG","BBB",0,1,1
"823","sample007","BRB","BBB",0,2,2
"824","sample007","BRB","BRR",0,1,1
"825","sample007","BRB","GGG",0,1,1
"826","sample007","BRB","RRR",0,1,1
"827","sample007","BRR","BBB",0,1,1
"828","sample007","GBB","GGB",0,1,1
"829","sample007","GBB","GRG",0,1,1
"830","sample007","GBB","RBB",0,1,1
"831","sample007","GBB","RRG",0,1,1
"832","sample007","GBG","BBB",0,1,1
"833","sample007","GGB","BGB",0,1,1
"834","sample007","GGB","GGR",0,1,1
"835","sample007","GGB","GRR",0,2,2
"836","sample007","GGB","RBR",0,1,1
"837","sample007","GGG","BGB",0,1,1
"838","sample007","GGG","BRR",0,2,2
"839","sample007","GGG","GRR",0,1,1
"840","sample007","GGG","RBG",0,1,1
"841","sample007","GGG","RBR",0,3,3
"842","sample007","GGR","BBB",0,1,1
"843","sample007","GRG","BGG",0,1,1
"844","sample007","GRR","BRR",0,1,1
"845","sample007","GRR","GGG",0,1,1
"846","sample007","RBB","BBR",0,1,1
"847","sample007","RBB","GRR",0,1,1
"848","sample007","RBB","RGG",0,1,1
"849","sample007","RBG","GRR",0,1,1
"850","sample007","RBR","BBB",0,4,4
"851","sample007","RBR","BGG",0,1,1
"852","sample007","RBR","RRR",0,1,1
"853","sample007","RGG","BBB",0,1,1
"854","sample007","RGG","GGR",0,1,1
"855","sample007","RGR","GGR",0,2,2
"856","sample007","RGR","RRG",0,1,1
"857","sample007","RRG","BBR",0,1,1
"858","sample008","BBB","GGG",1,0,1
"859","sample008","BBB","RRG",1,0,1
"860","sample008","BBG","BBB",1,1,2
"861","sample008","BBG","BRB",1,2,3
"862","sample008","BBG","GBG",2,0,2
"863","sample008","BBG","GGB",2,3,5
"864","sample008","BBG","GGG",4,3,7
"865","sample008","BBG","GRG",1,2,3
"866","sample008","BBG","RRG",1,0,1
"867","sample008","BGG","RBG",1,0,1
"868","sample008","BGG","RRR",1,0,1
"869","sample008","BRR","BGB",1,0,1
"870","sample008","GBB","BBB",12,5,17
"871","sample008","GBB","BRB",1,0,1
"872","sample008","GBB","BRR",1,1,2
"873","sample008","GBB","GGG",7,15,22
"874","sample008","GBB","GGR",1,0,1
"875","sample008","GBB","RBG",3,3,6
"876","sample008","GBB","RBR",1,0,1
"877","sample008","GBB","RGG",1,0,1
"878","sample008","GBB","RGR",2,0,2
"879","sample008","GBB","RRR",1,1,2
"880","sample008","GBG","BRB",1,1,2
"881","sample008","GBG","BRR",1,0,1
"882","sample008","GBG","GGG",4,1,5
"883","sample008","GBG","RBB",1,0,1
"884","sample008","GBG","RGR",1,1,2
"885","sample008","GBG","RRG",1,2,3
"886","sample008","GGB","BBB",3,3,6
"887","sample008","GGB","BBR",1,1,2
"888","sample008","GGB","BRR",1,2,3
"889","sample008","GGB","GBG",1,0,1
"890","sample008","GGB","GGG",13,11,24
"891","sample008","GGB","RGG",1,2,3
"892","sample008","GGB","RRG",1,0,1
"893","sample008","GGB","RRR",1,0,1
"894","sample008","GGG","BBB",8,2,10
"895","sample008","GGG","BGG",1,1,2
"896","sample008","GGG","BRB",1,0,1
"897","sample008","GGG","GGB",5,0,5
"898","sample008","GGG","GGR",1,2,3
"899","sample008","GGG","RBB",1,0,1
"900","sample008","GGG","RGR",1,4,5
"901","sample008","GGG","RRG",1,5,6
"902","sample008","GGR","BRR",1,0,1
"903","sample008","GGR","GRR",1,0,1
"904","sample008","GRG","BBB",3,2,5
"905","sample008","GRG","GGB",2,4,6
"906","sample008","GRG","GGG",3,2,5
"907","sample008","GRG","RGR",1,1,2
"908","sample008","GRG","RRG",2,0,2
"909","sample008","GRR","BGB",1,0,1
"910","sample008","RBG","BBB",2,0,2
"911","sample008","RBG","RBB",1,0,1
"912","sample008","RBR","BGB",2,1,3
"913","sample008","RBR","BRB",1,0,1
"914","sample008","RBR","BRR",1,1,2
"915","sample008","RBR","GRR",4,0,4
"916","sample008","RBR","RGG",2,1,3
"917","sample008","RBR","RGR",1,0,1
"918","sample008","RGG","BBR",1,0,1
"919","sample008","RGR","BBB",2,0,2
"920","sample008","RGR","BBR",1,1,2
"921","sample008","RGR","BGB",2,0,2
"922","sample008","RGR","BGG",2,1,3
"923","sample008","RGR","BRR",1,0,1
"924","sample008","RGR","GGB",2,0,2
"925","sample008","RGR","RGG",1,0,1
"926","sample008","RRG","BBB",2,6,8
"927","sample008","RRG","BGB",1,1,2
"928","sample008","RRG","BRB",2,3,5
"929","sample008","RRG","BRR",1,2,3
"930","sample008","RRG","GGG",2,4,6
"931","sample008","RRG","GRG",1,0,1
"932","sample008","RRG","GRR",3,1,4
"933","sample008","RRG","RBB",1,1,2
"934","sample008","RRR","BBR",1,0,1
"935","sample008","RRR","BGB",2,0,2
"936","sample008","RRR","BGG",1,0,1
"937","sample008","RRR","BRB",1,0,1
"938","sample008","RRR","BRR",1,0,1
"939","sample008","RRR","RBB",1,0,1
"940","sample008","RRR","RGR",1,0,1
"941","sample008","RRR","RRG",2,0,2
"942","sample008","BBB","BRB",0,1,1
"943","sample008","BBG","GBB",0,1,1
"944","sample008","BRB","BBB",0,3,3
"945","sample008","BRB","BRR",0,2,2
"946","sample008","BRB","GGR",0,1,1
"947","sample008","BRB","RRR",0,1,1
"948","sample008","BRR","BBB",0,3,3
"949","sample008","GBB","GBG",0,2,2
"950","sample008","GBB","GGB",0,3,3
"951","sample008","GBB","RRG",0,1,1
"952","sample008","GBG","BBB",0,1,1
"953","sample008","GBG","GGB",0,1,1
"954","sample008","GBG","RBG",0,1,1
"955","sample008","GGB","BRB",0,1,1
"956","sample008","GGB","GRR",0,1,1
"957","sample008","GGB","RBB",0,1,1
"958","sample008","GGB","RBR",0,1,1
"959","sample008","GGB","RGR",0,1,1
"960","sample008","GGG","BRR",0,1,1
"961","sample008","GGG","RBG",0,1,1
"962","sample008","GGG","RBR",0,3,3
"963","sample008","GGG","RGG",0,1,1
"964","sample008","GGR","BBB",0,1,1
"965","sample008","GGR","BBR",0,1,1
"966","sample008","GGR","RBB",0,1,1
"967","sample008","GRG","BRB",0,1,1
"968","sample008","GRG","GGR",0,1,1
"969","sample008","GRG","GRR",0,1,1
"970","sample008","GRR","BBR",0,1,1
"971","sample008","GRR","BGG",0,1,1
"972","sample008","RBB","BRB",0,1,1
"973","sample008","RBG","RGR",0,1,1
"974","sample008","RBR","BBB",0,3,3
"975","sample008","RBR","GGB",0,2,2
"976","sample008","RGG","BBB",0,2,2
"977","sample008","RGG","BRR",0,1,1
"978","sample008","RGG","GGG",0,1,1
"979","sample008","RGG","GGR",0,1,1
"980","sample008","RRR","GRR",0,1,1
"981","sample008","RRR","RBR",0,1,1
"982","sample009","BBB","GGG",1,0,1
"983","sample009","BBB","RRG",1,0,1
"984","sample009","BBG","BBB",1,1,2
"985","sample009","BBG","BRB",1,3,4
"986","sample009","BBG","GBG",2,2,4
"987","sample009","BBG","GGB",2,5,7
"988","sample009","BBG","GGG",4,4,8
"989","sample009","BBG","GRG",1,1,2
"990","sample009","BBG","RRG",1,0,1
"991","sample009","BGG","RBG",1,0,1
"992","sample009","BGG","RRR",1,0,1
"993","sample009","BRR","BGB",1,0,1
"994","sample009","GBB","BBB",12,1,13
"995","sample009","GBB","BRB",1,2,3
"996","sample009","GBB","BRR",1,1,2
"997","sample009","GBB","GGG",7,12,19
"998","sample009","GBB","GGR",1,0,1
"999","sample009","GBB","RBG",3,2,5
"1000","sample009","GBB","RBR",1,0,1
"1001","sample009","GBB","RGG",1,0,1
"1002","sample009","GBB","RGR",2,0,2
"1003","sample009","GBB","RRR",1,3,4
"1004","sample009","GBG","BRB",1,0,1
"1005","sample009","GBG","BRR",1,0,1
"1006","sample009","GBG","GGG",4,5,9
"1007","sample009","GBG","RBB",1,0,1
"1008","sample009","GBG","RGR",1,1,2
"1009","sample009","GBG","RRG",1,0,1
"1010","sample009","GGB","BBB",3,3,6
"1011","sample009","GGB","BBR",1,1,2
"1012","sample009","GGB","BRR",1,4,5
"1013","sample009","GGB","GBG",1,0,1
"1014","sample009","GGB","GGG",13,5,18
"1015","sample009","GGB","RGG",1,1,2
"1016","sample009","GGB","RRG",1,1,2
"1017","sample009","GGB","RRR",1,2,3
"1018","sample009","GGG","BBB",8,9,17
"1019","sample009","GGG","BGG",1,0,1
"1020","sample009","GGG","BRB",1,0,1
"1021","sample009","GGG","GGB",5,0,5
"1022","sample009","GGG","GGR",1,0,1
"1023","sample009","GGG","RBB",1,1,2
"1024","sample009","GGG","RGR",1,1,2
"1025","sample009","GGG","RRG",1,4,5
"1026","sample009","GGR","BRR",1,0,1
"1027","sample009","GGR","GRR",1,0,1
"1028","sample009","GRG","BBB",3,1,4
"1029","sample009","GRG","GGB",2,3,5
"1030","sample009","GRG","GGG",3,1,4
"1031","sample009","GRG","RGR",1,1,2
"1032","sample009","GRG","RRG",2,2,4
"1033","sample009","GRR","BGB",1,1,2
"1034","sample009","RBG","BBB",2,2,4
"1035","sample009","RBG","RBB",1,0,1
"1036","sample009","RBR","BGB",2,1,3
"1037","sample009","RBR","BRB",1,0,1
"1038","sample009","RBR","BRR",1,1,2
"1039","sample009","RBR","GRR",4,1,5
"1040","sample009","RBR","RGG",2,2,4
"1041","sample009","RBR","RGR",1,0,1
"1042","sample009","RGG","BBR",1,0,1
"1043","sample009","RGR","BBB",2,0,2
"1044","sample009","RGR","BBR",1,0,1
"1045","sample009","RGR","BGB",2,2,4
"1046","sample009","RGR","BGG",2,0,2
"1047","sample009","RGR","BRR",1,0,1
"1048","sample009","RGR","GGB",2,3,5
"1049","sample009","RGR","RGG",1,0,1
"1050","sample009","RRG","BBB",2,4,6
"1051","sample009","RRG","BGB",1,1,2
"1052","sample009","RRG","BRB",2,6,8
"1053","sample009","RRG","BRR",1,1,2
"1054","sample009","RRG","GGG",2,3,5
"1055","sample009","RRG","GRG",1,0,1
"1056","sample009","RRG","GRR",3,0,3
"1057","sample009","RRG","RBB",1,0,1
"1058","sample009","RRR","BBR",1,0,1
"1059","sample009","RRR","BGB",2,0,2
"1060","sample009","RRR","BGG",1,0,1
"1061","sample009","RRR","BRB",1,0,1
"1062","sample009","RRR","BRR",1,1,2
"1063","sample009","RRR","RBB",1,0,1
"1064","sample009","RRR","RGR",1,0,1
"1065","sample009","RRR","RRG",2,0,2
"1066","sample009","BBB","RBG",0,1,1
"1067","sample009","BBB","RRR",0,1,1
"1068","sample009","BBG","BGB",0,1,1
"1069","sample009","BBG","GRR",0,1,1
"1070","sample009","BBG","RBG",0,2,2
"1071","sample009","BBG","RRR",0,2,2
"1072","sample009","BGB","BBB",0,1,1
"1073","sample009","BGG","BBR",0,1,1
"1074","sample009","BGG","RGG",0,1,1
"1075","sample009","BRB","BBB",0,2,2
"1076","sample009","BRB","BBR",0,1,1
"1077","sample009","BRR","BBB",0,1,1
"1078","sample009","BRR","RBB",0,1,1
"1079","sample009","GBB","GBG",0,1,1
"1080","sample009","GBB","GGB",0,1,1
"1081","sample009","GBB","GRG",0,1,1
"1082","sample009","GBG","BBB",0,2,2
"1083","sample009","GGB","BGG",0,1,1
"1084","sample009","GGB","GGR",0,1,1
"1085","sample009","GGB","RBG",0,1,1
"1086","sample009","GGB","RBR",0,1,1
"1087","sample009","GGG","RBR",0,3,3
"1088","sample009","GGG","RRR",0,1,1
"1089","sample009","GGR","BBR",0,1,1
"1090","sample009","GGR","RBB",0,1,1
"1091","sample009","GRG","BRR",0,1,1
"1092","sample009","GRG","GGR",0,1,1
"1093","sample009","GRR","BGG",0,1,1
"1094","sample009","GRR","BRB",0,1,1
"1095","sample009","GRR","GGR",0,1,1
"1096","sample009","RBB","BBR",0,1,1
"1097","sample009","RBG","GRR",0,1,1
"1098","sample009","RBG","RBR",0,1,1
"1099","sample009","RBR","BBB",0,3,3
"1100","sample009","RGG","BRR",0,1,1
"1101","sample009","RGG","GRR",0,4,4
"1102","sample009","RRR","GRR",0,1,1
"1103","sample010","BBB","GGG",1,0,1
"1104","sample010","BBB","RRG",1,0,1
"1105","sample010","BBG","BBB",1,0,1
"1106","sample010","BBG","BRB",1,1,2
"1107","sample010","BBG","GBG",2,1,3
"1108","sample010","BBG","GGB",2,4,6
"1109","sample010","BBG","GGG",4,7,11
"1110","sample010","BBG","GRG",1,1,2
"1111","sample010","BBG","RRG",1,0,1
"1112","sample010","BGG","RBG",1,0,1
"1113","sample010","BGG","RRR",1,0,1
"1114","sample010","BRR","BGB",1,0,1
"1115","sample010","GBB","BBB",12,5,17
"1116","sample010","GBB","BRB",1,2,3
"1117","sample010","GBB","BRR",1,1,2
"1118","sample010","GBB","GGG",7,15,22
"1119","sample010","GBB","GGR",1,0,1
"1120","sample010","GBB","RBG",3,1,4
"1121","sample010","GBB","RBR",1,0,1
"1122","sample010","GBB","RGG",1,0,1
"1123","sample010","GBB","RGR",2,0,2
"1124","sample010","GBB","RRR",1,1,2
"1125","sample010","GBG","BRB",1,1,2
"1126","sample010","GBG","BRR",1,0,1
"1127","sample010","GBG","GGG",4,1,5
"1128","sample010","GBG","RBB",1,0,1
"1129","sample010","GBG","RGR",1,0,1
"1130","sample010","GBG","RRG",1,0,1
"1131","sample010","GGB","BBB",3,2,5
"1132","sample010","GGB","BBR",1,0,1
"1133","sample010","GGB","BRR",1,2,3
"1134","sample010","GGB","GBG",1,0,1
"1135","sample010","GGB","GGG",13,3,16
"1136","sample010","GGB","RGG",1,2,3
"1137","sample010","GGB","RRG",1,2,3
"1138","sample010","GGB","RRR",1,1,2
"1139","sample010","GGG","BBB",8,2,10
"1140","sample010","GGG","BGG",1,0,1
"1141","sample010","GGG","BRB",1,0,1
"1142","sample010","GGG","GGB",5,0,5
"1143","sample010","GGG","GGR",1,0,1
"1144","sample010","GGG","RBB",1,2,3
"1145","sample010","GGG","RGR",1,3,4
"1146","sample010","GGG","RRG",1,5,6
"1147","sample010","GGR","BRR",1,0,1
"1148","sample010","GGR","GRR",1,0,1
"1149","sample010","GRG","BBB",3,1,4
"1150","sample010","GRG","GGB",2,3,5
"1151","sample010","GRG","GGG",3,2,5
"1152","sample010","GRG","RGR",1,0,1
"1153","sample010","GRG","RRG",2,0,2
"1154","sample010","GRR","BGB",1,1,2
"1155","sample010","RBG","BBB",2,3,5
"1156","sample010","RBG","RBB",1,0,1
"1157","sample010","RBR","BGB",2,1,3
"1158","sample010","RBR","BRB",1,0,1
"1159","sample010","RBR","BRR",1,1,2
"1160","sample010","RBR","GRR",4,2,6
"1161","sample010","RBR","RGG",2,3,5
"1162","sample010","RBR","RGR",1,0,1
"1163","sample010","RGG","BBR",1,0,1
"1164","sample010","RGR","BBB",2,1,3
"1165","sample010","RGR","BBR",1,0,1
"1166","sample010","RGR","BGB",2,0,2
"1167","sample010","RGR","BGG",2,0,2
"1168","sample010","RGR","BRR",1,1,2
"1169","sample010","RGR","GGB",2,1,3
"1170","sample010","RGR","RGG",1,1,2
"1171","sample010","RRG","BBB",2,5,7
"1172","sample010","RRG","BGB",1,3,4
"1173","sample010","RRG","BRB",2,4,6
"1174","sample010","RRG","BRR",1,0,1
"1175","sample010","RRG","GGG",2,1,3
"1176","sample010","RRG","GRG",1,0,1
"1177","sample010","RRG","GRR",3,2,5
"1178","sample010","RRG","RBB",1,0,1
"1179","sample010","RRR","BBR",1,0,1
"1180","sample010","RRR","BGB",2,1,3
"1181","sample010","RRR","BGG",1,0,1
"1182","sample010","RRR","BRB",1,1,2
"1183","sample010","RRR","BRR",1,0,1
"1184","sample010","RRR","RBB",1,0,1
"1185","sample010","RRR","RGR",1,0,1
"1186","sample010","RRR","RRG",2,0,2
"1187","sample010","BBB","GRR",0,1,1
"1188","sample010","BBG","BGB",0,1,1
"1189","sample010","BBG","GRR",0,1,1
"1190","sample010","BBG","RBB",0,1,1
"1191","sample010","BBG","RBG",0,1,1
"1192","sample010","BBG","RRR",0,2,2
"1193","sample010","BRB","BBB",0,1,1
"1194","sample010","BRB","RRR",0,1,1
"1195","sample010","BRR","BBB",0,3,3
"1196","sample010","GBB","GBG",0,1,1
"1197","sample010","GBB","GGB",0,2,2
"1198","sample010","GBB","GRG",0,3,3
"1199","sample010","GBG","BBB",0,3,3
"1200","sample010","GBG","GGB",0,2,2
"1201","sample010","GGB","GGR",0,1,1
"1202","sample010","GGB","GRR",0,1,1
"1203","sample010","GGB","RBB",0,1,1
"1204","sample010","GGB","RBG",0,2,2
"1205","sample010","GGG","BRR",0,2,2
"1206","sample010","GGG","RBG",0,1,1
"1207","sample010","GGG","RBR",0,2,2
"1208","sample010","GGG","RRR",0,1,1
"1209","sample010","GGR","BBB",0,1,1
"1210","sample010","GRG","BRB",0,1,1
"1211","sample010","GRG","GBG",0,1,1
"1212","sample010","GRG","GGR",0,2,2
"1213","sample010","GRG","RBG",0,1,1
"1214","sample010","GRR","BGG",0,1,1
"1215","sample010","GRR","BRB",0,1,1
"1216","sample010","GRR","BRR",0,1,1
"1217","sample010","GRR","GGR",0,1,1
"1218","sample010","RBR","BBB",0,4,4
"1219","sample010","RBR","BGG",0,2,2
"1220","sample010","RBR","GGB",0,1,1
"1221","sample010","RGG","BRR",0,1,1
"1222","sample010","RGR","GGR",0,1,1
"1223","sample010","RGR","RRG",0,1,1
"1224","sample010","RRG","GGR",0,1,1
"1225","sample010","RRR","GGR",0,1,1
"1226","sample010","RRR","GRR",0,1,1
"1227","sample011","BBB","GGG",1,0,1
"1228","sample011","BBB","RRG",1,1,2
"1229","sample011","BBG","BBB",1,0,1
"1230","sample011","BBG","BRB",1,3,4
"1231","sample011","BBG","GBG",2,0,2
"1232","sample011","BBG","GGB",2,6,8
"1233","sample011","BBG","GGG",4,2,6
"1234","sample011","BBG","GRG",1,3,4
"1235","sample011","BBG","RRG",1,0,1
"1236","sample011","BGG","RBG",1,0,1
"1237","sample011","BGG","RRR",1,0,1
"1238","sample011","BRR","BGB",1,0,1
"1239","sample011","GBB","BBB",12,7,19
"1240","sample011","GBB","BRB",1,0,1
"1241","sample011","GBB","BRR",1,1,2
"1242","sample011","GBB","GGG",7,8,15
"1243","sample011","GBB","GGR",1,0,1
"1244","sample011","GBB","RBG",3,1,4
"1245","sample011","GBB","RBR",1,0,1
"1246","sample011","GBB","RGG",1,0,1
"1247","sample011","GBB","RGR",2,1,3
"1248","sample011","GBB","RRR",1,3,4
"1249","sample011","GBG","BRB",1,1,2
"1250","sample011","GBG","BRR",1,0,1
"1251","sample011","GBG","GGG",4,1,5
"1252","sample011","GBG","RBB",1,0,1
"1253","sample011","GBG","RGR",1,0,1
"1254","sample011","GBG","RRG",1,0,1
"1255","sample011","GGB","BBB",3,2,5
"1256","sample011","GGB","BBR",1,0,1
"1257","sample011","GGB","BRR",1,0,1
"1258","sample011","GGB","GBG",1,0,1
"1259","sample011","GGB","GGG",13,6,19
"1260","sample011","GGB","RGG",1,0,1
"1261","sample011","GGB","RRG",1,0,1
"1262","sample011","GGB","RRR",1,1,2
"1263","sample011","GGG","BBB",8,7,15
"1264","sample011","GGG","BGG",1,0,1
"1265","sample011","GGG","BRB",1,1,2
"1266","sample011","GGG","GGB",5,0,5
"1267","sample011","GGG","GGR",1,2,3
"1268","sample011","GGG","RBB",1,1,2
"1269","sample011","GGG","RGR",1,3,4
"1270","sample011","GGG","RRG",1,5,6
"1271","sample011","GGR","BRR",1,0,1
"1272","sample011","GGR","GRR",1,0,1
"1273","sample011","GRG","BBB",3,1,4
"1274","sample011","GRG","GGB",2,1,3
"1275","sample011","GRG","GGG",3,3,6
"1276","sample011","GRG","RGR",1,1,2
"1277","sample011","GRG","RRG",2,1,3
"1278","sample011","GRR","BGB",1,1,2
"1279","sample011","RBG","BBB",2,3,5
"1280","sample011","RBG","RBB",1,0,1
"1281","sample011","RBR","BGB",2,0,2
"1282","sample011","RBR","BRB",1,0,1
"1283","sample011","RBR","BRR",1,0,1
"1284","sample011","RBR","GRR",4,0,4
"1285","sample011","RBR","RGG",2,1,3
"1286","sample011","RBR","RGR",1,0,1
"1287","sample011","RGG","BBR",1,1,2
"1288","sample011","RGR","BBB",2,1,3
"1289","sample011","RGR","BBR",1,0,1
"1290","sample011","RGR","BGB",2,1,3
"1291","sample011","RGR","BGG",2,0,2
"1292","sample011","RGR","BRR",1,1,2
"1293","sample011","RGR","GGB",2,0,2
"1294","sample011","RGR","RGG",1,0,1
"1295","sample011","RRG","BBB",2,4,6
"1296","sample011","RRG","BGB",1,2,3
"1297","sample011","RRG","BRB",2,6,8
"1298","sample011","RRG","BRR",1,2,3
"1299","sample011","RRG","GGG",2,6,8
"1300","sample011","RRG","GRG",1,0,1
"1301","sample011","RRG","GRR",3,2,5
"1302","sample011","RRG","RBB",1,0,1
"1303","sample011","RRR","BBR",1,0,1
"1304","sample011","RRR","BGB",2,0,2
"1305","sample011","RRR","BGG",1,0,1
"1306","sample011","RRR","BRB",1,1,2
"1307","sample011","RRR","BRR",1,0,1
"1308","sample011","RRR","RBB",1,0,1
"1309","sample011","RRR","RGR",1,1,2
"1310","sample011","RRR","RRG",2,0,2
"1311","sample011","BBB","RRR",0,1,1
"1312","sample011","BBG","GRR",0,1,1
"1313","sample011","BBG","RBG",0,2,2
"1314","sample011","BBG","RRR",0,1,1
"1315","sample011","BRB","BBB",0,2,2
"1316","sample011","BRB","RGR",0,1,1
"1317","sample011","BRR","BBB",0,1,1
"1318","sample011","BRR","RBB",0,1,1
"1319","sample011","GBB","GGB",0,6,6
"1320","sample011","GBB","GRG",0,1,1
"1321","sample011","GBB","GRR",0,1,1
"1322","sample011","GBG","BBR",0,1,1
"1323","sample011","GBG","RGG",0,1,1
"1324","sample011","GGB","BGG",0,1,1
"1325","sample011","GGB","GBB",0,1,1
"1326","sample011","GGB","GGR",0,1,1
"1327","sample011","GGB","GRR",0,2,2
"1328","sample011","GGB","RBB",0,1,1
"1329","sample011","GGB","RBR",0,2,2
"1330","sample011","GGG","BRR",0,1,1
"1331","sample011","GGG","RBG",0,2,2
"1332","sample011","GGG","RBR",0,4,4
"1333","sample011","GRG","BRB",0,1,1
"1334","sample011","GRG","GGR",0,1,1
"1335","sample011","RBB","RGG",0,1,1
"1336","sample011","RBG","BBG",0,1,1
"1337","sample011","RBG","RGR",0,1,1
"1338","sample011","RBR","BBB",0,1,1
"1339","sample011","RBR","GGB",0,2,2
"1340","sample011","RBR","RBB",0,1,1
"1341","sample011","RBR","RRR",0,1,1
"1342","sample011","RGG","BBB",0,2,2
"1343","sample011","RGG","BRR",0,2,2
"1344","sample011","RGR","GGR",0,1,1
"1345","sample011","RRG","BGG",0,1,1
"1346","sample011","RRG","GGR",0,1,1
"1347","sample011","RRG","RGG",0,1,1
"1348","sample011","RRR","RGG",0,1,1
"1349","sample012","BBB","GGG",1,1,2
"1350","sample012","BBB","RRG",1,0,1
"1351","sample012","BBG","BBB",1,1,2
"1352","sample012","BBG","BRB",1,6,7
"1353","sample012","BBG","GBG",2,0,2
"1354","sample012","BBG","GGB",2,2,4
"1355","sample012","BBG","GGG",4,5,9
"1356","sample012","BBG","GRG",1,1,2
"1357","sample012","BBG","RRG",1,1,2
"1358","sample012","BGG","RBG",1,0,1
"1359","sample012","BGG","RRR",1,0,1
"1360","sample012","BRR","BGB",1,0,1
"1361","sample012","GBB","BBB",12,4,16
"1362","sample012","GBB","BRB",1,1,2
"1363","sample012","GBB","BRR",1,1,2
"1364","sample012","GBB","GGG",7,15,22
"1365","sample012","GBB","GGR",1,0,1
"1366","sample012","GBB","RBG",3,1,4
"1367","sample012","GBB","RBR",1,0,1
"1368","sample012","GBB","RGG",1,0,1
"1369","sample012","GBB","RGR",2,0,2
"1370","sample012","GBB","RRR",1,2,3
"1371","sample012","GBG","BRB",1,0,1
"1372","sample012","GBG","BRR",1,0,1
"1373","sample012","GBG","GGG",4,2,6
"1374","sample012","GBG","RBB",1,0,1
"1375","sample012","GBG","RGR",1,0,1
"1376","sample012","GBG","RRG",1,0,1
"1377","sample012","GGB","BBB",3,1,4
"1378","sample012","GGB","BBR",1,0,1
"1379","sample012","GGB","BRR",1,1,2
"1380","sample012","GGB","GBG",1,0,1
"1381","sample012","GGB","GGG",13,8,21
"1382","sample012","GGB","RGG",1,0,1
"1383","sample012","GGB","RRG",1,2,3
"1384","sample012","GGB","RRR",1,0,1
"1385","sample012","GGG","BBB",8,6,14
"1386","sample012","GGG","BGG",1,2,3
"1387","sample012","GGG","BRB",1,0,1
"1388","sample012","GGG","GGB",5,0,5
"1389","sample012","GGG","GGR",1,1,2
"1390","sample012","GGG","RBB",1,2,3
"1391","sample012","GGG","RGR",1,1,2
"1392","sample012","GGG","RRG",1,5,6
"1393","sample012","GGR","BRR",1,0,1
"1394","sample012","GGR","GRR",1,0,1
"1395","sample012","GRG","BBB",3,1,4
"1396","sample012","GRG","GGB",2,2,4
"1397","sample012","GRG","GGG",3,1,4
"1398","sample012","GRG","RGR",1,0,1
"1399","sample012","GRG","RRG",2,0,2
"1400","sample012","GRR","BGB",1,0,1
"1401","sample012","RBG","BBB",2,3,5
"1402","sample012","RBG","RBB",1,0,1
"1403","sample012","RBR","BGB",2,1,3
"1404","sample012","RBR","BRB",1,0,1
"1405","sample012","RBR","BRR",1,1,2
"1406","sample012","RBR","GRR",4,0,4
"1407","sample012","RBR","RGG",2,1,3
"1408","sample012","RBR","RGR",1,0,1
"1409","sample012","RGG","BBR",1,0,1
"1410","sample012","RGR","BBB",2,0,2
"1411","sample012","RGR","BBR",1,0,1
"1412","sample012","RGR","BGB",2,3,5
"1413","sample012","RGR","BGG",2,0,2
"1414","sample012","RGR","BRR",1,0,1
"1415","sample012","RGR","GGB",2,3,5
"1416","sample012","RGR","RGG",1,0,1
"1417","sample012","RRG","BBB",2,3,5
"1418","sample012","RRG","BGB",1,1,2
"1419","sample012","RRG","BRB",2,12,14
"1420","sample012","RRG","BRR",1,1,2
"1421","sample012","RRG","GGG",2,1,3
"1422","sample012","RRG","GRG",1,0,1
"1423","sample012","RRG","GRR",3,2,5
"1424","sample012","RRG","RBB",1,0,1
"1425","sample012","RRR","BBR",1,0,1
"1426","sample012","RRR","BGB",2,0,2
"1427","sample012","RRR","BGG",1,0,1
"1428","sample012","RRR","BRB",1,0,1
"1429","sample012","RRR","BRR",1,0,1
"1430","sample012","RRR","RBB",1,1,2
"1431","sample012","RRR","RGR",1,0,1
"1432","sample012","RRR","RRG",2,0,2
"1433","sample012","BBB","BRB",0,1,1
"1434","sample012","BBB","GRR",0,1,1
"1435","sample012","BBB","RBG",0,1,1
"1436","sample012","BBG","RRR",0,1,1
"1437","sample012","BGG","BBR",0,1,1
"1438","sample012","BRB","BBB",0,2,2
"1439","sample012","BRB","BRR",0,1,1
"1440","sample012","BRR","BBB",0,1,1
"1441","sample012","BRR","RBB",0,1,1
"1442","sample012","GBB","BGG",0,1,1
"1443","sample012","GBB","GGB",0,5,5
"1444","sample012","GBB","GRG",0,1,1
"1445","sample012","GBB","RRG",0,2,2
"1446","sample012","GGB","BGB",0,1,1
"1447","sample012","GGB","GGR",0,1,1
"1448","sample012","GGB","GRR",0,2,2
"1449","sample012","GGB","RBG",0,1,1
"1450","sample012","GGB","RBR",0,2,2
"1451","sample012","GGG","GRR",0,1,1
"1452","sample012","GGG","RBG",0,1,1
"1453","sample012","GGG","RBR",0,2,2
"1454","sample012","GGR","BBB",0,1,1
"1455","sample012","GGR","BGG",0,1,1
"1456","sample012","GRG","BBR",0,1,1
"1457","sample012","GRG","BGG",0,1,1
"1458","sample012","GRG","GGR",0,1,1
"1459","sample012","RBB","BBR",0,1,1
"1460","sample012","RBR","BBB",0,2,2
"1461","sample012","RBR","GGB",0,2,2
"1462","sample012","RBR","RBB",0,1,1
"1463","sample012","RBR","RRR",0,1,1
"1464","sample012","RGG","BBB",0,2,2
"1465","sample012","RGG","BGB",0,1,1
"1466","sample012","RGG","GRR",0,1,1
"1467","sample012","RGR","GGR",0,1,1
"1468","sample012","RGR","RRG",0,1,1
"1469","sample012","RRG","BBR",0,1,1
"1470","sample012","RRR","RBR",0,1,1
"1471","sample012","RRR","RGG",0,1,1
"1472","sample013","BBB","GGG",1,1,2
"1473","sample013","BBB","RRG",1,0,1
"1474","sample013","BBG","BBB",1,0,1
"1475","sample013","BBG","BRB",1,6,7
"1476","sample013","BBG","GBG",2,2,4
"1477","sample013","BBG","GGB",2,1,3
"1478","sample013","BBG","GGG",4,5,9
"1479","sample013","BBG","GRG",1,1,2
"1480","sample013","BBG","RRG",1,0,1
"1481","sample013","BGG","RBG",1,0,1
"1482","sample013","BGG","RRR",1,0,1
"1483","sample013","BRR","BGB",1,0,1
"1484","sample013","GBB","BBB",12,11,23
"1485","sample013","GBB","BRB",1,3,4
"1486","sample013","GBB","BRR",1,0,1
"1487","sample013","GBB","GGG",7,10,17
"1488","sample013","GBB","GGR",1,1,2
"1489","sample013","GBB","RBG",3,0,3
"1490","sample013","GBB","RBR",1,0,1
"1491","sample013","GBB","RGG",1,0,1
"1492","sample013","GBB","RGR",2,0,2
"1493","sample013","GBB","RRR",1,1,2
"1494","sample013","GBG","BRB",1,1,2
"1495","sample013","GBG","BRR",1,0,1
"1496","sample013","GBG","GGG",4,0,4
"1497","sample013","GBG","RBB",1,0,1
"1498","sample013","GBG","RGR",1,0,1
"1499","sample013","GBG","RRG",1,0,1
"1500","sample013","GGB","BBB",3,2,5
"1501","sample013","GGB","BBR",1,0,1
"1502","sample013","GGB","BRR",1,7,8
"1503","sample013","GGB","GBG",1,0,1
"1504","sample013","GGB","GGG",13,6,19
"1505","sample013","GGB","RGG",1,1,2
"1506","sample013","GGB","RRG",1,0,1
"1507","sample013","GGB","RRR",1,0,1
"1508","sample013","GGG","BBB",8,2,10
"1509","sample013","GGG","BGG",1,2,3
"1510","sample013","GGG","BRB",1,2,3
"1511","sample013","GGG","GGB",5,0,5
"1512","sample013","GGG","GGR",1,1,2
"1513","sample013","GGG","RBB",1,0,1
"1514","sample013","GGG","RGR",1,0,1
"1515","sample013","GGG","RRG",1,4,5
"1516","sample013","GGR","BRR",1,0,1
"1517","sample013","GGR","GRR",1,0,1
"1518","sample013","GRG","BBB",3,1,4
"1519","sample013","GRG","GGB",2,3,5
"1520","sample013","GRG","GGG",3,2,5
"1521","sample013","GRG","RGR",1,0,1
"1522","sample013","GRG","RRG",2,1,3
"1523","sample013","GRR","BGB",1,0,1
"1524","sample013","RBG","BBB",2,4,6
"1525","sample013","RBG","RBB",1,1,2
"1526","sample013","RBR","BGB",2,1,3
"1527","sample013","RBR","BRB",1,0,1
"1528","sample013","RBR","BRR",1,1,2
"1529","sample013","RBR","GRR",4,0,4
"1530","sample013","RBR","RGG",2,4,6
"1531","sample013","RBR","RGR",1,0,1
"1532","sample013","RGG","BBR",1,1,2
"1533","sample013","RGR","BBB",2,2,4
"1534","sample013","RGR","BBR",1,0,1
"1535","sample013","RGR","BGB",2,0,2
"1536","sample013","RGR","BGG",2,0,2
"1537","sample013","RGR","BRR",1,0,1
"1538","sample013","RGR","GGB",2,1,3
"1539","sample013","RGR","RGG",1,0,1
"1540","sample013","RRG","BBB",2,5,7
"1541","sample013","RRG","BGB",1,2,3
"1542","sample013","RRG","BRB",2,6,8
"1543","sample013","RRG","BRR",1,4,5
"1544","sample013","RRG","GGG",2,3,5
"1545","sample013","RRG","GRG",1,0,1
"1546","sample013","RRG","GRR",3,0,3
"1547","sample013","RRG","RBB",1,0,1
"1548","sample013","RRR","BBR",1,0,1
"1549","sample013","RRR","BGB",2,0,2
"1550","sample013","RRR","BGG",1,0,1
"1551","sample013","RRR","BRB",1,0,1
"1552","sample013","RRR","BRR",1,0,1
"1553","sample013","RRR","RBB",1,0,1
"1554","sample013","RRR","RGR",1,1,2
"1555","sample013","RRR","RRG",2,0,2
"1556","sample013","BBB","BRB",0,1,1
"1557","sample013","BBG","BGB",0,1,1
"1558","sample013","BBG","RRR",0,1,1
"1559","sample013","BRB","BBB",0,4,4
"1560","sample013","BRB","BRR",0,1,1
"1561","sample013","BRB","RBB",0,1,1
"1562","sample013","BRR","BBB",0,3,3
"1563","sample013","BRR","RBB",0,1,1
"1564","sample013","GBB","GGB",0,3,3
"1565","sample013","GBB","GRG",0,2,2
"1566","sample013","GBG","BBB",0,1,1
"1567","sample013","GBG","GGB",0,1,1
"1568","sample013","GBG","RGG",0,1,1
"1569","sample013","GGB","BRB",0,1,1
"1570","sample013","GGB","GGR",0,1,1
"1571","sample013","GGG","BGB",0,1,1
"1572","sample013","GGG","BRR",0,1,1
"1573","sample013","GGG","RBR",0,3,3
"1574","sample013","GGG","RRR",0,1,1
"1575","sample013","GRG","BBR",0,1,1
"1576","sample013","GRG","BRB",0,1,1
"1577","sample013","GRG","GGR",0,1,1
"1578","sample013","GRR","BGG",0,1,1
"1579","sample013","RBB","GRR",0,1,1
"1580","sample013","RBG","BBG",0,1,1
"1581","sample013","RBR","BBB",0,2,2
"1582","sample013","RBR","BGG",0,1,1
"1583","sample013","RBR","GGB",0,3,3
"1584","sample013","RBR","RRR",0,1,1
"1585","sample013","RGG","BRR",0,1,1
"1586","sample013","RGG","GGG",0,1,1
"1587","sample013","RGG","GGR",0,1,1
"1588","sample013","RGG","GRR",0,1,1
"1589","sample013","RGR","RBB",0,1,1
"1590","sample014","BBB","GGG",1,1,2
"1591","sample014","BBB","RRG",1,1,2
"1592","sample014","BBG","BBB",1,1,2
"1593","sample014","BBG","BRB",1,6,7
"1594","sample014","BBG","GBG",2,0,2
"1595","sample014","BBG","GGB",2,3,5
"1596","sample014","BBG","GGG",4,4,8
"1597","sample014","BBG","GRG",1,3,4
"1598","sample014","BBG","RRG",1,0,1
"1599","sample014","BGG","RBG",1,0,1
"1600","sample014","BGG","RRR",1,0,1
"1601","sample014","BRR","BGB",1,0,1
"1602","sample014","GBB","BBB",12,7,19
"1603","sample014","GBB","BRB",1,3,4
"1604","sample014","GBB","BRR",1,0,1
"1605","sample014","GBB","GGG",7,10,17
"1606","sample014","GBB","GGR",1,1,2
"1607","sample014","GBB","RBG",3,1,4
"1608","sample014","GBB","RBR",1,0,1
"1609","sample014","GBB","RGG",1,0,1
"1610","sample014","GBB","RGR",2,1,3
"1611","sample014","GBB","RRR",1,2,3
"1612","sample014","GBG","BRB",1,1,2
"1613","sample014","GBG","BRR",1,0,1
"1614","sample014","GBG","GGG",4,2,6
"1615","sample014","GBG","RBB",1,0,1
"1616","sample014","GBG","RGR",1,0,1
"1617","sample014","GBG","RRG",1,1,2
"1618","sample014","GGB","BBB",3,0,3
"1619","sample014","GGB","BBR",1,2,3
"1620","sample014","GGB","BRR",1,3,4
"1621","sample014","GGB","GBG",1,0,1
"1622","sample014","GGB","GGG",13,8,21
"1623","sample014","GGB","RGG",1,0,1
"1624","sample014","GGB","RRG",1,0,1
"1625","sample014","GGB","RRR",1,2,3
"1626","sample014","GGG","BBB",8,3,11
"1627","sample014","GGG","BGG",1,2,3
"1628","sample014","GGG","BRB",1,1,2
"1629","sample014","GGG","GGB",5,1,6
"1630","sample014","GGG","GGR",1,3,4
"1631","sample014","GGG","RBB",1,1,2
"1632","sample014","GGG","RGR",1,2,3
"1633","sample014","GGG","RRG",1,4,5
"1634","sample014","GGR","BRR",1,0,1
"1635","sample014","GGR","GRR",1,0,1
"1636","sample014","GRG","BBB",3,2,5
"1637","sample014","GRG","GGB",2,2,4
"1638","sample014","GRG","GGG",3,1,4
"1639","sample014","GRG","RGR",1,1,2
"1640","sample014","GRG","RRG",2,1,3
"1641","sample014","GRR","BGB",1,0,1
"1642","sample014","RBG","BBB",2,2,4
"1643","sample014","RBG","RBB",1,0,1
"1644","sample014","RBR","BGB",2,1,3
"1645","sample014","RBR","BRB",1,0,1
"1646","sample014","RBR","BRR",1,0,1
"1647","sample014","RBR","GRR",4,1,5
"1648","sample014","RBR","RGG",2,0,2
"1649","sample014","RBR","RGR",1,0,1
"1650","sample014","RGG","BBR",1,0,1
"1651","sample014","RGR","BBB",2,1,3
"1652","sample014","RGR","BBR",1,0,1
"1653","sample014","RGR","BGB",2,0,2
"1654","sample014","RGR","BGG",2,0,2
"1655","sample014","RGR","BRR",1,0,1
"1656","sample014","RGR","GGB",2,2,4
"1657","sample014","RGR","RGG",1,0,1
"1658","sample014","RRG","BBB",2,5,7
"1659","sample014","RRG","BGB",1,3,4
"1660","sample014","RRG","BRB",2,3,5
"1661","sample014","RRG","BRR",1,1,2
"1662","sample014","RRG","GGG",2,0,2
"1663","sample014","RRG","GRG",1,0,1
"1664","sample014","RRG","GRR",3,3,6
"1665","sample014","RRG","RBB",1,0,1
"1666","sample014","RRR","BBR",1,0,1
"1667","sample014","RRR","BGB",2,1,3
"1668","sample014","RRR","BGG",1,0,1
"1669","sample014","RRR","BRB",1,0,1
"1670","sample014","RRR","BRR",1,0,1
"1671","sample014","RRR","RBB",1,0,1
"1672","sample014","RRR","RGR",1,1,2
"1673","sample014","RRR","RRG",2,0,2
"1674","sample014","BBG","RBG",0,1,1
"1675","sample014","BBG","RRR",0,1,1
"1676","sample014","BGB","RRG",0,1,1
"1677","sample014","BGG","BBB",0,1,1
"1678","sample014","BRB","BBB",0,4,4
"1679","sample014","BRB","RBB",0,1,1
"1680","sample014","BRR","BBB",0,2,2
"1681","sample014","GBB","GGB",0,2,2
"1682","sample014","GBB","GRG",0,1,1
"1683","sample014","GBB","GRR",0,1,1
"1684","sample014","GGB","BGB",0,1,1
"1685","sample014","GGB","GGR",0,1,1
"1686","sample014","GGB","RGR",0,1,1
"1687","sample014","GGG","GRR",0,1,1
"1688","sample014","GGG","RBR",0,5,5
"1689","sample014","GGR","BBB",0,2,2
"1690","sample014","GGR","BBR",0,1,1
"1691","sample014","GRG","BRB",0,2,2
"1692","sample014","GRG","RBR",0,1,1
"1693","sample014","GRR","BGG",0,1,1
"1694","sample014","GRR","GGR",0,1,1
"1695","sample014","RBB","BBB",0,1,1
"1696","sample014","RBG","RGR",0,1,1
"1697","sample014","RBR","BBB",0,2,2
"1698","sample014","RBR","GGB",0,3,3
"1699","sample014","RGG","BBB",0,4,4
"1700","sample014","RGG","GGG",0,1,1
"1701","sample014","RGG","GRR",0,1,1
"1702","sample014","RRG","BBR",0,1,1
"1703","sample014","RRG","GGR",0,1,1
"1704","sample014","RRR","GRR",0,2,2
"1705","sample015","BBB","GGG",1,1,2
"1706","sample015","BBB","RRG",1,0,1
"1707","sample015","BBG","BBB",1,1,2
"1708","sample015","BBG","BRB",1,2,3
"1709","sample015","BBG","GBG",2,2,4
"1710","sample015","BBG","GGB",2,5,7
"1711","sample015","BBG","GGG",4,5,9
"1712","sample015","BBG","GRG",1,0,1
"1713","sample015","BBG","RRG",1,1,2
"1714","sample015","BGG","RBG",1,0,1
"1715","sample015","BGG","RRR",1,0,1
"1716","sample015","BRR","BGB",1,0,1
"1717","sample015","GBB","BBB",12,5,17
"1718","sample015","GBB","BRB",1,3,4
"1719","sample015","GBB","BRR",1,0,1
"1720","sample015","GBB","GGG",7,12,19
"1721","sample015","GBB","GGR",1,0,1
"1722","sample015","GBB","RBG",3,1,4
"1723","sample015","GBB","RBR",1,0,1
"1724","sample015","GBB","RGG",1,0,1
"1725","sample015","GBB","RGR",2,0,2
"1726","sample015","GBB","RRR",1,0,1
"1727","sample015","GBG","BRB",1,0,1
"1728","sample015","GBG","BRR",1,0,1
"1729","sample015","GBG","GGG",4,2,6
"1730","sample015","GBG","RBB",1,0,1
"1731","sample015","GBG","RGR",1,0,1
"1732","sample015","GBG","RRG",1,0,1
"1733","sample015","GGB","BBB",3,2,5
"1734","sample015","GGB","BBR",1,1,2
"1735","sample015","GGB","BRR",1,1,2
"1736","sample015","GGB","GBG",1,0,1
"1737","sample015","GGB","GGG",13,8,21
"1738","sample015","GGB","RGG",1,1,2
"1739","sample015","GGB","RRG",1,0,1
"1740","sample015","GGB","RRR",1,0,1
"1741","sample015","GGG","BBB",8,5,13
"1742","sample015","GGG","BGG",1,1,2
"1743","sample015","GGG","BRB",1,0,1
"1744","sample015","GGG","GGB",5,0,5
"1745","sample015","GGG","GGR",1,1,2
"1746","sample015","GGG","RBB",1,1,2
"1747","sample015","GGG","RGR",1,3,4
"1748","sample015","GGG","RRG",1,3,4
"1749","sample015","GGR","BRR",1,0,1
"1750","sample015","GGR","GRR",1,0,1
"1751","sample015","GRG","BBB",3,2,5
"1752","sample015","GRG","GGB",2,2,4
"1753","sample015","GRG","GGG",3,3,6
"1754","sample015","GRG","RGR",1,1,2
"1755","sample015","GRG","RRG",2,1,3
"1756","sample015","GRR","BGB",1,0,1
"1757","sample015","RBG","BBB",2,0,2
"1758","sample015","RBG","RBB",1,0,1
"1759","sample015","RBR","BGB",2,1,3
"1760","sample015","RBR","BRB",1,0,1
"1761","sample015","RBR","BRR",1,0,1
"1762","sample015","RBR","GRR",4,0,4
"1763","sample015","RBR","RGG",2,0,2
"1764","sample015","RBR","RGR",1,0,1
"1765","sample015","RGG","BBR",1,1,2
"1766","sample015","RGR","BBB",2,2,4
"1767","sample015","RGR","BBR",1,0,1
"1768","sample015","RGR","BGB",2,2,4
"1769","sample015","RGR","BGG",2,0,2
"1770","sample015","RGR","BRR",1,3,4
"1771","sample015","RGR","GGB",2,2,4
"1772","sample015","RGR","RGG",1,0,1
"1773","sample015","RRG","BBB",2,6,8
"1774","sample015","RRG","BGB",1,0,1
"1775","sample015","RRG","BRB",2,4,6
"1776","sample015","RRG","BRR",1,1,2
"1777","sample015","RRG","GGG",2,3,5
"1778","sample015","RRG","GRG",1,0,1
"1779","sample015","RRG","GRR",3,0,3
"1780","sample015","RRG","RBB",1,1,2
"1781","sample015","RRR","BBR",1,0,1
"1782","sample015","RRR","BGB",2,0,2
"1783","sample015","RRR","BGG",1,0,1
"1784","sample015","RRR","BRB",1,0,1
"1785","sample015","RRR","BRR",1,0,1
"1786","sample015","RRR","RBB",1,0,1
"1787","sample015","RRR","RGR",1,1,2
"1788","sample015","RRR","RRG",2,0,2
"1789","sample015","BBG","RBG",0,1,1
"1790","sample015","BBG","RRR",0,2,2
"1791","sample015","BGB","BBB",0,1,1
"1792","sample015","BRB","BBB",0,1,1
"1793","sample015","BRB","RBG",0,1,1
"1794","sample015","BRR","BBB",0,2,2
"1795","sample015","GBB","GBG",0,1,1
"1796","sample015","GBB","GGB",0,3,3
"1797","sample015","GBB","GRG",0,1,1
"1798","sample015","GBG","BBB",0,1,1
"1799","sample015","GBG","BBR",0,1,1
"1800","sample015","GBG","GGB",0,2,2
"1801","sample015","GBG","RGG",0,1,1
"1802","sample015","GGB","BRB",0,1,1
"1803","sample015","GGB","GGR",0,1,1
"1804","sample015","GGB","GRR",0,1,1
"1805","sample015","GGB","RBG",0,1,1
"1806","sample015","GGB","RBR",0,3,3
"1807","sample015","GGG","RBG",0,1,1
"1808","sample015","GGG","RBR",0,3,3
"1809","sample015","GGG","RRR",0,1,1
"1810","sample015","GGR","BBB",0,1,1
"1811","sample015","GRR","BBR",0,1,1
"1812","sample015","GRR","BGG",0,1,1
"1813","sample015","GRR","GGG",0,1,1
"1814","sample015","RBB","BRB",0,1,1
"1815","sample015","RBB","GRR",0,1,1
"1816","sample015","RBG","GBB",0,1,1
"1817","sample015","RBR","BBB",0,4,4
"1818","sample015","RBR","GGB",0,4,4
"1819","sample015","RBR","RBB",0,1,1
"1820","sample015","RGG","BBB",0,2,2
"1821","sample015","RGG","BGB",0,1,1
"1822","sample015","RGG","BRR",0,1,1
"1823","sample015","RGG","GGR",0,2,2
"1824","sample015","RGG","GRR",0,1,1
"1825","sample015","RGR","GGR",0,1,1
"1826","sample015","RRG","BBR",0,1,1
"1827","sample015","RRG","BGG",0,1,1
"1828","sample015","RRR","RBR",0,1,1
"1829","sample016","BBB","GGG",1,0,1
"1830","sample016","BBB","RRG",1,0,1
"1831","sample016","BBG","BBB",1,0,1
"1832","sample016","BBG","BRB",1,2,3
"1833","sample016","BBG","GBG",2,1,3
"1834","sample016","BBG","GGB",2,3,5
"1835","sample016","BBG","GGG",4,8,12
"1836","sample016","BBG","GRG",1,2,3
"1837","sample016","BBG","RRG",1,0,1
"1838","sample016","BGG","RBG",1,0,1
"1839","sample016","BGG","RRR",1,0,1
"1840","sample016","BRR","BGB",1,1,2
"1841","sample016","GBB","BBB",12,6,18
"1842","sample016","GBB","BRB",1,1,2
"1843","sample016","GBB","BRR",1,0,1
"1844","sample016","GBB","GGG",7,11,18
"1845","sample016","GBB","GGR",1,0,1
"1846","sample016","GBB","RBG",3,2,5
"1847","sample016","GBB","RBR",1,0,1
"1848","sample016","GBB","RGG",1,0,1
"1849","sample016","GBB","RGR",2,0,2
"1850","sample016","GBB","RRR",1,1,2
"1851","sample016","GBG","BRB",1,0,1
"1852","sample016","GBG","BRR",1,0,1
"1853","sample016","GBG","GGG",4,1,5
"1854","sample016","GBG","RBB",1,0,1
"1855","sample016","GBG","RGR",1,1,2
"1856","sample016","GBG","RRG",1,1,2
"1857","sample016","GGB","BBB",3,0,3
"1858","sample016","GGB","BBR",1,2,3
"1859","sample016","GGB","BRR",1,3,4
"1860","sample016","GGB","GBG",1,0,1
"1861","sample016","GGB","GGG",13,7,20
"1862","sample016","GGB","RGG",1,0,1
"1863","sample016","GGB","RRG",1,1,2
"1864","sample016","GGB","RRR",1,0,1
"1865","sample016","GGG","BBB",8,6,14
"1866","sample016","GGG","BGG",1,0,1
"1867","sample016","GGG","BRB",1,0,1
"1868","sample016","GGG","GGB",5,1,6
"1869","sample016","GGG","GGR",1,3,4
"1870","sample016","GGG","RBB",1,3,4
"1871","sample016","GGG","RGR",1,3,4
"1872","sample016","GGG","RRG",1,3,4
"1873","sample016","GGR","BRR",1,0,1
"1874","sample016","GGR","GRR",1,0,1
"1875","sample016","GRG","BBB",3,3,6
"1876","sample016","GRG","GGB",2,2,4
"1877","sample016","GRG","GGG",3,3,6
"1878","sample016","GRG","RGR",1,0,1
"1879","sample016","GRG","RRG",2,1,3
"1880","sample016","GRR","BGB",1,0,1
"1881","sample016","RBG","BBB",2,2,4
"1882","sample016","RBG","RBB",1,0,1
"1883","sample016","RBR","BGB",2,1,3
"1884","sample016","RBR","BRB",1,0,1
"1885","sample016","RBR","BRR",1,0,1
"1886","sample016","RBR","GRR",4,0,4
"1887","sample016","RBR","RGG",2,5,7
"1888","sample016","RBR","RGR",1,0,1
"1889","sample016","RGG","BBR",1,0,1
"1890","sample016","RGR","BBB",2,1,3
"1891","sample016","RGR","BBR",1,1,2
"1892","sample016","RGR","BGB",2,2,4
"1893","sample016","RGR","BGG",2,0,2
"1894","sample016","RGR","BRR",1,3,4
"1895","sample016","RGR","GGB",2,2,4
"1896","sample016","RGR","RGG",1,1,2
"1897","sample016","RRG","BBB",2,4,6
"1898","sample016","RRG","BGB",1,1,2
"1899","sample016","RRG","BRB",2,6,8
"1900","sample016","RRG","BRR",1,2,3
"1901","sample016","RRG","GGG",2,4,6
"1902","sample016","RRG","GRG",1,0,1
"1903","sample016","RRG","GRR",3,1,4
"1904","sample016","RRG","RBB",1,0,1
"1905","sample016","RRR","BBR",1,0,1
"1906","sample016","RRR","BGB",2,0,2
"1907","sample016","RRR","BGG",1,0,1
"1908","sample016","RRR","BRB",1,1,2
"1909","sample016","RRR","BRR",1,1,2
"1910","sample016","RRR","RBB",1,0,1
"1911","sample016","RRR","RGR",1,0,1
"1912","sample016","RRR","RRG",2,2,4
"1913","sample016","BBG","RRR",0,2,2
"1914","sample016","BGB","BBB",0,1,1
"1915","sample016","BGG","RGR",0,1,1
"1916","sample016","BRB","BBB",0,1,1
"1917","sample016","BRB","GGG",0,1,1
"1918","sample016","BRB","RGR",0,1,1
"1919","sample016","BRR","BBB",0,1,1
"1920","sample016","GBB","GBG",0,1,1
"1921","sample016","GBB","GGB",0,4,4
"1922","sample016","GBB","GRG",0,1,1
"1923","sample016","GBB","GRR",0,1,1
"1924","sample016","GBG","BBB",0,1,1
"1925","sample016","GGB","BGG",0,1,1
"1926","sample016","GGB","GGR",0,1,1
"1927","sample016","GGB","GRR",0,1,1
"1928","sample016","GGB","RBG",0,1,1
"1929","sample016","GGB","RBR",0,1,1
"1930","sample016","GGG","BRR",0,1,1
"1931","sample016","GGG","RBG",0,1,1
"1932","sample016","GGG","RBR",0,1,1
"1933","sample016","GRG","GGR",0,1,1
"1934","sample016","GRR","BRB",0,1,1
"1935","sample016","GRR","BRR",0,1,1
"1936","sample016","RBG","GBB",0,1,1
"1937","sample016","RBR","BBB",0,2,2
"1938","sample016","RGG","BBB",0,2,2
"1939","sample016","RGG","GRR",0,1,1
"1940","sample016","RGR","GGR",0,1,1
"1941","sample016","RGR","RRG",0,3,3
"1942","sample016","RRR","RBR",0,1,1
"1943","sample017","BBB","GGG",1,0,1
"1944","sample017","BBB","RRG",1,1,2
"1945","sample017","BBG","BBB",1,0,1
"1946","sample017","BBG","BRB",1,4,5
"1947","sample017","BBG","GBG",2,3,5
"1948","sample017","BBG","GGB",2,2,4
"1949","sample017","BBG","GGG",4,3,7
"1950","sample017","BBG","GRG",1,1,2
"1951","sample017","BBG","RRG",1,0,1
"1952","sample017","BGG","RBG",1,0,1
"1953","sample017","BGG","RRR",1,0,1
"1954","sample017","BRR","BGB",1,0,1
"1955","sample017","GBB","BBB",12,6,18
"1956","sample017","GBB","BRB",1,1,2
"1957","sample017","GBB","BRR",1,0,1
"1958","sample017","GBB","GGG",7,13,20
"1959","sample017","GBB","GGR",1,0,1
"1960","sample017","GBB","RBG",3,1,4
"1961","sample017","GBB","RBR",1,0,1
"1962","sample017","GBB","RGG",1,0,1
"1963","sample017","GBB","RGR",2,0,2
"1964","sample017","GBB","RRR",1,0,1
"1965","sample017","GBG","BRB",1,0,1
"1966","sample017","GBG","BRR",1,0,1
"1967","sample017","GBG","GGG",4,1,5
"1968","sample017","GBG","RBB",1,0,1
"1969","sample017","GBG","RGR",1,0,1
"1970","sample017","GBG","RRG",1,2,3
"1971","sample017","GGB","BBB",3,3,6
"1972","sample017","GGB","BBR",1,1,2
"1973","sample017","GGB","BRR",1,1,2
"1974","sample017","GGB","GBG",1,0,1
"1975","sample017","GGB","GGG",13,7,20
"1976","sample017","GGB","RGG",1,1,2
"1977","sample017","GGB","RRG",1,2,3
"1978","sample017","GGB","RRR",1,0,1
"1979","sample017","GGG","BBB",8,6,14
"1980","sample017","GGG","BGG",1,1,2
"1981","sample017","GGG","BRB",1,0,1
"1982","sample017","GGG","GGB",5,1,6
"1983","sample017","GGG","GGR",1,1,2
"1984","sample017","GGG","RBB",1,2,3
"1985","sample017","GGG","RGR",1,2,3
"1986","sample017","GGG","RRG",1,3,4
"1987","sample017","GGR","BRR",1,0,1
"1988","sample017","GGR","GRR",1,0,1
"1989","sample017","GRG","BBB",3,1,4
"1990","sample017","GRG","GGB",2,4,6
"1991","sample017","GRG","GGG",3,4,7
"1992","sample017","GRG","RGR",1,0,1
"1993","sample017","GRG","RRG",2,0,2
"1994","sample017","GRR","BGB",1,0,1
"1995","sample017","RBG","BBB",2,1,3
"1996","sample017","RBG","RBB",1,0,1
"1997","sample017","RBR","BGB",2,0,2
"1998","sample017","RBR","BRB",1,0,1
"1999","sample017","RBR","BRR",1,1,2
"2000","sample017","RBR","GRR",4,0,4
"2001","sample017","RBR","RGG",2,1,3
"2002","sample017","RBR","RGR",1,0,1
"2003","sample017","RGG","BBR",1,0,1
"2004","sample017","RGR","BBB",2,1,3
"2005","sample017","RGR","BBR",1,0,1
"2006","sample017","RGR","BGB",2,1,3
"2007","sample017","RGR","BGG",2,0,2
"2008","sample017","RGR","BRR",1,0,1
"2009","sample017","RGR","GGB",2,2,4
"2010","sample017","RGR","RGG",1,0,1
"2011","sample017","RRG","BBB",2,10,12
"2012","sample017","RRG","BGB",1,2,3
"2013","sample017","RRG","BRB",2,7,9
"2014","sample017","RRG","BRR",1,3,4
"2015","sample017","RRG","GGG",2,0,2
"2016","sample017","RRG","GRG",1,0,1
"2017","sample017","RRG","GRR",3,1,4
"2018","sample017","RRG","RBB",1,0,1
"2019","sample017","RRR","BBR",1,0,1
"2020","sample017","RRR","BGB",2,0,2
"2021","sample017","RRR","BGG",1,0,1
"2022","sample017","RRR","BRB",1,0,1
"2023","sample017","RRR","BRR",1,0,1
"2024","sample017","RRR","RBB",1,0,1
"2025","sample017","RRR","RGR",1,1,2
"2026","sample017","RRR","RRG",2,0,2
"2027","sample017","BBG","BGG",0,1,1
"2028","sample017","BBG","GBB",0,1,1
"2029","sample017","BBG","RBG",0,1,1
"2030","sample017","BGG","BBB",0,1,1
"2031","sample017","BGG","BBR",0,1,1
"2032","sample017","BRB","BBB",0,2,2
"2033","sample017","BRB","BRR",0,1,1
"2034","sample017","BRB","GGR",0,1,1
"2035","sample017","BRR","BBB",0,4,4
"2036","sample017","BRR","RBB",0,1,1
"2037","sample017","GBB","GGB",0,2,2
"2038","sample017","GBB","GRG",0,3,3
"2039","sample017","GBB","RBB",0,1,1
"2040","sample017","GBG","BBB",0,3,3
"2041","sample017","GBG","RBG",0,1,1
"2042","sample017","GGB","GBB",0,1,1
"2043","sample017","GGB","GGR",0,3,3
"2044","sample017","GGB","RBG",0,2,2
"2045","sample017","GGB","RBR",0,1,1
"2046","sample017","GGG","BGB",0,1,1
"2047","sample017","GGG","RBR",0,2,2
"2048","sample017","GGG","RGG",0,1,1
"2049","sample017","GGR","BGG",0,1,1
"2050","sample017","GRG","GBG",0,1,1
"2051","sample017","GRG","GGR",0,2,2
"2052","sample017","GRR","BRR",0,2,2
"2053","sample017","RBG","GBB",0,1,1
"2054","sample017","RBG","GRR",0,1,1
"2055","sample017","RBR","BBB",0,1,1
"2056","sample017","RGG","GRR",0,3,3
"2057","sample017","RGR","RBB",0,1,1
"2058","sample017","RRG","BGG",0,2,2
"2059","sample017","RRR","RBR",0,1,1
"2060","sample018","BBB","GGG",1,2,3
"2061","sample018","BBB","RRG",1,0,1
"2062","sample018","BBG","BBB",1,1,2
"2063","sample018","BBG","BRB",1,1,2
"2064","sample018","BBG","GBG",2,0,2
"2065","sample018","BBG","GGB",2,6,8
"2066","sample018","BBG","GGG",4,6,10
"2067","sample018","BBG","GRG",1,3,4
"2068","sample018","BBG","RRG",1,0,1
"2069","sample018","BGG","RBG",1,0,1
"2070","sample018","BGG","RRR",1,0,1
"2071","sample018","BRR","BGB",1,0,1
"2072","sample018","GBB","BBB",12,2,14
"2073","sample018","GBB","BRB",1,3,4
"2074","sample018","GBB","BRR",1,0,1
"2075","sample018","GBB","GGG",7,15,22
"2076","sample018","GBB","GGR",1,0,1
"2077","sample018","GBB","RBG",3,0,3
"2078","sample018","GBB","RBR",1,0,1
"2079","sample018","GBB","RGG",1,0,1
"2080","sample018","GBB","RGR",2,1,3
"2081","sample018","GBB","RRR",1,2,3
"2082","sample018","GBG","BRB",1,0,1
"2083","sample018","GBG","BRR",1,0,1
"2084","sample018","GBG","GGG",4,3,7
"2085","sample018","GBG","RBB",1,0,1
"2086","sample018","GBG","RGR",1,0,1
"2087","sample018","GBG","RRG",1,0,1
"2088","sample018","GGB","BBB",3,2,5
"2089","sample018","GGB","BBR",1,1,2
"2090","sample018","GGB","BRR",1,1,2
"2091","sample018","GGB","GBG",1,0,1
"2092","sample018","GGB","GGG",13,7,20
"2093","sample018","GGB","RGG",1,1,2
"2094","sample018","GGB","RRG",1,3,4
"2095","sample018","GGB","RRR",1,1,2
"2096","sample018","GGG","BBB",8,2,10
"2097","sample018","GGG","BGG",1,0,1
"2098","sample018","GGG","BRB",1,1,2
"2099","sample018","GGG","GGB",5,0,5
"2100","sample018","GGG","GGR",1,2,3
"2101","sample018","GGG","RBB",1,2,3
"2102","sample018","GGG","RGR",1,2,3
"2103","sample018","GGG","RRG",1,1,2
"2104","sample018","GGR","BRR",1,0,1
"2105","sample018","GGR","GRR",1,0,1
"2106","sample018","GRG","BBB",3,0,3
"2107","sample018","GRG","GGB",2,1,3
"2108","sample018","GRG","GGG",3,1,4
"2109","sample018","GRG","RGR",1,0,1
"2110","sample018","GRG","RRG",2,0,2
"2111","sample018","GRR","BGB",1,0,1
"2112","sample018","RBG","BBB",2,3,5
"2113","sample018","RBG","RBB",1,0,1
"2114","sample018","RBR","BGB",2,1,3
"2115","sample018","RBR","BRB",1,0,1
"2116","sample018","RBR","BRR",1,0,1
"2117","sample018","RBR","GRR",4,0,4
"2118","sample018","RBR","RGG",2,1,3
"2119","sample018","RBR","RGR",1,0,1
"2120","sample018","RGG","BBR",1,1,2
"2121","sample018","RGR","BBB",2,2,4
"2122","sample018","RGR","BBR",1,0,1
"2123","sample018","RGR","BGB",2,0,2
"2124","sample018","RGR","BGG",2,0,2
"2125","sample018","RGR","BRR",1,1,2
"2126","sample018","RGR","GGB",2,1,3
"2127","sample018","RGR","RGG",1,0,1
"2128","sample018","RRG","BBB",2,6,8
"2129","sample018","RRG","BGB",1,2,3
"2130","sample018","RRG","BRB",2,4,6
"2131","sample018","RRG","BRR",1,3,4
"2132","sample018","RRG","GGG",2,2,4
"2133","sample018","RRG","GRG",1,0,1
"2134","sample018","RRG","GRR",3,2,5
"2135","sample018","RRG","RBB",1,0,1
"2136","sample018","RRR","BBR",1,0,1
"2137","sample018","RRR","BGB",2,1,3
"2138","sample018","RRR","BGG",1,0,1
"2139","sample018","RRR","BRB",1,0,1
"2140","sample018","RRR","BRR",1,0,1
"2141","sample018","RRR","RBB",1,0,1
"2142","sample018","RRR","RGR",1,0,1
"2143","sample018","RRR","RRG",2,0,2
"2144","sample018","BBB","GRR",0,1,1
"2145","sample018","BBB","RRR",0,1,1
"2146","sample018","BBG","RBG",0,1,1
"2147","sample018","BBG","RRR",0,2,2
"2148","sample018","BGB","BBB",0,1,1
"2149","sample018","BGG","BBB",0,1,1
"2150","sample018","BGG","BBR",0,1,1
"2151","sample018","BGG","GRG",0,1,1
"2152","sample018","BGG","RGR",0,1,1
"2153","sample018","BRB","BRR",0,1,1
"2154","sample018","BRR","BBB",0,2,2
"2155","sample018","BRR","BRB",0,1,1
"2156","sample018","BRR","RBB",0,1,1
"2157","sample018","GBB","GGB",0,5,5
"2158","sample018","GBB","RBB",0,1,1
"2159","sample018","GBG","BBB",0,1,1
"2160","sample018","GBG","GGB",0,1,1
"2161","sample018","GGB","BGG",0,1,1
"2162","sample018","GGB","RBB",0,1,1
"2163","sample018","GGB","RBR",0,2,2
"2164","sample018","GGG","BRR",0,2,2
"2165","sample018","GGG","RBG",0,2,2
"2166","sample018","GGG","RBR",0,1,1
"2167","sample018","GGG","RGG",0,1,1
"2168","sample018","GGR","BBB",0,1,1
"2169","sample018","GRG","BRB",0,2,2
"2170","sample018","RBB","BBB",0,1,1
"2171","sample018","RBR","BBB",0,4,4
"2172","sample018","RBR","GGB",0,3,3
"2173","sample018","RGG","BBB",0,2,2
"2174","sample018","RGG","BGB",0,1,1
"2175","sample018","RGG","GGR",0,1,1
"2176","sample018","RGR","GGG",0,2,2
"2177","sample018","RGR","RBB",0,1,1
"2178","sample018","RRG","BBR",0,2,2
"2179","sample018","RRG","BGG",0,2,2
"2180","sample018","RRG","GGR",0,1,1
"2181","sample018","RRG","RGG",0,1,1
"2182","sample019","BBB","GGG",1,0,1
"2183","sample019","BBB","RRG",1,1,2
"2184","sample019","BBG","BBB",1,0,1
"2185","sample019","BBG","BRB",1,2,3
"2186","sample019","BBG","GBG",2,2,4
"2187","sample019","BBG","GGB",2,3,5
"2188","sample019","BBG","GGG",4,4,8
"2189","sample019","BBG","GRG",1,1,2
"2190","sample019","BBG","RRG",1,0,1
"2191","sample019","BGG","RBG",1,0,1
"2192","sample019","BGG","RRR",1,1,2
"2193","sample019","BRR","BGB",1,0,1
"2194","sample019","GBB","BBB",12,6,18
"2195","sample019","GBB","BRB",1,2,3
"2196","sample019","GBB","BRR",1,0,1
"2197","sample019","GBB","GGG",7,9,16
"2198","sample019","GBB","GGR",1,1,2
"2199","sample019","GBB","RBG",3,1,4
"2200","sample019","GBB","RBR",1,0,1
"2201","sample019","GBB","RGG",1,0,1
"2202","sample019","GBB","RGR",2,0,2
"2203","sample019","GBB","RRR",1,3,4
"2204","sample019","GBG","BRB",1,0,1
"2205","sample019","GBG","BRR",1,0,1
"2206","sample019","GBG","GGG",4,2,6
"2207","sample019","GBG","RBB",1,0,1
"2208","sample019","GBG","RGR",1,2,3
"2209","sample019","GBG","RRG",1,1,2
"2210","sample019","GGB","BBB",3,2,5
"2211","sample019","GGB","BBR",1,0,1
"2212","sample019","GGB","BRR",1,0,1
"2213","sample019","GGB","GBG",1,0,1
"2214","sample019","GGB","GGG",13,9,22
"2215","sample019","GGB","RGG",1,1,2
"2216","sample019","GGB","RRG",1,1,2
"2217","sample019","GGB","RRR",1,1,2
"2218","sample019","GGG","BBB",8,2,10
"2219","sample019","GGG","BGG",1,1,2
"2220","sample019","GGG","BRB",1,0,1
"2221","sample019","GGG","GGB",5,0,5
"2222","sample019","GGG","GGR",1,1,2
"2223","sample019","GGG","RBB",1,0,1
"2224","sample019","GGG","RGR",1,1,2
"2225","sample019","GGG","RRG",1,3,4
"2226","sample019","GGR","BRR",1,0,1
"2227","sample019","GGR","GRR",1,0,1
"2228","sample019","GRG","BBB",3,1,4
"2229","sample019","GRG","GGB",2,1,3
"2230","sample019","GRG","GGG",3,4,7
"2231","sample019","GRG","RGR",1,0,1
"2232","sample019","GRG","RRG",2,0,2
"2233","sample019","GRR","BGB",1,0,1
"2234","sample019","RBG","BBB",2,0,2
"2235","sample019","RBG","RBB",1,1,2
"2236","sample019","RBR","BGB",2,1,3
"2237","sample019","RBR","BRB",1,0,1
"2238","sample019","RBR","BRR",1,2,3
"2239","sample019","RBR","GRR",4,0,4
"2240","sample019","RBR","RGG",2,2,4
"2241","sample019","RBR","RGR",1,0,1
"2242","sample019","RGG","BBR",1,0,1
"2243","sample019","RGR","BBB",2,0,2
"2244","sample019","RGR","BBR",1,0,1
"2245","sample019","RGR","BGB",2,0,2
"2246","sample019","RGR","BGG",2,1,3
"2247","sample019","RGR","BRR",1,1,2
"2248","sample019","RGR","GGB",2,5,7
"2249","sample019","RGR","RGG",1,0,1
"2250","sample019","RRG","BBB",2,7,9
"2251","sample019","RRG","BGB",1,0,1
"2252","sample019","RRG","BRB",2,7,9
"2253","sample019","RRG","BRR",1,3,4
"2254","sample019","RRG","GGG",2,5,7
"2255","sample019","RRG","GRG",1,0,1
"2256","sample019","RRG","GRR",3,1,4
"2257","sample019","RRG","RBB",1,0,1
"2258","sample019","RRR","BBR",1,0,1
"2259","sample019","RRR","BGB",2,0,2
"2260","sample019","RRR","BGG",1,0,1
"2261","sample019","RRR","BRB",1,0,1
"2262","sample019","RRR","BRR",1,0,1
"2263","sample019","RRR","RBB",1,0,1
"2264","sample019","RRR","RGR",1,0,1
"2265","sample019","RRR","RRG",2,0,2
"2266","sample019","BBB","GRR",0,1,1
"2267","sample019","BBG","RBG",0,1,1
"2268","sample019","BGG","BBB",0,1,1
"2269","sample019","BGG","RGG",0,2,2
"2270","sample019","BRB","BBB",0,1,1
"2271","sample019","BRB","BRR",0,1,1
"2272","sample019","BRB","GGG",0,1,1
"2273","sample019","BRR","BBB",0,1,1
"2274","sample019","BRR","RBB",0,1,1
"2275","sample019","GBB","GBG",0,1,1
"2276","sample019","GBB","GGB",0,4,4
"2277","sample019","GBB","GRG",0,2,2
"2278","sample019","GBG","RGG",0,1,1
"2279","sample019","GGB","BGG",0,2,2
"2280","sample019","GGB","GBB",0,1,1
"2281","sample019","GGB","GRR",0,1,1
"2282","sample019","GGB","RGR",0,1,1
"2283","sample019","GGG","BRR",0,2,2
"2284","sample019","GGG","RBG",0,1,1
"2285","sample019","GGG","RBR",0,3,3
"2286","sample019","GGG","RGG",0,2,2
"2287","sample019","GGR","BBB",0,1,1
"2288","sample019","GRG","GBG",0,1,1
"2289","sample019","GRR","GGR",0,1,1
"2290","sample019","RBG","GRR",0,2,2
"2291","sample019","RBR","BBB",0,2,2
"2292","sample019","RBR","GGB",0,1,1
"2293","sample019","RBR","RRR",0,1,1
"2294","sample019","RGG","BBB",0,4,4
"2295","sample019","RGG","GGG",0,1,1
"2296","sample019","RGG","GRR",0,1,1
"2297","sample019","RGR","GGG",0,1,1
"2298","sample019","RGR","GGR",0,1,1
"2299","sample019","RGR","RBB",0,1,1
"2300","sample019","RRG","BBR",0,1,1
"2301","sample019","RRG","BGG",0,2,2
"2302","sample019","RRG","GGR",0,1,1
"2303","sample019","RRR","GRR",0,1,1
"2304","sample019","RRR","RGG",0,1,1
"2305","sample020","BBB","GGG",1,0,1
"2306","sample020","BBB","RRG",1,1,2
"2307","sample020","BBG","BBB",1,0,1
"2308","sample020","BBG","BRB",1,1,2
"2309","sample020","BBG","GBG",2,0,2
"2310","sample020","BBG","GGB",2,2,4
"2311","sample020","BBG","GGG",4,6,10
"2312","sample020","BBG","GRG",1,1,2
"2313","sample020","BBG","RRG",1,0,1
"2314","sample020","BGG","RBG",1,0,1
"2315","sample020","BGG","RRR",1,0,1
"2316","sample020","BRR","BGB",1,1,2
"2317","sample020","GBB","BBB",12,7,19
"2318","sample020","GBB","BRB",1,3,4
"2319","sample020","GBB","BRR",1,0,1
"2320","sample020","GBB","GGG",7,16,23
"2321","sample020","GBB","GGR",1,1,2
"2322","sample020","GBB","RBG",3,2,5
"2323","sample020","GBB","RBR",1,0,1
"2324","sample020","GBB","RGG",1,0,1
"2325","sample020","GBB","RGR",2,0,2
"2326","sample020","GBB","RRR",1,0,1
"2327","sample020","GBG","BRB",1,1,2
"2328","sample020","GBG","BRR",1,0,1
"2329","sample020","GBG","GGG",4,1,5
"2330","sample020","GBG","RBB",1,0,1
"2331","sample020","GBG","RGR",1,1,2
"2332","sample020","GBG","RRG",1,0,1
"2333","sample020","GGB","BBB",3,2,5
"2334","sample020","GGB","BBR",1,0,1
"2335","sample020","GGB","BRR",1,1,2
"2336","sample020","GGB","GBG",1,0,1
"2337","sample020","GGB","GGG",13,7,20
"2338","sample020","GGB","RGG",1,0,1
"2339","sample020","GGB","RRG",1,2,3
"2340","sample020","GGB","RRR",1,0,1
"2341","sample020","GGG","BBB",8,9,17
"2342","sample020","GGG","BGG",1,1,2
"2343","sample020","GGG","BRB",1,0,1
"2344","sample020","GGG","GGB",5,1,6
"2345","sample020","GGG","GGR",1,2,3
"2346","sample020","GGG","RBB",1,3,4
"2347","sample020","GGG","RGR",1,2,3
"2348","sample020","GGG","RRG",1,3,4
"2349","sample020","GGR","BRR",1,0,1
"2350","sample020","GGR","GRR",1,0,1
"2351","sample020","GRG","BBB",3,1,4
"2352","sample020","GRG","GGB",2,3,5
"2353","sample020","GRG","GGG",3,0,3
"2354","sample020","GRG","RGR",1,1,2
"2355","sample020","GRG","RRG",2,1,3
"2356","sample020","GRR","BGB",1,0,1
"2357","sample020","RBG","BBB",2,1,3
"2358","sample020","RBG","RBB",1,0,1
"2359","sample020","RBR","BGB",2,1,3
"2360","sample020","RBR","BRB",1,0,1
"2361","sample020","RBR","BRR",1,0,1
"2362","sample020","RBR","GRR",4,0,4
"2363","sample020","RBR","RGG",2,3,5
"2364","sample020","RBR","RGR",1,0,1
"2365","sample020","RGG","BBR",1,0,1
"2366","sample020","RGR","BBB",2,0,2
"2367","sample020","RGR","BBR",1,0,1
"2368","sample020","RGR","BGB",2,0,2
"2369","sample020","RGR","BGG",2,0,2
"2370","sample020","RGR","BRR",1,1,2
"2371","sample020","RGR","GGB",2,4,6
"2372","sample020","RGR","RGG",1,0,1
"2373","sample020","RRG","BBB",2,4,6
"2374","sample020","RRG","BGB",1,1,2
"2375","sample020","RRG","BRB",2,5,7
"2376","sample020","RRG","BRR",1,3,4
"2377","sample020","RRG","GGG",2,1,3
"2378","sample020","RRG","GRG",1,0,1
"2379","sample020","RRG","GRR",3,1,4
"2380","sample020","RRG","RBB",1,0,1
"2381","sample020","RRR","BBR",1,0,1
"2382","sample020","RRR","BGB",2,0,2
"2383","sample020","RRR","BGG",1,0,1
"2384","sample020","RRR","BRB",1,0,1
"2385","sample020","RRR","BRR",1,1,2
"2386","sample020","RRR","RBB",1,1,2
"2387","sample020","RRR","RGR",1,0,1
"2388","sample020","RRR","RRG",2,0,2
"2389","sample020","BBB","GRR",0,1,1
"2390","sample020","BBB","RBG",0,1,1
"2391","sample020","BBG","RRR",0,3,3
"2392","sample020","BRB","BBB",0,2,2
"2393","sample020","BRB","RBG",0,1,1
"2394","sample020","BRR","BBB",0,3,3
"2395","sample020","GBB","GBG",0,1,1
"2396","sample020","GBB","GGB",0,2,2
"2397","sample020","GBB","GRG",0,1,1
"2398","sample020","GBG","BBB",0,2,2
"2399","sample020","GGB","BRB",0,1,1
"2400","sample020","GGB","GGR",0,1,1
"2401","sample020","GGB","RBR",0,2,2
"2402","sample020","GGB","RGR",0,1,1
"2403","sample020","GGG","BRR",0,1,1
"2404","sample020","GGG","GRR",0,1,1
"2405","sample020","GGG","RBG",0,1,1
"2406","sample020","GGG","RBR",0,7,7
"2407","sample020","GRG","GRR",0,1,1
"2408","sample020","GRR","BGG",0,1,1
"2409","sample020","GRR","BRB",0,1,1
"2410","sample020","GRR","BRR",0,1,1
"2411","sample020","RBR","BBB",0,4,4
"2412","sample020","RBR","GGB",0,1,1
"2413","sample020","RBR","RBB",0,1,1
"2414","sample020","RBR","RRR",0,1,1
"2415","sample020","RGG","BRR",0,1,1
"2416","sample020","RGG","GRR",0,2,2
"2417","sample020","RGR","GGR",0,1,1
"2418","sample020","RGR","RBB",0,2,2
"2419","sample020","RRR","GRR",0,1,1
"2420","sample021","BBB","GGG",1,0,1
"2421","sample021","BBB","RRG",1,0,1
"2422","sample021","BBG","BBB",1,2,3
"2423","sample021","BBG","BRB",1,3,4
"2424","sample021","BBG","GBG",2,1,3
"2425","sample021","BBG","GGB",2,2,4
"2426","sample021","BBG","GGG",4,4,8
"2427","sample021","BBG","GRG",1,0,1
"2428","sample021","BBG","RRG",1,0,1
"2429","sample021","BGG","RBG",1,0,1
"2430","sample021","BGG","RRR",1,1,2
"2431","sample021","BRR","BGB",1,1,2
"2432","sample021","GBB","BBB",12,8,20
"2433","sample021","GBB","BRB",1,0,1
"2434","sample021","GBB","BRR",1,1,2
"2435","sample021","GBB","GGG",7,13,20
"2436","sample021","GBB","GGR",1,1,2
"2437","sample021","GBB","RBG",3,1,4
"2438","sample021","GBB","RBR",1,0,1
"2439","sample021","GBB","RGG",1,0,1
"2440","sample021","GBB","RGR",2,1,3
"2441","sample021","GBB","RRR",1,1,2
"2442","sample021","GBG","BRB",1,0,1
"2443","sample021","GBG","BRR",1,0,1
"2444","sample021","GBG","GGG",4,2,6
"2445","sample021","GBG","RBB",1,0,1
"2446","sample021","GBG","RGR",1,0,1
"2447","sample021","GBG","RRG",1,0,1
"2448","sample021","GGB","BBB",3,1,4
"2449","sample021","GGB","BBR",1,1,2
"2450","sample021","GGB","BRR",1,1,2
"2451","sample021","GGB","GBG",1,0,1
"2452","sample021","GGB","GGG",13,8,21
"2453","sample021","GGB","RGG",1,1,2
"2454","sample021","GGB","RRG",1,0,1
"2455","sample021","GGB","RRR",1,1,2
"2456","sample021","GGG","BBB",8,4,12
"2457","sample021","GGG","BGG",1,0,1
"2458","sample021","GGG","BRB",1,0,1
"2459","sample021","GGG","GGB",5,0,5
"2460","sample021","GGG","GGR",1,3,4
"2461","sample021","GGG","RBB",1,1,2
"2462","sample021","GGG","RGR",1,1,2
"2463","sample021","GGG","RRG",1,4,5
"2464","sample021","GGR","BRR",1,0,1
"2465","sample021","GGR","GRR",1,0,1
"2466","sample021","GRG","BBB",3,1,4
"2467","sample021","GRG","GGB",2,2,4
"2468","sample021","GRG","GGG",3,2,5
"2469","sample021","GRG","RGR",1,0,1
"2470","sample021","GRG","RRG",2,1,3
"2471","sample021","GRR","BGB",1,0,1
"2472","sample021","RBG","BBB",2,0,2
"2473","sample021","RBG","RBB",1,0,1
"2474","sample021","RBR","BGB",2,1,3
"2475","sample021","RBR","BRB",1,0,1
"2476","sample021","RBR","BRR",1,1,2
"2477","sample021","RBR","GRR",4,0,4
"2478","sample021","RBR","RGG",2,2,4
"2479","sample021","RBR","RGR",1,0,1
"2480","sample021","RGG","BBR",1,1,2
"2481","sample021","RGR","BBB",2,0,2
"2482","sample021","RGR","BBR",1,0,1
"2483","sample021","RGR","BGB",2,1,3
"2484","sample021","RGR","BGG",2,0,2
"2485","sample021","RGR","BRR",1,1,2
"2486","sample021","RGR","GGB",2,1,3
"2487","sample021","RGR","RGG",1,0,1
"2488","sample021","RRG","BBB",2,7,9
"2489","sample021","RRG","BGB",1,4,5
"2490","sample021","RRG","BRB",2,5,7
"2491","sample021","RRG","BRR",1,2,3
"2492","sample021","RRG","GGG",2,0,2
"2493","sample021","RRG","GRG",1,0,1
"2494","sample021","RRG","GRR",3,2,5
"2495","sample021","RRG","RBB",1,0,1
"2496","sample021","RRR","BBR",1,0,1
"2497","sample021","RRR","BGB",2,0,2
"2498","sample021","RRR","BGG",1,0,1
"2499","sample021","RRR","BRB",1,1,2
"2500","sample021","RRR","BRR",1,0,1
"2501","sample021","RRR","RBB",1,0,1
"2502","sample021","RRR","RGR",1,1,2
"2503","sample021","RRR","RRG",2,0,2
"2504","sample021","BBB","GRR",0,2,2
"2505","sample021","BBG","RBG",0,1,1
"2506","sample021","BBG","RBR",0,1,1
"2507","sample021","BBG","RRR",0,2,2
"2508","sample021","BGB","RRG",0,1,1
"2509","sample021","BGG","BBR",0,1,1
"2510","sample021","BGG","GRG",0,1,1
"2511","sample021","BGG","RGG",0,1,1
"2512","sample021","BGG","RGR",0,1,1
"2513","sample021","BRB","BBB",0,3,3
"2514","sample021","BRB","GGG",0,1,1
"2515","sample021","BRR","BBB",0,4,4
"2516","sample021","BRR","RBB",0,1,1
"2517","sample021","GBB","GBG",0,1,1
"2518","sample021","GBB","GGB",0,4,4
"2519","sample021","GBB","RBB",0,1,1
"2520","sample021","GBG","RGG",0,1,1
"2521","sample021","GGB","BRB",0,1,1
"2522","sample021","GGB","GBB",0,1,1
"2523","sample021","GGB","RBB",0,1,1
"2524","sample021","GGG","BGB",0,1,1
"2525","sample021","GGG","RBR",0,1,1
"2526","sample021","GGG","RGG",0,1,1
"2527","sample021","GRG","GGR",0,4,4
"2528","sample021","GRG","RBG",0,1,1
"2529","sample021","GRR","BGG",0,1,1
"2530","sample021","GRR","BRR",0,1,1
"2531","sample021","RBB","BBR",0,1,1
"2532","sample021","RBG","BRR",0,1,1
"2533","sample021","RBG","GRR",0,2,2
"2534","sample021","RBR","GGB",0,3,3
"2535","sample021","RBR","RBB",0,1,1
"2536","sample021","RGG","BBB",0,2,2
"2537","sample021","RGG","BRR",0,1,1
"2538","sample021","RGG","RBB",0,1,1
"2539","sample021","RGR","RBB",0,1,1
"2540","sample021","RGR","RRG",0,1,1
"2541","sample021","RRG","BBR",0,2,2
"2542","sample022","BBB","GGG",1,1,2
"2543","sample022","BBB","RRG",1,0,1
"2544","sample022","BBG","BBB",1,0,1
"2545","sample022","BBG","BRB",1,1,2
"2546","sample022","BBG","GBG",2,3,5
"2547","sample022","BBG","GGB",2,1,3
"2548","sample022","BBG","GGG",4,3,7
"2549","sample022","BBG","GRG",1,1,2
"2550","sample022","BBG","RRG",1,1,2
"2551","sample022","BGG","RBG",1,0,1
"2552","sample022","BGG","RRR",1,0,1
"2553","sample022","BRR","BGB",1,1,2
"2554","sample022","GBB","BBB",12,6,18
"2555","sample022","GBB","BRB",1,2,3
"2556","sample022","GBB","BRR",1,0,1
"2557","sample022","GBB","GGG",7,9,16
"2558","sample022","GBB","GGR",1,0,1
"2559","sample022","GBB","RBG",3,1,4
"2560","sample022","GBB","RBR",1,0,1
"2561","sample022","GBB","RGG",1,0,1
"2562","sample022","GBB","RGR",2,1,3
"2563","sample022","GBB","RRR",1,1,2
"2564","sample022","GBG","BRB",1,1,2
"2565","sample022","GBG","BRR",1,0,1
"2566","sample022","GBG","GGG",4,3,7
"2567","sample022","GBG","RBB",1,0,1
"2568","sample022","GBG","RGR",1,1,2
"2569","sample022","GBG","RRG",1,0,1
"2570","sample022","GGB","BBB",3,0,3
"2571","sample022","GGB","BBR",1,0,1
"2572","sample022","GGB","BRR",1,4,5
"2573","sample022","GGB","GBG",1,0,1
"2574","sample022","GGB","GGG",13,4,17
"2575","sample022","GGB","RGG",1,0,1
"2576","sample022","GGB","RRG",1,0,1
"2577","sample022","GGB","RRR",1,0,1
"2578","sample022","GGG","BBB",8,3,11
"2579","sample022","GGG","BGG",1,2,3
"2580","sample022","GGG","BRB",1,1,2
"2581","sample022","GGG","GGB",5,0,5
"2582","sample022","GGG","GGR",1,0,1
"2583","sample022","GGG","RBB",1,4,5
"2584","sample022","GGG","RGR",1,3,4
"2585","sample022","GGG","RRG",1,2,3
"2586","sample022","GGR","BRR",1,0,1
"2587","sample022","GGR","GRR",1,0,1
"2588","sample022","GRG","BBB",3,1,4
"2589","sample022","GRG","GGB",2,4,6
"2590","sample022","GRG","GGG",3,2,5
"2591","sample022","GRG","RGR",1,0,1
"2592","sample022","GRG","RRG",2,0,2
"2593","sample022","GRR","BGB",1,1,2
"2594","sample022","RBG","BBB",2,4,6
"2595","sample022","RBG","RBB",1,0,1
"2596","sample022","RBR","BGB",2,0,2
"2597","sample022","RBR","BRB",1,0,1
"2598","sample022","RBR","BRR",1,0,1
"2599","sample022","RBR","GRR",4,0,4
"2600","sample022","RBR","RGG",2,1,3
"2601","sample022","RBR","RGR",1,0,1
"2602","sample022","RGG","BBR",1,1,2
"2603","sample022","RGR","BBB",2,0,2
"2604","sample022","RGR","BBR",1,0,1
"2605","sample022","RGR","BGB",2,0,2
"2606","sample022","RGR","BGG",2,0,2
"2607","sample022","RGR","BRR",1,0,1
"2608","sample022","RGR","GGB",2,1,3
"2609","sample022","RGR","RGG",1,0,1
"2610","sample022","RRG","BBB",2,4,6
"2611","sample022","RRG","BGB",1,3,4
"2612","sample022","RRG","BRB",2,7,9
"2613","sample022","RRG","BRR",1,4,5
"2614","sample022","RRG","GGG",2,1,3
"2615","sample022","RRG","GRG",1,0,1
"2616","sample022","RRG","GRR",3,2,5
"2617","sample022","RRG","RBB",1,0,1
"2618","sample022","RRR","BBR",1,0,1
"2619","sample022","RRR","BGB",2,0,2
"2620","sample022","RRR","BGG",1,0,1
"2621","sample022","RRR","BRB",1,1,2
"2622","sample022","RRR","BRR",1,0,1
"2623","sample022","RRR","RBB",1,0,1
"2624","sample022","RRR","RGR",1,1,2
"2625","sample022","RRR","RRG",2,0,2
"2626","sample022","BBG","RRR",0,3,3
"2627","sample022","BGB","RRG",0,1,1
"2628","sample022","BGG","BBB",0,1,1
"2629","sample022","BRB","BBB",0,2,2
"2630","sample022","BRB","BRR",0,2,2
"2631","sample022","GBB","GBG",0,1,1
"2632","sample022","GBB","GGB",0,5,5
"2633","sample022","GBB","GRG",0,2,2
"2634","sample022","GBG","GGB",0,2,2
"2635","sample022","GBG","RGG",0,1,1
"2636","sample022","GGB","GGR",0,1,1
"2637","sample022","GGB","GRR",0,2,2
"2638","sample022","GGG","RBG",0,1,1
"2639","sample022","GGG","RBR",0,5,5
"2640","sample022","GGG","RRR",0,1,1
"2641","sample022","GRG","BBR",0,1,1
"2642","sample022","GRG","BGG",0,1,1
"2643","sample022","GRG","GBG",0,1,1
"2644","sample022","GRG","GGR",0,3,3
"2645","sample022","GRG","RBR",0,1,1
"2646","sample022","GRR","BGG",0,1,1
"2647","sample022","RBG","GRR",0,2,2
"2648","sample022","RBG","RGR",0,1,1
"2649","sample022","RBR","BBB",0,4,4
"2650","sample022","RBR","BGG",0,1,1
"2651","sample022","RBR","GGB",0,3,3
"2652","sample022","RBR","RBB",0,1,1
"2653","sample022","RGG","BBB",0,1,1
"2654","sample022","RGG","BRR",0,2,2
"2655","sample022","RGG","GRR",0,2,2
"2656","sample022","RGR","RBB",0,1,1
"2657","sample022","RRG","BBR",0,1,1
"2658","sample022","RRG","GGR",0,3,3
"2659","sample022","RRG","RGR",0,1,1
"2660","sample022","RRR","GRR",0,1,1
"2661","sample023","BBB","GGG",1,0,1
"2662","sample023","BBB","RRG",1,0,1
"2663","sample023","BBG","BBB",1,1,2
"2664","sample023","BBG","BRB",1,2,3
"2665","sample023","BBG","GBG",2,1,3
"2666","sample023","BBG","GGB",2,1,3
"2667","sample023","BBG","GGG",4,6,10
"2668","sample023","BBG","GRG",1,1,2
"2669","sample023","BBG","RRG",1,1,2
"2670","sample023","BGG","RBG",1,0,1
"2671","sample023","BGG","RRR",1,0,1
"2672","sample023","BRR","BGB",1,0,1
"2673","sample023","GBB","BBB",12,4,16
"2674","sample023","GBB","BRB",1,2,3
"2675","sample023","GBB","BRR",1,0,1
"2676","sample023","GBB","GGG",7,11,18
"2677","sample023","GBB","GGR",1,0,1
"2678","sample023","GBB","RBG",3,3,6
"2679","sample023","GBB","RBR",1,0,1
"2680","sample023","GBB","RGG",1,0,1
"2681","sample023","GBB","RGR",2,0,2
"2682","sample023","GBB","RRR",1,0,1
"2683","sample023","GBG","BRB",1,2,3
"2684","sample023","GBG","BRR",1,0,1
"2685","sample023","GBG","GGG",4,1,5
"2686","sample023","GBG","RBB",1,0,1
"2687","sample023","GBG","RGR",1,0,1
"2688","sample023","GBG","RRG",1,1,2
"2689","sample023","GGB","BBB",3,3,6
"2690","sample023","GGB","BBR",1,0,1
"2691","sample023","GGB","BRR",1,0,1
"2692","sample023","GGB","GBG",1,0,1
"2693","sample023","GGB","GGG",13,7,20
"2694","sample023","GGB","RGG",1,0,1
"2695","sample023","GGB","RRG",1,0,1
"2696","sample023","GGB","RRR",1,1,2
"2697","sample023","GGG","BBB",8,7,15
"2698","sample023","GGG","BGG",1,1,2
"2699","sample023","GGG","BRB",1,0,1
"2700","sample023","GGG","GGB",5,0,5
"2701","sample023","GGG","GGR",1,1,2
"2702","sample023","GGG","RBB",1,1,2
"2703","sample023","GGG","RGR",1,2,3
"2704","sample023","GGG","RRG",1,3,4
"2705","sample023","GGR","BRR",1,0,1
"2706","sample023","GGR","GRR",1,0,1
"2707","sample023","GRG","BBB",3,2,5
"2708","sample023","GRG","GGB",2,5,7
"2709","sample023","GRG","GGG",3,3,6
"2710","sample023","GRG","RGR",1,0,1
"2711","sample023","GRG","RRG",2,2,4
"2712","sample023","GRR","BGB",1,1,2
"2713","sample023","RBG","BBB",2,2,4
"2714","sample023","RBG","RBB",1,0,1
"2715","sample023","RBR","BGB",2,0,2
"2716","sample023","RBR","BRB",1,0,1
"2717","sample023","RBR","BRR",1,1,2
"2718","sample023","RBR","GRR",4,0,4
"2719","sample023","RBR","RGG",2,2,4
"2720","sample023","RBR","RGR",1,0,1
"2721","sample023","RGG","BBR",1,1,2
"2722","sample023","RGR","BBB",2,2,4
"2723","sample023","RGR","BBR",1,0,1
"2724","sample023","RGR","BGB",2,1,3
"2725","sample023","RGR","BGG",2,0,2
"2726","sample023","RGR","BRR",1,0,1
"2727","sample023","RGR","GGB",2,1,3
"2728","sample023","RGR","RGG",1,0,1
"2729","sample023","RRG","BBB",2,7,9
"2730","sample023","RRG","BGB",1,1,2
"2731","sample023","RRG","BRB",2,8,10
"2732","sample023","RRG","BRR",1,3,4
"2733","sample023","RRG","GGG",2,3,5
"2734","sample023","RRG","GRG",1,0,1
"2735","sample023","RRG","GRR",3,1,4
"2736","sample023","RRG","RBB",1,0,1
"2737","sample023","RRR","BBR",1,0,1
"2738","sample023","RRR","BGB",2,0,2
"2739","sample023","RRR","BGG",1,0,1
"2740","sample023","RRR","BRB",1,0,1
"2741","sample023","RRR","BRR",1,0,1
"2742","sample023","RRR","RBB",1,1,2
"2743","sample023","RRR","RGR",1,0,1
"2744","sample023","RRR","RRG",2,0,2
"2745","sample023","BBB","RBG",0,1,1
"2746","sample023","BBG","GBB",0,1,1
"2747","sample023","BBG","RBR",0,1,1
"2748","sample023","BBG","RRR",0,1,1
"2749","sample023","BRB","BBB",0,1,1
"2750","sample023","BRB","RGR",0,1,1
"2751","sample023","BRR","BBB",0,2,2
"2752","sample023","GBB","GGB",0,5,5
"2753","sample023","GBB","GRG",0,1,1
"2754","sample023","GBB","RRG",0,1,1
"2755","sample023","GBG","RGG",0,1,1
"2756","sample023","GGB","BGG",0,1,1
"2757","sample023","GGB","GBB",0,1,1
"2758","sample023","GGB","GRR",0,2,2
"2759","sample023","GGB","RBB",0,1,1
"2760","sample023","GGB","RBR",0,1,1
"2761","sample023","GGG","BRR",0,2,2
"2762","sample023","GGG","RBR",0,2,2
"2763","sample023","GGG","RGG",0,1,1
"2764","sample023","GGR","RBB",0,1,1
"2765","sample023","GRG","BBR",0,1,1
"2766","sample023","GRG","BGG",0,1,1
"2767","sample023","GRG","GGR",0,2,2
"2768","sample023","GRR","BRB",0,1,1
"2769","sample023","GRR","BRR",0,2,2
"2770","sample023","RBG","GRR",0,2,2
"2771","sample023","RBR","BBB",0,2,2
"2772","sample023","RBR","BBR",0,1,1
"2773","sample023","RGG","GGR",0,1,1
"2774","sample023","RGG","GRR",0,2,2
"2775","sample023","RGR","RBB",0,1,1
"2776","sample023","RGR","RRG",0,1,1
"2777","sample023","RRG","BBR",0,1,1
"2778","sample023","RRG","BGG",0,1,1
"2779","sample023","RRR","GRR",0,2,2
"2780","sample023","RRR","RGG",0,1,1
"2781","sample024","BBB","GGG",1,1,2
"2782","sample024","BBB","RRG",1,0,1
"2783","sample024","BBG","BBB",1,1,2
"2784","sample024","BBG","BRB",1,5,6
"2785","sample024","BBG","GBG",2,0,2
"2786","sample024","BBG","GGB",2,10,12
"2787","sample024","BBG","GGG",4,9,13
"2788","sample024","BBG","GRG",1,1,2
"2789","sample024","BBG","RRG",1,0,1
"2790","sample024","BGG","RBG",1,0,1
"2791","sample024","BGG","RRR",1,1,2
"2792","sample024","BRR","BGB",1,1,2
"2793","sample024","GBB","BBB",12,7,19
"2794","sample024","GBB","BRB",1,3,4
"2795","sample024","GBB","BRR",1,1,2
"2796","sample024","GBB","GGG",7,10,17
"2797","sample024","GBB","GGR",1,0,1
"2798","sample024","GBB","RBG",3,0,3
"2799","sample024","GBB","RBR",1,0,1
"2800","sample024","GBB","RGG",1,0,1
"2801","sample024","GBB","RGR",2,0,2
"2802","sample024","GBB","RRR",1,1,2
"2803","sample024","GBG","BRB",1,2,3
"2804","sample024","GBG","BRR",1,0,1
"2805","sample024","GBG","GGG",4,0,4
"2806","sample024","GBG","RBB",1,0,1
"2807","sample024","GBG","RGR",1,0,1
"2808","sample024","GBG","RRG",1,1,2
"2809","sample024","GGB","BBB",3,1,4
"2810","sample024","GGB","BBR",1,0,1
"2811","sample024","GGB","BRR",1,2,3
"2812","sample024","GGB","GBG",1,0,1
"2813","sample024","GGB","GGG",13,7,20
"2814","sample024","GGB","RGG",1,0,1
"2815","sample024","GGB","RRG",1,0,1
"2816","sample024","GGB","RRR",1,2,3
"2817","sample024","GGG","BBB",8,2,10
"2818","sample024","GGG","BGG",1,2,3
"2819","sample024","GGG","BRB",1,0,1
"2820","sample024","GGG","GGB",5,0,5
"2821","sample024","GGG","GGR",1,0,1
"2822","sample024","GGG","RBB",1,0,1
"2823","sample024","GGG","RGR",1,2,3
"2824","sample024","GGG","RRG",1,2,3
"2825","sample024","GGR","BRR",1,0,1
"2826","sample024","GGR","GRR",1,0,1
"2827","sample024","GRG","BBB",3,1,4
"2828","sample024","GRG","GGB",2,3,5
"2829","sample024","GRG","GGG",3,3,6
"2830","sample024","GRG","RGR",1,0,1
"2831","sample024","GRG","RRG",2,1,3
"2832","sample024","GRR","BGB",1,0,1
"2833","sample024","RBG","BBB",2,2,4
"2834","sample024","RBG","RBB",1,0,1
"2835","sample024","RBR","BGB",2,1,3
"2836","sample024","RBR","BRB",1,0,1
"2837","sample024","RBR","BRR",1,1,2
"2838","sample024","RBR","GRR",4,1,5
"2839","sample024","RBR","RGG",2,1,3
"2840","sample024","RBR","RGR",1,0,1
"2841","sample024","RGG","BBR",1,0,1
"2842","sample024","RGR","BBB",2,2,4
"2843","sample024","RGR","BBR",1,0,1
"2844","sample024","RGR","BGB",2,0,2
"2845","sample024","RGR","BGG",2,1,3
"2846","sample024","RGR","BRR",1,0,1
"2847","sample024","RGR","GGB",2,2,4
"2848","sample024","RGR","RGG",1,0,1
"2849","sample024","RRG","BBB",2,4,6
"2850","sample024","RRG","BGB",1,1,2
"2851","sample024","RRG","BRB",2,9,11
"2852","sample024","RRG","BRR",1,3,4
"2853","sample024","RRG","GGG",2,0,2
"2854","sample024","RRG","GRG",1,0,1
"2855","sample024","RRG","GRR",3,0,3
"2856","sample024","RRG","RBB",1,0,1
"2857","sample024","RRR","BBR",1,0,1
"2858","sample024","RRR","BGB",2,0,2
"2859","sample024","RRR","BGG",1,0,1
"2860","sample024","RRR","BRB",1,0,1
"2861","sample024","RRR","BRR",1,0,1
"2862","sample024","RRR","RBB",1,1,2
"2863","sample024","RRR","RGR",1,0,1
"2864","sample024","RRR","RRG",2,1,3
"2865","sample024","BBB","GRR",0,1,1
"2866","sample024","BBG","BGB",0,1,1
"2867","sample024","BBG","BGG",0,1,1
"2868","sample024","BBG","GBB",0,1,1
"2869","sample024","BBG","GRR",0,1,1
"2870","sample024","BBG","RRR",0,2,2
"2871","sample024","BGB","BBB",0,1,1
"2872","sample024","BGG","BBB",0,1,1
"2873","sample024","BRB","BBB",0,3,3
"2874","sample024","BRB","BRR",0,1,1
"2875","sample024","BRR","BBB",0,1,1
"2876","sample024","BRR","RBB",0,1,1
"2877","sample024","GBB","GBG",0,1,1
"2878","sample024","GBB","GGB",0,3,3
"2879","sample024","GBB","GRG",0,2,2
"2880","sample024","GBB","RBB",0,1,1
"2881","sample024","GBG","BBB",0,1,1
"2882","sample024","GBG","BBR",0,1,1
"2883","sample024","GBG","RBG",0,1,1
"2884","sample024","GGB","BGG",0,2,2
"2885","sample024","GGB","GGR",0,1,1
"2886","sample024","GGB","RBR",0,2,2
"2887","sample024","GGG","BRR",0,1,1
"2888","sample024","GGG","RRR",0,1,1
"2889","sample024","GGR","BBR",0,1,1
"2890","sample024","GRG","BRB",0,1,1
"2891","sample024","GRG","GBG",0,1,1
"2892","sample024","GRG","GGR",0,1,1
"2893","sample024","GRR","BGG",0,2,2
"2894","sample024","GRR","BRB",0,1,1
"2895","sample024","RBG","BRR",0,1,1
"2896","sample024","RBR","GGB",0,2,2
"2897","sample024","RGG","BRR",0,2,2
"2898","sample024","RGR","RBB",0,1,1
"2899","sample024","RGR","RRG",0,1,1
"2900","sample024","RRG","RGG",0,1,1
"2901","sample024","RRR","GRR",0,1,1
"2902","sample025","BBB","GGG",1,0,1
"2903","sample025","BBB","RRG",1,0,1
"2904","sample025","BBG","BBB",1,1,2
"2905","sample025","BBG","BRB",1,3,4
"2906","sample025","BBG","GBG",2,2,4
"2907","sample025","BBG","GGB",2,2,4
"2908","sample025","BBG","GGG",4,5,9
"2909","sample025","BBG","GRG",1,0,1
"2910","sample025","BBG","RRG",1,0,1
"2911","sample025","BGG","RBG",1,0,1
"2912","sample025","BGG","RRR",1,0,1
"2913","sample025","BRR","BGB",1,0,1
"2914","sample025","GBB","BBB",12,6,18
"2915","sample025","GBB","BRB",1,2,3
"2916","sample025","GBB","BRR",1,1,2
"2917","sample025","GBB","GGG",7,12,19
"2918","sample025","GBB","GGR",1,0,1
"2919","sample025","GBB","RBG",3,2,5
"2920","sample025","GBB","RBR",1,0,1
"2921","sample025","GBB","RGG",1,0,1
"2922","sample025","GBB","RGR",2,0,2
"2923","sample025","GBB","RRR",1,2,3
"2924","sample025","GBG","BRB",1,1,2
"2925","sample025","GBG","BRR",1,0,1
"2926","sample025","GBG","GGG",4,2,6
"2927","sample025","GBG","RBB",1,0,1
"2928","sample025","GBG","RGR",1,0,1
"2929","sample025","GBG","RRG",1,0,1
"2930","sample025","GGB","BBB",3,1,4
"2931","sample025","GGB","BBR",1,3,4
"2932","sample025","GGB","BRR",1,1,2
"2933","sample025","GGB","GBG",1,0,1
"2934","sample025","GGB","GGG",13,10,23
"2935","sample025","GGB","RGG",1,1,2
"2936","sample025","GGB","RRG",1,2,3
"2937","sample025","GGB","RRR",1,1,2
"2938","sample025","GGG","BBB",8,7,15
"2939","sample025","GGG","BGG",1,1,2
"2940","sample025","GGG","BRB",1,0,1
"2941","sample025","GGG","GGB",5,0,5
"2942","sample025","GGG","GGR",1,2,3
"2943","sample025","GGG","RBB",1,1,2
"2944","sample025","GGG","RGR",1,2,3
"2945","sample025","GGG","RRG",1,2,3
"2946","sample025","GGR","BRR",1,0,1
"2947","sample025","GGR","GRR",1,0,1
"2948","sample025","GRG","BBB",3,0,3
"2949","sample025","GRG","GGB",2,4,6
"2950","sample025","GRG","GGG",3,2,5
"2951","sample025","GRG","RGR",1,0,1
"2952","sample025","GRG","RRG",2,0,2
"2953","sample025","GRR","BGB",1,0,1
"2954","sample025","RBG","BBB",2,0,2
"2955","sample025","RBG","RBB",1,0,1
"2956","sample025","RBR","BGB",2,2,4
"2957","sample025","RBR","BRB",1,0,1
"2958","sample025","RBR","BRR",1,1,2
"2959","sample025","RBR","GRR",4,0,4
"2960","sample025","RBR","RGG",2,0,2
"2961","sample025","RBR","RGR",1,0,1
"2962","sample025","RGG","BBR",1,0,1
"2963","sample025","RGR","BBB",2,0,2
"2964","sample025","RGR","BBR",1,1,2
"2965","sample025","RGR","BGB",2,0,2
"2966","sample025","RGR","BGG",2,1,3
"2967","sample025","RGR","BRR",1,0,1
"2968","sample025","RGR","GGB",2,2,4
"2969","sample025","RGR","RGG",1,0,1
"2970","sample025","RRG","BBB",2,5,7
"2971","sample025","RRG","BGB",1,2,3
"2972","sample025","RRG","BRB",2,6,8
"2973","sample025","RRG","BRR",1,3,4
"2974","sample025","RRG","GGG",2,1,3
"2975","sample025","RRG","GRG",1,0,1
"2976","sample025","RRG","GRR",3,1,4
"2977","sample025","RRG","RBB",1,0,1
"2978","sample025","RRR","BBR",1,0,1
"2979","sample025","RRR","BGB",2,0,2
"2980","sample025","RRR","BGG",1,0,1
"2981","sample025","RRR","BRB",1,0,1
"2982","sample025","RRR","BRR",1,0,1
"2983","sample025","RRR","RBB",1,0,1
"2984","sample025","RRR","RGR",1,0,1
"2985","sample025","RRR","RRG",2,0,2
"2986","sample025","BBB","GRR",0,1,1
"2987","sample025","BBG","BGB",0,1,1
"2988","sample025","BBG","GBB",0,1,1
"2989","sample025","BBG","RBB",0,1,1
"2990","sample025","BBG","RBG",0,1,1
"2991","sample025","BBG","RRR",0,2,2
"2992","sample025","BGG","BBB",0,2,2
"2993","sample025","BGG","RGG",0,2,2
"2994","sample025","BGG","RGR",0,1,1
"2995","sample025","BRB","BBB",0,3,3
"2996","sample025","BRB","GGR",0,1,1
"2997","sample025","BRB","RBB",0,1,1
"2998","sample025","BRB","RBG",0,1,1
"2999","sample025","BRR","BBB",0,1,1
"3000","sample025","BRR","BGG",0,1,1
"3001","sample025","BRR","BRB",0,1,1
"3002","sample025","BRR","RBB",0,1,1
"3003","sample025","GBB","BGG",0,1,1
"3004","sample025","GBB","GGB",0,1,1
"3005","sample025","GBG","GGB",0,1,1
"3006","sample025","GBG","RBG",0,1,1
"3007","sample025","GGB","BGB",0,1,1
"3008","sample025","GGB","GGR",0,2,2
"3009","sample025","GGB","RBG",0,3,3
"3010","sample025","GGG","BGB",0,1,1
"3011","sample025","GGG","RBR",0,1,1
"3012","sample025","GRG","BRR",0,1,1
"3013","sample025","GRR","BBB",0,1,1
"3014","sample025","GRR","BRB",0,1,1
"3015","sample025","RBG","BBG",0,1,1
"3016","sample025","RBG","GRR",0,1,1
"3017","sample025","RBG","RGR",0,1,1
"3018","sample025","RBR","BBB",0,2,2
"3019","sample025","RBR","GGB",0,1,1
"3020","sample025","RBR","RRR",0,1,1
"3021","sample025","RGG","BBB",0,1,1
"3022","sample025","RGR","RBB",0,1,1
"3023","sample025","RGR","RRG",0,1,1
"3024","sample025","RRG","BBR",0,1,1
"3025","sample025","RRG","BGG",0,1,1
"3026","sample025","RRG","GGR",0,1,1
"3027","sample025","RRG","RGG",0,1,1
"3028","sample025","RRR","GRR",0,1,1
"3029","sample025","RRR","RBR",0,1,1
"3030","sample025","RRR","RGG",0,1,1
"3031","sample026","BBB","GGG",1,0,1
"3032","sample026","BBB","RRG",1,0,1
"3033","sample026","BBG","BBB",1,0,1
"3034","sample026","BBG","BRB",1,1,2
"3035","sample026","BBG","GBG",2,1,3
"3036","sample026","BBG","GGB",2,2,4
"3037","sample026","BBG","GGG",4,2,6
"3038","sample026","BBG","GRG",1,1,2
"3039","sample026","BBG","RRG",1,0,1
"3040","sample026","BGG","RBG",1,1,2
"3041","sample026","BGG","RRR",1,0,1
"3042","sample026","BRR","BGB",1,0,1
"3043","sample026","GBB","BBB",12,9,21
"3044","sample026","GBB","BRB",1,1,2
"3045","sample026","GBB","BRR",1,0,1
"3046","sample026","GBB","GGG",7,8,15
"3047","sample026","GBB","GGR",1,1,2
"3048","sample026","GBB","RBG",3,0,3
"3049","sample026","GBB","RBR",1,0,1
"3050","sample026","GBB","RGG",1,0,1
"3051","sample026","GBB","RGR",2,0,2
"3052","sample026","GBB","RRR",1,1,2
"3053","sample026","GBG","BRB",1,0,1
"3054","sample026","GBG","BRR",1,0,1
"3055","sample026","GBG","GGG",4,1,5
"3056","sample026","GBG","RBB",1,0,1
"3057","sample026","GBG","RGR",1,0,1
"3058","sample026","GBG","RRG",1,0,1
"3059","sample026","GGB","BBB",3,5,8
"3060","sample026","GGB","BBR",1,0,1
"3061","sample026","GGB","BRR",1,1,2
"3062","sample026","GGB","GBG",1,0,1
"3063","sample026","GGB","GGG",13,9,22
"3064","sample026","GGB","RGG",1,2,3
"3065","sample026","GGB","RRG",1,2,3
"3066","sample026","GGB","RRR",1,0,1
"3067","sample026","GGG","BBB",8,3,11
"3068","sample026","GGG","BGG",1,0,1
"3069","sample026","GGG","BRB",1,0,1
"3070","sample026","GGG","GGB",5,0,5
"3071","sample026","GGG","GGR",1,0,1
"3072","sample026","GGG","RBB",1,2,3
"3073","sample026","GGG","RGR",1,3,4
"3074","sample026","GGG","RRG",1,6,7
"3075","sample026","GGR","BRR",1,0,1
"3076","sample026","GGR","GRR",1,0,1
"3077","sample026","GRG","BBB",3,1,4
"3078","sample026","GRG","GGB",2,2,4
"3079","sample026","GRG","GGG",3,5,8
"3080","sample026","GRG","RGR",1,0,1
"3081","sample026","GRG","RRG",2,2,4
"3082","sample026","GRR","BGB",1,0,1
"3083","sample026","RBG","BBB",2,1,3
"3084","sample026","RBG","RBB",1,0,1
"3085","sample026","RBR","BGB",2,2,4
"3086","sample026","RBR","BRB",1,0,1
"3087","sample026","RBR","BRR",1,1,2
"3088","sample026","RBR","GRR",4,0,4
"3089","sample026","RBR","RGG",2,2,4
"3090","sample026","RBR","RGR",1,0,1
"3091","sample026","RGG","BBR",1,1,2
"3092","sample026","RGR","BBB",2,1,3
"3093","sample026","RGR","BBR",1,0,1
"3094","sample026","RGR","BGB",2,3,5
"3095","sample026","RGR","BGG",2,0,2
"3096","sample026","RGR","BRR",1,0,1
"3097","sample026","RGR","GGB",2,1,3
"3098","sample026","RGR","RGG",1,0,1
"3099","sample026","RRG","BBB",2,4,6
"3100","sample026","RRG","BGB",1,1,2
"3101","sample026","RRG","BRB",2,6,8
"3102","sample026","RRG","BRR",1,2,3
"3103","sample026","RRG","GGG",2,2,4
"3104","sample026","RRG","GRG",1,0,1
"3105","sample026","RRG","GRR",3,2,5
"3106","sample026","RRG","RBB",1,1,2
"3107","sample026","RRR","BBR",1,0,1
"3108","sample026","RRR","BGB",2,1,3
"3109","sample026","RRR","BGG",1,0,1
"3110","sample026","RRR","BRB",1,0,1
"3111","sample026","RRR","BRR",1,0,1
"3112","sample026","RRR","RBB",1,0,1
"3113","sample026","RRR","RGR",1,0,1
"3114","sample026","RRR","RRG",2,0,2
"3115","sample026","BBB","GRR",0,1,1
"3116","sample026","BBB","RRR",0,1,1
"3117","sample026","BBG","RBG",0,1,1
"3118","sample026","BBG","RRR",0,1,1
"3119","sample026","BGG","BBR",0,1,1
"3120","sample026","BGG","RGG",0,1,1
"3121","sample026","BGG","RGR",0,1,1
"3122","sample026","BRB","BBB",0,2,2
"3123","sample026","BRB","BBR",0,1,1
"3124","sample026","BRB","GGG",0,1,1
"3125","sample026","BRR","BBB",0,1,1
"3126","sample026","GBB","BGG",0,1,1
"3127","sample026","GBB","GBG",0,1,1
"3128","sample026","GBB","GGB",0,2,2
"3129","sample026","GBG","BBB",0,1,1
"3130","sample026","GBG","BBR",0,1,1
"3131","sample026","GBG","RGG",0,1,1
"3132","sample026","GGB","BGG",0,1,1
"3133","sample026","GGB","GGR",0,2,2
"3134","sample026","GGB","GRR",0,2,2
"3135","sample026","GGB","RBB",0,1,1
"3136","sample026","GGB","RBG",0,1,1
"3137","sample026","GGB","RBR",0,3,3
"3138","sample026","GGB","RGR",0,1,1
"3139","sample026","GGG","BRR",0,2,2
"3140","sample026","GGG","RBG",0,4,4
"3141","sample026","GGG","RBR",0,3,3
"3142","sample026","GGR","RBB",0,1,1
"3143","sample026","GRG","GGR",0,1,1
"3144","sample026","GRR","BGG",0,1,1
"3145","sample026","GRR","GGG",0,1,1
"3146","sample026","RBG","GRR",0,1,1
"3147","sample026","RBR","BBB",0,5,5
"3148","sample026","RBR","BGG",0,1,1
"3149","sample026","RBR","GGB",0,1,1
"3150","sample026","RGG","BBB",0,1,1
"3151","sample026","RGG","BRR",0,1,1
"3152","sample026","RGG","GRR",0,1,1
"3153","sample026","RGR","RRG",0,1,1
"3154","sample026","RRG","BBR",0,1,1
"3155","sample026","RRG","BGG",0,1,1
"3156","sample027","BBB","GGG",1,0,1
"3157","sample027","BBB","RRG",1,0,1
"3158","sample027","BBG","BBB",1,1,2
"3159","sample027","BBG","BRB",1,3,4
"3160","sample027","BBG","GBG",2,1,3
"3161","sample027","BBG","GGB",2,8,10
"3162","sample027","BBG","GGG",4,7,11
"3163","sample027","BBG","GRG",1,3,4
"3164","sample027","BBG","RRG",1,0,1
"3165","sample027","BGG","RBG",1,0,1
"3166","sample027","BGG","RRR",1,0,1
"3167","sample027","BRR","BGB",1,0,1
"3168","sample027","GBB","BBB",12,4,16
"3169","sample027","GBB","BRB",1,1,2
"3170","sample027","GBB","BRR",1,0,1
"3171","sample027","GBB","GGG",7,14,21
"3172","sample027","GBB","GGR",1,0,1
"3173","sample027","GBB","RBG",3,1,4
"3174","sample027","GBB","RBR",1,0,1
"3175","sample027","GBB","RGG",1,0,1
"3176","sample027","GBB","RGR",2,0,2
"3177","sample027","GBB","RRR",1,2,3
"3178","sample027","GBG","BRB",1,0,1
"3179","sample027","GBG","BRR",1,0,1
"3180","sample027","GBG","GGG",4,2,6
"3181","sample027","GBG","RBB",1,0,1
"3182","sample027","GBG","RGR",1,1,2
"3183","sample027","GBG","RRG",1,1,2
"3184","sample027","GGB","BBB",3,0,3
"3185","sample027","GGB","BBR",1,0,1
"3186","sample027","GGB","BRR",1,1,2
"3187","sample027","GGB","GBG",1,0,1
"3188","sample027","GGB","GGG",13,7,20
"3189","sample027","GGB","RGG",1,1,2
"3190","sample027","GGB","RRG",1,2,3
"3191","sample027","GGB","RRR",1,1,2
"3192","sample027","GGG","BBB",8,10,18
"3193","sample027","GGG","BGG",1,1,2
"3194","sample027","GGG","BRB",1,0,1
"3195","sample027","GGG","GGB",5,0,5
"3196","sample027","GGG","GGR",1,1,2
"3197","sample027","GGG","RBB",1,0,1
"3198","sample027","GGG","RGR",1,0,1
"3199","sample027","GGG","RRG",1,5,6
"3200","sample027","GGR","BRR",1,0,1
"3201","sample027","GGR","GRR",1,0,1
"3202","sample027","GRG","BBB",3,1,4
"3203","sample027","GRG","GGB",2,1,3
"3204","sample027","GRG","GGG",3,2,5
"3205","sample027","GRG","RGR",1,0,1
"3206","sample027","GRG","RRG",2,0,2
"3207","sample027","GRR","BGB",1,0,1
"3208","sample027","RBG","BBB",2,1,3
"3209","sample027","RBG","RBB",1,0,1
"3210","sample027","RBR","BGB",2,1,3
"3211","sample027","RBR","BRB",1,0,1
"3212","sample027","RBR","BRR",1,0,1
"3213","sample027","RBR","GRR",4,2,6
"3214","sample027","RBR","RGG",2,2,4
"3215","sample027","RBR","RGR",1,0,1
"3216","sample027","RGG","BBR",1,0,1
"3217","sample027","RGR","BBB",2,0,2
"3218","sample027","RGR","BBR",1,0,1
"3219","sample027","RGR","BGB",2,1,3
"3220","sample027","RGR","BGG",2,1,3
"3221","sample027","RGR","BRR",1,1,2
"3222","sample027","RGR","GGB",2,4,6
"3223","sample027","RGR","RGG",1,0,1
"3224","sample027","RRG","BBB",2,1,3
"3225","sample027","RRG","BGB",1,2,3
"3226","sample027","RRG","BRB",2,7,9
"3227","sample027","RRG","BRR",1,0,1
"3228","sample027","RRG","GGG",2,4,6
"3229","sample027","RRG","GRG",1,0,1
"3230","sample027","RRG","GRR",3,1,4
"3231","sample027","RRG","RBB",1,0,1
"3232","sample027","RRR","BBR",1,0,1
"3233","sample027","RRR","BGB",2,0,2
"3234","sample027","RRR","BGG",1,0,1
"3235","sample027","RRR","BRB",1,0,1
"3236","sample027","RRR","BRR",1,0,1
"3237","sample027","RRR","RBB",1,0,1
"3238","sample027","RRR","RGR",1,0,1
"3239","sample027","RRR","RRG",2,0,2
"3240","sample027","BBG","GBB",0,1,1
"3241","sample027","BBG","GRR",0,1,1
"3242","sample027","BGG","GRG",0,1,1
"3243","sample027","BGG","RGG",0,1,1
"3244","sample027","BRB","BBB",0,1,1
"3245","sample027","BRB","GGG",0,1,1
"3246","sample027","BRB","RBB",0,1,1
"3247","sample027","BRR","RBB",0,1,1
"3248","sample027","GBB","GGB",0,1,1
"3249","sample027","GBB","GRG",0,1,1
"3250","sample027","GBB","GRR",0,1,1
"3251","sample027","GBG","GGB",0,2,2
"3252","sample027","GBG","RGG",0,1,1
"3253","sample027","GGB","BGB",0,1,1
"3254","sample027","GGB","GBB",0,1,1
"3255","sample027","GGB","GGR",0,1,1
"3256","sample027","GGB","RBB",0,1,1
"3257","sample027","GGB","RGR",0,1,1
"3258","sample027","GGG","BRR",0,2,2
"3259","sample027","GGG","RBG",0,2,2
"3260","sample027","GGG","RBR",0,7,7
"3261","sample027","GGG","RRR",0,1,1
"3262","sample027","GRG","BRR",0,1,1
"3263","sample027","GRG","GGR",0,2,2
"3264","sample027","GRR","BBR",0,1,1
"3265","sample027","RBB","BBB",0,1,1
"3266","sample027","RBB","BRB",0,1,1
"3267","sample027","RBG","GRR",0,2,2
"3268","sample027","RBG","RBR",0,1,1
"3269","sample027","RBR","BBB",0,1,1
"3270","sample027","RBR","BGG",0,1,1
"3271","sample027","RBR","GGB",0,2,2
"3272","sample027","RGG","BBB",0,1,1
"3273","sample027","RGG","BGB",0,1,1
"3274","sample027","RGG","GRR",0,1,1
"3275","sample027","RGR","RBB",0,1,1
"3276","sample027","RRG","GGR",0,1,1
"3277","sample027","RRG","RGR",0,1,1
"3278","sample028","BBB","GGG",1,0,1
"3279","sample028","BBB","RRG",1,0,1
"3280","sample028","BBG","BBB",1,1,2
"3281","sample028","BBG","BRB",1,1,2
"3282","sample028","BBG","GBG",2,1,3
"3283","sample028","BBG","GGB",2,3,5
"3284","sample028","BBG","GGG",4,3,7
"3285","sample028","BBG","GRG",1,5,6
"3286","sample028","BBG","RRG",1,0,1
"3287","sample028","BGG","RBG",1,0,1
"3288","sample028","BGG","RRR",1,0,1
"3289","sample028","BRR","BGB",1,0,1
"3290","sample028","GBB","BBB",12,9,21
"3291","sample028","GBB","BRB",1,1,2
"3292","sample028","GBB","BRR",1,1,2
"3293","sample028","GBB","GGG",7,14,21
"3294","sample028","GBB","GGR",1,0,1
"3295","sample028","GBB","RBG",3,0,3
"3296","sample028","GBB","RBR",1,0,1
"3297","sample028","GBB","RGG",1,0,1
"3298","sample028","GBB","RGR",2,1,3
"3299","sample028","GBB","RRR",1,1,2
"3300","sample028","GBG","BRB",1,0,1
"3301","sample028","GBG","BRR",1,0,1
"3302","sample028","GBG","GGG",4,1,5
"3303","sample028","GBG","RBB",1,0,1
"3304","sample028","GBG","RGR",1,0,1
"3305","sample028","GBG","RRG",1,1,2
"3306","sample028","GGB","BBB",3,1,4
"3307","sample028","GGB","BBR",1,0,1
"3308","sample028","GGB","BRR",1,2,3
"3309","sample028","GGB","GBG",1,0,1
"3310","sample028","GGB","GGG",13,5,18
"3311","sample028","GGB","RGG",1,1,2
"3312","sample028","GGB","RRG",1,1,2
"3313","sample028","GGB","RRR",1,1,2
"3314","sample028","GGG","BBB",8,8,16
"3315","sample028","GGG","BGG",1,1,2
"3316","sample028","GGG","BRB",1,0,1
"3317","sample028","GGG","GGB",5,1,6
"3318","sample028","GGG","GGR",1,1,2
"3319","sample028","GGG","RBB",1,1,2
"3320","sample028","GGG","RGR",1,2,3
"3321","sample028","GGG","RRG",1,2,3
"3322","sample028","GGR","BRR",1,0,1
"3323","sample028","GGR","GRR",1,0,1
"3324","sample028","GRG","BBB",3,2,5
"3325","sample028","GRG","GGB",2,1,3
"3326","sample028","GRG","GGG",3,1,4
"3327","sample028","GRG","RGR",1,1,2
"3328","sample028","GRG","RRG",2,1,3
"3329","sample028","GRR","BGB",1,0,1
"3330","sample028","RBG","BBB",2,1,3
"3331","sample028","RBG","RBB",1,0,1
"3332","sample028","RBR","BGB",2,1,3
"3333","sample028","RBR","BRB",1,0,1
"3334","sample028","RBR","BRR",1,0,1
"3335","sample028","RBR","GRR",4,0,4
"3336","sample028","RBR","RGG",2,1,3
"3337","sample028","RBR","RGR",1,0,1
"3338","sample028","RGG","BBR",1,0,1
"3339","sample028","RGR","BBB",2,0,2
"3340","sample028","RGR","BBR",1,0,1
"3341","sample028","RGR","BGB",2,0,2
"3342","sample028","RGR","BGG",2,0,2
"3343","sample028","RGR","BRR",1,1,2
"3344","sample028","RGR","GGB",2,3,5
"3345","sample028","RGR","RGG",1,0,1
"3346","sample028","RRG","BBB",2,9,11
"3347","sample028","RRG","BGB",1,0,1
"3348","sample028","RRG","BRB",2,5,7
"3349","sample028","RRG","BRR",1,1,2
"3350","sample028","RRG","GGG",2,4,6
"3351","sample028","RRG","GRG",1,0,1
"3352","sample028","RRG","GRR",3,0,3
"3353","sample028","RRG","RBB",1,0,1
"3354","sample028","RRR","BBR",1,0,1
"3355","sample028","RRR","BGB",2,0,2
"3356","sample028","RRR","BGG",1,0,1
"3357","sample028","RRR","BRB",1,0,1
"3358","sample028","RRR","BRR",1,0,1
"3359","sample028","RRR","RBB",1,1,2
"3360","sample028","RRR","RGR",1,0,1
"3361","sample028","RRR","RRG",2,0,2
"3362","sample028","BBB","BRB",0,1,1
"3363","sample028","BBB","GRR",0,1,1
"3364","sample028","BBG","RBG",0,1,1
"3365","sample028","BBG","RGR",0,1,1
"3366","sample028","BGB","RRG",0,1,1
"3367","sample028","BGG","BBB",0,1,1
"3368","sample028","BRB","BBB",0,3,3
"3369","sample028","BRB","RBB",0,1,1
"3370","sample028","BRB","RBG",0,1,1
"3371","sample028","BRB","RRR",0,1,1
"3372","sample028","BRR","BBB",0,2,2
"3373","sample028","BRR","BGG",0,1,1
"3374","sample028","GBB","GBG",0,1,1
"3375","sample028","GBB","GGB",0,5,5
"3376","sample028","GBB","RRG",0,1,1
"3377","sample028","GBG","BBB",0,1,1
"3378","sample028","GBG","BBR",0,1,1
"3379","sample028","GBG","GGB",0,2,2
"3380","sample028","GGB","BGG",0,1,1
"3381","sample028","GGB","GGR",0,2,2
"3382","sample028","GGB","GRR",0,2,2
"3383","sample028","GGB","RBR",0,2,2
"3384","sample028","GGG","BRR",0,1,1
"3385","sample028","GGG","RBR",0,1,1
"3386","sample028","GRG","BGG",0,1,1
"3387","sample028","GRG","GGR",0,2,2
"3388","sample028","RBG","BRR",0,1,1
"3389","sample028","RBG","GRR",0,1,1
"3390","sample028","RBR","BBB",0,1,1
"3391","sample028","RBR","GGB",0,2,2
"3392","sample028","RBR","RBB",0,1,1
"3393","sample028","RGG","BBB",0,2,2
"3394","sample028","RGG","BRR",0,1,1
"3395","sample028","RGG","GRR",0,1,1
"3396","sample028","RGR","GGG",0,1,1
"3397","sample028","RGR","GGR",0,2,2
"3398","sample028","RGR","RBB",0,1,1
"3399","sample028","RRG","BGG",0,1,1
"3400","sample028","RRG","GGR",0,1,1
"3401","sample028","RRG","RGG",0,1,1
"3402","sample028","RRR","GRR",0,2,2
"3403","sample029","BBB","GGG",1,1,2
"3404","sample029","BBB","RRG",1,1,2
"3405","sample029","BBG","BBB",1,0,1
"3406","sample029","BBG","BRB",1,3,4
"3407","sample029","BBG","GBG",2,0,2
"3408","sample029","BBG","GGB",2,4,6
"3409","sample029","BBG","GGG",4,7,11
"3410","sample029","BBG","GRG",1,2,3
"3411","sample029","BBG","RRG",1,0,1
"3412","sample029","BGG","RBG",1,0,1
"3413","sample029","BGG","RRR",1,1,2
"3414","sample029","BRR","BGB",1,1,2
"3415","sample029","GBB","BBB",12,6,18
"3416","sample029","GBB","BRB",1,4,5
"3417","sample029","GBB","BRR",1,0,1
"3418","sample029","GBB","GGG",7,5,12
"3419","sample029","GBB","GGR",1,0,1
"3420","sample029","GBB","RBG",3,2,5
"3421","sample029","GBB","RBR",1,0,1
"3422","sample029","GBB","RGG",1,0,1
"3423","sample029","GBB","RGR",2,0,2
"3424","sample029","GBB","RRR",1,1,2
"3425","sample029","GBG","BRB",1,0,1
"3426","sample029","GBG","BRR",1,0,1
"3427","sample029","GBG","GGG",4,1,5
"3428","sample029","GBG","RBB",1,0,1
"3429","sample029","GBG","RGR",1,1,2
"3430","sample029","GBG","RRG",1,2,3
"3431","sample029","GGB","BBB",3,3,6
"3432","sample029","GGB","BBR",1,0,1
"3433","sample029","GGB","BRR",1,1,2
"3434","sample029","GGB","GBG",1,0,1
"3435","sample029","GGB","GGG",13,11,24
"3436","sample029","GGB","RGG",1,1,2
"3437","sample029","GGB","RRG",1,0,1
"3438","sample029","GGB","RRR",1,1,2
"3439","sample029","GGG","BBB",8,5,13
"3440","sample029","GGG","BGG",1,1,2
"3441","sample029","GGG","BRB",1,1,2
"3442","sample029","GGG","GGB",5,0,5
"3443","sample029","GGG","GGR",1,0,1
"3444","sample029","GGG","RBB",1,1,2
"3445","sample029","GGG","RGR",1,1,2
"3446","sample029","GGG","RRG",1,2,3
"3447","sample029","GGR","BRR",1,0,1
"3448","sample029","GGR","GRR",1,0,1
"3449","sample029","GRG","BBB",3,2,5
"3450","sample029","GRG","GGB",2,1,3
"3451","sample029","GRG","GGG",3,2,5
"3452","sample029","GRG","RGR",1,0,1
"3453","sample029","GRG","RRG",2,0,2
"3454","sample029","GRR","BGB",1,0,1
"3455","sample029","RBG","BBB",2,0,2
"3456","sample029","RBG","RBB",1,0,1
"3457","sample029","RBR","BGB",2,1,3
"3458","sample029","RBR","BRB",1,0,1
"3459","sample029","RBR","BRR",1,1,2
"3460","sample029","RBR","GRR",4,2,6
"3461","sample029","RBR","RGG",2,0,2
"3462","sample029","RBR","RGR",1,0,1
"3463","sample029","RGG","BBR",1,0,1
"3464","sample029","RGR","BBB",2,0,2
"3465","sample029","RGR","BBR",1,0,1
"3466","sample029","RGR","BGB",2,2,4
"3467","sample029","RGR","BGG",2,0,2
"3468","sample029","RGR","BRR",1,0,1
"3469","sample029","RGR","GGB",2,0,2
"3470","sample029","RGR","RGG",1,0,1
"3471","sample029","RRG","BBB",2,2,4
"3472","sample029","RRG","BGB",1,0,1
"3473","sample029","RRG","BRB",2,9,11
"3474","sample029","RRG","BRR",1,2,3
"3475","sample029","RRG","GGG",2,4,6
"3476","sample029","RRG","GRG",1,0,1
"3477","sample029","RRG","GRR",3,1,4
"3478","sample029","RRG","RBB",1,0,1
"3479","sample029","RRR","BBR",1,0,1
"3480","sample029","RRR","BGB",2,0,2
"3481","sample029","RRR","BGG",1,0,1
"3482","sample029","RRR","BRB",1,0,1
"3483","sample029","RRR","BRR",1,0,1
"3484","sample029","RRR","RBB",1,1,2
"3485","sample029","RRR","RGR",1,0,1
"3486","sample029","RRR","RRG",2,1,3
"3487","sample029","BBB","RRR",0,1,1
"3488","sample029","BBG","RBR",0,1,1
"3489","sample029","BGB","BBB",0,1,1
"3490","sample029","BGG","BBR",0,1,1
"3491","sample029","BGG","GRG",0,1,1
"3492","sample029","BRB","BBB",0,1,1
"3493","sample029","BRR","BBB",0,2,2
"3494","sample029","BRR","RBB",0,1,1
"3495","sample029","GBB","BGG",0,1,1
"3496","sample029","GBB","GBG",0,1,1
"3497","sample029","GBB","GGB",0,2,2
"3498","sample029","GBB","GRG",0,3,3
"3499","sample029","GBB","RRG",0,1,1
"3500","sample029","GBG","GGB",0,1,1
"3501","sample029","GBG","RGG",0,1,1
"3502","sample029","GGB","BGG",0,1,1
"3503","sample029","GGB","RBB",0,3,3
"3504","sample029","GGB","RGR",0,1,1
"3505","sample029","GGG","BGB",0,1,1
"3506","sample029","GGG","BRR",0,1,1
"3507","sample029","GGG","RBR",0,4,4
"3508","sample029","GGG","RRR",0,2,2
"3509","sample029","GGR","RBB",0,1,1
"3510","sample029","GRG","BRB",0,2,2
"3511","sample029","GRR","BGG",0,1,1
"3512","sample029","GRR","BRB",0,1,1
"3513","sample029","RBB","BBB",0,1,1
"3514","sample029","RBB","BRB",0,1,1
"3515","sample029","RBG","GRR",0,1,1
"3516","sample029","RBR","BBB",0,4,4
"3517","sample029","RBR","GGB",0,2,2
"3518","sample029","RGG","BBB",0,1,1
"3519","sample029","RGG","BRR",0,2,2
"3520","sample029","RGG","GGR",0,1,1
"3521","sample029","RGG","GRR",0,1,1
"3522","sample029","RGR","GGR",0,1,1
"3523","sample029","RGR","RBB",0,1,1
"3524","sample029","RRG","BGG",0,1,1
"3525","sample029","RRG","GGR",0,1,1
"3526","sample029","RRG","RGG",0,1,1
"3527","sample029","RRR","GGR",0,1,1
"3528","sample029","RRR","GRR",0,1,1
"3529","sample029","RRR","RBR",0,1,1
"3530","sample030","BBB","GGG",1,0,1
"3531","sample030","BBB","RRG",1,1,2
"3532","sample030","BBG","BBB",1,1,2
"3533","sample030","BBG","BRB",1,2,3
"3534","sample030","BBG","GBG",2,1,3
"3535","sample030","BBG","GGB",2,5,7
"3536","sample030","BBG","GGG",4,2,6
"3537","sample030","BBG","GRG",1,0,1
"3538","sample030","BBG","RRG",1,0,1
"3539","sample030","BGG","RBG",1,0,1
"3540","sample030","BGG","RRR",1,0,1
"3541","sample030","BRR","BGB",1,1,2
"3542","sample030","GBB","BBB",12,6,18
"3543","sample030","GBB","BRB",1,1,2
"3544","sample030","GBB","BRR",1,2,3
"3545","sample030","GBB","GGG",7,10,17
"3546","sample030","GBB","GGR",1,0,1
"3547","sample030","GBB","RBG",3,1,4
"3548","sample030","GBB","RBR",1,0,1
"3549","sample030","GBB","RGG",1,0,1
"3550","sample030","GBB","RGR",2,1,3
"3551","sample030","GBB","RRR",1,2,3
"3552","sample030","GBG","BRB",1,0,1
"3553","sample030","GBG","BRR",1,0,1
"3554","sample030","GBG","GGG",4,1,5
"3555","sample030","GBG","RBB",1,0,1
"3556","sample030","GBG","RGR",1,0,1
"3557","sample030","GBG","RRG",1,1,2
"3558","sample030","GGB","BBB",3,1,4
"3559","sample030","GGB","BBR",1,0,1
"3560","sample030","GGB","BRR",1,3,4
"3561","sample030","GGB","GBG",1,0,1
"3562","sample030","GGB","GGG",13,9,22
"3563","sample030","GGB","RGG",1,0,1
"3564","sample030","GGB","RRG",1,0,1
"3565","sample030","GGB","RRR",1,0,1
"3566","sample030","GGG","BBB",8,4,12
"3567","sample030","GGG","BGG",1,0,1
"3568","sample030","GGG","BRB",1,0,1
"3569","sample030","GGG","GGB",5,0,5
"3570","sample030","GGG","GGR",1,2,3
"3571","sample030","GGG","RBB",1,2,3
"3572","sample030","GGG","RGR",1,2,3
"3573","sample030","GGG","RRG",1,5,6
"3574","sample030","GGR","BRR",1,0,1
"3575","sample030","GGR","GRR",1,0,1
"3576","sample030","GRG","BBB",3,0,3
"3577","sample030","GRG","GGB",2,4,6
"3578","sample030","GRG","GGG",3,1,4
"3579","sample030","GRG","RGR",1,0,1
"3580","sample030","GRG","RRG",2,0,2
"3581","sample030","GRR","BGB",1,1,2
"3582","sample030","RBG","BBB",2,0,2
"3583","sample030","RBG","RBB",1,0,1
"3584","sample030","RBR","BGB",2,1,3
"3585","sample030","RBR","BRB",1,0,1
"3586","sample030","RBR","BRR",1,1,2
"3587","sample030","RBR","GRR",4,1,5
"3588","sample030","RBR","RGG",2,1,3
"3589","sample030","RBR","RGR",1,0,1
"3590","sample030","RGG","BBR",1,0,1
"3591","sample030","RGR","BBB",2,0,2
"3592","sample030","RGR","BBR",1,0,1
"3593","sample030","RGR","BGB",2,2,4
"3594","sample030","RGR","BGG",2,1,3
"3595","sample030","RGR","BRR",1,0,1
"3596","sample030","RGR","GGB",2,0,2
"3597","sample030","RGR","RGG",1,0,1
"3598","sample030","RRG","BBB",2,4,6
"3599","sample030","RRG","BGB",1,1,2
"3600","sample030","RRG","BRB",2,3,5
"3601","sample030","RRG","BRR",1,2,3
"3602","sample030","RRG","GGG",2,2,4
"3603","sample030","RRG","GRG",1,0,1
"3604","sample030","RRG","GRR",3,2,5
"3605","sample030","RRG","RBB",1,0,1
"3606","sample030","RRR","BBR",1,0,1
"3607","sample030","RRR","BGB",2,0,2
"3608","sample030","RRR","BGG",1,0,1
"3609","sample030","RRR","BRB",1,0,1
"3610","sample030","RRR","BRR",1,0,1
"3611","sample030","RRR","RBB",1,0,1
"3612","sample030","RRR","RGR",1,0,1
"3613","sample030","RRR","RRG",2,0,2
"3614","sample030","BBB","BRB",0,1,1
"3615","sample030","BBG","RBB",0,1,1
"3616","sample030","BBG","RBG",0,2,2
"3617","sample030","BBG","RRR",0,1,1
"3618","sample030","BGB","BBB",0,1,1
"3619","sample030","BGG","BBB",0,1,1
"3620","sample030","BGG","BBR",0,1,1
"3621","sample030","BRB","BBB",0,4,4
"3622","sample030","BRR","BBB",0,3,3
"3623","sample030","GBB","GGB",0,4,4
"3624","sample030","GBB","GRG",0,1,1
"3625","sample030","GBB","GRR",0,1,1
"3626","sample030","GBB","RRG",0,1,1
"3627","sample030","GBG","BBB",0,2,2
"3628","sample030","GBG","GGB",0,1,1
"3629","sample030","GGB","BGG",0,1,1
"3630","sample030","GGB","GGR",0,1,1
"3631","sample030","GGB","RBG",0,1,1
"3632","sample030","GGB","RBR",0,2,2
"3633","sample030","GGB","RGR",0,1,1
"3634","sample030","GGG","BRR",0,1,1
"3635","sample030","GGG","RBG",0,2,2
"3636","sample030","GGG","RBR",0,3,3
"3637","sample030","GGG","RGG",0,2,2
"3638","sample030","GGR","BBB",0,1,1
"3639","sample030","GGR","BBR",0,1,1
"3640","sample030","GRG","BRR",0,1,1
"3641","sample030","GRR","BRR",0,1,1
"3642","sample030","RBG","BBG",0,1,1
"3643","sample030","RBG","GRR",0,1,1
"3644","sample030","RBR","BBB",0,4,4
"3645","sample030","RBR","BGG",0,1,1
"3646","sample030","RBR","GGB",0,4,4
"3647","sample030","RBR","RRR",0,1,1
"3648","sample030","RGG","BBB",0,2,2
"3649","sample030","RGG","GRR",0,2,2
"3650","sample030","RGR","GGG",0,1,1
"3651","sample030","RGR","RBB",0,1,1
"3652","sample030","RRG","BBR",0,3,3
"3653","sample030","RRG","GGR",0,2,2
"3654","sample030","RRG","RGR",0,1,1
"3655","sample031","BBB","GGG",1,0,1
"3656","sample031","BBB","RRG",1,2,3
"3657","sample031","BBG","BBB",1,0,1
"3658","sample031","BBG","BRB",1,2,3
"3659","sample031","BBG","GBG",2,0,2
"3660","sample031","BBG","GGB",2,6,8
"3661","sample031","BBG","GGG",4,7,11
"3662","sample031","BBG","GRG",1,1,2
"3663","sample031","BBG","RRG",1,0,1
"3664","sample031","BGG","RBG",1,0,1
"3665","sample031","BGG","RRR",1,0,1
"3666","sample031","BRR","BGB",1,0,1
"3667","sample031","GBB","BBB",12,4,16
"3668","sample031","GBB","BRB",1,1,2
"3669","sample031","GBB","BRR",1,1,2
"3670","sample031","GBB","GGG",7,14,21
"3671","sample031","GBB","GGR",1,1,2
"3672","sample031","GBB","RBG",3,1,4
"3673","sample031","GBB","RBR",1,0,1
"3674","sample031","GBB","RGG",1,0,1
"3675","sample031","GBB","RGR",2,0,2
"3676","sample031","GBB","RRR",1,4,5
"3677","sample031","GBG","BRB",1,1,2
"3678","sample031","GBG","BRR",1,0,1
"3679","sample031","GBG","GGG",4,2,6
"3680","sample031","GBG","RBB",1,0,1
"3681","sample031","GBG","RGR",1,1,2
"3682","sample031","GBG","RRG",1,0,1
"3683","sample031","GGB","BBB",3,3,6
"3684","sample031","GGB","BBR",1,1,2
"3685","sample031","GGB","BRR",1,2,3
"3686","sample031","GGB","GBG",1,0,1
"3687","sample031","GGB","GGG",13,5,18
"3688","sample031","GGB","RGG",1,1,2
"3689","sample031","GGB","RRG",1,1,2
"3690","sample031","GGB","RRR",1,1,2
"3691","sample031","GGG","BBB",8,1,9
"3692","sample031","GGG","BGG",1,2,3
"3693","sample031","GGG","BRB",1,1,2
"3694","sample031","GGG","GGB",5,0,5
"3695","sample031","GGG","GGR",1,2,3
"3696","sample031","GGG","RBB",1,1,2
"3697","sample031","GGG","RGR",1,4,5
"3698","sample031","GGG","RRG",1,6,7
"3699","sample031","GGR","BRR",1,0,1
"3700","sample031","GGR","GRR",1,0,1
"3701","sample031","GRG","BBB",3,0,3
"3702","sample031","GRG","GGB",2,7,9
"3703","sample031","GRG","GGG",3,2,5
"3704","sample031","GRG","RGR",1,0,1
"3705","sample031","GRG","RRG",2,1,3
"3706","sample031","GRR","BGB",1,0,1
"3707","sample031","RBG","BBB",2,0,2
"3708","sample031","RBG","RBB",1,1,2
"3709","sample031","RBR","BGB",2,0,2
"3710","sample031","RBR","BRB",1,0,1
"3711","sample031","RBR","BRR",1,0,1
"3712","sample031","RBR","GRR",4,0,4
"3713","sample031","RBR","RGG",2,1,3
"3714","sample031","RBR","RGR",1,0,1
"3715","sample031","RGG","BBR",1,0,1
"3716","sample031","RGR","BBB",2,0,2
"3717","sample031","RGR","BBR",1,1,2
"3718","sample031","RGR","BGB",2,2,4
"3719","sample031","RGR","BGG",2,0,2
"3720","sample031","RGR","BRR",1,1,2
"3721","sample031","RGR","GGB",2,3,5
"3722","sample031","RGR","RGG",1,1,2
"3723","sample031","RRG","BBB",2,5,7
"3724","sample031","RRG","BGB",1,3,4
"3725","sample031","RRG","BRB",2,4,6
"3726","sample031","RRG","BRR",1,1,2
"3727","sample031","RRG","GGG",2,2,4
"3728","sample031","RRG","GRG",1,0,1
"3729","sample031","RRG","GRR",3,4,7
"3730","sample031","RRG","RBB",1,0,1
"3731","sample031","RRR","BBR",1,0,1
"3732","sample031","RRR","BGB",2,0,2
"3733","sample031","RRR","BGG",1,0,1
"3734","sample031","RRR","BRB",1,0,1
"3735","sample031","RRR","BRR",1,0,1
"3736","sample031","RRR","RBB",1,0,1
"3737","sample031","RRR","RGR",1,0,1
"3738","sample031","RRR","RRG",2,0,2
"3739","sample031","BBG","RBR",0,1,1
"3740","sample031","BGB","BBB",0,1,1
"3741","sample031","BGG","RGG",0,1,1
"3742","sample031","BRB","BBB",0,2,2
"3743","sample031","BRB","BBR",0,1,1
"3744","sample031","BRB","BRR",0,2,2
"3745","sample031","BRR","BBB",0,1,1
"3746","sample031","GBB","GGB",0,1,1
"3747","sample031","GBB","GRG",0,1,1
"3748","sample031","GBB","RBB",0,1,1
"3749","sample031","GBG","BBB",0,1,1
"3750","sample031","GBG","RGG",0,1,1
"3751","sample031","GGB","BRB",0,1,1
"3752","sample031","GGB","RBG",0,1,1
"3753","sample031","GGG","BRR",0,1,1
"3754","sample031","GGG","GRR",0,1,1
"3755","sample031","GGG","RBR",0,3,3
"3756","sample031","GGG","RGG",0,1,1
"3757","sample031","GGG","RRR",0,2,2
"3758","sample031","GGR","BBB",0,1,1
"3759","sample031","GRG","BRB",0,1,1
"3760","sample031","GRG","GGR",0,1,1
"3761","sample031","RBB","BBB",0,1,1
"3762","sample031","RBB","BBR",0,1,1
"3763","sample031","RBR","BBR",0,1,1
"3764","sample031","RBR","BGG",0,1,1
"3765","sample031","RBR","GGB",0,1,1
"3766","sample031","RBR","RBB",0,1,1
"3767","sample031","RBR","RRR",0,1,1
"3768","sample031","RGG","BRR",0,1,1
"3769","sample031","RGG","GGG",0,1,1
"3770","sample031","RRG","BBR",0,2,2
"3771","sample031","RRG","BGG",0,1,1
"3772","sample031","RRG","GGR",0,1,1
"3773","sample031","RRG","RGR",0,1,1
"3774","sample031","RRR","GRR",0,1,1
"3775","sample032","BBB","GGG",1,0,1
"3776","sample032","BBB","RRG",1,1,2
"3777","sample032","BBG","BBB",1,1,2
"3778","sample032","BBG","BRB",1,0,1
"3779","sample032","BBG","GBG",2,1,3
"3780","sample032","BBG","GGB",2,3,5
"3781","sample032","BBG","GGG",4,7,11
"3782","sample032","BBG","GRG",1,2,3
"3783","sample032","BBG","RRG",1,0,1
"3784","sample032","BGG","RBG",1,0,1
"3785","sample032","BGG","RRR",1,0,1
"3786","sample032","BRR","BGB",1,0,1
"3787","sample032","GBB","BBB",12,1,13
"3788","sample032","GBB","BRB",1,2,3
"3789","sample032","GBB","BRR",1,1,2
"3790","sample032","GBB","GGG",7,12,19
"3791","sample032","GBB","GGR",1,0,1
"3792","sample032","GBB","RBG",3,1,4
"3793","sample032","GBB","RBR",1,0,1
"3794","sample032","GBB","RGG",1,0,1
"3795","sample032","GBB","RGR",2,0,2
"3796","sample032","GBB","RRR",1,0,1
"3797","sample032","GBG","BRB",1,0,1
"3798","sample032","GBG","BRR",1,0,1
"3799","sample032","GBG","GGG",4,3,7
"3800","sample032","GBG","RBB",1,0,1
"3801","sample032","GBG","RGR",1,0,1
"3802","sample032","GBG","RRG",1,0,1
"3803","sample032","GGB","BBB",3,1,4
"3804","sample032","GGB","BBR",1,0,1
"3805","sample032","GGB","BRR",1,1,2
"3806","sample032","GGB","GBG",1,0,1
"3807","sample032","GGB","GGG",13,6,19
"3808","sample032","GGB","RGG",1,1,2
"3809","sample032","GGB","RRG",1,2,3
"3810","sample032","GGB","RRR",1,0,1
"3811","sample032","GGG","BBB",8,6,14
"3812","sample032","GGG","BGG",1,1,2
"3813","sample032","GGG","BRB",1,2,3
"3814","sample032","GGG","GGB",5,0,5
"3815","sample032","GGG","GGR",1,2,3
"3816","sample032","GGG","RBB",1,4,5
"3817","sample032","GGG","RGR",1,1,2
"3818","sample032","GGG","RRG",1,4,5
"3819","sample032","GGR","BRR",1,0,1
"3820","sample032","GGR","GRR",1,0,1
"3821","sample032","GRG","BBB",3,0,3
"3822","sample032","GRG","GGB",2,5,7
"3823","sample032","GRG","GGG",3,3,6
"3824","sample032","GRG","RGR",1,0,1
"3825","sample032","GRG","RRG",2,2,4
"3826","sample032","GRR","BGB",1,1,2
"3827","sample032","RBG","BBB",2,3,5
"3828","sample032","RBG","RBB",1,0,1
"3829","sample032","RBR","BGB",2,1,3
"3830","sample032","RBR","BRB",1,0,1
"3831","sample032","RBR","BRR",1,2,3
"3832","sample032","RBR","GRR",4,1,5
"3833","sample032","RBR","RGG",2,0,2
"3834","sample032","RBR","RGR",1,0,1
"3835","sample032","RGG","BBR",1,0,1
"3836","sample032","RGR","BBB",2,0,2
"3837","sample032","RGR","BBR",1,0,1
"3838","sample032","RGR","BGB",2,0,2
"3839","sample032","RGR","BGG",2,0,2
"3840","sample032","RGR","BRR",1,0,1
"3841","sample032","RGR","GGB",2,2,4
"3842","sample032","RGR","RGG",1,1,2
"3843","sample032","RRG","BBB",2,2,4
"3844","sample032","RRG","BGB",1,3,4
"3845","sample032","RRG","BRB",2,8,10
"3846","sample032","RRG","BRR",1,3,4
"3847","sample032","RRG","GGG",2,1,3
"3848","sample032","RRG","GRG",1,0,1
"3849","sample032","RRG","GRR",3,2,5
"3850","sample032","RRG","RBB",1,0,1
"3851","sample032","RRR","BBR",1,0,1
"3852","sample032","RRR","BGB",2,0,2
"3853","sample032","RRR","BGG",1,0,1
"3854","sample032","RRR","BRB",1,0,1
"3855","sample032","RRR","BRR",1,0,1
"3856","sample032","RRR","RBB",1,0,1
"3857","sample032","RRR","RGR",1,0,1
"3858","sample032","RRR","RRG",2,0,2
"3859","sample032","BBB","GRR",0,1,1
"3860","sample032","BBB","RBG",0,1,1
"3861","sample032","BBG","BGG",0,1,1
"3862","sample032","BBG","RRR",0,1,1
"3863","sample032","BGG","GRG",0,1,1
"3864","sample032","BRB","BBB",0,3,3
"3865","sample032","BRB","RBB",0,1,1
"3866","sample032","BRR","BRB",0,1,1
"3867","sample032","BRR","RBB",0,1,1
"3868","sample032","GBB","BGG",0,1,1
"3869","sample032","GBB","GGB",0,4,4
"3870","sample032","GBB","GRG",0,2,2
"3871","sample032","GBB","RRG",0,1,1
"3872","sample032","GBG","GGB",0,1,1
"3873","sample032","GBG","RBG",0,1,1
"3874","sample032","GGB","BGG",0,1,1
"3875","sample032","GGB","BRB",0,1,1
"3876","sample032","GGB","GGR",0,1,1
"3877","sample032","GGB","GRR",0,1,1
"3878","sample032","GGB","RBB",0,1,1
"3879","sample032","GGB","RBG",0,1,1
"3880","sample032","GGG","BGB",0,2,2
"3881","sample032","GGG","RBG",0,1,1
"3882","sample032","GGG","RBR",0,3,3
"3883","sample032","GGR","BBR",0,1,1
"3884","sample032","GRG","GGR",0,1,1
"3885","sample032","GRG","GRR",0,1,1
"3886","sample032","GRG","RBG",0,1,1
"3887","sample032","RBB","GRR",0,1,1
"3888","sample032","RBR","BBB",0,1,1
"3889","sample032","RBR","GGB",0,3,3
"3890","sample032","RBR","RBB",0,1,1
"3891","sample032","RBR","RRR",0,1,1
"3892","sample032","RGG","BBB",0,2,2
"3893","sample032","RGG","BRR",0,1,1
"3894","sample032","RGG","GRR",0,2,2
"3895","sample032","RGR","RRG",0,1,1
"3896","sample032","RRG","BBR",0,1,1
"3897","sample032","RRG","GGR",0,1,1
"3898","sample032","RRG","RGG",0,1,1
"3899","sample032","RRG","RGR",0,1,1
"3900","sample033","BBB","GGG",1,1,2
"3901","sample033","BBB","RRG",1,0,1
"3902","sample033","BBG","BBB",1,0,1
"3903","sample033","BBG","BRB",1,2,3
"3904","sample033","BBG","GBG",2,0,2
"3905","sample033","BBG","GGB",2,2,4
"3906","sample033","BBG","GGG",4,1,5
"3907","sample033","BBG","GRG",1,1,2
"3908","sample033","BBG","RRG",1,0,1
"3909","sample033","BGG","RBG",1,0,1
"3910","sample033","BGG","RRR",1,0,1
"3911","sample033","BRR","BGB",1,0,1
"3912","sample033","GBB","BBB",12,9,21
"3913","sample033","GBB","BRB",1,0,1
"3914","sample033","GBB","BRR",1,0,1
"3915","sample033","GBB","GGG",7,14,21
"3916","sample033","GBB","GGR",1,0,1
"3917","sample033","GBB","RBG",3,3,6
"3918","sample033","GBB","RBR",1,0,1
"3919","sample033","GBB","RGG",1,0,1
"3920","sample033","GBB","RGR",2,0,2
"3921","sample033","GBB","RRR",1,2,3
"3922","sample033","GBG","BRB",1,3,4
"3923","sample033","GBG","BRR",1,0,1
"3924","sample033","GBG","GGG",4,0,4
"3925","sample033","GBG","RBB",1,0,1
"3926","sample033","GBG","RGR",1,1,2
"3927","sample033","GBG","RRG",1,1,2
"3928","sample033","GGB","BBB",3,3,6
"3929","sample033","GGB","BBR",1,1,2
"3930","sample033","GGB","BRR",1,3,4
"3931","sample033","GGB","GBG",1,0,1
"3932","sample033","GGB","GGG",13,7,20
"3933","sample033","GGB","RGG",1,0,1
"3934","sample033","GGB","RRG",1,1,2
"3935","sample033","GGB","RRR",1,0,1
"3936","sample033","GGG","BBB",8,5,13
"3937","sample033","GGG","BGG",1,2,3
"3938","sample033","GGG","BRB",1,1,2
"3939","sample033","GGG","GGB",5,0,5
"3940","sample033","GGG","GGR",1,1,2
"3941","sample033","GGG","RBB",1,1,2
"3942","sample033","GGG","RGR",1,2,3
"3943","sample033","GGG","RRG",1,6,7
"3944","sample033","GGR","BRR",1,0,1
"3945","sample033","GGR","GRR",1,0,1
"3946","sample033","GRG","BBB",3,2,5
"3947","sample033","GRG","GGB",2,0,2
"3948","sample033","GRG","GGG",3,1,4
"3949","sample033","GRG","RGR",1,0,1
"3950","sample033","GRG","RRG",2,1,3
"3951","sample033","GRR","BGB",1,0,1
"3952","sample033","RBG","BBB",2,1,3
"3953","sample033","RBG","RBB",1,0,1
"3954","sample033","RBR","BGB",2,0,2
"3955","sample033","RBR","BRB",1,0,1
"3956","sample033","RBR","BRR",1,0,1
"3957","sample033","RBR","GRR",4,0,4
"3958","sample033","RBR","RGG",2,2,4
"3959","sample033","RBR","RGR",1,0,1
"3960","sample033","RGG","BBR",1,0,1
"3961","sample033","RGR","BBB",2,1,3
"3962","sample033","RGR","BBR",1,0,1
"3963","sample033","RGR","BGB",2,0,2
"3964","sample033","RGR","BGG",2,1,3
"3965","sample033","RGR","BRR",1,2,3
"3966","sample033","RGR","GGB",2,2,4
"3967","sample033","RGR","RGG",1,0,1
"3968","sample033","RRG","BBB",2,4,6
"3969","sample033","RRG","BGB",1,2,3
"3970","sample033","RRG","BRB",2,8,10
"3971","sample033","RRG","BRR",1,3,4
"3972","sample033","RRG","GGG",2,4,6
"3973","sample033","RRG","GRG",1,0,1
"3974","sample033","RRG","GRR",3,0,3
"3975","sample033","RRG","RBB",1,0,1
"3976","sample033","RRR","BBR",1,0,1
"3977","sample033","RRR","BGB",2,0,2
"3978","sample033","RRR","BGG",1,0,1
"3979","sample033","RRR","BRB",1,0,1
"3980","sample033","RRR","BRR",1,0,1
"3981","sample033","RRR","RBB",1,0,1
"3982","sample033","RRR","RGR",1,0,1
"3983","sample033","RRR","RRG",2,0,2
"3984","sample033","BBB","BRB",0,1,1
"3985","sample033","BBB","GRR",0,2,2
"3986","sample033","BBG","BGG",0,1,1
"3987","sample033","BBG","GRR",0,1,1
"3988","sample033","BBG","RBG",0,1,1
"3989","sample033","BBG","RGR",0,1,1
"3990","sample033","BBG","RRR",0,3,3
"3991","sample033","BGG","RGG",0,1,1
"3992","sample033","BRB","BBB",0,1,1
"3993","sample033","BRB","BRR",0,2,2
"3994","sample033","BRB","RRR",0,1,1
"3995","sample033","BRR","BBB",0,1,1
"3996","sample033","BRR","BRB",0,1,1
"3997","sample033","GBB","GGB",0,4,4
"3998","sample033","GBB","GRG",0,1,1
"3999","sample033","GBB","RRG",0,1,1
"4000","sample033","GBG","BBB",0,1,1
"4001","sample033","GBG","GGB",0,2,2
"4002","sample033","GGB","BGG",0,1,1
"4003","sample033","GGB","GGR",0,1,1
"4004","sample033","GGB","RBB",0,1,1
"4005","sample033","GGB","RBR",0,3,3
"4006","sample033","GGG","BRR",0,2,2
"4007","sample033","GGG","GRR",0,1,1
"4008","sample033","GGG","RBR",0,2,2
"4009","sample033","GGG","RRR",0,1,1
"4010","sample033","GGR","BGG",0,1,1
"4011","sample033","GRG","BBR",0,1,1
"4012","sample033","GRG","GBG",0,1,1
"4013","sample033","GRG","GGR",0,2,2
"4014","sample033","GRR","BGG",0,1,1
"4015","sample033","RBR","BGG",0,1,1
"4016","sample033","RBR","GGB",0,2,2
"4017","sample033","RGG","BBB",0,1,1
"4018","sample033","RGR","GGG",0,1,1
"4019","sample033","RGR","RRG",0,1,1
"4020","sample033","RRG","BBR",0,1,1
"4021","sample033","RRG","GGR",0,1,1
"4022","sample033","RRR","GRR",0,1,1
"4023","sample034","BBB","GGG",1,1,2
"4024","sample034","BBB","RRG",1,1,2
"4025","sample034","BBG","BBB",1,1,2
"4026","sample034","BBG","BRB",1,0,1
"4027","sample034","BBG","GBG",2,1,3
"4028","sample034","BBG","GGB",2,4,6
"4029","sample034","BBG","GGG",4,6,10
"4030","sample034","BBG","GRG",1,3,4
"4031","sample034","BBG","RRG",1,0,1
"4032","sample034","BGG","RBG",1,0,1
"4033","sample034","BGG","RRR",1,0,1
"4034","sample034","BRR","BGB",1,0,1
"4035","sample034","GBB","BBB",12,8,20
"4036","sample034","GBB","BRB",1,0,1
"4037","sample034","GBB","BRR",1,0,1
"4038","sample034","GBB","GGG",7,20,27
"4039","sample034","GBB","GGR",1,0,1
"4040","sample034","GBB","RBG",3,3,6
"4041","sample034","GBB","RBR",1,0,1
"4042","sample034","GBB","RGG",1,0,1
"4043","sample034","GBB","RGR",2,0,2
"4044","sample034","GBB","RRR",1,0,1
"4045","sample034","GBG","BRB",1,0,1
"4046","sample034","GBG","BRR",1,0,1
"4047","sample034","GBG","GGG",4,1,5
"4048","sample034","GBG","RBB",1,0,1
"4049","sample034","GBG","RGR",1,0,1
"4050","sample034","GBG","RRG",1,0,1
"4051","sample034","GGB","BBB",3,1,4
"4052","sample034","GGB","BBR",1,1,2
"4053","sample034","GGB","BRR",1,4,5
"4054","sample034","GGB","GBG",1,0,1
"4055","sample034","GGB","GGG",13,5,18
"4056","sample034","GGB","RGG",1,1,2
"4057","sample034","GGB","RRG",1,0,1
"4058","sample034","GGB","RRR",1,0,1
"4059","sample034","GGG","BBB",8,5,13
"4060","sample034","GGG","BGG",1,1,2
"4061","sample034","GGG","BRB",1,0,1
"4062","sample034","GGG","GGB",5,0,5
"4063","sample034","GGG","GGR",1,3,4
"4064","sample034","GGG","RBB",1,2,3
"4065","sample034","GGG","RGR",1,1,2
"4066","sample034","GGG","RRG",1,3,4
"4067","sample034","GGR","BRR",1,0,1
"4068","sample034","GGR","GRR",1,0,1
"4069","sample034","GRG","BBB",3,1,4
"4070","sample034","GRG","GGB",2,1,3
"4071","sample034","GRG","GGG",3,1,4
"4072","sample034","GRG","RGR",1,0,1
"4073","sample034","GRG","RRG",2,0,2
"4074","sample034","GRR","BGB",1,0,1
"4075","sample034","RBG","BBB",2,3,5
"4076","sample034","RBG","RBB",1,1,2
"4077","sample034","RBR","BGB",2,0,2
"4078","sample034","RBR","BRB",1,0,1
"4079","sample034","RBR","BRR",1,1,2
"4080","sample034","RBR","GRR",4,0,4
"4081","sample034","RBR","RGG",2,3,5
"4082","sample034","RBR","RGR",1,0,1
"4083","sample034","RGG","BBR",1,0,1
"4084","sample034","RGR","BBB",2,2,4
"4085","sample034","RGR","BBR",1,0,1
"4086","sample034","RGR","BGB",2,0,2
"4087","sample034","RGR","BGG",2,1,3
"4088","sample034","RGR","BRR",1,1,2
"4089","sample034","RGR","GGB",2,3,5
"4090","sample034","RGR","RGG",1,0,1
"4091","sample034","RRG","BBB",2,5,7
"4092","sample034","RRG","BGB",1,3,4
"4093","sample034","RRG","BRB",2,4,6
"4094","sample034","RRG","BRR",1,3,4
"4095","sample034","RRG","GGG",2,0,2
"4096","sample034","RRG","GRG",1,0,1
"4097","sample034","RRG","GRR",3,2,5
"4098","sample034","RRG","RBB",1,0,1
"4099","sample034","RRR","BBR",1,0,1
"4100","sample034","RRR","BGB",2,0,2
"4101","sample034","RRR","BGG",1,0,1
"4102","sample034","RRR","BRB",1,0,1
"4103","sample034","RRR","BRR",1,0,1
"4104","sample034","RRR","RBB",1,1,2
"4105","sample034","RRR","RGR",1,0,1
"4106","sample034","RRR","RRG",2,2,4
"4107","sample034","BBB","RRR",0,1,1
"4108","sample034","BBG","RBG",0,1,1
"4109","sample034","BGG","BBB",0,1,1
"4110","sample034","BGG","GRG",0,1,1
"4111","sample034","BGG","RGG",0,1,1
"4112","sample034","BRB","BBB",0,5,5
"4113","sample034","BRB","BRR",0,1,1
"4114","sample034","BRB","RGR",0,1,1
"4115","sample034","BRR","BBB",0,2,2
"4116","sample034","GBB","GGB",0,4,4
"4117","sample034","GBB","RRG",0,2,2
"4118","sample034","GBG","BBB",0,1,1
"4119","sample034","GBG","GGB",0,1,1
"4120","sample034","GGB","BGB",0,1,1
"4121","sample034","GGB","GGR",0,1,1
"4122","sample034","GGB","RBB",0,1,1
"4123","sample034","GGG","RBG",0,2,2
"4124","sample034","GGG","RBR",0,1,1
"4125","sample034","GGG","RRR",0,1,1
"4126","sample034","GGR","BBB",0,1,1
"4127","sample034","GRG","GGR",0,1,1
"4128","sample034","GRG","RBR",0,1,1
"4129","sample034","GRR","BRB",0,1,1
"4130","sample034","GRR","GGR",0,1,1
"4131","sample034","RBB","BRB",0,1,1
"4132","sample034","RBB","RGG",0,1,1
"4133","sample034","RBG","RGR",0,1,1
"4134","sample034","RBR","GGB",0,2,2
"4135","sample034","RBR","RBB",0,1,1
"4136","sample034","RBR","RRR",0,1,1
"4137","sample034","RGG","BBB",0,1,1
"4138","sample034","RGG","BGB",0,1,1
"4139","sample034","RRG","GGR",0,1,1
"4140","sample034","RRR","GGR",0,1,1
"4141","sample034","RRR","RBR",0,1,1
"4142","sample035","BBB","GGG",1,2,3
"4143","sample035","BBB","RRG",1,0,1
"4144","sample035","BBG","BBB",1,0,1
"4145","sample035","BBG","BRB",1,3,4
"4146","sample035","BBG","GBG",2,1,3
"4147","sample035","BBG","GGB",2,2,4
"4148","sample035","BBG","GGG",4,9,13
"4149","sample035","BBG","GRG",1,1,2
"4150","sample035","BBG","RRG",1,0,1
"4151","sample035","BGG","RBG",1,0,1
"4152","sample035","BGG","RRR",1,0,1
"4153","sample035","BRR","BGB",1,0,1
"4154","sample035","GBB","BBB",12,4,16
"4155","sample035","GBB","BRB",1,0,1
"4156","sample035","GBB","BRR",1,1,2
"4157","sample035","GBB","GGG",7,13,20
"4158","sample035","GBB","GGR",1,0,1
"4159","sample035","GBB","RBG",3,1,4
"4160","sample035","GBB","RBR",1,0,1
"4161","sample035","GBB","RGG",1,0,1
"4162","sample035","GBB","RGR",2,1,3
"4163","sample035","GBB","RRR",1,3,4
"4164","sample035","GBG","BRB",1,0,1
"4165","sample035","GBG","BRR",1,0,1
"4166","sample035","GBG","GGG",4,3,7
"4167","sample035","GBG","RBB",1,0,1
"4168","sample035","GBG","RGR",1,0,1
"4169","sample035","GBG","RRG",1,0,1
"4170","sample035","GGB","BBB",3,2,5
"4171","sample035","GGB","BBR",1,3,4
"4172","sample035","GGB","BRR",1,1,2
"4173","sample035","GGB","GBG",1,0,1
"4174","sample035","GGB","GGG",13,7,20
"4175","sample035","GGB","RGG",1,0,1
"4176","sample035","GGB","RRG",1,0,1
"4177","sample035","GGB","RRR",1,1,2
"4178","sample035","GGG","BBB",8,8,16
"4179","sample035","GGG","BGG",1,0,1
"4180","sample035","GGG","BRB",1,0,1
"4181","sample035","GGG","GGB",5,1,6
"4182","sample035","GGG","GGR",1,3,4
"4183","sample035","GGG","RBB",1,2,3
"4184","sample035","GGG","RGR",1,3,4
"4185","sample035","GGG","RRG",1,4,5
"4186","sample035","GGR","BRR",1,0,1
"4187","sample035","GGR","GRR",1,0,1
"4188","sample035","GRG","BBB",3,2,5
"4189","sample035","GRG","GGB",2,2,4
"4190","sample035","GRG","GGG",3,2,5
"4191","sample035","GRG","RGR",1,0,1
"4192","sample035","GRG","RRG",2,0,2
"4193","sample035","GRR","BGB",1,0,1
"4194","sample035","RBG","BBB",2,0,2
"4195","sample035","RBG","RBB",1,0,1
"4196","sample035","RBR","BGB",2,0,2
"4197","sample035","RBR","BRB",1,0,1
"4198","sample035","RBR","BRR",1,1,2
"4199","sample035","RBR","GRR",4,2,6
"4200","sample035","RBR","RGG",2,0,2
"4201","sample035","RBR","RGR",1,0,1
"4202","sample035","RGG","BBR",1,0,1
"4203","sample035","RGR","BBB",2,2,4
"4204","sample035","RGR","BBR",1,0,1
"4205","sample035","RGR","BGB",2,3,5
"4206","sample035","RGR","BGG",2,1,3
"4207","sample035","RGR","BRR",1,0,1
"4208","sample035","RGR","GGB",2,2,4
"4209","sample035","RGR","RGG",1,0,1
"4210","sample035","RRG","BBB",2,6,8
"4211","sample035","RRG","BGB",1,0,1
"4212","sample035","RRG","BRB",2,7,9
"4213","sample035","RRG","BRR",1,1,2
"4214","sample035","RRG","GGG",2,2,4
"4215","sample035","RRG","GRG",1,0,1
"4216","sample035","RRG","GRR",3,1,4
"4217","sample035","RRG","RBB",1,0,1
"4218","sample035","RRR","BBR",1,0,1
"4219","sample035","RRR","BGB",2,1,3
"4220","sample035","RRR","BGG",1,0,1
"4221","sample035","RRR","BRB",1,0,1
"4222","sample035","RRR","BRR",1,0,1
"4223","sample035","RRR","RBB",1,1,2
"4224","sample035","RRR","RGR",1,1,2
"4225","sample035","RRR","RRG",2,0,2
"4226","sample035","BBB","GRR",0,1,1
"4227","sample035","BBB","RRR",0,2,2
"4228","sample035","BGB","BBB",0,1,1
"4229","sample035","BGG","RGG",0,1,1
"4230","sample035","BRB","RBG",0,1,1
"4231","sample035","BRR","BBB",0,3,3
"4232","sample035","GBB","BGG",0,1,1
"4233","sample035","GBB","GBG",0,1,1
"4234","sample035","GBB","GGB",0,1,1
"4235","sample035","GBB","GRG",0,1,1
"4236","sample035","GBB","RBB",0,1,1
"4237","sample035","GGB","GGR",0,1,1
"4238","sample035","GGB","GRR",0,1,1
"4239","sample035","GGB","RBB",0,1,1
"4240","sample035","GGB","RBG",0,1,1
"4241","sample035","GGB","RBR",0,1,1
"4242","sample035","GGG","BRR",0,2,2
"4243","sample035","GGG","GRR",0,1,1
"4244","sample035","GGG","RBG",0,1,1
"4245","sample035","GGG","RBR",0,3,3
"4246","sample035","GGG","RGG",0,1,1
"4247","sample035","GRG","BGG",0,1,1
"4248","sample035","GRG","GGR",0,1,1
"4249","sample035","GRR","BGG",0,1,1
"4250","sample035","GRR","GGR",0,1,1
"4251","sample035","RBG","BRR",0,1,1
"4252","sample035","RBR","BBB",0,1,1
"4253","sample035","RBR","GGB",0,3,3
"4254","sample035","RBR","RBB",0,1,1
"4255","sample035","RBR","RRR",0,1,1
"4256","sample035","RGG","BBB",0,1,1
"4257","sample035","RGG","GRR",0,1,1
"4258","sample035","RGR","GGR",0,1,1
"4259","sample035","RGR","RBB",0,1,1
"4260","sample035","RGR","RRG",0,1,1
"4261","sample035","RRG","GGR",0,1,1
"4262","sample036","BBB","GGG",1,0,1
"4263","sample036","BBB","RRG",1,1,2
"4264","sample036","BBG","BBB",1,1,2
"4265","sample036","BBG","BRB",1,6,7
"4266","sample036","BBG","GBG",2,2,4
"4267","sample036","BBG","GGB",2,5,7
"4268","sample036","BBG","GGG",4,7,11
"4269","sample036","BBG","GRG",1,1,2
"4270","sample036","BBG","RRG",1,1,2
"4271","sample036","BGG","RBG",1,0,1
"4272","sample036","BGG","RRR",1,0,1
"4273","sample036","BRR","BGB",1,0,1
"4274","sample036","GBB","BBB",12,6,18
"4275","sample036","GBB","BRB",1,1,2
"4276","sample036","GBB","BRR",1,0,1
"4277","sample036","GBB","GGG",7,5,12
"4278","sample036","GBB","GGR",1,1,2
"4279","sample036","GBB","RBG",3,1,4
"4280","sample036","GBB","RBR",1,0,1
"4281","sample036","GBB","RGG",1,0,1
"4282","sample036","GBB","RGR",2,0,2
"4283","sample036","GBB","RRR",1,1,2
"4284","sample036","GBG","BRB",1,1,2
"4285","sample036","GBG","BRR",1,0,1
"4286","sample036","GBG","GGG",4,2,6
"4287","sample036","GBG","RBB",1,0,1
"4288","sample036","GBG","RGR",1,0,1
"4289","sample036","GBG","RRG",1,1,2
"4290","sample036","GGB","BBB",3,0,3
"4291","sample036","GGB","BBR",1,0,1
"4292","sample036","GGB","BRR",1,3,4
"4293","sample036","GGB","GBG",1,0,1
"4294","sample036","GGB","GGG",13,11,24
"4295","sample036","GGB","RGG",1,0,1
"4296","sample036","GGB","RRG",1,0,1
"4297","sample036","GGB","RRR",1,2,3
"4298","sample036","GGG","BBB",8,8,16
"4299","sample036","GGG","BGG",1,0,1
"4300","sample036","GGG","BRB",1,1,2
"4301","sample036","GGG","GGB",5,0,5
"4302","sample036","GGG","GGR",1,3,4
"4303","sample036","GGG","RBB",1,0,1
"4304","sample036","GGG","RGR",1,0,1
"4305","sample036","GGG","RRG",1,3,4
"4306","sample036","GGR","BRR",1,0,1
"4307","sample036","GGR","GRR",1,0,1
"4308","sample036","GRG","BBB",3,1,4
"4309","sample036","GRG","GGB",2,4,6
"4310","sample036","GRG","GGG",3,2,5
"4311","sample036","GRG","RGR",1,0,1
"4312","sample036","GRG","RRG",2,1,3
"4313","sample036","GRR","BGB",1,0,1
"4314","sample036","RBG","BBB",2,3,5
"4315","sample036","RBG","RBB",1,0,1
"4316","sample036","RBR","BGB",2,0,2
"4317","sample036","RBR","BRB",1,0,1
"4318","sample036","RBR","BRR",1,0,1
"4319","sample036","RBR","GRR",4,1,5
"4320","sample036","RBR","RGG",2,2,4
"4321","sample036","RBR","RGR",1,0,1
"4322","sample036","RGG","BBR",1,0,1
"4323","sample036","RGR","BBB",2,0,2
"4324","sample036","RGR","BBR",1,0,1
"4325","sample036","RGR","BGB",2,0,2
"4326","sample036","RGR","BGG",2,1,3
"4327","sample036","RGR","BRR",1,1,2
"4328","sample036","RGR","GGB",2,0,2
"4329","sample036","RGR","RGG",1,0,1
"4330","sample036","RRG","BBB",2,3,5
"4331","sample036","RRG","BGB",1,0,1
"4332","sample036","RRG","BRB",2,4,6
"4333","sample036","RRG","BRR",1,1,2
"4334","sample036","RRG","GGG",2,3,5
"4335","sample036","RRG","GRG",1,0,1
"4336","sample036","RRG","GRR",3,1,4
"4337","sample036","RRG","RBB",1,0,1
"4338","sample036","RRR","BBR",1,0,1
"4339","sample036","RRR","BGB",2,0,2
"4340","sample036","RRR","BGG",1,0,1
"4341","sample036","RRR","BRB",1,0,1
"4342","sample036","RRR","BRR",1,0,1
"4343","sample036","RRR","RBB",1,0,1
"4344","sample036","RRR","RGR",1,0,1
"4345","sample036","RRR","RRG",2,0,2
"4346","sample036","BBB","RBG",0,1,1
"4347","sample036","BBG","RRR",0,1,1
"4348","sample036","BGG","BBR",0,1,1
"4349","sample036","BRB","BBB",0,3,3
"4350","sample036","BRB","BRR",0,1,1
"4351","sample036","BRB","GGR",0,1,1
"4352","sample036","BRB","RBB",0,1,1
"4353","sample036","BRB","RBG",0,1,1
"4354","sample036","BRR","BBB",0,5,5
"4355","sample036","BRR","RBB",0,1,1
"4356","sample036","GBB","GBG",0,2,2
"4357","sample036","GBB","GRG",0,1,1
"4358","sample036","GBB","RBB",0,1,1
"4359","sample036","GBG","RGG",0,1,1
"4360","sample036","GGB","GGR",0,1,1
"4361","sample036","GGB","GRR",0,1,1
"4362","sample036","GGB","RBR",0,1,1
"4363","sample036","GGG","RBG",0,3,3
"4364","sample036","GGG","RBR",0,4,4
"4365","sample036","GRG","BBR",0,1,1
"4366","sample036","GRG","BRB",0,1,1
"4367","sample036","GRG","GGR",0,1,1
"4368","sample036","RBB","BBB",0,1,1
"4369","sample036","RBG","GRR",0,2,2
"4370","sample036","RBR","BBB",0,2,2
"4371","sample036","RBR","BGG",0,1,1
"4372","sample036","RBR","GGB",0,2,2
"4373","sample036","RBR","RBB",0,2,2
"4374","sample036","RGG","BBB",0,1,1
"4375","sample036","RGG","GGR",0,2,2
"4376","sample036","RGG","GRR",0,1,1
"4377","sample036","RGR","GGR",0,2,2
"4378","sample036","RGR","RBB",0,3,3
"4379","sample036","RRG","BGG",0,1,1
"4380","sample036","RRG","GGR",0,1,1
"4381","sample036","RRG","RGR",0,1,1
"4382","sample036","RRR","GRR",0,1,1
"4383","sample036","RRR","RGG",0,1,1
"4384","sample037","BBB","GGG",1,0,1
"4385","sample037","BBB","RRG",1,1,2
"4386","sample037","BBG","BBB",1,0,1
"4387","sample037","BBG","BRB",1,1,2
"4388","sample037","BBG","GBG",2,2,4
"4389","sample037","BBG","GGB",2,4,6
"4390","sample037","BBG","GGG",4,5,9
"4391","sample037","BBG","GRG",1,0,1
"4392","sample037","BBG","RRG",1,0,1
"4393","sample037","BGG","RBG",1,0,1
"4394","sample037","BGG","RRR",1,0,1
"4395","sample037","BRR","BGB",1,0,1
"4396","sample037","GBB","BBB",12,11,23
"4397","sample037","GBB","BRB",1,1,2
"4398","sample037","GBB","BRR",1,1,2
"4399","sample037","GBB","GGG",7,10,17
"4400","sample037","GBB","GGR",1,1,2
"4401","sample037","GBB","RBG",3,3,6
"4402","sample037","GBB","RBR",1,0,1
"4403","sample037","GBB","RGG",1,0,1
"4404","sample037","GBB","RGR",2,0,2
"4405","sample037","GBB","RRR",1,2,3
"4406","sample037","GBG","BRB",1,1,2
"4407","sample037","GBG","BRR",1,0,1
"4408","sample037","GBG","GGG",4,3,7
"4409","sample037","GBG","RBB",1,0,1
"4410","sample037","GBG","RGR",1,0,1
"4411","sample037","GBG","RRG",1,0,1
"4412","sample037","GGB","BBB",3,2,5
"4413","sample037","GGB","BBR",1,0,1
"4414","sample037","GGB","BRR",1,1,2
"4415","sample037","GGB","GBG",1,0,1
"4416","sample037","GGB","GGG",13,4,17
"4417","sample037","GGB","RGG",1,0,1
"4418","sample037","GGB","RRG",1,1,2
"4419","sample037","GGB","RRR",1,1,2
"4420","sample037","GGG","BBB",8,5,13
"4421","sample037","GGG","BGG",1,0,1
"4422","sample037","GGG","BRB",1,0,1
"4423","sample037","GGG","GGB",5,0,5
"4424","sample037","GGG","GGR",1,1,2
"4425","sample037","GGG","RBB",1,0,1
"4426","sample037","GGG","RGR",1,2,3
"4427","sample037","GGG","RRG",1,5,6
"4428","sample037","GGR","BRR",1,0,1
"4429","sample037","GGR","GRR",1,0,1
"4430","sample037","GRG","BBB",3,2,5
"4431","sample037","GRG","GGB",2,5,7
"4432","sample037","GRG","GGG",3,3,6
"4433","sample037","GRG","RGR",1,0,1
"4434","sample037","GRG","RRG",2,0,2
"4435","sample037","GRR","BGB",1,0,1
"4436","sample037","RBG","BBB",2,0,2
"4437","sample037","RBG","RBB",1,0,1
"4438","sample037","RBR","BGB",2,0,2
"4439","sample037","RBR","BRB",1,0,1
"4440","sample037","RBR","BRR",1,1,2
"4441","sample037","RBR","GRR",4,1,5
"4442","sample037","RBR","RGG",2,0,2
"4443","sample037","RBR","RGR",1,0,1
"4444","sample037","RGG","BBR",1,0,1
"4445","sample037","RGR","BBB",2,1,3
"4446","sample037","RGR","BBR",1,0,1
"4447","sample037","RGR","BGB",2,2,4
"4448","sample037","RGR","BGG",2,1,3
"4449","sample037","RGR","BRR",1,2,3
"4450","sample037","RGR","GGB",2,2,4
"4451","sample037","RGR","RGG",1,0,1
"4452","sample037","RRG","BBB",2,4,6
"4453","sample037","RRG","BGB",1,2,3
"4454","sample037","RRG","BRB",2,5,7
"4455","sample037","RRG","BRR",1,3,4
"4456","sample037","RRG","GGG",2,3,5
"4457","sample037","RRG","GRG",1,0,1
"4458","sample037","RRG","GRR",3,1,4
"4459","sample037","RRG","RBB",1,1,2
"4460","sample037","RRR","BBR",1,0,1
"4461","sample037","RRR","BGB",2,0,2
"4462","sample037","RRR","BGG",1,0,1
"4463","sample037","RRR","BRB",1,1,2
"4464","sample037","RRR","BRR",1,1,2
"4465","sample037","RRR","RBB",1,1,2
"4466","sample037","RRR","RGR",1,0,1
"4467","sample037","RRR","RRG",2,0,2
"4468","sample037","BBB","GRR",0,1,1
"4469","sample037","BBG","BGG",0,1,1
"4470","sample037","BBG","RRR",0,2,2
"4471","sample037","BGG","BBB",0,2,2
"4472","sample037","BGG","GRG",0,1,1
"4473","sample037","BGG","RGG",0,1,1
"4474","sample037","BRB","BBB",0,2,2
"4475","sample037","BRR","BBB",0,3,3
"4476","sample037","BRR","BRB",0,1,1
"4477","sample037","GBB","BGG",0,1,1
"4478","sample037","GBB","GBG",0,2,2
"4479","sample037","GBB","GGB",0,3,3
"4480","sample037","GBB","GRG",0,1,1
"4481","sample037","GBB","RBB",0,1,1
"4482","sample037","GGB","GRR",0,1,1
"4483","sample037","GGB","RBB",0,1,1
"4484","sample037","GGB","RBG",0,1,1
"4485","sample037","GGB","RGR",0,2,2
"4486","sample037","GGG","BGB",0,1,1
"4487","sample037","GGG","BRR",0,2,2
"4488","sample037","GGG","RBR",0,3,3
"4489","sample037","GGG","RGG",0,1,1
"4490","sample037","GGR","RBB",0,1,1
"4491","sample037","GRG","BGG",0,1,1
"4492","sample037","GRG","BRR",0,1,1
"4493","sample037","GRG","GGR",0,2,2
"4494","sample037","GRG","GRR",0,1,1
"4495","sample037","RBR","BBB",0,3,3
"4496","sample037","RGG","BBB",0,2,2
"4497","sample037","RGG","BRR",0,2,2
"4498","sample037","RGG","GGG",0,1,1
"4499","sample037","RGR","RBB",0,1,1
"4500","sample037","RRR","RBR",0,1,1
"4501","sample038","BBB","GGG",1,0,1
"4502","sample038","BBB","RRG",1,0,1
"4503","sample038","BBG","BBB",1,1,2
"4504","sample038","BBG","BRB",1,2,3
"4505","sample038","BBG","GBG",2,1,3
"4506","sample038","BBG","GGB",2,3,5
"4507","sample038","BBG","GGG",4,8,12
"4508","sample038","BBG","GRG",1,1,2
"4509","sample038","BBG","RRG",1,0,1
"4510","sample038","BGG","RBG",1,0,1
"4511","sample038","BGG","RRR",1,1,2
"4512","sample038","BRR","BGB",1,0,1
"4513","sample038","GBB","BBB",12,8,20
"4514","sample038","GBB","BRB",1,1,2
"4515","sample038","GBB","BRR",1,0,1
"4516","sample038","GBB","GGG",7,12,19
"4517","sample038","GBB","GGR",1,0,1
"4518","sample038","GBB","RBG",3,1,4
"4519","sample038","GBB","RBR",1,0,1
"4520","sample038","GBB","RGG",1,0,1
"4521","sample038","GBB","RGR",2,0,2
"4522","sample038","GBB","RRR",1,0,1
"4523","sample038","GBG","BRB",1,1,2
"4524","sample038","GBG","BRR",1,0,1
"4525","sample038","GBG","GGG",4,2,6
"4526","sample038","GBG","RBB",1,0,1
"4527","sample038","GBG","RGR",1,0,1
"4528","sample038","GBG","RRG",1,0,1
"4529","sample038","GGB","BBB",3,1,4
"4530","sample038","GGB","BBR",1,0,1
"4531","sample038","GGB","BRR",1,3,4
"4532","sample038","GGB","GBG",1,0,1
"4533","sample038","GGB","GGG",13,7,20
"4534","sample038","GGB","RGG",1,0,1
"4535","sample038","GGB","RRG",1,1,2
"4536","sample038","GGB","RRR",1,1,2
"4537","sample038","GGG","BBB",8,7,15
"4538","sample038","GGG","BGG",1,2,3
"4539","sample038","GGG","BRB",1,1,2
"4540","sample038","GGG","GGB",5,0,5
"4541","sample038","GGG","GGR",1,0,1
"4542","sample038","GGG","RBB",1,2,3
"4543","sample038","GGG","RGR",1,2,3
"4544","sample038","GGG","RRG",1,3,4
"4545","sample038","GGR","BRR",1,0,1
"4546","sample038","GGR","GRR",1,0,1
"4547","sample038","GRG","BBB",3,2,5
"4548","sample038","GRG","GGB",2,1,3
"4549","sample038","GRG","GGG",3,3,6
"4550","sample038","GRG","RGR",1,0,1
"4551","sample038","GRG","RRG",2,0,2
"4552","sample038","GRR","BGB",1,0,1
"4553","sample038","RBG","BBB",2,0,2
"4554","sample038","RBG","RBB",1,0,1
"4555","sample038","RBR","BGB",2,1,3
"4556","sample038","RBR","BRB",1,0,1
"4557","sample038","RBR","BRR",1,0,1
"4558","sample038","RBR","GRR",4,0,4
"4559","sample038","RBR","RGG",2,2,4
"4560","sample038","RBR","RGR",1,0,1
"4561","sample038","RGG","BBR",1,0,1
"4562","sample038","RGR","BBB",2,1,3
"4563","sample038","RGR","BBR",1,0,1
"4564","sample038","RGR","BGB",2,0,2
"4565","sample038","RGR","BGG",2,1,3
"4566","sample038","RGR","BRR",1,1,2
"4567","sample038","RGR","GGB",2,0,2
"4568","sample038","RGR","RGG",1,0,1
"4569","sample038","RRG","BBB",2,6,8
"4570","sample038","RRG","BGB",1,3,4
"4571","sample038","RRG","BRB",2,7,9
"4572","sample038","RRG","BRR",1,3,4
"4573","sample038","RRG","GGG",2,3,5
"4574","sample038","RRG","GRG",1,0,1
"4575","sample038","RRG","GRR",3,1,4
"4576","sample038","RRG","RBB",1,0,1
"4577","sample038","RRR","BBR",1,0,1
"4578","sample038","RRR","BGB",2,0,2
"4579","sample038","RRR","BGG",1,0,1
"4580","sample038","RRR","BRB",1,0,1
"4581","sample038","RRR","BRR",1,0,1
"4582","sample038","RRR","RBB",1,0,1
"4583","sample038","RRR","RGR",1,0,1
"4584","sample038","RRR","RRG",2,1,3
"4585","sample038","BBB","RBG",0,1,1
"4586","sample038","BBG","RGR",0,1,1
"4587","sample038","BBG","RRR",0,2,2
"4588","sample038","BGG","BBR",0,1,1
"4589","sample038","BGG","GRG",0,1,1
"4590","sample038","BRR","BBB",0,3,3
"4591","sample038","BRR","BGG",0,1,1
"4592","sample038","GBB","GGB",0,1,1
"4593","sample038","GBB","GRG",0,1,1
"4594","sample038","GBG","BBB",0,1,1
"4595","sample038","GBG","BBR",0,1,1
"4596","sample038","GBG","GGB",0,1,1
"4597","sample038","GGB","GGR",0,3,3
"4598","sample038","GGB","RBB",0,2,2
"4599","sample038","GGB","RBG",0,1,1
"4600","sample038","GGB","RBR",0,3,3
"4601","sample038","GGG","BRR",0,1,1
"4602","sample038","GGG","RBG",0,1,1
"4603","sample038","GGG","RBR",0,2,2
"4604","sample038","GGG","RGG",0,1,1
"4605","sample038","GGG","RRR",0,1,1
"4606","sample038","GRG","BGG",0,1,1
"4607","sample038","GRG","BRR",0,1,1
"4608","sample038","GRG","GGR",0,1,1
"4609","sample038","GRR","BGG",0,1,1
"4610","sample038","GRR","BRB",0,1,1
"4611","sample038","RBB","RGG",0,1,1
"4612","sample038","RBR","BBB",0,3,3
"4613","sample038","RBR","GGB",0,2,2
"4614","sample038","RBR","RBB",0,1,1
"4615","sample038","RGG","BBB",0,3,3
"4616","sample038","RGG","BRR",0,1,1
"4617","sample038","RGG","GGR",0,1,1
"4618","sample038","RGG","GRR",0,2,2
"4619","sample038","RGR","GGR",0,1,1
"4620","sample038","RRR","GRR",0,1,1
"4621","sample038","RRR","RBR",0,1,1
"4622","sample039","BBB","GGG",1,0,1
"4623","sample039","BBB","RRG",1,3,4
"4624","sample039","BBG","BBB",1,0,1
"4625","sample039","BBG","BRB",1,0,1
"4626","sample039","BBG","GBG",2,3,5
"4627","sample039","BBG","GGB",2,2,4
"4628","sample039","BBG","GGG",4,7,11
"4629","sample039","BBG","GRG",1,2,3
"4630","sample039","BBG","RRG",1,1,2
"4631","sample039","BGG","RBG",1,0,1
"4632","sample039","BGG","RRR",1,0,1
"4633","sample039","BRR","BGB",1,0,1
"4634","sample039","GBB","BBB",12,5,17
"4635","sample039","GBB","BRB",1,0,1
"4636","sample039","GBB","BRR",1,0,1
"4637","sample039","GBB","GGG",7,12,19
"4638","sample039","GBB","GGR",1,0,1
"4639","sample039","GBB","RBG",3,2,5
"4640","sample039","GBB","RBR",1,0,1
"4641","sample039","GBB","RGG",1,0,1
"4642","sample039","GBB","RGR",2,0,2
"4643","sample039","GBB","RRR",1,1,2
"4644","sample039","GBG","BRB",1,0,1
"4645","sample039","GBG","BRR",1,0,1
"4646","sample039","GBG","GGG",4,4,8
"4647","sample039","GBG","RBB",1,0,1
"4648","sample039","GBG","RGR",1,1,2
"4649","sample039","GBG","RRG",1,0,1
"4650","sample039","GGB","BBB",3,4,7
"4651","sample039","GGB","BBR",1,1,2
"4652","sample039","GGB","BRR",1,2,3
"4653","sample039","GGB","GBG",1,0,1
"4654","sample039","GGB","GGG",13,10,23
"4655","sample039","GGB","RGG",1,0,1
"4656","sample039","GGB","RRG",1,1,2
"4657","sample039","GGB","RRR",1,2,3
"4658","sample039","GGG","BBB",8,6,14
"4659","sample039","GGG","BGG",1,3,4
"4660","sample039","GGG","BRB",1,0,1
"4661","sample039","GGG","GGB",5,0,5
"4662","sample039","GGG","GGR",1,2,3
"4663","sample039","GGG","RBB",1,0,1
"4664","sample039","GGG","RGR",1,0,1
"4665","sample039","GGG","RRG",1,1,2
"4666","sample039","GGR","BRR",1,0,1
"4667","sample039","GGR","GRR",1,0,1
"4668","sample039","GRG","BBB",3,2,5
"4669","sample039","GRG","GGB",2,4,6
"4670","sample039","GRG","GGG",3,2,5
"4671","sample039","GRG","RGR",1,0,1
"4672","sample039","GRG","RRG",2,0,2
"4673","sample039","GRR","BGB",1,1,2
"4674","sample039","RBG","BBB",2,1,3
"4675","sample039","RBG","RBB",1,1,2
"4676","sample039","RBR","BGB",2,2,4
"4677","sample039","RBR","BRB",1,0,1
"4678","sample039","RBR","BRR",1,0,1
"4679","sample039","RBR","GRR",4,0,4
"4680","sample039","RBR","RGG",2,2,4
"4681","sample039","RBR","RGR",1,0,1
"4682","sample039","RGG","BBR",1,1,2
"4683","sample039","RGR","BBB",2,0,2
"4684","sample039","RGR","BBR",1,0,1
"4685","sample039","RGR","BGB",2,1,3
"4686","sample039","RGR","BGG",2,1,3
"4687","sample039","RGR","BRR",1,0,1
"4688","sample039","RGR","GGB",2,2,4
"4689","sample039","RGR","RGG",1,0,1
"4690","sample039","RRG","BBB",2,3,5
"4691","sample039","RRG","BGB",1,1,2
"4692","sample039","RRG","BRB",2,8,10
"4693","sample039","RRG","BRR",1,2,3
"4694","sample039","RRG","GGG",2,2,4
"4695","sample039","RRG","GRG",1,0,1
"4696","sample039","RRG","GRR",3,0,3
"4697","sample039","RRG","RBB",1,0,1
"4698","sample039","RRR","BBR",1,0,1
"4699","sample039","RRR","BGB",2,0,2
"4700","sample039","RRR","BGG",1,0,1
"4701","sample039","RRR","BRB",1,0,1
"4702","sample039","RRR","BRR",1,0,1
"4703","sample039","RRR","RBB",1,0,1
"4704","sample039","RRR","RGR",1,0,1
"4705","sample039","RRR","RRG",2,0,2
"4706","sample039","BBB","GRR",0,1,1
"4707","sample039","BBB","RBG",0,1,1
"4708","sample039","BBG","RBG",0,1,1
"4709","sample039","BBG","RRR",0,1,1
"4710","sample039","BGG","GRG",0,1,1
"4711","sample039","BGG","RGG",0,1,1
"4712","sample039","BRB","BBB",0,2,2
"4713","sample039","BRB","BBR",0,1,1
"4714","sample039","BRR","BBB",0,2,2
"4715","sample039","BRR","BRB",0,1,1
"4716","sample039","GBB","GBG",0,1,1
"4717","sample039","GBB","GGB",0,1,1
"4718","sample039","GBB","RRG",0,1,1
"4719","sample039","GBG","GGB",0,1,1
"4720","sample039","GGB","BGG",0,1,1
"4721","sample039","GGB","RBR",0,2,2
"4722","sample039","GGG","BGB",0,1,1
"4723","sample039","GGG","BRR",0,2,2
"4724","sample039","GGG","RBG",0,2,2
"4725","sample039","GGG","RBR",0,1,1
"4726","sample039","GGG","RGG",0,1,1
"4727","sample039","GGG","RRR",0,1,1
"4728","sample039","GRG","RBR",0,1,1
"4729","sample039","GRR","BBR",0,1,1
"4730","sample039","GRR","BGG",0,1,1
"4731","sample039","RBG","GBB",0,1,1
"4732","sample039","RBG","GRR",0,1,1
"4733","sample039","RBR","BBB",0,2,2
"4734","sample039","RBR","GGB",0,3,3
"4735","sample039","RBR","RBB",0,1,1
"4736","sample039","RGG","BRR",0,2,2
"4737","sample039","RGG","GGR",0,1,1
"4738","sample039","RGG","GRR",0,1,1
"4739","sample039","RGR","RBB",0,2,2
"4740","sample039","RGR","RRG",0,1,1
"4741","sample039","RRG","RGR",0,1,1
"4742","sample039","RRR","GRR",0,2,2
"4743","sample039","RRR","RGG",0,1,1
"4744","sample040","BBB","GGG",1,1,2
"4745","sample040","BBB","RRG",1,0,1
"4746","sample040","BBG","BBB",1,1,2
"4747","sample040","BBG","BRB",1,1,2
"4748","sample040","BBG","GBG",2,0,2
"4749","sample040","BBG","GGB",2,4,6
"4750","sample040","BBG","GGG",4,5,9
"4751","sample040","BBG","GRG",1,2,3
"4752","sample040","BBG","RRG",1,0,1
"4753","sample040","BGG","RBG",1,0,1
"4754","sample040","BGG","RRR",1,0,1
"4755","sample040","BRR","BGB",1,1,2
"4756","sample040","GBB","BBB",12,3,15
"4757","sample040","GBB","BRB",1,2,3
"4758","sample040","GBB","BRR",1,0,1
"4759","sample040","GBB","GGG",7,7,14
"4760","sample040","GBB","GGR",1,0,1
"4761","sample040","GBB","RBG",3,0,3
"4762","sample040","GBB","RBR",1,0,1
"4763","sample040","GBB","RGG",1,0,1
"4764","sample040","GBB","RGR",2,0,2
"4765","sample040","GBB","RRR",1,1,2
"4766","sample040","GBG","BRB",1,1,2
"4767","sample040","GBG","BRR",1,0,1
"4768","sample040","GBG","GGG",4,2,6
"4769","sample040","GBG","RBB",1,0,1
"4770","sample040","GBG","RGR",1,1,2
"4771","sample040","GBG","RRG",1,0,1
"4772","sample040","GGB","BBB",3,1,4
"4773","sample040","GGB","BBR",1,0,1
"4774","sample040","GGB","BRR",1,2,3
"4775","sample040","GGB","GBG",1,0,1
"4776","sample040","GGB","GGG",13,9,22
"4777","sample040","GGB","RGG",1,0,1
"4778","sample040","GGB","RRG",1,1,2
"4779","sample040","GGB","RRR",1,2,3
"4780","sample040","GGG","BBB",8,3,11
"4781","sample040","GGG","BGG",1,1,2
"4782","sample040","GGG","BRB",1,1,2
"4783","sample040","GGG","GGB",5,0,5
"4784","sample040","GGG","GGR",1,2,3
"4785","sample040","GGG","RBB",1,1,2
"4786","sample040","GGG","RGR",1,3,4
"4787","sample040","GGG","RRG",1,3,4
"4788","sample040","GGR","BRR",1,0,1
"4789","sample040","GGR","GRR",1,0,1
"4790","sample040","GRG","BBB",3,2,5
"4791","sample040","GRG","GGB",2,4,6
"4792","sample040","GRG","GGG",3,2,5
"4793","sample040","GRG","RGR",1,1,2
"4794","sample040","GRG","RRG",2,0,2
"4795","sample040","GRR","BGB",1,0,1
"4796","sample040","RBG","BBB",2,0,2
"4797","sample040","RBG","RBB",1,0,1
"4798","sample040","RBR","BGB",2,2,4
"4799","sample040","RBR","BRB",1,0,1
"4800","sample040","RBR","BRR",1,1,2
"4801","sample040","RBR","GRR",4,0,4
"4802","sample040","RBR","RGG",2,2,4
"4803","sample040","RBR","RGR",1,0,1
"4804","sample040","RGG","BBR",1,0,1
"4805","sample040","RGR","BBB",2,0,2
"4806","sample040","RGR","BBR",1,0,1
"4807","sample040","RGR","BGB",2,2,4
"4808","sample040","RGR","BGG",2,0,2
"4809","sample040","RGR","BRR",1,0,1
"4810","sample040","RGR","GGB",2,3,5
"4811","sample040","RGR","RGG",1,0,1
"4812","sample040","RRG","BBB",2,8,10
"4813","sample040","RRG","BGB",1,1,2
"4814","sample040","RRG","BRB",2,6,8
"4815","sample040","RRG","BRR",1,5,6
"4816","sample040","RRG","GGG",2,0,2
"4817","sample040","RRG","GRG",1,0,1
"4818","sample040","RRG","GRR",3,1,4
"4819","sample040","RRG","RBB",1,0,1
"4820","sample040","RRR","BBR",1,0,1
"4821","sample040","RRR","BGB",2,0,2
"4822","sample040","RRR","BGG",1,0,1
"4823","sample040","RRR","BRB",1,0,1
"4824","sample040","RRR","BRR",1,0,1
"4825","sample040","RRR","RBB",1,1,2
"4826","sample040","RRR","RGR",1,0,1
"4827","sample040","RRR","RRG",2,0,2
"4828","sample040","BBG","RRR",0,1,1
"4829","sample040","BGB","BBB",0,1,1
"4830","sample040","BGG","BBB",0,2,2
"4831","sample040","BGG","RGR",0,1,1
"4832","sample040","BRB","BBB",0,2,2
"4833","sample040","BRB","GGG",0,1,1
"4834","sample040","BRB","RGR",0,1,1
"4835","sample040","BRR","BBB",0,4,4
"4836","sample040","BRR","BGG",0,1,1
"4837","sample040","BRR","RBB",0,1,1
"4838","sample040","GBB","GGB",0,2,2
"4839","sample040","GBB","GRG",0,1,1
"4840","sample040","GBG","BBB",0,2,2
"4841","sample040","GBG","BBR",0,1,1
"4842","sample040","GBG","GGB",0,2,2
"4843","sample040","GGB","BGG",0,3,3
"4844","sample040","GGB","GBB",0,1,1
"4845","sample040","GGB","GRR",0,1,1
"4846","sample040","GGB","RBG",0,2,2
"4847","sample040","GGG","BRR",0,3,3
"4848","sample040","GGG","RBG",0,2,2
"4849","sample040","GGG","RBR",0,2,2
"4850","sample040","GGG","RRR",0,2,2
"4851","sample040","GGR","BBR",0,1,1
"4852","sample040","GRG","GGR",0,1,1
"4853","sample040","GRG","GRR",0,1,1
"4854","sample040","RBR","BBB",0,3,3
"4855","sample040","RBR","BGG",0,1,1
"4856","sample040","RBR","GGB",0,2,2
"4857","sample040","RGG","BBB",0,1,1
"4858","sample040","RGG","BRR",0,1,1
"4859","sample040","RGG","GRR",0,3,3
"4860","sample040","RGR","GGG",0,1,1
"4861","sample040","RRG","GGR",0,1,1
"4862","sample040","RRR","GRR",0,2,2
"4863","sample040","RRR","RBR",0,1,1
"4864","sample041","BBB","GGG",1,0,1
"4865","sample041","BBB","RRG",1,1,2
"4866","sample041","BBG","BBB",1,0,1
"4867","sample041","BBG","BRB",1,1,2
"4868","sample041","BBG","GBG",2,1,3
"4869","sample041","BBG","GGB",2,3,5
"4870","sample041","BBG","GGG",4,7,11
"4871","sample041","BBG","GRG",1,1,2
"4872","sample041","BBG","RRG",1,1,2
"4873","sample041","BGG","RBG",1,0,1
"4874","sample041","BGG","RRR",1,0,1
"4875","sample041","BRR","BGB",1,0,1
"4876","sample041","GBB","BBB",12,6,18
"4877","sample041","GBB","BRB",1,1,2
"4878","sample041","GBB","BRR",1,0,1
"4879","sample041","GBB","GGG",7,12,19
"4880","sample041","GBB","GGR",1,0,1
"4881","sample041","GBB","RBG",3,1,4
"4882","sample041","GBB","RBR",1,0,1
"4883","sample041","GBB","RGG",1,0,1
"4884","sample041","GBB","RGR",2,0,2
"4885","sample041","GBB","RRR",1,2,3
"4886","sample041","GBG","BRB",1,0,1
"4887","sample041","GBG","BRR",1,0,1
"4888","sample041","GBG","GGG",4,2,6
"4889","sample041","GBG","RBB",1,0,1
"4890","sample041","GBG","RGR",1,0,1
"4891","sample041","GBG","RRG",1,0,1
"4892","sample041","GGB","BBB",3,6,9
"4893","sample041","GGB","BBR",1,0,1
"4894","sample041","GGB","BRR",1,2,3
"4895","sample041","GGB","GBG",1,0,1
"4896","sample041","GGB","GGG",13,8,21
"4897","sample041","GGB","RGG",1,1,2
"4898","sample041","GGB","RRG",1,0,1
"4899","sample041","GGB","RRR",1,0,1
"4900","sample041","GGG","BBB",8,6,14
"4901","sample041","GGG","BGG",1,1,2
"4902","sample041","GGG","BRB",1,0,1
"4903","sample041","GGG","GGB",5,0,5
"4904","sample041","GGG","GGR",1,2,3
"4905","sample041","GGG","RBB",1,0,1
"4906","sample041","GGG","RGR",1,2,3
"4907","sample041","GGG","RRG",1,2,3
"4908","sample041","GGR","BRR",1,0,1
"4909","sample041","GGR","GRR",1,0,1
"4910","sample041","GRG","BBB",3,1,4
"4911","sample041","GRG","GGB",2,1,3
"4912","sample041","GRG","GGG",3,3,6
"4913","sample041","GRG","RGR",1,0,1
"4914","sample041","GRG","RRG",2,0,2
"4915","sample041","GRR","BGB",1,0,1
"4916","sample041","RBG","BBB",2,1,3
"4917","sample041","RBG","RBB",1,0,1
"4918","sample041","RBR","BGB",2,0,2
"4919","sample041","RBR","BRB",1,0,1
"4920","sample041","RBR","BRR",1,0,1
"4921","sample041","RBR","GRR",4,0,4
"4922","sample041","RBR","RGG",2,1,3
"4923","sample041","RBR","RGR",1,0,1
"4924","sample041","RGG","BBR",1,0,1
"4925","sample041","RGR","BBB",2,1,3
"4926","sample041","RGR","BBR",1,0,1
"4927","sample041","RGR","BGB",2,1,3
"4928","sample041","RGR","BGG",2,1,3
"4929","sample041","RGR","BRR",1,2,3
"4930","sample041","RGR","GGB",2,2,4
"4931","sample041","RGR","RGG",1,0,1
"4932","sample041","RRG","BBB",2,5,7
"4933","sample041","RRG","BGB",1,0,1
"4934","sample041","RRG","BRB",2,9,11
"4935","sample041","RRG","BRR",1,2,3
"4936","sample041","RRG","GGG",2,4,6
"4937","sample041","RRG","GRG",1,0,1
"4938","sample041","RRG","GRR",3,2,5
"4939","sample041","RRG","RBB",1,0,1
"4940","sample041","RRR","BBR",1,0,1
"4941","sample041","RRR","BGB",2,1,3
"4942","sample041","RRR","BGG",1,0,1
"4943","sample041","RRR","BRB",1,0,1
"4944","sample041","RRR","BRR",1,1,2
"4945","sample041","RRR","RBB",1,1,2
"4946","sample041","RRR","RGR",1,2,3
"4947","sample041","RRR","RRG",2,0,2
"4948","sample041","BBB","BRB",0,1,1
"4949","sample041","BBB","RBG",0,1,1
"4950","sample041","BBG","BGG",0,1,1
"4951","sample041","BBG","RGR",0,1,1
"4952","sample041","BBG","RRR",0,1,1
"4953","sample041","BRB","BBB",0,1,1
"4954","sample041","BRB","BRR",0,1,1
"4955","sample041","BRB","GGR",0,1,1
"4956","sample041","BRB","RBB",0,1,1
"4957","sample041","BRB","RBG",0,1,1
"4958","sample041","BRR","BBB",0,4,4
"4959","sample041","GBB","GBG",0,1,1
"4960","sample041","GBB","GGB",0,4,4
"4961","sample041","GBB","GRG",0,1,1
"4962","sample041","GBG","BBB",0,1,1
"4963","sample041","GGB","GRR",0,1,1
"4964","sample041","GGB","RBB",0,3,3
"4965","sample041","GGB","RBG",0,1,1
"4966","sample041","GGG","BRR",0,1,1
"4967","sample041","GGG","RBR",0,3,3
"4968","sample041","GGG","RGG",0,1,1
"4969","sample041","GGG","RRR",0,1,1
"4970","sample041","GRG","RBR",0,1,1
"4971","sample041","GRR","BBB",0,1,1
"4972","sample041","GRR","BGG",0,2,2
"4973","sample041","RBB","GRR",0,1,1
"4974","sample041","RBG","GBB",0,1,1
"4975","sample041","RBG","RGR",0,1,1
"4976","sample041","RBR","BBB",0,1,1
"4977","sample041","RBR","GGB",0,1,1
"4978","sample041","RGG","GGR",0,1,1
"4979","sample041","RGG","GRR",0,3,3
"4980","sample041","RGR","GGG",0,1,1
"4981","sample041","RGR","RBB",0,1,1
"4982","sample041","RRG","BBR",0,1,1
"4983","sample041","RRG","BGG",0,1,1
"4984","sample041","RRR","GRR",0,1,1
"4985","sample042","BBB","GGG",1,0,1
"4986","sample042","BBB","RRG",1,1,2
"4987","sample042","BBG","BBB",1,1,2
"4988","sample042","BBG","BRB",1,3,4
"4989","sample042","BBG","GBG",2,2,4
"4990","sample042","BBG","GGB",2,4,6
"4991","sample042","BBG","GGG",4,2,6
"4992","sample042","BBG","GRG",1,0,1
"4993","sample042","BBG","RRG",1,0,1
"4994","sample042","BGG","RBG",1,0,1
"4995","sample042","BGG","RRR",1,0,1
"4996","sample042","BRR","BGB",1,0,1
"4997","sample042","GBB","BBB",12,8,20
"4998","sample042","GBB","BRB",1,0,1
"4999","sample042","GBB","BRR",1,0,1
"5000","sample042","GBB","GGG",7,11,18
"5001","sample042","GBB","GGR",1,0,1
"5002","sample042","GBB","RBG",3,3,6
"5003","sample042","GBB","RBR",1,0,1
"5004","sample042","GBB","RGG",1,0,1
"5005","sample042","GBB","RGR",2,0,2
"5006","sample042","GBB","RRR",1,1,2
"5007","sample042","GBG","BRB",1,1,2
"5008","sample042","GBG","BRR",1,0,1
"5009","sample042","GBG","GGG",4,1,5
"5010","sample042","GBG","RBB",1,0,1
"5011","sample042","GBG","RGR",1,0,1
"5012","sample042","GBG","RRG",1,1,2
"5013","sample042","GGB","BBB",3,1,4
"5014","sample042","GGB","BBR",1,0,1
"5015","sample042","GGB","BRR",1,1,2
"5016","sample042","GGB","GBG",1,0,1
"5017","sample042","GGB","GGG",13,4,17
"5018","sample042","GGB","RGG",1,1,2
"5019","sample042","GGB","RRG",1,1,2
"5020","sample042","GGB","RRR",1,1,2
"5021","sample042","GGG","BBB",8,4,12
"5022","sample042","GGG","BGG",1,1,2
"5023","sample042","GGG","BRB",1,0,1
"5024","sample042","GGG","GGB",5,1,6
"5025","sample042","GGG","GGR",1,0,1
"5026","sample042","GGG","RBB",1,1,2
"5027","sample042","GGG","RGR",1,1,2
"5028","sample042","GGG","RRG",1,2,3
"5029","sample042","GGR","BRR",1,0,1
"5030","sample042","GGR","GRR",1,0,1
"5031","sample042","GRG","BBB",3,0,3
"5032","sample042","GRG","GGB",2,1,3
"5033","sample042","GRG","GGG",3,3,6
"5034","sample042","GRG","RGR",1,1,2
"5035","sample042","GRG","RRG",2,1,3
"5036","sample042","GRR","BGB",1,0,1
"5037","sample042","RBG","BBB",2,1,3
"5038","sample042","RBG","RBB",1,0,1
"5039","sample042","RBR","BGB",2,1,3
"5040","sample042","RBR","BRB",1,0,1
"5041","sample042","RBR","BRR",1,0,1
"5042","sample042","RBR","GRR",4,0,4
"5043","sample042","RBR","RGG",2,2,4
"5044","sample042","RBR","RGR",1,0,1
"5045","sample042","RGG","BBR",1,0,1
"5046","sample042","RGR","BBB",2,2,4
"5047","sample042","RGR","BBR",1,0,1
"5048","sample042","RGR","BGB",2,0,2
"5049","sample042","RGR","BGG",2,0,2
"5050","sample042","RGR","BRR",1,0,1
"5051","sample042","RGR","GGB",2,1,3
"5052","sample042","RGR","RGG",1,0,1
"5053","sample042","RRG","BBB",2,7,9
"5054","sample042","RRG","BGB",1,1,2
"5055","sample042","RRG","BRB",2,9,11
"5056","sample042","RRG","BRR",1,5,6
"5057","sample042","RRG","GGG",2,2,4
"5058","sample042","RRG","GRG",1,0,1
"5059","sample042","RRG","GRR",3,1,4
"5060","sample042","RRG","RBB",1,0,1
"5061","sample042","RRR","BBR",1,0,1
"5062","sample042","RRR","BGB",2,1,3
"5063","sample042","RRR","BGG",1,0,1
"5064","sample042","RRR","BRB",1,0,1
"5065","sample042","RRR","BRR",1,1,2
"5066","sample042","RRR","RBB",1,0,1
"5067","sample042","RRR","RGR",1,0,1
"5068","sample042","RRR","RRG",2,0,2
"5069","sample042","BBB","GRR",0,1,1
"5070","sample042","BBG","GBB",0,1,1
"5071","sample042","BBG","RBB",0,1,1
"5072","sample042","BBG","RRR",0,2,2
"5073","sample042","BGG","BBB",0,1,1
"5074","sample042","BGG","RGG",0,2,2
"5075","sample042","BRB","BBB",0,2,2
"5076","sample042","BRB","BRR",0,1,1
"5077","sample042","BRR","BRB",0,1,1
"5078","sample042","GBB","GGB",0,2,2
"5079","sample042","GBB","GRG",0,2,2
"5080","sample042","GBB","RRG",0,1,1
"5081","sample042","GBG","RBG",0,1,1
"5082","sample042","GGB","BGB",0,1,1
"5083","sample042","GGB","GGR",0,4,4
"5084","sample042","GGB","RBG",0,2,2
"5085","sample042","GGB","RBR",0,1,1
"5086","sample042","GGG","BGB",0,1,1
"5087","sample042","GGG","BRR",0,2,2
"5088","sample042","GGG","GRR",0,1,1
"5089","sample042","GGG","RBG",0,1,1
"5090","sample042","GGG","RBR",0,4,4
"5091","sample042","GGG","RRR",0,1,1
"5092","sample042","GGR","BGG",0,1,1
"5093","sample042","GGR","RBB",0,1,1
"5094","sample042","GRG","BRB",0,1,1
"5095","sample042","GRG","GBG",0,1,1
"5096","sample042","GRG","RBG",0,1,1
"5097","sample042","GRG","RBR",0,1,1
"5098","sample042","GRR","BRR",0,1,1
"5099","sample042","GRR","GGR",0,1,1
"5100","sample042","RBB","GRR",0,1,1
"5101","sample042","RBG","RGR",0,1,1
"5102","sample042","RBR","BBB",0,3,3
"5103","sample042","RBR","BBR",0,1,1
"5104","sample042","RBR","GGB",0,1,1
"5105","sample042","RBR","RBB",0,1,1
"5106","sample042","RGG","BBB",0,1,1
"5107","sample042","RGG","BRR",0,1,1
"5108","sample042","RGG","GGR",0,1,1
"5109","sample042","RGG","GRR",0,1,1
"5110","sample042","RGG","RBB",0,1,1
"5111","sample042","RGR","GGR",0,1,1
"5112","sample042","RGR","RRG",0,1,1
"5113","sample042","RRG","BBR",0,1,1
"5114","sample042","RRG","BGG",0,1,1
"5115","sample042","RRR","GRR",0,1,1
"5116","sample043","BBB","GGG",1,0,1
"5117","sample043","BBB","RRG",1,0,1
"5118","sample043","BBG","BBB",1,0,1
"5119","sample043","BBG","BRB",1,1,2
"5120","sample043","BBG","GBG",2,0,2
"5121","sample043","BBG","GGB",2,2,4
"5122","sample043","BBG","GGG",4,8,12
"5123","sample043","BBG","GRG",1,1,2
"5124","sample043","BBG","RRG",1,1,2
"5125","sample043","BGG","RBG",1,0,1
"5126","sample043","BGG","RRR",1,0,1
"5127","sample043","BRR","BGB",1,0,1
"5128","sample043","GBB","BBB",12,10,22
"5129","sample043","GBB","BRB",1,1,2
"5130","sample043","GBB","BRR",1,2,3
"5131","sample043","GBB","GGG",7,11,18
"5132","sample043","GBB","GGR",1,1,2
"5133","sample043","GBB","RBG",3,1,4
"5134","sample043","GBB","RBR",1,0,1
"5135","sample043","GBB","RGG",1,0,1
"5136","sample043","GBB","RGR",2,0,2
"5137","sample043","GBB","RRR",1,2,3
"5138","sample043","GBG","BRB",1,1,2
"5139","sample043","GBG","BRR",1,0,1
"5140","sample043","GBG","GGG",4,1,5
"5141","sample043","GBG","RBB",1,0,1
"5142","sample043","GBG","RGR",1,1,2
"5143","sample043","GBG","RRG",1,0,1
"5144","sample043","GGB","BBB",3,3,6
"5145","sample043","GGB","BBR",1,0,1
"5146","sample043","GGB","BRR",1,1,2
"5147","sample043","GGB","GBG",1,0,1
"5148","sample043","GGB","GGG",13,11,24
"5149","sample043","GGB","RGG",1,2,3
"5150","sample043","GGB","RRG",1,0,1
"5151","sample043","GGB","RRR",1,1,2
"5152","sample043","GGG","BBB",8,1,9
"5153","sample043","GGG","BGG",1,0,1
"5154","sample043","GGG","BRB",1,0,1
"5155","sample043","GGG","GGB",5,0,5
"5156","sample043","GGG","GGR",1,1,2
"5157","sample043","GGG","RBB",1,1,2
"5158","sample043","GGG","RGR",1,1,2
"5159","sample043","GGG","RRG",1,4,5
"5160","sample043","GGR","BRR",1,0,1
"5161","sample043","GGR","GRR",1,0,1
"5162","sample043","GRG","BBB",3,3,6
"5163","sample043","GRG","GGB",2,4,6
"5164","sample043","GRG","GGG",3,1,4
"5165","sample043","GRG","RGR",1,1,2
"5166","sample043","GRG","RRG",2,1,3
"5167","sample043","GRR","BGB",1,0,1
"5168","sample043","RBG","BBB",2,0,2
"5169","sample043","RBG","RBB",1,0,1
"5170","sample043","RBR","BGB",2,0,2
"5171","sample043","RBR","BRB",1,0,1
"5172","sample043","RBR","BRR",1,1,2
"5173","sample043","RBR","GRR",4,1,5
"5174","sample043","RBR","RGG",2,2,4
"5175","sample043","RBR","RGR",1,0,1
"5176","sample043","RGG","BBR",1,0,1
"5177","sample043","RGR","BBB",2,0,2
"5178","sample043","RGR","BBR",1,0,1
"5179","sample043","RGR","BGB",2,1,3
"5180","sample043","RGR","BGG",2,0,2
"5181","sample043","RGR","BRR",1,1,2
"5182","sample043","RGR","GGB",2,4,6
"5183","sample043","RGR","RGG",1,0,1
"5184","sample043","RRG","BBB",2,3,5
"5185","sample043","RRG","BGB",1,2,3
"5186","sample043","RRG","BRB",2,10,12
"5187","sample043","RRG","BRR",1,2,3
"5188","sample043","RRG","GGG",2,2,4
"5189","sample043","RRG","GRG",1,0,1
"5190","sample043","RRG","GRR",3,2,5
"5191","sample043","RRG","RBB",1,1,2
"5192","sample043","RRR","BBR",1,0,1
"5193","sample043","RRR","BGB",2,0,2
"5194","sample043","RRR","BGG",1,0,1
"5195","sample043","RRR","BRB",1,0,1
"5196","sample043","RRR","BRR",1,0,1
"5197","sample043","RRR","RBB",1,1,2
"5198","sample043","RRR","RGR",1,1,2
"5199","sample043","RRR","RRG",2,1,3
"5200","sample043","BBB","BRB",0,1,1
"5201","sample043","BBB","RBG",0,1,1
"5202","sample043","BBG","GBB",0,1,1
"5203","sample043","BBG","RBB",0,1,1
"5204","sample043","BBG","RRR",0,1,1
"5205","sample043","BRB","BBB",0,1,1
"5206","sample043","BRB","BRR",0,1,1
"5207","sample043","BRR","BBB",0,4,4
"5208","sample043","GBB","GBG",0,1,1
"5209","sample043","GBB","GGB",0,1,1
"5210","sample043","GBB","GRG",0,1,1
"5211","sample043","GBB","RBB",0,1,1
"5212","sample043","GBG","BBB",0,1,1
"5213","sample043","GGB","BGB",0,1,1
"5214","sample043","GGB","BGG",0,1,1
"5215","sample043","GGB","GGR",0,1,1
"5216","sample043","GGB","GRR",0,1,1
"5217","sample043","GGB","RBR",0,1,1
"5218","sample043","GGG","RBG",0,1,1
"5219","sample043","GGG","RBR",0,2,2
"5220","sample043","GGG","RRR",0,1,1
"5221","sample043","GGR","BBR",0,1,1
"5222","sample043","GRG","GGR",0,1,1
"5223","sample043","GRG","GRR",0,1,1
"5224","sample043","RBB","BBR",0,1,1
"5225","sample043","RBB","RGG",0,1,1
"5226","sample043","RBG","GRR",0,1,1
"5227","sample043","RBR","BBB",0,2,2
"5228","sample043","RBR","GGB",0,2,2
"5229","sample043","RGG","BRR",0,2,2
"5230","sample043","RGG","GGG",0,1,1
"5231","sample043","RGG","GGR",0,1,1
"5232","sample043","RGR","GGG",0,1,1
"5233","sample043","RGR","GGR",0,1,1
"5234","sample043","RGR","RRG",0,2,2
"5235","sample043","RRG","BGG",0,1,1
"5236","sample043","RRR","RGG",0,1,1
"5237","sample044","BBB","GGG",1,2,3
"5238","sample044","BBB","RRG",1,0,1
"5239","sample044","BBG","BBB",1,0,1
"5240","sample044","BBG","BRB",1,1,2
"5241","sample044","BBG","GBG",2,1,3
"5242","sample044","BBG","GGB",2,3,5
"5243","sample044","BBG","GGG",4,3,7
"5244","sample044","BBG","GRG",1,0,1
"5245","sample044","BBG","RRG",1,0,1
"5246","sample044","BGG","RBG",1,0,1
"5247","sample044","BGG","RRR",1,0,1
"5248","sample044","BRR","BGB",1,0,1
"5249","sample044","GBB","BBB",12,5,17
"5250","sample044","GBB","BRB",1,1,2
"5251","sample044","GBB","BRR",1,1,2
"5252","sample044","GBB","GGG",7,15,22
"5253","sample044","GBB","GGR",1,0,1
"5254","sample044","GBB","RBG",3,1,4
"5255","sample044","GBB","RBR",1,0,1
"5256","sample044","GBB","RGG",1,0,1
"5257","sample044","GBB","RGR",2,0,2
"5258","sample044","GBB","RRR",1,4,5
"5259","sample044","GBG","BRB",1,0,1
"5260","sample044","GBG","BRR",1,0,1
"5261","sample044","GBG","GGG",4,1,5
"5262","sample044","GBG","RBB",1,0,1
"5263","sample044","GBG","RGR",1,2,3
"5264","sample044","GBG","RRG",1,0,1
"5265","sample044","GGB","BBB",3,2,5
"5266","sample044","GGB","BBR",1,1,2
"5267","sample044","GGB","BRR",1,3,4
"5268","sample044","GGB","GBG",1,0,1
"5269","sample044","GGB","GGG",13,8,21
"5270","sample044","GGB","RGG",1,0,1
"5271","sample044","GGB","RRG",1,1,2
"5272","sample044","GGB","RRR",1,2,3
"5273","sample044","GGG","BBB",8,4,12
"5274","sample044","GGG","BGG",1,1,2
"5275","sample044","GGG","BRB",1,0,1
"5276","sample044","GGG","GGB",5,0,5
"5277","sample044","GGG","GGR",1,1,2
"5278","sample044","GGG","RBB",1,0,1
"5279","sample044","GGG","RGR",1,3,4
"5280","sample044","GGG","RRG",1,2,3
"5281","sample044","GGR","BRR",1,0,1
"5282","sample044","GGR","GRR",1,0,1
"5283","sample044","GRG","BBB",3,1,4
"5284","sample044","GRG","GGB",2,3,5
"5285","sample044","GRG","GGG",3,2,5
"5286","sample044","GRG","RGR",1,0,1
"5287","sample044","GRG","RRG",2,0,2
"5288","sample044","GRR","BGB",1,1,2
"5289","sample044","RBG","BBB",2,2,4
"5290","sample044","RBG","RBB",1,0,1
"5291","sample044","RBR","BGB",2,0,2
"5292","sample044","RBR","BRB",1,0,1
"5293","sample044","RBR","BRR",1,1,2
"5294","sample044","RBR","GRR",4,1,5
"5295","sample044","RBR","RGG",2,1,3
"5296","sample044","RBR","RGR",1,0,1
"5297","sample044","RGG","BBR",1,0,1
"5298","sample044","RGR","BBB",2,1,3
"5299","sample044","RGR","BBR",1,0,1
"5300","sample044","RGR","BGB",2,1,3
"5301","sample044","RGR","BGG",2,0,2
"5302","sample044","RGR","BRR",1,0,1
"5303","sample044","RGR","GGB",2,2,4
"5304","sample044","RGR","RGG",1,0,1
"5305","sample044","RRG","BBB",2,4,6
"5306","sample044","RRG","BGB",1,2,3
"5307","sample044","RRG","BRB",2,5,7
"5308","sample044","RRG","BRR",1,1,2
"5309","sample044","RRG","GGG",2,7,9
"5310","sample044","RRG","GRG",1,0,1
"5311","sample044","RRG","GRR",3,0,3
"5312","sample044","RRG","RBB",1,0,1
"5313","sample044","RRR","BBR",1,0,1
"5314","sample044","RRR","BGB",2,1,3
"5315","sample044","RRR","BGG",1,0,1
"5316","sample044","RRR","BRB",1,0,1
"5317","sample044","RRR","BRR",1,1,2
"5318","sample044","RRR","RBB",1,1,2
"5319","sample044","RRR","RGR",1,0,1
"5320","sample044","RRR","RRG",2,0,2
"5321","sample044","BBB","RRR",0,1,1
"5322","sample044","BBG","BGB",0,1,1
"5323","sample044","BBG","BGG",0,1,1
"5324","sample044","BBG","RRR",0,2,2
"5325","sample044","BRB","BBB",0,3,3
"5326","sample044","BRB","BRR",0,1,1
"5327","sample044","BRB","RRR",0,1,1
"5328","sample044","GBB","BGG",0,1,1
"5329","sample044","GBB","GGB",0,1,1
"5330","sample044","GBB","GRG",0,1,1
"5331","sample044","GBB","RBB",0,1,1
"5332","sample044","GBG","BBB",0,1,1
"5333","sample044","GGB","BGG",0,1,1
"5334","sample044","GGB","GRR",0,1,1
"5335","sample044","GGB","RBG",0,1,1
"5336","sample044","GGG","RBG",0,2,2
"5337","sample044","GGG","RBR",0,7,7
"5338","sample044","GGG","RGG",0,1,1
"5339","sample044","GGG","RRR",0,1,1
"5340","sample044","GGR","BBR",0,1,1
"5341","sample044","GRG","BBR",0,1,1
"5342","sample044","GRG","GBG",0,1,1
"5343","sample044","GRG","GGR",0,2,2
"5344","sample044","GRR","BBB",0,1,1
"5345","sample044","GRR","BBR",0,1,1
"5346","sample044","RBG","RBR",0,1,1
"5347","sample044","RBG","RGR",0,1,1
"5348","sample044","RBR","BBB",0,2,2
"5349","sample044","RBR","BBR",0,1,1
"5350","sample044","RBR","BGG",0,1,1
"5351","sample044","RBR","GGB",0,1,1
"5352","sample044","RGG","BBB",0,2,2
"5353","sample044","RGG","BRR",0,1,1
"5354","sample044","RGG","GRR",0,3,3
"5355","sample044","RGR","GGR",0,1,1
"5356","sample044","RRG","GGR",0,2,2
"5357","sample044","RRR","GGR",0,1,1
"5358","sample044","RRR","GRR",0,1,1
"5359","sample045","BBB","GGG",1,0,1
"5360","sample045","BBB","RRG",1,0,1
"5361","sample045","BBG","BBB",1,1,2
"5362","sample045","BBG","BRB",1,4,5
"5363","sample045","BBG","GBG",2,3,5
"5364","sample045","BBG","GGB",2,4,6
"5365","sample045","BBG","GGG",4,8,12
"5366","sample045","BBG","GRG",1,0,1
"5367","sample045","BBG","RRG",1,0,1
"5368","sample045","BGG","RBG",1,0,1
"5369","sample045","BGG","RRR",1,0,1
"5370","sample045","BRR","BGB",1,0,1
"5371","sample045","GBB","BBB",12,5,17
"5372","sample045","GBB","BRB",1,3,4
"5373","sample045","GBB","BRR",1,0,1
"5374","sample045","GBB","GGG",7,10,17
"5375","sample045","GBB","GGR",1,2,3
"5376","sample045","GBB","RBG",3,1,4
"5377","sample045","GBB","RBR",1,0,1
"5378","sample045","GBB","RGG",1,0,1
"5379","sample045","GBB","RGR",2,1,3
"5380","sample045","GBB","RRR",1,1,2
"5381","sample045","GBG","BRB",1,1,2
"5382","sample045","GBG","BRR",1,0,1
"5383","sample045","GBG","GGG",4,3,7
"5384","sample045","GBG","RBB",1,0,1
"5385","sample045","GBG","RGR",1,0,1
"5386","sample045","GBG","RRG",1,0,1
"5387","sample045","GGB","BBB",3,1,4
"5388","sample045","GGB","BBR",1,1,2
"5389","sample045","GGB","BRR",1,3,4
"5390","sample045","GGB","GBG",1,0,1
"5391","sample045","GGB","GGG",13,6,19
"5392","sample045","GGB","RGG",1,1,2
"5393","sample045","GGB","RRG",1,0,1
"5394","sample045","GGB","RRR",1,1,2
"5395","sample045","GGG","BBB",8,3,11
"5396","sample045","GGG","BGG",1,0,1
"5397","sample045","GGG","BRB",1,1,2
"5398","sample045","GGG","GGB",5,0,5
"5399","sample045","GGG","GGR",1,2,3
"5400","sample045","GGG","RBB",1,1,2
"5401","sample045","GGG","RGR",1,2,3
"5402","sample045","GGG","RRG",1,4,5
"5403","sample045","GGR","BRR",1,0,1
"5404","sample045","GGR","GRR",1,0,1
"5405","sample045","GRG","BBB",3,3,6
"5406","sample045","GRG","GGB",2,5,7
"5407","sample045","GRG","GGG",3,1,4
"5408","sample045","GRG","RGR",1,0,1
"5409","sample045","GRG","RRG",2,0,2
"5410","sample045","GRR","BGB",1,0,1
"5411","sample045","RBG","BBB",2,1,3
"5412","sample045","RBG","RBB",1,1,2
"5413","sample045","RBR","BGB",2,0,2
"5414","sample045","RBR","BRB",1,0,1
"5415","sample045","RBR","BRR",1,1,2
"5416","sample045","RBR","GRR",4,0,4
"5417","sample045","RBR","RGG",2,1,3
"5418","sample045","RBR","RGR",1,0,1
"5419","sample045","RGG","BBR",1,0,1
"5420","sample045","RGR","BBB",2,1,3
"5421","sample045","RGR","BBR",1,0,1
"5422","sample045","RGR","BGB",2,3,5
"5423","sample045","RGR","BGG",2,0,2
"5424","sample045","RGR","BRR",1,0,1
"5425","sample045","RGR","GGB",2,1,3
"5426","sample045","RGR","RGG",1,0,1
"5427","sample045","RRG","BBB",2,6,8
"5428","sample045","RRG","BGB",1,2,3
"5429","sample045","RRG","BRB",2,6,8
"5430","sample045","RRG","BRR",1,4,5
"5431","sample045","RRG","GGG",2,4,6
"5432","sample045","RRG","GRG",1,0,1
"5433","sample045","RRG","GRR",3,1,4
"5434","sample045","RRG","RBB",1,0,1
"5435","sample045","RRR","BBR",1,0,1
"5436","sample045","RRR","BGB",2,0,2
"5437","sample045","RRR","BGG",1,0,1
"5438","sample045","RRR","BRB",1,0,1
"5439","sample045","RRR","BRR",1,0,1
"5440","sample045","RRR","RBB",1,0,1
"5441","sample045","RRR","RGR",1,0,1
"5442","sample045","RRR","RRG",2,0,2
"5443","sample045","BBB","GRR",0,1,1
"5444","sample045","BBG","RRR",0,1,1
"5445","sample045","BGB","BBB",0,1,1
"5446","sample045","BRB","BBB",0,2,2
"5447","sample045","BRB","RBB",0,1,1
"5448","sample045","BRR","BBB",0,3,3
"5449","sample045","GBB","GBG",0,1,1
"5450","sample045","GBB","GGB",0,4,4
"5451","sample045","GBG","BBB",0,1,1
"5452","sample045","GBG","RGG",0,1,1
"5453","sample045","GGB","BRB",0,1,1
"5454","sample045","GGB","GBB",0,1,1
"5455","sample045","GGB","RBB",0,1,1
"5456","sample045","GGB","RBG",0,2,2
"5457","sample045","GGG","BRR",0,1,1
"5458","sample045","GGG","GRR",0,1,1
"5459","sample045","GGG","RBG",0,1,1
"5460","sample045","GGG","RBR",0,2,2
"5461","sample045","GGR","RBB",0,1,1
"5462","sample045","GRG","BBR",0,1,1
"5463","sample045","GRG","BGG",0,1,1
"5464","sample045","GRG","GBG",0,1,1
"5465","sample045","GRG","GGR",0,1,1
"5466","sample045","RBG","GRR",0,1,1
"5467","sample045","RBR","BBB",0,2,2
"5468","sample045","RBR","BGG",0,1,1
"5469","sample045","RGG","BBB",0,3,3
"5470","sample045","RGG","BRR",0,1,1
"5471","sample045","RGG","GRR",0,2,2
"5472","sample045","RGR","RRG",0,2,2
"5473","sample045","RRG","BBR",0,1,1
"5474","sample045","RRG","BGG",0,1,1
"5475","sample045","RRG","RGR",0,1,1
"5476","sample046","BBB","GGG",1,0,1
"5477","sample046","BBB","RRG",1,0,1
"5478","sample046","BBG","BBB",1,0,1
"5479","sample046","BBG","BRB",1,3,4
"5480","sample046","BBG","GBG",2,1,3
"5481","sample046","BBG","GGB",2,6,8
"5482","sample046","BBG","GGG",4,3,7
"5483","sample046","BBG","GRG",1,1,2
"5484","sample046","BBG","RRG",1,0,1
"5485","sample046","BGG","RBG",1,0,1
"5486","sample046","BGG","RRR",1,1,2
"5487","sample046","BRR","BGB",1,0,1
"5488","sample046","GBB","BBB",12,6,18
"5489","sample046","GBB","BRB",1,0,1
"5490","sample046","GBB","BRR",1,0,1
"5491","sample046","GBB","GGG",7,12,19
"5492","sample046","GBB","GGR",1,0,1
"5493","sample046","GBB","RBG",3,2,5
"5494","sample046","GBB","RBR",1,0,1
"5495","sample046","GBB","RGG",1,0,1
"5496","sample046","GBB","RGR",2,0,2
"5497","sample046","GBB","RRR",1,1,2
"5498","sample046","GBG","BRB",1,0,1
"5499","sample046","GBG","BRR",1,0,1
"5500","sample046","GBG","GGG",4,0,4
"5501","sample046","GBG","RBB",1,0,1
"5502","sample046","GBG","RGR",1,0,1
"5503","sample046","GBG","RRG",1,1,2
"5504","sample046","GGB","BBB",3,4,7
"5505","sample046","GGB","BBR",1,1,2
"5506","sample046","GGB","BRR",1,2,3
"5507","sample046","GGB","GBG",1,0,1
"5508","sample046","GGB","GGG",13,6,19
"5509","sample046","GGB","RGG",1,1,2
"5510","sample046","GGB","RRG",1,4,5
"5511","sample046","GGB","RRR",1,1,2
"5512","sample046","GGG","BBB",8,6,14
"5513","sample046","GGG","BGG",1,1,2
"5514","sample046","GGG","BRB",1,0,1
"5515","sample046","GGG","GGB",5,0,5
"5516","sample046","GGG","GGR",1,1,2
"5517","sample046","GGG","RBB",1,1,2
"5518","sample046","GGG","RGR",1,1,2
"5519","sample046","GGG","RRG",1,6,7
"5520","sample046","GGR","BRR",1,0,1
"5521","sample046","GGR","GRR",1,0,1
"5522","sample046","GRG","BBB",3,1,4
"5523","sample046","GRG","GGB",2,3,5
"5524","sample046","GRG","GGG",3,2,5
"5525","sample046","GRG","RGR",1,1,2
"5526","sample046","GRG","RRG",2,1,3
"5527","sample046","GRR","BGB",1,1,2
"5528","sample046","RBG","BBB",2,1,3
"5529","sample046","RBG","RBB",1,0,1
"5530","sample046","RBR","BGB",2,0,2
"5531","sample046","RBR","BRB",1,0,1
"5532","sample046","RBR","BRR",1,0,1
"5533","sample046","RBR","GRR",4,0,4
"5534","sample046","RBR","RGG",2,1,3
"5535","sample046","RBR","RGR",1,0,1
"5536","sample046","RGG","BBR",1,1,2
"5537","sample046","RGR","BBB",2,1,3
"5538","sample046","RGR","BBR",1,0,1
"5539","sample046","RGR","BGB",2,0,2
"5540","sample046","RGR","BGG",2,0,2
"5541","sample046","RGR","BRR",1,1,2
"5542","sample046","RGR","GGB",2,0,2
"5543","sample046","RGR","RGG",1,0,1
"5544","sample046","RRG","BBB",2,5,7
"5545","sample046","RRG","BGB",1,1,2
"5546","sample046","RRG","BRB",2,9,11
"5547","sample046","RRG","BRR",1,3,4
"5548","sample046","RRG","GGG",2,1,3
"5549","sample046","RRG","GRG",1,0,1
"5550","sample046","RRG","GRR",3,2,5
"5551","sample046","RRG","RBB",1,0,1
"5552","sample046","RRR","BBR",1,0,1
"5553","sample046","RRR","BGB",2,0,2
"5554","sample046","RRR","BGG",1,0,1
"5555","sample046","RRR","BRB",1,0,1
"5556","sample046","RRR","BRR",1,0,1
"5557","sample046","RRR","RBB",1,0,1
"5558","sample046","RRR","RGR",1,0,1
"5559","sample046","RRR","RRG",2,0,2
"5560","sample046","BBG","BGG",0,1,1
"5561","sample046","BBG","RBG",0,1,1
"5562","sample046","BBG","RRR",0,2,2
"5563","sample046","BRB","BBR",0,1,1
"5564","sample046","BRB","RBB",0,1,1
"5565","sample046","BRB","RGR",0,1,1
"5566","sample046","BRR","BBB",0,2,2
"5567","sample046","BRR","RBB",0,1,1
"5568","sample046","GBB","GBG",0,1,1
"5569","sample046","GBB","GGB",0,2,2
"5570","sample046","GBB","RRG",0,1,1
"5571","sample046","GBG","BBR",0,1,1
"5572","sample046","GBG","GGB",0,1,1
"5573","sample046","GGB","GGR",0,1,1
"5574","sample046","GGB","GRR",0,1,1
"5575","sample046","GGB","RBB",0,2,2
"5576","sample046","GGB","RBG",0,1,1
"5577","sample046","GGB","RBR",0,1,1
"5578","sample046","GGB","RGR",0,1,1
"5579","sample046","GGG","BRR",0,2,2
"5580","sample046","GGG","RBG",0,1,1
"5581","sample046","GGG","RBR",0,4,4
"5582","sample046","GGR","BBB",0,1,1
"5583","sample046","GRG","GGR",0,1,1
"5584","sample046","GRG","RBR",0,1,1
"5585","sample046","GRR","BGG",0,1,1
"5586","sample046","RBB","GRR",0,1,1
"5587","sample046","RBR","BBB",0,1,1
"5588","sample046","RBR","GGB",0,4,4
"5589","sample046","RBR","RBB",0,2,2
"5590","sample046","RGG","RBB",0,1,1
"5591","sample046","RGR","GGG",0,1,1
"5592","sample046","RGR","RBB",0,2,2
"5593","sample046","RGR","RRG",0,1,1
"5594","sample046","RRG","BBR",0,1,1
"5595","sample046","RRG","GGR",0,3,3
"5596","sample046","RRR","GRR",0,1,1
"5597","sample046","RRR","RGG",0,1,1
"5598","sample047","BBB","GGG",1,1,2
"5599","sample047","BBB","RRG",1,0,1
"5600","sample047","BBG","BBB",1,1,2
"5601","sample047","BBG","BRB",1,4,5
"5602","sample047","BBG","GBG",2,0,2
"5603","sample047","BBG","GGB",2,6,8
"5604","sample047","BBG","GGG",4,5,9
"5605","sample047","BBG","GRG",1,0,1
"5606","sample047","BBG","RRG",1,0,1
"5607","sample047","BGG","RBG",1,0,1
"5608","sample047","BGG","RRR",1,0,1
"5609","sample047","BRR","BGB",1,0,1
"5610","sample047","GBB","BBB",12,5,17
"5611","sample047","GBB","BRB",1,1,2
"5612","sample047","GBB","BRR",1,1,2
"5613","sample047","GBB","GGG",7,17,24
"5614","sample047","GBB","GGR",1,1,2
"5615","sample047","GBB","RBG",3,1,4
"5616","sample047","GBB","RBR",1,0,1
"5617","sample047","GBB","RGG",1,0,1
"5618","sample047","GBB","RGR",2,0,2
"5619","sample047","GBB","RRR",1,2,3
"5620","sample047","GBG","BRB",1,1,2
"5621","sample047","GBG","BRR",1,0,1
"5622","sample047","GBG","GGG",4,0,4
"5623","sample047","GBG","RBB",1,0,1
"5624","sample047","GBG","RGR",1,0,1
"5625","sample047","GBG","RRG",1,1,2
"5626","sample047","GGB","BBB",3,2,5
"5627","sample047","GGB","BBR",1,0,1
"5628","sample047","GGB","BRR",1,2,3
"5629","sample047","GGB","GBG",1,0,1
"5630","sample047","GGB","GGG",13,6,19
"5631","sample047","GGB","RGG",1,0,1
"5632","sample047","GGB","RRG",1,0,1
"5633","sample047","GGB","RRR",1,2,3
"5634","sample047","GGG","BBB",8,2,10
"5635","sample047","GGG","BGG",1,2,3
"5636","sample047","GGG","BRB",1,1,2
"5637","sample047","GGG","GGB",5,0,5
"5638","sample047","GGG","GGR",1,0,1
"5639","sample047","GGG","RBB",1,0,1
"5640","sample047","GGG","RGR",1,4,5
"5641","sample047","GGG","RRG",1,4,5
"5642","sample047","GGR","BRR",1,0,1
"5643","sample047","GGR","GRR",1,0,1
"5644","sample047","GRG","BBB",3,2,5
"5645","sample047","GRG","GGB",2,3,5
"5646","sample047","GRG","GGG",3,1,4
"5647","sample047","GRG","RGR",1,1,2
"5648","sample047","GRG","RRG",2,0,2
"5649","sample047","GRR","BGB",1,1,2
"5650","sample047","RBG","BBB",2,1,3
"5651","sample047","RBG","RBB",1,0,1
"5652","sample047","RBR","BGB",2,0,2
"5653","sample047","RBR","BRB",1,0,1
"5654","sample047","RBR","BRR",1,1,2
"5655","sample047","RBR","GRR",4,0,4
"5656","sample047","RBR","RGG",2,1,3
"5657","sample047","RBR","RGR",1,0,1
"5658","sample047","RGG","BBR",1,1,2
"5659","sample047","RGR","BBB",2,0,2
"5660","sample047","RGR","BBR",1,0,1
"5661","sample047","RGR","BGB",2,1,3
"5662","sample047","RGR","BGG",2,0,2
"5663","sample047","RGR","BRR",1,2,3
"5664","sample047","RGR","GGB",2,1,3
"5665","sample047","RGR","RGG",1,1,2
"5666","sample047","RRG","BBB",2,6,8
"5667","sample047","RRG","BGB",1,4,5
"5668","sample047","RRG","BRB",2,7,9
"5669","sample047","RRG","BRR",1,0,1
"5670","sample047","RRG","GGG",2,5,7
"5671","sample047","RRG","GRG",1,0,1
"5672","sample047","RRG","GRR",3,2,5
"5673","sample047","RRG","RBB",1,0,1
"5674","sample047","RRR","BBR",1,0,1
"5675","sample047","RRR","BGB",2,0,2
"5676","sample047","RRR","BGG",1,0,1
"5677","sample047","RRR","BRB",1,0,1
"5678","sample047","RRR","BRR",1,0,1
"5679","sample047","RRR","RBB",1,0,1
"5680","sample047","RRR","RGR",1,1,2
"5681","sample047","RRR","RRG",2,0,2
"5682","sample047","BBB","GRR",0,1,1
"5683","sample047","BBG","BGG",0,1,1
"5684","sample047","BBG","RBR",0,1,1
"5685","sample047","BBG","RRR",0,1,1
"5686","sample047","BGB","RRG",0,1,1
"5687","sample047","BGG","BBB",0,1,1
"5688","sample047","BRR","BBB",0,2,2
"5689","sample047","GBB","GBG",0,1,1
"5690","sample047","GBB","GGB",0,2,2
"5691","sample047","GBB","GRG",0,1,1
"5692","sample047","GBB","RBB",0,1,1
"5693","sample047","GBB","RRG",0,1,1
"5694","sample047","GBG","BBR",0,1,1
"5695","sample047","GBG","GGB",0,1,1
"5696","sample047","GBG","RGG",0,1,1
"5697","sample047","GGB","BGB",0,1,1
"5698","sample047","GGB","BGG",0,1,1
"5699","sample047","GGB","RGR",0,2,2
"5700","sample047","GGG","BRR",0,1,1
"5701","sample047","GGG","RBR",0,3,3
"5702","sample047","GGR","RBB",0,1,1
"5703","sample047","GRG","BRB",0,1,1
"5704","sample047","GRG","BRR",0,1,1
"5705","sample047","GRG","GBG",0,1,1
"5706","sample047","GRR","BBB",0,1,1
"5707","sample047","RBG","BRR",0,1,1
"5708","sample047","RBR","BBB",0,3,3
"5709","sample047","RBR","GGB",0,5,5
"5710","sample047","RBR","RBB",0,1,1
"5711","sample047","RGG","BBB",0,1,1
"5712","sample047","RGG","BRR",0,1,1
"5713","sample047","RGG","GRR",0,1,1
"5714","sample047","RGR","RBB",0,1,1
"5715","sample047","RRG","GGR",0,1,1
"5716","sample047","RRR","RGG",0,1,1
"5717","sample048","BBB","GGG",1,1,2
"5718","sample048","BBB","RRG",1,0,1
"5719","sample048","BBG","BBB",1,2,3
"5720","sample048","BBG","BRB",1,2,3
"5721","sample048","BBG","GBG",2,1,3
"5722","sample048","BBG","GGB",2,5,7
"5723","sample048","BBG","GGG",4,1,5
"5724","sample048","BBG","GRG",1,0,1
"5725","sample048","BBG","RRG",1,0,1
"5726","sample048","BGG","RBG",1,0,1
"5727","sample048","BGG","RRR",1,0,1
"5728","sample048","BRR","BGB",1,0,1
"5729","sample048","GBB","BBB",12,5,17
"5730","sample048","GBB","BRB",1,1,2
"5731","sample048","GBB","BRR",1,0,1
"5732","sample048","GBB","GGG",7,11,18
"5733","sample048","GBB","GGR",1,0,1
"5734","sample048","GBB","RBG",3,2,5
"5735","sample048","GBB","RBR",1,0,1
"5736","sample048","GBB","RGG",1,0,1
"5737","sample048","GBB","RGR",2,0,2
"5738","sample048","GBB","RRR",1,2,3
"5739","sample048","GBG","BRB",1,1,2
"5740","sample048","GBG","BRR",1,0,1
"5741","sample048","GBG","GGG",4,3,7
"5742","sample048","GBG","RBB",1,0,1
"5743","sample048","GBG","RGR",1,1,2
"5744","sample048","GBG","RRG",1,1,2
"5745","sample048","GGB","BBB",3,5,8
"5746","sample048","GGB","BBR",1,1,2
"5747","sample048","GGB","BRR",1,3,4
"5748","sample048","GGB","GBG",1,0,1
"5749","sample048","GGB","GGG",13,10,23
"5750","sample048","GGB","RGG",1,0,1
"5751","sample048","GGB","RRG",1,1,2
"5752","sample048","GGB","RRR",1,0,1
"5753","sample048","GGG","BBB",8,5,13
"5754","sample048","GGG","BGG",1,3,4
"5755","sample048","GGG","BRB",1,2,3
"5756","sample048","GGG","GGB",5,1,6
"5757","sample048","GGG","GGR",1,0,1
"5758","sample048","GGG","RBB",1,1,2
"5759","sample048","GGG","RGR",1,2,3
"5760","sample048","GGG","RRG",1,3,4
"5761","sample048","GGR","BRR",1,0,1
"5762","sample048","GGR","GRR",1,0,1
"5763","sample048","GRG","BBB",3,0,3
"5764","sample048","GRG","GGB",2,1,3
"5765","sample048","GRG","GGG",3,2,5
"5766","sample048","GRG","RGR",1,0,1
"5767","sample048","GRG","RRG",2,0,2
"5768","sample048","GRR","BGB",1,0,1
"5769","sample048","RBG","BBB",2,0,2
"5770","sample048","RBG","RBB",1,0,1
"5771","sample048","RBR","BGB",2,0,2
"5772","sample048","RBR","BRB",1,0,1
"5773","sample048","RBR","BRR",1,0,1
"5774","sample048","RBR","GRR",4,0,4
"5775","sample048","RBR","RGG",2,1,3
"5776","sample048","RBR","RGR",1,0,1
"5777","sample048","RGG","BBR",1,0,1
"5778","sample048","RGR","BBB",2,0,2
"5779","sample048","RGR","BBR",1,0,1
"5780","sample048","RGR","BGB",2,1,3
"5781","sample048","RGR","BGG",2,0,2
"5782","sample048","RGR","BRR",1,0,1
"5783","sample048","RGR","GGB",2,2,4
"5784","sample048","RGR","RGG",1,0,1
"5785","sample048","RRG","BBB",2,4,6
"5786","sample048","RRG","BGB",1,2,3
"5787","sample048","RRG","BRB",2,8,10
"5788","sample048","RRG","BRR",1,2,3
"5789","sample048","RRG","GGG",2,2,4
"5790","sample048","RRG","GRG",1,0,1
"5791","sample048","RRG","GRR",3,0,3
"5792","sample048","RRG","RBB",1,0,1
"5793","sample048","RRR","BBR",1,0,1
"5794","sample048","RRR","BGB",2,0,2
"5795","sample048","RRR","BGG",1,0,1
"5796","sample048","RRR","BRB",1,0,1
"5797","sample048","RRR","BRR",1,1,2
"5798","sample048","RRR","RBB",1,1,2
"5799","sample048","RRR","RGR",1,1,2
"5800","sample048","RRR","RRG",2,0,2
"5801","sample048","BBB","BRB",0,1,1
"5802","sample048","BBB","RRR",0,1,1
"5803","sample048","BBG","BGG",0,1,1
"5804","sample048","BBG","GBB",0,1,1
"5805","sample048","BBG","RRR",0,2,2
"5806","sample048","BRB","BBB",0,1,1
"5807","sample048","BRB","BRR",0,1,1
"5808","sample048","BRB","GGR",0,1,1
"5809","sample048","BRB","RBB",0,1,1
"5810","sample048","GBB","GGB",0,3,3
"5811","sample048","GBB","GRR",0,1,1
"5812","sample048","GBB","RRG",0,1,1
"5813","sample048","GGB","BGB",0,1,1
"5814","sample048","GGB","BGG",0,1,1
"5815","sample048","GGB","GGR",0,3,3
"5816","sample048","GGB","RBB",0,2,2
"5817","sample048","GGB","RBG",0,2,2
"5818","sample048","GGB","RBR",0,2,2
"5819","sample048","GGB","RGR",0,1,1
"5820","sample048","GGG","BRR",0,1,1
"5821","sample048","GGG","GRR",0,1,1
"5822","sample048","GGG","RBR",0,3,3
"5823","sample048","GGG","RGG",0,1,1
"5824","sample048","GRG","BRR",0,1,1
"5825","sample048","GRG","GGR",0,1,1
"5826","sample048","RBB","GRR",0,1,1
"5827","sample048","RBG","BBG",0,1,1
"5828","sample048","RBG","GBB",0,1,1
"5829","sample048","RBR","BBB",0,2,2
"5830","sample048","RBR","BBR",0,1,1
"5831","sample048","RBR","GGB",0,2,2
"5832","sample048","RBR","RBB",0,1,1
"5833","sample048","RBR","RRR",0,1,1
"5834","sample048","RGG","BBB",0,3,3
"5835","sample048","RGG","BGB",0,1,1
"5836","sample048","RGG","GGR",0,1,1
"5837","sample048","RGR","RBB",0,2,2
"5838","sample048","RGR","RRG",0,1,1
"5839","sample048","RRG","BGG",0,2,2
"5840","sample048","RRG","GGR",0,1,1
"5841","sample049","BBB","GGG",1,1,2
"5842","sample049","BBB","RRG",1,1,2
"5843","sample049","BBG","BBB",1,0,1
"5844","sample049","BBG","BRB",1,2,3
"5845","sample049","BBG","GBG",2,1,3
"5846","sample049","BBG","GGB",2,4,6
"5847","sample049","BBG","GGG",4,6,10
"5848","sample049","BBG","GRG",1,2,3
"5849","sample049","BBG","RRG",1,2,3
"5850","sample049","BGG","RBG",1,0,1
"5851","sample049","BGG","RRR",1,0,1
"5852","sample049","BRR","BGB",1,0,1
"5853","sample049","GBB","BBB",12,9,21
"5854","sample049","GBB","BRB",1,1,2
"5855","sample049","GBB","BRR",1,0,1
"5856","sample049","GBB","GGG",7,13,20
"5857","sample049","GBB","GGR",1,1,2
"5858","sample049","GBB","RBG",3,2,5
"5859","sample049","GBB","RBR",1,0,1
"5860","sample049","GBB","RGG",1,0,1
"5861","sample049","GBB","RGR",2,0,2
"5862","sample049","GBB","RRR",1,0,1
"5863","sample049","GBG","BRB",1,0,1
"5864","sample049","GBG","BRR",1,0,1
"5865","sample049","GBG","GGG",4,1,5
"5866","sample049","GBG","RBB",1,0,1
"5867","sample049","GBG","RGR",1,2,3
"5868","sample049","GBG","RRG",1,1,2
"5869","sample049","GGB","BBB",3,3,6
"5870","sample049","GGB","BBR",1,0,1
"5871","sample049","GGB","BRR",1,1,2
"5872","sample049","GGB","GBG",1,0,1
"5873","sample049","GGB","GGG",13,4,17
"5874","sample049","GGB","RGG",1,0,1
"5875","sample049","GGB","RRG",1,0,1
"5876","sample049","GGB","RRR",1,1,2
"5877","sample049","GGG","BBB",8,3,11
"5878","sample049","GGG","BGG",1,1,2
"5879","sample049","GGG","BRB",1,0,1
"5880","sample049","GGG","GGB",5,0,5
"5881","sample049","GGG","GGR",1,2,3
"5882","sample049","GGG","RBB",1,0,1
"5883","sample049","GGG","RGR",1,1,2
"5884","sample049","GGG","RRG",1,4,5
"5885","sample049","GGR","BRR",1,0,1
"5886","sample049","GGR","GRR",1,0,1
"5887","sample049","GRG","BBB",3,1,4
"5888","sample049","GRG","GGB",2,7,9
"5889","sample049","GRG","GGG",3,1,4
"5890","sample049","GRG","RGR",1,0,1
"5891","sample049","GRG","RRG",2,0,2
"5892","sample049","GRR","BGB",1,0,1
"5893","sample049","RBG","BBB",2,0,2
"5894","sample049","RBG","RBB",1,0,1
"5895","sample049","RBR","BGB",2,1,3
"5896","sample049","RBR","BRB",1,0,1
"5897","sample049","RBR","BRR",1,1,2
"5898","sample049","RBR","GRR",4,1,5
"5899","sample049","RBR","RGG",2,0,2
"5900","sample049","RBR","RGR",1,0,1
"5901","sample049","RGG","BBR",1,1,2
"5902","sample049","RGR","BBB",2,2,4
"5903","sample049","RGR","BBR",1,1,2
"5904","sample049","RGR","BGB",2,0,2
"5905","sample049","RGR","BGG",2,0,2
"5906","sample049","RGR","BRR",1,0,1
"5907","sample049","RGR","GGB",2,1,3
"5908","sample049","RGR","RGG",1,1,2
"5909","sample049","RRG","BBB",2,6,8
"5910","sample049","RRG","BGB",1,1,2
"5911","sample049","RRG","BRB",2,4,6
"5912","sample049","RRG","BRR",1,2,3
"5913","sample049","RRG","GGG",2,2,4
"5914","sample049","RRG","GRG",1,0,1
"5915","sample049","RRG","GRR",3,0,3
"5916","sample049","RRG","RBB",1,0,1
"5917","sample049","RRR","BBR",1,0,1
"5918","sample049","RRR","BGB",2,0,2
"5919","sample049","RRR","BGG",1,0,1
"5920","sample049","RRR","BRB",1,0,1
"5921","sample049","RRR","BRR",1,0,1
"5922","sample049","RRR","RBB",1,1,2
"5923","sample049","RRR","RGR",1,1,2
"5924","sample049","RRR","RRG",2,0,2
"5925","sample049","BBB","RBG",0,1,1
"5926","sample049","BBB","RRR",0,1,1
"5927","sample049","BBG","BGB",0,1,1
"5928","sample049","BBG","RBG",0,1,1
"5929","sample049","BBG","RRR",0,3,3
"5930","sample049","BGB","BBB",0,1,1
"5931","sample049","BGG","RGR",0,1,1
"5932","sample049","BRB","BBB",0,3,3
"5933","sample049","BRB","BRR",0,1,1
"5934","sample049","BRR","BBB",0,2,2
"5935","sample049","BRR","BRB",0,1,1
"5936","sample049","GBB","GGB",0,6,6
"5937","sample049","GBB","RRG",0,1,1
"5938","sample049","GBG","BBB",0,1,1
"5939","sample049","GBG","GGB",0,1,1
"5940","sample049","GBG","RBG",0,1,1
"5941","sample049","GGB","BGG",0,1,1
"5942","sample049","GGB","BRB",0,1,1
"5943","sample049","GGB","GBB",0,1,1
"5944","sample049","GGB","GRR",0,1,1
"5945","sample049","GGB","RBB",0,1,1
"5946","sample049","GGG","BGB",0,1,1
"5947","sample049","GGG","BRR",0,3,3
"5948","sample049","GGG","RBG",0,1,1
"5949","sample049","GGG","RBR",0,3,3
"5950","sample049","GGR","BBB",0,1,1
"5951","sample049","GGR","BBR",0,1,1
"5952","sample049","GRG","GGR",0,1,1
"5953","sample049","RBR","BBB",0,2,2
"5954","sample049","RBR","GGB",0,1,1
"5955","sample049","RBR","RBB",0,1,1
"5956","sample049","RGG","BBB",0,2,2
"5957","sample049","RGG","BRR",0,1,1
"5958","sample049","RGG","GGR",0,1,1
"5959","sample049","RGR","GGR",0,1,1
"5960","sample049","RGR","RRG",0,1,1
"5961","sample049","RRG","BBR",0,1,1
"5962","sample049","RRG","GGR",0,2,2
"5963","sample049","RRR","RBR",0,1,1
"5964","sample050","BBB","GGG",1,0,1
"5965","sample050","BBB","RRG",1,0,1
"5966","sample050","BBG","BBB",1,0,1
"5967","sample050","BBG","BRB",1,3,4
"5968","sample050","BBG","GBG",2,2,4
"5969","sample050","BBG","GGB",2,4,6
"5970","sample050","BBG","GGG",4,5,9
"5971","sample050","BBG","GRG",1,1,2
"5972","sample050","BBG","RRG",1,0,1
"5973","sample050","BGG","RBG",1,0,1
"5974","sample050","BGG","RRR",1,0,1
"5975","sample050","BRR","BGB",1,0,1
"5976","sample050","GBB","BBB",12,6,18
"5977","sample050","GBB","BRB",1,0,1
"5978","sample050","GBB","BRR",1,1,2
"5979","sample050","GBB","GGG",7,16,23
"5980","sample050","GBB","GGR",1,1,2
"5981","sample050","GBB","RBG",3,3,6
"5982","sample050","GBB","RBR",1,0,1
"5983","sample050","GBB","RGG",1,0,1
"5984","sample050","GBB","RGR",2,0,2
"5985","sample050","GBB","RRR",1,2,3
"5986","sample050","GBG","BRB",1,0,1
"5987","sample050","GBG","BRR",1,0,1
"5988","sample050","GBG","GGG",4,1,5
"5989","sample050","GBG","RBB",1,0,1
"5990","sample050","GBG","RGR",1,1,2
"5991","sample050","GBG","RRG",1,0,1
"5992","sample050","GGB","BBB",3,2,5
"5993","sample050","GGB","BBR",1,0,1
"5994","sample050","GGB","BRR",1,2,3
"5995","sample050","GGB","GBG",1,0,1
"5996","sample050","GGB","GGG",13,6,19
"5997","sample050","GGB","RGG",1,1,2
"5998","sample050","GGB","RRG",1,0,1
"5999","sample050","GGB","RRR",1,1,2
"6000","sample050","GGG","BBB",8,6,14
"6001","sample050","GGG","BGG",1,1,2
"6002","sample050","GGG","BRB",1,1,2
"6003","sample050","GGG","GGB",5,1,6
"6004","sample050","GGG","GGR",1,0,1
"6005","sample050","GGG","RBB",1,3,4
"6006","sample050","GGG","RGR",1,3,4
"6007","sample050","GGG","RRG",1,6,7
"6008","sample050","GGR","BRR",1,0,1
"6009","sample050","GGR","GRR",1,0,1
"6010","sample050","GRG","BBB",3,0,3
"6011","sample050","GRG","GGB",2,1,3
"6012","sample050","GRG","GGG",3,1,4
"6013","sample050","GRG","RGR",1,0,1
"6014","sample050","GRG","RRG",2,0,2
"6015","sample050","GRR","BGB",1,0,1
"6016","sample050","RBG","BBB",2,2,4
"6017","sample050","RBG","RBB",1,0,1
"6018","sample050","RBR","BGB",2,0,2
"6019","sample050","RBR","BRB",1,0,1
"6020","sample050","RBR","BRR",1,1,2
"6021","sample050","RBR","GRR",4,0,4
"6022","sample050","RBR","RGG",2,2,4
"6023","sample050","RBR","RGR",1,0,1
"6024","sample050","RGG","BBR",1,1,2
"6025","sample050","RGR","BBB",2,0,2
"6026","sample050","RGR","BBR",1,0,1
"6027","sample050","RGR","BGB",2,1,3
"6028","sample050","RGR","BGG",2,0,2
"6029","sample050","RGR","BRR",1,1,2
"6030","sample050","RGR","GGB",2,0,2
"6031","sample050","RGR","RGG",1,0,1
"6032","sample050","RRG","BBB",2,9,11
"6033","sample050","RRG","BGB",1,2,3
"6034","sample050","RRG","BRB",2,4,6
"6035","sample050","RRG","BRR",1,2,3
"6036","sample050","RRG","GGG",2,4,6
"6037","sample050","RRG","GRG",1,0,1
"6038","sample050","RRG","GRR",3,1,4
"6039","sample050","RRG","RBB",1,0,1
"6040","sample050","RRR","BBR",1,0,1
"6041","sample050","RRR","BGB",2,0,2
"6042","sample050","RRR","BGG",1,0,1
"6043","sample050","RRR","BRB",1,0,1
"6044","sample050","RRR","BRR",1,0,1
"6045","sample050","RRR","RBB",1,0,1
"6046","sample050","RRR","RGR",1,0,1
"6047","sample050","RRR","RRG",2,0,2
"6048","sample050","BBB","BRB",0,1,1
"6049","sample050","BBG","BGB",0,1,1
"6050","sample050","BBG","RRR",0,2,2
"6051","sample050","BGB","BBB",0,1,1
"6052","sample050","BRB","BRR",0,1,1
"6053","sample050","BRB","GGG",0,1,1
"6054","sample050","BRB","RBB",0,1,1
"6055","sample050","BRR","BBB",0,2,2
"6056","sample050","GBB","GGB",0,2,2
"6057","sample050","GBB","GRG",0,1,1
"6058","sample050","GGB","BGB",0,2,2
"6059","sample050","GGB","BGG",0,1,1
"6060","sample050","GGB","GBB",0,1,1
"6061","sample050","GGB","GGR",0,1,1
"6062","sample050","GGB","GRR",0,1,1
"6063","sample050","GGB","RBB",0,1,1
"6064","sample050","GGB","RBR",0,1,1
"6065","sample050","GGG","GRR",0,1,1
"6066","sample050","GGG","RBG",0,1,1
"6067","sample050","GGG","RBR",0,4,4
"6068","sample050","GRG","BBR",0,1,1
"6069","sample050","GRG","GGR",0,1,1
"6070","sample050","GRG","GRR",0,1,1
"6071","sample050","GRG","RBR",0,1,1
"6072","sample050","GRR","BBR",0,1,1
"6073","sample050","GRR","BGG",0,1,1
"6074","sample050","RBG","GBB",0,1,1
"6075","sample050","RBR","BBB",0,1,1
"6076","sample050","RBR","GGB",0,1,1
"6077","sample050","RBR","RBB",0,2,2
"6078","sample050","RGG","GGR",0,1,1
"6079","sample050","RGG","GRR",0,2,2
"6080","sample050","RGR","GGG",0,1,1
"6081","sample050","RGR","GGR",0,1,1
"6082","sample050","RGR","RRG",0,2,2
"6083","sample050","RRG","BBR",0,2,2
"6084","sample050","RRG","GGR",0,1,1
"6085","sample050","RRG","RGG",0,1,1
"6086","sample051","BBB","GGG",1,0,1
"6087","sample051","BBB","RRG",1,1,2
"6088","sample051","BBG","BBB",1,0,1
"6089","sample051","BBG","BRB",1,4,5
"6090","sample051","BBG","GBG",2,0,2
"6091","sample051","BBG","GGB",2,6,8
"6092","sample051","BBG","GGG",4,5,9
"6093","sample051","BBG","GRG",1,2,3
"6094","sample051","BBG","RRG",1,1,2
"6095","sample051","BGG","RBG",1,0,1
"6096","sample051","BGG","RRR",1,0,1
"6097","sample051","BRR","BGB",1,0,1
"6098","sample051","GBB","BBB",12,6,18
"6099","sample051","GBB","BRB",1,3,4
"6100","sample051","GBB","BRR",1,0,1
"6101","sample051","GBB","GGG",7,11,18
"6102","sample051","GBB","GGR",1,0,1
"6103","sample051","GBB","RBG",3,4,7
"6104","sample051","GBB","RBR",1,0,1
"6105","sample051","GBB","RGG",1,0,1
"6106","sample051","GBB","RGR",2,1,3
"6107","sample051","GBB","RRR",1,1,2
"6108","sample051","GBG","BRB",1,2,3
"6109","sample051","GBG","BRR",1,0,1
"6110","sample051","GBG","GGG",4,2,6
"6111","sample051","GBG","RBB",1,0,1
"6112","sample051","GBG","RGR",1,0,1
"6113","sample051","GBG","RRG",1,3,4
"6114","sample051","GGB","BBB",3,3,6
"6115","sample051","GGB","BBR",1,0,1
"6116","sample051","GGB","BRR",1,3,4
"6117","sample051","GGB","GBG",1,0,1
"6118","sample051","GGB","GGG",13,10,23
"6119","sample051","GGB","RGG",1,1,2
"6120","sample051","GGB","RRG",1,0,1
"6121","sample051","GGB","RRR",1,0,1
"6122","sample051","GGG","BBB",8,3,11
"6123","sample051","GGG","BGG",1,0,1
"6124","sample051","GGG","BRB",1,0,1
"6125","sample051","GGG","GGB",5,0,5
"6126","sample051","GGG","GGR",1,2,3
"6127","sample051","GGG","RBB",1,1,2
"6128","sample051","GGG","RGR",1,2,3
"6129","sample051","GGG","RRG",1,0,1
"6130","sample051","GGR","BRR",1,0,1
"6131","sample051","GGR","GRR",1,0,1
"6132","sample051","GRG","BBB",3,0,3
"6133","sample051","GRG","GGB",2,2,4
"6134","sample051","GRG","GGG",3,1,4
"6135","sample051","GRG","RGR",1,1,2
"6136","sample051","GRG","RRG",2,0,2
"6137","sample051","GRR","BGB",1,0,1
"6138","sample051","RBG","BBB",2,1,3
"6139","sample051","RBG","RBB",1,0,1
"6140","sample051","RBR","BGB",2,0,2
"6141","sample051","RBR","BRB",1,0,1
"6142","sample051","RBR","BRR",1,0,1
"6143","sample051","RBR","GRR",4,0,4
"6144","sample051","RBR","RGG",2,0,2
"6145","sample051","RBR","RGR",1,0,1
"6146","sample051","RGG","BBR",1,1,2
"6147","sample051","RGR","BBB",2,1,3
"6148","sample051","RGR","BBR",1,0,1
"6149","sample051","RGR","BGB",2,0,2
"6150","sample051","RGR","BGG",2,1,3
"6151","sample051","RGR","BRR",1,0,1
"6152","sample051","RGR","GGB",2,3,5
"6153","sample051","RGR","RGG",1,0,1
"6154","sample051","RRG","BBB",2,3,5
"6155","sample051","RRG","BGB",1,4,5
"6156","sample051","RRG","BRB",2,6,8
"6157","sample051","RRG","BRR",1,2,3
"6158","sample051","RRG","GGG",2,1,3
"6159","sample051","RRG","GRG",1,0,1
"6160","sample051","RRG","GRR",3,0,3
"6161","sample051","RRG","RBB",1,0,1
"6162","sample051","RRR","BBR",1,0,1
"6163","sample051","RRR","BGB",2,0,2
"6164","sample051","RRR","BGG",1,0,1
"6165","sample051","RRR","BRB",1,1,2
"6166","sample051","RRR","BRR",1,0,1
"6167","sample051","RRR","RBB",1,1,2
"6168","sample051","RRR","RGR",1,0,1
"6169","sample051","RRR","RRG",2,1,3
"6170","sample051","BBG","RRR",0,1,1
"6171","sample051","BGG","BBB",0,1,1
"6172","sample051","BGG","BBR",0,1,1
"6173","sample051","BGG","GRG",0,1,1
"6174","sample051","BGG","RGR",0,1,1
"6175","sample051","BRB","BBB",0,1,1
"6176","sample051","BRB","BRR",0,1,1
"6177","sample051","BRR","BBB",0,1,1
"6178","sample051","GBB","GGB",0,4,4
"6179","sample051","GBB","RBB",0,1,1
"6180","sample051","GBG","BBB",0,1,1
"6181","sample051","GBG","GGB",0,1,1
"6182","sample051","GGB","BGB",0,1,1
"6183","sample051","GGB","BGG",0,2,2
"6184","sample051","GGB","GGR",0,3,3
"6185","sample051","GGB","RBR",0,2,2
"6186","sample051","GGB","RGR",0,1,1
"6187","sample051","GGG","BRR",0,2,2
"6188","sample051","GGG","RBG",0,2,2
"6189","sample051","GGG","RBR",0,4,4
"6190","sample051","GGG","RGG",0,1,1
"6191","sample051","GGR","BBR",0,1,1
"6192","sample051","GRG","GGR",0,1,1
"6193","sample051","GRR","BBB",0,1,1
"6194","sample051","GRR","BBR",0,1,1
"6195","sample051","GRR","GGG",0,1,1
"6196","sample051","RBG","RGR",0,1,1
"6197","sample051","RBR","BBB",0,1,1
"6198","sample051","RBR","GGB",0,1,1
"6199","sample051","RBR","RRR",0,1,1
"6200","sample051","RGG","BBB",0,2,2
"6201","sample051","RGG","BGB",0,1,1
"6202","sample051","RGG","BRR",0,1,1
"6203","sample051","RGG","GGG",0,1,1
"6204","sample051","RGG","GRR",0,1,1
"6205","sample051","RGR","GGG",0,1,1
"6206","sample051","RGR","RBB",0,2,2
"6207","sample051","RRG","BBR",0,1,1
"6208","sample051","RRG","RGR",0,1,1
"6209","sample052","BBB","GGG",1,0,1
"6210","sample052","BBB","RRG",1,1,2
"6211","sample052","BBG","BBB",1,1,2
"6212","sample052","BBG","BRB",1,1,2
"6213","sample052","BBG","GBG",2,0,2
"6214","sample052","BBG","GGB",2,3,5
"6215","sample052","BBG","GGG",4,9,13
"6216","sample052","BBG","GRG",1,3,4
"6217","sample052","BBG","RRG",1,0,1
"6218","sample052","BGG","RBG",1,0,1
"6219","sample052","BGG","RRR",1,0,1
"6220","sample052","BRR","BGB",1,0,1
"6221","sample052","GBB","BBB",12,12,24
"6222","sample052","GBB","BRB",1,3,4
"6223","sample052","GBB","BRR",1,0,1
"6224","sample052","GBB","GGG",7,16,23
"6225","sample052","GBB","GGR",1,1,2
"6226","sample052","GBB","RBG",3,2,5
"6227","sample052","GBB","RBR",1,0,1
"6228","sample052","GBB","RGG",1,0,1
"6229","sample052","GBB","RGR",2,0,2
"6230","sample052","GBB","RRR",1,1,2
"6231","sample052","GBG","BRB",1,0,1
"6232","sample052","GBG","BRR",1,0,1
"6233","sample052","GBG","GGG",4,2,6
"6234","sample052","GBG","RBB",1,0,1
"6235","sample052","GBG","RGR",1,0,1
"6236","sample052","GBG","RRG",1,2,3
"6237","sample052","GGB","BBB",3,2,5
"6238","sample052","GGB","BBR",1,1,2
"6239","sample052","GGB","BRR",1,2,3
"6240","sample052","GGB","GBG",1,0,1
"6241","sample052","GGB","GGG",13,5,18
"6242","sample052","GGB","RGG",1,1,2
"6243","sample052","GGB","RRG",1,1,2
"6244","sample052","GGB","RRR",1,2,3
"6245","sample052","GGG","BBB",8,4,12
"6246","sample052","GGG","BGG",1,3,4
"6247","sample052","GGG","BRB",1,0,1
"6248","sample052","GGG","GGB",5,0,5
"6249","sample052","GGG","GGR",1,0,1
"6250","sample052","GGG","RBB",1,0,1
"6251","sample052","GGG","RGR",1,3,4
"6252","sample052","GGG","RRG",1,4,5
"6253","sample052","GGR","BRR",1,0,1
"6254","sample052","GGR","GRR",1,0,1
"6255","sample052","GRG","BBB",3,1,4
"6256","sample052","GRG","GGB",2,1,3
"6257","sample052","GRG","GGG",3,2,5
"6258","sample052","GRG","RGR",1,1,2
"6259","sample052","GRG","RRG",2,1,3
"6260","sample052","GRR","BGB",1,0,1
"6261","sample052","RBG","BBB",2,1,3
"6262","sample052","RBG","RBB",1,0,1
"6263","sample052","RBR","BGB",2,2,4
"6264","sample052","RBR","BRB",1,0,1
"6265","sample052","RBR","BRR",1,0,1
"6266","sample052","RBR","GRR",4,0,4
"6267","sample052","RBR","RGG",2,1,3
"6268","sample052","RBR","RGR",1,0,1
"6269","sample052","RGG","BBR",1,0,1
"6270","sample052","RGR","BBB",2,1,3
"6271","sample052","RGR","BBR",1,0,1
"6272","sample052","RGR","BGB",2,2,4
"6273","sample052","RGR","BGG",2,0,2
"6274","sample052","RGR","BRR",1,0,1
"6275","sample052","RGR","GGB",2,0,2
"6276","sample052","RGR","RGG",1,0,1
"6277","sample052","RRG","BBB",2,5,7
"6278","sample052","RRG","BGB",1,1,2
"6279","sample052","RRG","BRB",2,7,9
"6280","sample052","RRG","BRR",1,1,2
"6281","sample052","RRG","GGG",2,1,3
"6282","sample052","RRG","GRG",1,0,1
"6283","sample052","RRG","GRR",3,1,4
"6284","sample052","RRG","RBB",1,1,2
"6285","sample052","RRR","BBR",1,0,1
"6286","sample052","RRR","BGB",2,0,2
"6287","sample052","RRR","BGG",1,0,1
"6288","sample052","RRR","BRB",1,0,1
"6289","sample052","RRR","BRR",1,0,1
"6290","sample052","RRR","RBB",1,1,2
"6291","sample052","RRR","RGR",1,0,1
"6292","sample052","RRR","RRG",2,1,3
"6293","sample052","BBB","RRR",0,1,1
"6294","sample052","BBG","RRR",0,2,2
"6295","sample052","BGG","RGG",0,1,1
"6296","sample052","BRB","BBB",0,1,1
"6297","sample052","BRB","BRR",0,3,3
"6298","sample052","BRR","BBB",0,1,1
"6299","sample052","BRR","BRB",0,1,1
"6300","sample052","GBB","GGB",0,5,5
"6301","sample052","GBB","GRG",0,1,1
"6302","sample052","GGB","BGB",0,3,3
"6303","sample052","GGB","BGG",0,1,1
"6304","sample052","GGB","GGR",0,1,1
"6305","sample052","GGB","GRR",0,1,1
"6306","sample052","GGB","RBG",0,1,1
"6307","sample052","GGB","RBR",0,1,1
"6308","sample052","GGG","BGB",0,1,1
"6309","sample052","GGG","BRR",0,1,1
"6310","sample052","GGG","RBR",0,1,1
"6311","sample052","GGG","RGG",0,1,1
"6312","sample052","GRG","BRB",0,1,1
"6313","sample052","GRG","GGR",0,1,1
"6314","sample052","GRG","RBG",0,1,1
"6315","sample052","RBR","BBB",0,1,1
"6316","sample052","RBR","BGG",0,1,1
"6317","sample052","RBR","GGB",0,1,1
"6318","sample052","RBR","RBB",0,1,1
"6319","sample052","RGG","GRR",0,1,1
"6320","sample052","RGR","GGR",0,2,2
"6321","sample052","RRG","GGR",0,2,2
"6322","sample052","RRG","RGR",0,1,1
"6323","sample052","RRR","GRR",0,1,1
"6324","sample052","RRR","RGG",0,1,1
"6325","sample053","BBB","GGG",1,0,1
"6326","sample053","BBB","RRG",1,1,2
"6327","sample053","BBG","BBB",1,0,1
"6328","sample053","BBG","BRB",1,5,6
"6329","sample053","BBG","GBG",2,1,3
"6330","sample053","BBG","GGB",2,4,6
"6331","sample053","BBG","GGG",4,5,9
"6332","sample053","BBG","GRG",1,1,2
"6333","sample053","BBG","RRG",1,0,1
"6334","sample053","BGG","RBG",1,0,1
"6335","sample053","BGG","RRR",1,0,1
"6336","sample053","BRR","BGB",1,1,2
"6337","sample053","GBB","BBB",12,7,19
"6338","sample053","GBB","BRB",1,1,2
"6339","sample053","GBB","BRR",1,1,2
"6340","sample053","GBB","GGG",7,11,18
"6341","sample053","GBB","GGR",1,0,1
"6342","sample053","GBB","RBG",3,1,4
"6343","sample053","GBB","RBR",1,0,1
"6344","sample053","GBB","RGG",1,0,1
"6345","sample053","GBB","RGR",2,0,2
"6346","sample053","GBB","RRR",1,3,4
"6347","sample053","GBG","BRB",1,0,1
"6348","sample053","GBG","BRR",1,0,1
"6349","sample053","GBG","GGG",4,1,5
"6350","sample053","GBG","RBB",1,0,1
"6351","sample053","GBG","RGR",1,0,1
"6352","sample053","GBG","RRG",1,2,3
"6353","sample053","GGB","BBB",3,3,6
"6354","sample053","GGB","BBR",1,0,1
"6355","sample053","GGB","BRR",1,2,3
"6356","sample053","GGB","GBG",1,0,1
"6357","sample053","GGB","GGG",13,9,22
"6358","sample053","GGB","RGG",1,1,2
"6359","sample053","GGB","RRG",1,0,1
"6360","sample053","GGB","RRR",1,1,2
"6361","sample053","GGG","BBB",8,3,11
"6362","sample053","GGG","BGG",1,1,2
"6363","sample053","GGG","BRB",1,1,2
"6364","sample053","GGG","GGB",5,0,5
"6365","sample053","GGG","GGR",1,2,3
"6366","sample053","GGG","RBB",1,2,3
"6367","sample053","GGG","RGR",1,1,2
"6368","sample053","GGG","RRG",1,2,3
"6369","sample053","GGR","BRR",1,0,1
"6370","sample053","GGR","GRR",1,0,1
"6371","sample053","GRG","BBB",3,1,4
"6372","sample053","GRG","GGB",2,2,4
"6373","sample053","GRG","GGG",3,1,4
"6374","sample053","GRG","RGR",1,0,1
"6375","sample053","GRG","RRG",2,0,2
"6376","sample053","GRR","BGB",1,1,2
"6377","sample053","RBG","BBB",2,0,2
"6378","sample053","RBG","RBB",1,0,1
"6379","sample053","RBR","BGB",2,1,3
"6380","sample053","RBR","BRB",1,0,1
"6381","sample053","RBR","BRR",1,0,1
"6382","sample053","RBR","GRR",4,0,4
"6383","sample053","RBR","RGG",2,0,2
"6384","sample053","RBR","RGR",1,0,1
"6385","sample053","RGG","BBR",1,1,2
"6386","sample053","RGR","BBB",2,1,3
"6387","sample053","RGR","BBR",1,0,1
"6388","sample053","RGR","BGB",2,2,4
"6389","sample053","RGR","BGG",2,0,2
"6390","sample053","RGR","BRR",1,1,2
"6391","sample053","RGR","GGB",2,3,5
"6392","sample053","RGR","RGG",1,0,1
"6393","sample053","RRG","BBB",2,6,8
"6394","sample053","RRG","BGB",1,1,2
"6395","sample053","RRG","BRB",2,6,8
"6396","sample053","RRG","BRR",1,1,2
"6397","sample053","RRG","GGG",2,1,3
"6398","sample053","RRG","GRG",1,0,1
"6399","sample053","RRG","GRR",3,5,8
"6400","sample053","RRG","RBB",1,0,1
"6401","sample053","RRR","BBR",1,0,1
"6402","sample053","RRR","BGB",2,0,2
"6403","sample053","RRR","BGG",1,0,1
"6404","sample053","RRR","BRB",1,0,1
"6405","sample053","RRR","BRR",1,1,2
"6406","sample053","RRR","RBB",1,0,1
"6407","sample053","RRR","RGR",1,0,1
"6408","sample053","RRR","RRG",2,1,3
"6409","sample053","BBB","RRR",0,1,1
"6410","sample053","BBG","BGB",0,1,1
"6411","sample053","BBG","RRR",0,2,2
"6412","sample053","BGB","RRG",0,1,1
"6413","sample053","BRB","BBB",0,4,4
"6414","sample053","BRB","BBR",0,1,1
"6415","sample053","BRB","BRR",0,2,2
"6416","sample053","BRB","RBG",0,1,1
"6417","sample053","BRB","RRR",0,1,1
"6418","sample053","BRR","BBB",0,1,1
"6419","sample053","BRR","RBB",0,1,1
"6420","sample053","GBB","GGB",0,2,2
"6421","sample053","GBB","GRG",0,1,1
"6422","sample053","GBB","GRR",0,1,1
"6423","sample053","GBG","GGB",0,1,1
"6424","sample053","GGB","BRB",0,1,1
"6425","sample053","GGB","GGR",0,2,2
"6426","sample053","GGB","RBB",0,1,1
"6427","sample053","GGB","RBG",0,2,2
"6428","sample053","GGB","RGR",0,1,1
"6429","sample053","GGG","RBG",0,2,2
"6430","sample053","GGG","RBR",0,2,2
"6431","sample053","GGR","BBB",0,1,1
"6432","sample053","GRG","BBR",0,1,1
"6433","sample053","GRG","BGG",0,1,1
"6434","sample053","GRR","BRR",0,1,1
"6435","sample053","RBB","BRB",0,1,1
"6436","sample053","RBB","GRR",0,1,1
"6437","sample053","RBB","RGG",0,1,1
"6438","sample053","RBR","BBB",0,2,2
"6439","sample053","RGG","BBB",0,3,3
"6440","sample053","RGG","GGR",0,1,1
"6441","sample053","RGG","GRR",0,3,3
"6442","sample053","RRG","BBR",0,1,1
"6443","sample053","RRG","GGR",0,1,1
"6444","sample053","RRR","GRR",0,1,1
"6445","sample054","BBB","GGG",1,0,1
"6446","sample054","BBB","RRG",1,0,1
"6447","sample054","BBG","BBB",1,2,3
"6448","sample054","BBG","BRB",1,3,4
"6449","sample054","BBG","GBG",2,0,2
"6450","sample054","BBG","GGB",2,9,11
"6451","sample054","BBG","GGG",4,3,7
"6452","sample054","BBG","GRG",1,0,1
"6453","sample054","BBG","RRG",1,0,1
"6454","sample054","BGG","RBG",1,0,1
"6455","sample054","BGG","RRR",1,1,2
"6456","sample054","BRR","BGB",1,0,1
"6457","sample054","GBB","BBB",12,6,18
"6458","sample054","GBB","BRB",1,2,3
"6459","sample054","GBB","BRR",1,1,2
"6460","sample054","GBB","GGG",7,9,16
"6461","sample054","GBB","GGR",1,2,3
"6462","sample054","GBB","RBG",3,1,4
"6463","sample054","GBB","RBR",1,0,1
"6464","sample054","GBB","RGG",1,0,1
"6465","sample054","GBB","RGR",2,0,2
"6466","sample054","GBB","RRR",1,2,3
"6467","sample054","GBG","BRB",1,2,3
"6468","sample054","GBG","BRR",1,0,1
"6469","sample054","GBG","GGG",4,0,4
"6470","sample054","GBG","RBB",1,0,1
"6471","sample054","GBG","RGR",1,0,1
"6472","sample054","GBG","RRG",1,0,1
"6473","sample054","GGB","BBB",3,3,6
"6474","sample054","GGB","BBR",1,0,1
"6475","sample054","GGB","BRR",1,0,1
"6476","sample054","GGB","GBG",1,0,1
"6477","sample054","GGB","GGG",13,11,24
"6478","sample054","GGB","RGG",1,0,1
"6479","sample054","GGB","RRG",1,0,1
"6480","sample054","GGB","RRR",1,1,2
"6481","sample054","GGG","BBB",8,11,19
"6482","sample054","GGG","BGG",1,0,1
"6483","sample054","GGG","BRB",1,0,1
"6484","sample054","GGG","GGB",5,0,5
"6485","sample054","GGG","GGR",1,2,3
"6486","sample054","GGG","RBB",1,1,2
"6487","sample054","GGG","RGR",1,2,3
"6488","sample054","GGG","RRG",1,3,4
"6489","sample054","GGR","BRR",1,0,1
"6490","sample054","GGR","GRR",1,0,1
"6491","sample054","GRG","BBB",3,2,5
"6492","sample054","GRG","GGB",2,3,5
"6493","sample054","GRG","GGG",3,1,4
"6494","sample054","GRG","RGR",1,0,1
"6495","sample054","GRG","RRG",2,2,4
"6496","sample054","GRR","BGB",1,1,2
"6497","sample054","RBG","BBB",2,0,2
"6498","sample054","RBG","RBB",1,0,1
"6499","sample054","RBR","BGB",2,1,3
"6500","sample054","RBR","BRB",1,0,1
"6501","sample054","RBR","BRR",1,3,4
"6502","sample054","RBR","GRR",4,1,5
"6503","sample054","RBR","RGG",2,4,6
"6504","sample054","RBR","RGR",1,0,1
"6505","sample054","RGG","BBR",1,0,1
"6506","sample054","RGR","BBB",2,2,4
"6507","sample054","RGR","BBR",1,0,1
"6508","sample054","RGR","BGB",2,1,3
"6509","sample054","RGR","BGG",2,0,2
"6510","sample054","RGR","BRR",1,1,2
"6511","sample054","RGR","GGB",2,1,3
"6512","sample054","RGR","RGG",1,0,1
"6513","sample054","RRG","BBB",2,5,7
"6514","sample054","RRG","BGB",1,2,3
"6515","sample054","RRG","BRB",2,1,3
"6516","sample054","RRG","BRR",1,1,2
"6517","sample054","RRG","GGG",2,1,3
"6518","sample054","RRG","GRG",1,0,1
"6519","sample054","RRG","GRR",3,1,4
"6520","sample054","RRG","RBB",1,0,1
"6521","sample054","RRR","BBR",1,0,1
"6522","sample054","RRR","BGB",2,0,2
"6523","sample054","RRR","BGG",1,0,1
"6524","sample054","RRR","BRB",1,0,1
"6525","sample054","RRR","BRR",1,0,1
"6526","sample054","RRR","RBB",1,0,1
"6527","sample054","RRR","RGR",1,0,1
"6528","sample054","RRR","RRG",2,0,2
"6529","sample054","BBB","GRR",0,1,1
"6530","sample054","BBG","RBB",0,1,1
"6531","sample054","BBG","RBG",0,1,1
"6532","sample054","BBG","RBR",0,1,1
"6533","sample054","BBG","RRR",0,1,1
"6534","sample054","BRB","BBB",0,2,2
"6535","sample054","BRB","RRR",0,1,1
"6536","sample054","BRR","BGG",0,1,1
"6537","sample054","GBB","BGG",0,1,1
"6538","sample054","GBB","GBG",0,1,1
"6539","sample054","GBB","GGB",0,5,5
"6540","sample054","GBB","RRG",0,2,2
"6541","sample054","GBG","BBB",0,1,1
"6542","sample054","GBG","BBR",0,1,1
"6543","sample054","GBG","RBG",0,1,1
"6544","sample054","GGB","GGR",0,1,1
"6545","sample054","GGB","RBB",0,1,1
"6546","sample054","GGB","RBG",0,1,1
"6547","sample054","GGB","RBR",0,1,1
"6548","sample054","GGB","RGR",0,1,1
"6549","sample054","GGG","BRR",0,1,1
"6550","sample054","GGG","GRR",0,1,1
"6551","sample054","GGG","RBR",0,3,3
"6552","sample054","GRG","GGR",0,2,2
"6553","sample054","RBG","RGR",0,1,1
"6554","sample054","RBR","BBB",0,2,2
"6555","sample054","RBR","GGB",0,1,1
"6556","sample054","RGG","BBB",0,2,2
"6557","sample054","RGG","GGG",0,1,1
"6558","sample054","RGG","GGR",0,1,1
"6559","sample054","RGG","GRR",0,1,1
"6560","sample054","RGR","GGG",0,1,1
"6561","sample054","RGR","RBB",0,1,1
"6562","sample054","RRG","BBR",0,1,1
"6563","sample054","RRG","GGR",0,1,1
"6564","sample054","RRR","GRR",0,1,1
"6565","sample054","RRR","RBR",0,1,1
"6566","sample054","RRR","RGG",0,1,1
"6567","sample055","BBB","GGG",1,0,1
"6568","sample055","BBB","RRG",1,0,1
"6569","sample055","BBG","BBB",1,1,2
"6570","sample055","BBG","BRB",1,0,1
"6571","sample055","BBG","GBG",2,0,2
"6572","sample055","BBG","GGB",2,6,8
"6573","sample055","BBG","GGG",4,6,10
"6574","sample055","BBG","GRG",1,1,2
"6575","sample055","BBG","RRG",1,0,1
"6576","sample055","BGG","RBG",1,0,1
"6577","sample055","BGG","RRR",1,1,2
"6578","sample055","BRR","BGB",1,0,1
"6579","sample055","GBB","BBB",12,4,16
"6580","sample055","GBB","BRB",1,1,2
"6581","sample055","GBB","BRR",1,0,1
"6582","sample055","GBB","GGG",7,14,21
"6583","sample055","GBB","GGR",1,0,1
"6584","sample055","GBB","RBG",3,1,4
"6585","sample055","GBB","RBR",1,0,1
"6586","sample055","GBB","RGG",1,0,1
"6587","sample055","GBB","RGR",2,0,2
"6588","sample055","GBB","RRR",1,2,3
"6589","sample055","GBG","BRB",1,0,1
"6590","sample055","GBG","BRR",1,0,1
"6591","sample055","GBG","GGG",4,0,4
"6592","sample055","GBG","RBB",1,0,1
"6593","sample055","GBG","RGR",1,1,2
"6594","sample055","GBG","RRG",1,0,1
"6595","sample055","GGB","BBB",3,3,6
"6596","sample055","GGB","BBR",1,0,1
"6597","sample055","GGB","BRR",1,1,2
"6598","sample055","GGB","GBG",1,0,1
"6599","sample055","GGB","GGG",13,8,21
"6600","sample055","GGB","RGG",1,0,1
"6601","sample055","GGB","RRG",1,1,2
"6602","sample055","GGB","RRR",1,0,1
"6603","sample055","GGG","BBB",8,7,15
"6604","sample055","GGG","BGG",1,2,3
"6605","sample055","GGG","BRB",1,1,2
"6606","sample055","GGG","GGB",5,0,5
"6607","sample055","GGG","GGR",1,2,3
"6608","sample055","GGG","RBB",1,2,3
"6609","sample055","GGG","RGR",1,1,2
"6610","sample055","GGG","RRG",1,3,4
"6611","sample055","GGR","BRR",1,0,1
"6612","sample055","GGR","GRR",1,0,1
"6613","sample055","GRG","BBB",3,2,5
"6614","sample055","GRG","GGB",2,2,4
"6615","sample055","GRG","GGG",3,2,5
"6616","sample055","GRG","RGR",1,0,1
"6617","sample055","GRG","RRG",2,2,4
"6618","sample055","GRR","BGB",1,0,1
"6619","sample055","RBG","BBB",2,0,2
"6620","sample055","RBG","RBB",1,0,1
"6621","sample055","RBR","BGB",2,1,3
"6622","sample055","RBR","BRB",1,0,1
"6623","sample055","RBR","BRR",1,0,1
"6624","sample055","RBR","GRR",4,1,5
"6625","sample055","RBR","RGG",2,2,4
"6626","sample055","RBR","RGR",1,0,1
"6627","sample055","RGG","BBR",1,0,1
"6628","sample055","RGR","BBB",2,1,3
"6629","sample055","RGR","BBR",1,0,1
"6630","sample055","RGR","BGB",2,1,3
"6631","sample055","RGR","BGG",2,0,2
"6632","sample055","RGR","BRR",1,0,1
"6633","sample055","RGR","GGB",2,4,6
"6634","sample055","RGR","RGG",1,0,1
"6635","sample055","RRG","BBB",2,7,9
"6636","sample055","RRG","BGB",1,1,2
"6637","sample055","RRG","BRB",2,3,5
"6638","sample055","RRG","BRR",1,3,4
"6639","sample055","RRG","GGG",2,3,5
"6640","sample055","RRG","GRG",1,0,1
"6641","sample055","RRG","GRR",3,1,4
"6642","sample055","RRG","RBB",1,0,1
"6643","sample055","RRR","BBR",1,0,1
"6644","sample055","RRR","BGB",2,1,3
"6645","sample055","RRR","BGG",1,0,1
"6646","sample055","RRR","BRB",1,0,1
"6647","sample055","RRR","BRR",1,0,1
"6648","sample055","RRR","RBB",1,1,2
"6649","sample055","RRR","RGR",1,0,1
"6650","sample055","RRR","RRG",2,0,2
"6651","sample055","BBG","RRR",0,1,1
"6652","sample055","BGB","RRG",0,1,1
"6653","sample055","BGG","BBB",0,1,1
"6654","sample055","BGG","RGG",0,1,1
"6655","sample055","BRB","BBB",0,3,3
"6656","sample055","BRB","BBR",0,1,1
"6657","sample055","BRB","RGR",0,1,1
"6658","sample055","BRR","BBB",0,4,4
"6659","sample055","BRR","BRB",0,1,1
"6660","sample055","BRR","RBB",0,1,1
"6661","sample055","GBB","GBG",0,2,2
"6662","sample055","GBB","GRG",0,2,2
"6663","sample055","GBG","BBB",0,2,2
"6664","sample055","GBG","GGB",0,1,1
"6665","sample055","GGB","GGR",0,4,4
"6666","sample055","GGB","GRR",0,1,1
"6667","sample055","GGB","RBG",0,2,2
"6668","sample055","GGB","RBR",0,1,1
"6669","sample055","GGG","RBG",0,1,1
"6670","sample055","GGG","RBR",0,5,5
"6671","sample055","GGG","RGG",0,2,2
"6672","sample055","GGG","RRR",0,1,1
"6673","sample055","GRG","GGR",0,1,1
"6674","sample055","RBB","GRR",0,1,1
"6675","sample055","RBB","RGG",0,1,1
"6676","sample055","RBG","BRR",0,1,1
"6677","sample055","RBG","GRR",0,1,1
"6678","sample055","RBG","RBR",0,1,1
"6679","sample055","RBR","BBB",0,1,1
"6680","sample055","RBR","GGB",0,2,2
"6681","sample055","RGG","BBB",0,1,1
"6682","sample055","RGG","BRR",0,1,1
"6683","sample055","RGG","GRR",0,1,1
"6684","sample055","RGR","RRG",0,1,1
"6685","sample055","RRR","GRR",0,1,1
"6686","sample056","BBB","GGG",1,0,1
"6687","sample056","BBB","RRG",1,0,1
"6688","sample056","BBG","BBB",1,0,1
"6689","sample056","BBG","BRB",1,4,5
"6690","sample056","BBG","GBG",2,2,4
"6691","sample056","BBG","GGB",2,5,7
"6692","sample056","BBG","GGG",4,10,14
"6693","sample056","BBG","GRG",1,3,4
"6694","sample056","BBG","RRG",1,0,1
"6695","sample056","BGG","RBG",1,0,1
"6696","sample056","BGG","RRR",1,0,1
"6697","sample056","BRR","BGB",1,0,1
"6698","sample056","GBB","BBB",12,5,17
"6699","sample056","GBB","BRB",1,2,3
"6700","sample056","GBB","BRR",1,0,1
"6701","sample056","GBB","GGG",7,12,19
"6702","sample056","GBB","GGR",1,0,1
"6703","sample056","GBB","RBG",3,2,5
"6704","sample056","GBB","RBR",1,0,1
"6705","sample056","GBB","RGG",1,0,1
"6706","sample056","GBB","RGR",2,0,2
"6707","sample056","GBB","RRR",1,2,3
"6708","sample056","GBG","BRB",1,0,1
"6709","sample056","GBG","BRR",1,0,1
"6710","sample056","GBG","GGG",4,2,6
"6711","sample056","GBG","RBB",1,0,1
"6712","sample056","GBG","RGR",1,0,1
"6713","sample056","GBG","RRG",1,0,1
"6714","sample056","GGB","BBB",3,2,5
"6715","sample056","GGB","BBR",1,0,1
"6716","sample056","GGB","BRR",1,1,2
"6717","sample056","GGB","GBG",1,0,1
"6718","sample056","GGB","GGG",13,7,20
"6719","sample056","GGB","RGG",1,2,3
"6720","sample056","GGB","RRG",1,0,1
"6721","sample056","GGB","RRR",1,0,1
"6722","sample056","GGG","BBB",8,8,16
"6723","sample056","GGG","BGG",1,0,1
"6724","sample056","GGG","BRB",1,0,1
"6725","sample056","GGG","GGB",5,0,5
"6726","sample056","GGG","GGR",1,1,2
"6727","sample056","GGG","RBB",1,1,2
"6728","sample056","GGG","RGR",1,4,5
"6729","sample056","GGG","RRG",1,2,3
"6730","sample056","GGR","BRR",1,0,1
"6731","sample056","GGR","GRR",1,0,1
"6732","sample056","GRG","BBB",3,0,3
"6733","sample056","GRG","GGB",2,1,3
"6734","sample056","GRG","GGG",3,2,5
"6735","sample056","GRG","RGR",1,0,1
"6736","sample056","GRG","RRG",2,1,3
"6737","sample056","GRR","BGB",1,0,1
"6738","sample056","RBG","BBB",2,0,2
"6739","sample056","RBG","RBB",1,0,1
"6740","sample056","RBR","BGB",2,3,5
"6741","sample056","RBR","BRB",1,0,1
"6742","sample056","RBR","BRR",1,0,1
"6743","sample056","RBR","GRR",4,2,6
"6744","sample056","RBR","RGG",2,3,5
"6745","sample056","RBR","RGR",1,0,1
"6746","sample056","RGG","BBR",1,0,1
"6747","sample056","RGR","BBB",2,0,2
"6748","sample056","RGR","BBR",1,1,2
"6749","sample056","RGR","BGB",2,1,3
"6750","sample056","RGR","BGG",2,0,2
"6751","sample056","RGR","BRR",1,1,2
"6752","sample056","RGR","GGB",2,4,6
"6753","sample056","RGR","RGG",1,1,2
"6754","sample056","RRG","BBB",2,1,3
"6755","sample056","RRG","BGB",1,2,3
"6756","sample056","RRG","BRB",2,4,6
"6757","sample056","RRG","BRR",1,1,2
"6758","sample056","RRG","GGG",2,1,3
"6759","sample056","RRG","GRG",1,0,1
"6760","sample056","RRG","GRR",3,0,3
"6761","sample056","RRG","RBB",1,0,1
"6762","sample056","RRR","BBR",1,0,1
"6763","sample056","RRR","BGB",2,1,3
"6764","sample056","RRR","BGG",1,0,1
"6765","sample056","RRR","BRB",1,0,1
"6766","sample056","RRR","BRR",1,0,1
"6767","sample056","RRR","RBB",1,0,1
"6768","sample056","RRR","RGR",1,0,1
"6769","sample056","RRR","RRG",2,0,2
"6770","sample056","BBB","GRR",0,1,1
"6771","sample056","BBG","BGB",0,1,1
"6772","sample056","BBG","BGG",0,1,1
"6773","sample056","BBG","RBG",0,1,1
"6774","sample056","BBG","RGR",0,1,1
"6775","sample056","BBG","RRR",0,1,1
"6776","sample056","BGG","GRG",0,1,1
"6777","sample056","BRB","BBB",0,1,1
"6778","sample056","BRB","BBR",0,1,1
"6779","sample056","BRB","GGG",0,1,1
"6780","sample056","BRB","RBG",0,1,1
"6781","sample056","BRR","BBB",0,3,3
"6782","sample056","BRR","BRB",0,1,1
"6783","sample056","GBB","GGB",0,3,3
"6784","sample056","GBB","GRG",0,1,1
"6785","sample056","GBB","RRG",0,1,1
"6786","sample056","GBG","BBB",0,2,2
"6787","sample056","GGB","BGG",0,1,1
"6788","sample056","GGB","GGR",0,2,2
"6789","sample056","GGB","GRR",0,1,1
"6790","sample056","GGB","RBB",0,1,1
"6791","sample056","GGB","RBR",0,1,1
"6792","sample056","GGB","RGR",0,1,1
"6793","sample056","GGG","BGB",0,1,1
"6794","sample056","GGG","BRR",0,1,1
"6795","sample056","GGG","GRR",0,1,1
"6796","sample056","GGG","RBG",0,1,1
"6797","sample056","GGG","RBR",0,4,4
"6798","sample056","GGR","RBB",0,1,1
"6799","sample056","GRG","BBR",0,1,1
"6800","sample056","GRG","GGR",0,2,2
"6801","sample056","GRR","BRR",0,1,1
"6802","sample056","RBR","BBB",0,3,3
"6803","sample056","RBR","BGG",0,2,2
"6804","sample056","RBR","GGB",0,2,2
"6805","sample056","RGG","BBB",0,1,1
"6806","sample056","RGG","BRR",0,1,1
"6807","sample056","RGG","GRR",0,1,1
"6808","sample056","RRR","GRR",0,1,1
"6809","sample057","BBB","GGG",1,0,1
"6810","sample057","BBB","RRG",1,0,1
"6811","sample057","BBG","BBB",1,1,2
"6812","sample057","BBG","BRB",1,1,2
"6813","sample057","BBG","GBG",2,0,2
"6814","sample057","BBG","GGB",2,8,10
"6815","sample057","BBG","GGG",4,9,13
"6816","sample057","BBG","GRG",1,2,3
"6817","sample057","BBG","RRG",1,0,1
"6818","sample057","BGG","RBG",1,0,1
"6819","sample057","BGG","RRR",1,0,1
"6820","sample057","BRR","BGB",1,0,1
"6821","sample057","GBB","BBB",12,2,14
"6822","sample057","GBB","BRB",1,2,3
"6823","sample057","GBB","BRR",1,1,2
"6824","sample057","GBB","GGG",7,17,24
"6825","sample057","GBB","GGR",1,1,2
"6826","sample057","GBB","RBG",3,1,4
"6827","sample057","GBB","RBR",1,0,1
"6828","sample057","GBB","RGG",1,0,1
"6829","sample057","GBB","RGR",2,0,2
"6830","sample057","GBB","RRR",1,0,1
"6831","sample057","GBG","BRB",1,1,2
"6832","sample057","GBG","BRR",1,0,1
"6833","sample057","GBG","GGG",4,4,8
"6834","sample057","GBG","RBB",1,0,1
"6835","sample057","GBG","RGR",1,0,1
"6836","sample057","GBG","RRG",1,0,1
"6837","sample057","GGB","BBB",3,0,3
"6838","sample057","GGB","BBR",1,0,1
"6839","sample057","GGB","BRR",1,0,1
"6840","sample057","GGB","GBG",1,0,1
"6841","sample057","GGB","GGG",13,10,23
"6842","sample057","GGB","RGG",1,0,1
"6843","sample057","GGB","RRG",1,0,1
"6844","sample057","GGB","RRR",1,2,3
"6845","sample057","GGG","BBB",8,5,13
"6846","sample057","GGG","BGG",1,1,2
"6847","sample057","GGG","BRB",1,0,1
"6848","sample057","GGG","GGB",5,1,6
"6849","sample057","GGG","GGR",1,1,2
"6850","sample057","GGG","RBB",1,2,3
"6851","sample057","GGG","RGR",1,2,3
"6852","sample057","GGG","RRG",1,1,2
"6853","sample057","GGR","BRR",1,0,1
"6854","sample057","GGR","GRR",1,0,1
"6855","sample057","GRG","BBB",3,1,4
"6856","sample057","GRG","GGB",2,1,3
"6857","sample057","GRG","GGG",3,2,5
"6858","sample057","GRG","RGR",1,0,1
"6859","sample057","GRG","RRG",2,2,4
"6860","sample057","GRR","BGB",1,0,1
"6861","sample057","RBG","BBB",2,3,5
"6862","sample057","RBG","RBB",1,0,1
"6863","sample057","RBR","BGB",2,1,3
"6864","sample057","RBR","BRB",1,0,1
"6865","sample057","RBR","BRR",1,1,2
"6866","sample057","RBR","GRR",4,1,5
"6867","sample057","RBR","RGG",2,0,2
"6868","sample057","RBR","RGR",1,0,1
"6869","sample057","RGG","BBR",1,0,1
"6870","sample057","RGR","BBB",2,3,5
"6871","sample057","RGR","BBR",1,0,1
"6872","sample057","RGR","BGB",2,0,2
"6873","sample057","RGR","BGG",2,0,2
"6874","sample057","RGR","BRR",1,0,1
"6875","sample057","RGR","GGB",2,2,4
"6876","sample057","RGR","RGG",1,0,1
"6877","sample057","RRG","BBB",2,3,5
"6878","sample057","RRG","BGB",1,1,2
"6879","sample057","RRG","BRB",2,6,8
"6880","sample057","RRG","BRR",1,3,4
"6881","sample057","RRG","GGG",2,2,4
"6882","sample057","RRG","GRG",1,0,1
"6883","sample057","RRG","GRR",3,1,4
"6884","sample057","RRG","RBB",1,0,1
"6885","sample057","RRR","BBR",1,0,1
"6886","sample057","RRR","BGB",2,0,2
"6887","sample057","RRR","BGG",1,0,1
"6888","sample057","RRR","BRB",1,0,1
"6889","sample057","RRR","BRR",1,0,1
"6890","sample057","RRR","RBB",1,0,1
"6891","sample057","RRR","RGR",1,0,1
"6892","sample057","RRR","RRG",2,0,2
"6893","sample057","BBB","GRR",0,1,1
"6894","sample057","BBB","RRR",0,1,1
"6895","sample057","BBG","RBG",0,1,1
"6896","sample057","BBG","RRR",0,2,2
"6897","sample057","BGB","BBB",0,1,1
"6898","sample057","BGG","BBB",0,1,1
"6899","sample057","BRB","BBB",0,2,2
"6900","sample057","BRB","BRR",0,1,1
"6901","sample057","BRR","BBB",0,2,2
"6902","sample057","GBB","GGB",0,2,2
"6903","sample057","GBB","RRG",0,2,2
"6904","sample057","GBG","BBB",0,2,2
"6905","sample057","GBG","GGB",0,2,2
"6906","sample057","GGB","BGB",0,1,1
"6907","sample057","GGB","BRB",0,1,1
"6908","sample057","GGB","GGR",0,1,1
"6909","sample057","GGB","GRR",0,1,1
"6910","sample057","GGB","RBB",0,2,2
"6911","sample057","GGB","RBR",0,2,2
"6912","sample057","GGB","RGR",0,1,1
"6913","sample057","GGG","BRR",0,1,1
"6914","sample057","GGG","RBR",0,3,3
"6915","sample057","GRG","GGR",0,2,2
"6916","sample057","RBB","BBR",0,1,1
"6917","sample057","RBB","RGG",0,1,1
"6918","sample057","RBG","RBR",0,1,1
"6919","sample057","RBR","BBB",0,2,2
"6920","sample057","RBR","GGB",0,1,1
"6921","sample057","RBR","RRR",0,1,1
"6922","sample057","RGG","GRR",0,4,4
"6923","sample057","RGR","GGR",0,1,1
"6924","sample057","RGR","RBB",0,1,1
"6925","sample057","RRG","BBR",0,1,1
"6926","sample057","RRG","GGR",0,1,1
"6927","sample057","RRG","RGG",0,1,1
"6928","sample057","RRR","RGG",0,1,1
"6929","sample058","BBB","GGG",1,0,1
"6930","sample058","BBB","RRG",1,1,2
"6931","sample058","BBG","BBB",1,0,1
"6932","sample058","BBG","BRB",1,4,5
"6933","sample058","BBG","GBG",2,0,2
"6934","sample058","BBG","GGB",2,3,5
"6935","sample058","BBG","GGG",4,10,14
"6936","sample058","BBG","GRG",1,1,2
"6937","sample058","BBG","RRG",1,0,1
"6938","sample058","BGG","RBG",1,0,1
"6939","sample058","BGG","RRR",1,0,1
"6940","sample058","BRR","BGB",1,0,1
"6941","sample058","GBB","BBB",12,6,18
"6942","sample058","GBB","BRB",1,2,3
"6943","sample058","GBB","BRR",1,0,1
"6944","sample058","GBB","GGG",7,11,18
"6945","sample058","GBB","GGR",1,0,1
"6946","sample058","GBB","RBG",3,1,4
"6947","sample058","GBB","RBR",1,0,1
"6948","sample058","GBB","RGG",1,0,1
"6949","sample058","GBB","RGR",2,1,3
"6950","sample058","GBB","RRR",1,0,1
"6951","sample058","GBG","BRB",1,0,1
"6952","sample058","GBG","BRR",1,0,1
"6953","sample058","GBG","GGG",4,0,4
"6954","sample058","GBG","RBB",1,0,1
"6955","sample058","GBG","RGR",1,0,1
"6956","sample058","GBG","RRG",1,0,1
"6957","sample058","GGB","BBB",3,4,7
"6958","sample058","GGB","BBR",1,1,2
"6959","sample058","GGB","BRR",1,2,3
"6960","sample058","GGB","GBG",1,0,1
"6961","sample058","GGB","GGG",13,11,24
"6962","sample058","GGB","RGG",1,1,2
"6963","sample058","GGB","RRG",1,0,1
"6964","sample058","GGB","RRR",1,0,1
"6965","sample058","GGG","BBB",8,4,12
"6966","sample058","GGG","BGG",1,1,2
"6967","sample058","GGG","BRB",1,0,1
"6968","sample058","GGG","GGB",5,0,5
"6969","sample058","GGG","GGR",1,0,1
"6970","sample058","GGG","RBB",1,2,3
"6971","sample058","GGG","RGR",1,3,4
"6972","sample058","GGG","RRG",1,3,4
"6973","sample058","GGR","BRR",1,0,1
"6974","sample058","GGR","GRR",1,0,1
"6975","sample058","GRG","BBB",3,1,4
"6976","sample058","GRG","GGB",2,2,4
"6977","sample058","GRG","GGG",3,2,5
"6978","sample058","GRG","RGR",1,1,2
"6979","sample058","GRG","RRG",2,1,3
"6980","sample058","GRR","BGB",1,0,1
"6981","sample058","RBG","BBB",2,2,4
"6982","sample058","RBG","RBB",1,0,1
"6983","sample058","RBR","BGB",2,0,2
"6984","sample058","RBR","BRB",1,0,1
"6985","sample058","RBR","BRR",1,2,3
"6986","sample058","RBR","GRR",4,1,5
"6987","sample058","RBR","RGG",2,1,3
"6988","sample058","RBR","RGR",1,0,1
"6989","sample058","RGG","BBR",1,0,1
"6990","sample058","RGR","BBB",2,1,3
"6991","sample058","RGR","BBR",1,0,1
"6992","sample058","RGR","BGB",2,2,4
"6993","sample058","RGR","BGG",2,0,2
"6994","sample058","RGR","BRR",1,2,3
"6995","sample058","RGR","GGB",2,4,6
"6996","sample058","RGR","RGG",1,0,1
"6997","sample058","RRG","BBB",2,4,6
"6998","sample058","RRG","BGB",1,0,1
"6999","sample058","RRG","BRB",2,3,5
"7000","sample058","RRG","BRR",1,3,4
"7001","sample058","RRG","GGG",2,2,4
"7002","sample058","RRG","GRG",1,0,1
"7003","sample058","RRG","GRR",3,2,5
"7004","sample058","RRG","RBB",1,0,1
"7005","sample058","RRR","BBR",1,0,1
"7006","sample058","RRR","BGB",2,0,2
"7007","sample058","RRR","BGG",1,0,1
"7008","sample058","RRR","BRB",1,1,2
"7009","sample058","RRR","BRR",1,0,1
"7010","sample058","RRR","RBB",1,0,1
"7011","sample058","RRR","RGR",1,0,1
"7012","sample058","RRR","RRG",2,0,2
"7013","sample058","BBB","BRB",0,1,1
"7014","sample058","BBG","RBG",0,1,1
"7015","sample058","BBG","RBR",0,1,1
"7016","sample058","BBG","RGR",0,1,1
"7017","sample058","BBG","RRR",0,2,2
"7018","sample058","BRB","BBB",0,3,3
"7019","sample058","BRR","BRB",0,1,1
"7020","sample058","GBB","GBG",0,1,1
"7021","sample058","GBB","GGB",0,6,6
"7022","sample058","GBB","GRG",0,1,1
"7023","sample058","GGB","BGB",0,1,1
"7024","sample058","GGB","BGG",0,1,1
"7025","sample058","GGB","GGR",0,1,1
"7026","sample058","GGB","RBB",0,1,1
"7027","sample058","GGB","RBG",0,1,1
"7028","sample058","GGB","RBR",0,1,1
"7029","sample058","GGB","RGR",0,1,1
"7030","sample058","GGG","GRR",0,1,1
"7031","sample058","GGG","RBG",0,1,1
"7032","sample058","GGG","RBR",0,1,1
"7033","sample058","GGG","RRR",0,1,1
"7034","sample058","GGR","BGG",0,1,1
"7035","sample058","GGR","RBB",0,1,1
"7036","sample058","GRG","BGG",0,1,1
"7037","sample058","GRG","GGR",0,1,1
"7038","sample058","GRR","BRR",0,1,1
"7039","sample058","RBG","GRR",0,2,2
"7040","sample058","RBR","BBB",0,1,1
"7041","sample058","RBR","GGB",0,3,3
"7042","sample058","RBR","RBB",0,1,1
"7043","sample058","RGG","BRR",0,2,2
"7044","sample058","RGG","GRR",0,1,1
"7045","sample058","RGR","GGG",0,1,1
"7046","sample058","RGR","GGR",0,1,1
"7047","sample058","RGR","RRG",0,2,2
"7048","sample058","RRG","BGG",0,1,1
"7049","sample058","RRG","RGR",0,1,1
"7050","sample058","RRR","RBR",0,1,1
"7051","sample059","BBB","GGG",1,1,2
"7052","sample059","BBB","RRG",1,0,1
"7053","sample059","BBG","BBB",1,0,1
"7054","sample059","BBG","BRB",1,2,3
"7055","sample059","BBG","GBG",2,1,3
"7056","sample059","BBG","GGB",2,4,6
"7057","sample059","BBG","GGG",4,9,13
"7058","sample059","BBG","GRG",1,1,2
"7059","sample059","BBG","RRG",1,1,2
"7060","sample059","BGG","RBG",1,0,1
"7061","sample059","BGG","RRR",1,1,2
"7062","sample059","BRR","BGB",1,0,1
"7063","sample059","GBB","BBB",12,6,18
"7064","sample059","GBB","BRB",1,2,3
"7065","sample059","GBB","BRR",1,0,1
"7066","sample059","GBB","GGG",7,12,19
"7067","sample059","GBB","GGR",1,1,2
"7068","sample059","GBB","RBG",3,0,3
"7069","sample059","GBB","RBR",1,0,1
"7070","sample059","GBB","RGG",1,0,1
"7071","sample059","GBB","RGR",2,0,2
"7072","sample059","GBB","RRR",1,2,3
"7073","sample059","GBG","BRB",1,0,1
"7074","sample059","GBG","BRR",1,0,1
"7075","sample059","GBG","GGG",4,1,5
"7076","sample059","GBG","RBB",1,0,1
"7077","sample059","GBG","RGR",1,1,2
"7078","sample059","GBG","RRG",1,1,2
"7079","sample059","GGB","BBB",3,2,5
"7080","sample059","GGB","BBR",1,0,1
"7081","sample059","GGB","BRR",1,3,4
"7082","sample059","GGB","GBG",1,0,1
"7083","sample059","GGB","GGG",13,4,17
"7084","sample059","GGB","RGG",1,1,2
"7085","sample059","GGB","RRG",1,1,2
"7086","sample059","GGB","RRR",1,1,2
"7087","sample059","GGG","BBB",8,3,11
"7088","sample059","GGG","BGG",1,0,1
"7089","sample059","GGG","BRB",1,0,1
"7090","sample059","GGG","GGB",5,0,5
"7091","sample059","GGG","GGR",1,2,3
"7092","sample059","GGG","RBB",1,4,5
"7093","sample059","GGG","RGR",1,1,2
"7094","sample059","GGG","RRG",1,5,6
"7095","sample059","GGR","BRR",1,0,1
"7096","sample059","GGR","GRR",1,0,1
"7097","sample059","GRG","BBB",3,0,3
"7098","sample059","GRG","GGB",2,3,5
"7099","sample059","GRG","GGG",3,4,7
"7100","sample059","GRG","RGR",1,0,1
"7101","sample059","GRG","RRG",2,1,3
"7102","sample059","GRR","BGB",1,1,2
"7103","sample059","RBG","BBB",2,3,5
"7104","sample059","RBG","RBB",1,0,1
"7105","sample059","RBR","BGB",2,1,3
"7106","sample059","RBR","BRB",1,0,1
"7107","sample059","RBR","BRR",1,3,4
"7108","sample059","RBR","GRR",4,0,4
"7109","sample059","RBR","RGG",2,4,6
"7110","sample059","RBR","RGR",1,0,1
"7111","sample059","RGG","BBR",1,0,1
"7112","sample059","RGR","BBB",2,0,2
"7113","sample059","RGR","BBR",1,0,1
"7114","sample059","RGR","BGB",2,1,3
"7115","sample059","RGR","BGG",2,0,2
"7116","sample059","RGR","BRR",1,0,1
"7117","sample059","RGR","GGB",2,0,2
"7118","sample059","RGR","RGG",1,0,1
"7119","sample059","RRG","BBB",2,6,8
"7120","sample059","RRG","BGB",1,0,1
"7121","sample059","RRG","BRB",2,2,4
"7122","sample059","RRG","BRR",1,4,5
"7123","sample059","RRG","GGG",2,1,3
"7124","sample059","RRG","GRG",1,0,1
"7125","sample059","RRG","GRR",3,2,5
"7126","sample059","RRG","RBB",1,1,2
"7127","sample059","RRR","BBR",1,0,1
"7128","sample059","RRR","BGB",2,0,2
"7129","sample059","RRR","BGG",1,0,1
"7130","sample059","RRR","BRB",1,0,1
"7131","sample059","RRR","BRR",1,0,1
"7132","sample059","RRR","RBB",1,1,2
"7133","sample059","RRR","RGR",1,0,1
"7134","sample059","RRR","RRG",2,0,2
"7135","sample059","BBB","BRB",0,1,1
"7136","sample059","BBB","GRR",0,1,1
"7137","sample059","BBG","GRR",0,1,1
"7138","sample059","BBG","RBG",0,1,1
"7139","sample059","BBG","RGR",0,1,1
"7140","sample059","BBG","RRR",0,1,1
"7141","sample059","BGG","BBB",0,2,2
"7142","sample059","BGG","RGG",0,2,2
"7143","sample059","BRB","BBB",0,2,2
"7144","sample059","BRB","BRR",0,1,1
"7145","sample059","BRB","GGG",0,1,1
"7146","sample059","BRR","BBB",0,2,2
"7147","sample059","GBB","BGG",0,1,1
"7148","sample059","GBB","GBG",0,1,1
"7149","sample059","GBB","GGB",0,1,1
"7150","sample059","GBG","RGG",0,1,1
"7151","sample059","GGB","GGR",0,3,3
"7152","sample059","GGG","BRR",0,2,2
"7153","sample059","GGG","RBG",0,1,1
"7154","sample059","GGG","RBR",0,3,3
"7155","sample059","GGG","RGG",0,1,1
"7156","sample059","GGR","BBR",0,1,1
"7157","sample059","GGR","RBB",0,1,1
"7158","sample059","GRG","RBR",0,1,1
"7159","sample059","GRR","BBR",0,1,1
"7160","sample059","RBB","BBR",0,1,1
"7161","sample059","RBR","BBB",0,2,2
"7162","sample059","RBR","GGB",0,2,2
"7163","sample059","RBR","RBB",0,1,1
"7164","sample059","RGG","BGB",0,1,1
"7165","sample059","RGG","BRR",0,1,1
"7166","sample059","RGG","GRR",0,2,2
"7167","sample059","RGR","GGG",0,1,1
"7168","sample059","RGR","RBB",0,1,1
"7169","sample059","RRG","BBR",0,1,1
"7170","sample059","RRG","GGR",0,2,2
"7171","sample060","BBB","GGG",1,1,2
"7172","sample060","BBB","RRG",1,0,1
"7173","sample060","BBG","BBB",1,1,2
"7174","sample060","BBG","BRB",1,3,4
"7175","sample060","BBG","GBG",2,0,2
"7176","sample060","BBG","GGB",2,3,5
"7177","sample060","BBG","GGG",4,7,11
"7178","sample060","BBG","GRG",1,2,3
"7179","sample060","BBG","RRG",1,0,1
"7180","sample060","BGG","RBG",1,0,1
"7181","sample060","BGG","RRR",1,0,1
"7182","sample060","BRR","BGB",1,0,1
"7183","sample060","GBB","BBB",12,4,16
"7184","sample060","GBB","BRB",1,2,3
"7185","sample060","GBB","BRR",1,0,1
"7186","sample060","GBB","GGG",7,15,22
"7187","sample060","GBB","GGR",1,0,1
"7188","sample060","GBB","RBG",3,0,3
"7189","sample060","GBB","RBR",1,0,1
"7190","sample060","GBB","RGG",1,0,1
"7191","sample060","GBB","RGR",2,0,2
"7192","sample060","GBB","RRR",1,2,3
"7193","sample060","GBG","BRB",1,2,3
"7194","sample060","GBG","BRR",1,0,1
"7195","sample060","GBG","GGG",4,0,4
"7196","sample060","GBG","RBB",1,0,1
"7197","sample060","GBG","RGR",1,1,2
"7198","sample060","GBG","RRG",1,0,1
"7199","sample060","GGB","BBB",3,4,7
"7200","sample060","GGB","BBR",1,0,1
"7201","sample060","GGB","BRR",1,2,3
"7202","sample060","GGB","GBG",1,0,1
"7203","sample060","GGB","GGG",13,3,16
"7204","sample060","GGB","RGG",1,1,2
"7205","sample060","GGB","RRG",1,0,1
"7206","sample060","GGB","RRR",1,0,1
"7207","sample060","GGG","BBB",8,8,16
"7208","sample060","GGG","BGG",1,1,2
"7209","sample060","GGG","BRB",1,1,2
"7210","sample060","GGG","GGB",5,0,5
"7211","sample060","GGG","GGR",1,2,3
"7212","sample060","GGG","RBB",1,1,2
"7213","sample060","GGG","RGR",1,4,5
"7214","sample060","GGG","RRG",1,5,6
"7215","sample060","GGR","BRR",1,0,1
"7216","sample060","GGR","GRR",1,0,1
"7217","sample060","GRG","BBB",3,3,6
"7218","sample060","GRG","GGB",2,3,5
"7219","sample060","GRG","GGG",3,1,4
"7220","sample060","GRG","RGR",1,0,1
"7221","sample060","GRG","RRG",2,1,3
"7222","sample060","GRR","BGB",1,0,1
"7223","sample060","RBG","BBB",2,0,2
"7224","sample060","RBG","RBB",1,0,1
"7225","sample060","RBR","BGB",2,1,3
"7226","sample060","RBR","BRB",1,0,1
"7227","sample060","RBR","BRR",1,1,2
"7228","sample060","RBR","GRR",4,1,5
"7229","sample060","RBR","RGG",2,2,4
"7230","sample060","RBR","RGR",1,0,1
"7231","sample060","RGG","BBR",1,0,1
"7232","sample060","RGR","BBB",2,0,2
"7233","sample060","RGR","BBR",1,0,1
"7234","sample060","RGR","BGB",2,0,2
"7235","sample060","RGR","BGG",2,0,2
"7236","sample060","RGR","BRR",1,2,3
"7237","sample060","RGR","GGB",2,2,4
"7238","sample060","RGR","RGG",1,0,1
"7239","sample060","RRG","BBB",2,5,7
"7240","sample060","RRG","BGB",1,5,6
"7241","sample060","RRG","BRB",2,7,9
"7242","sample060","RRG","BRR",1,0,1
"7243","sample060","RRG","GGG",2,2,4
"7244","sample060","RRG","GRG",1,0,1
"7245","sample060","RRG","GRR",3,1,4
"7246","sample060","RRG","RBB",1,0,1
"7247","sample060","RRR","BBR",1,0,1
"7248","sample060","RRR","BGB",2,0,2
"7249","sample060","RRR","BGG",1,0,1
"7250","sample060","RRR","BRB",1,0,1
"7251","sample060","RRR","BRR",1,0,1
"7252","sample060","RRR","RBB",1,0,1
"7253","sample060","RRR","RGR",1,0,1
"7254","sample060","RRR","RRG",2,0,2
"7255","sample060","BBB","RRR",0,1,1
"7256","sample060","BBG","BGB",0,1,1
"7257","sample060","BRB","BBB",0,4,4
"7258","sample060","BRB","BRR",0,1,1
"7259","sample060","BRB","GGG",0,1,1
"7260","sample060","BRB","RGR",0,1,1
"7261","sample060","BRR","BBB",0,1,1
"7262","sample060","BRR","BGG",0,1,1
"7263","sample060","GBB","GBG",0,1,1
"7264","sample060","GBB","GGB",0,3,3
"7265","sample060","GGB","BGG",0,1,1
"7266","sample060","GGB","GRR",0,1,1
"7267","sample060","GGB","RBB",0,1,1
"7268","sample060","GGG","BRR",0,2,2
"7269","sample060","GGG","RBR",0,2,2
"7270","sample060","GGG","RRR",0,1,1
"7271","sample060","GGR","BBR",0,1,1
"7272","sample060","GRG","BRB",0,1,1
"7273","sample060","GRG","GGR",0,1,1
"7274","sample060","RBG","BRR",0,1,1
"7275","sample060","RBG","RBR",0,1,1
"7276","sample060","RBR","BBB",0,3,3
"7277","sample060","RBR","GGB",0,1,1
"7278","sample060","RBR","RBB",0,1,1
"7279","sample060","RGG","BBB",0,2,2
"7280","sample060","RGG","BRR",0,1,1
"7281","sample060","RGG","GRR",0,3,3
"7282","sample060","RGR","GGG",0,1,1
"7283","sample060","RGR","GGR",0,1,1
"7284","sample060","RRG","BBR",0,3,3
"7285","sample060","RRG","GGR",0,2,2
"7286","sample060","RRR","GGR",0,1,1
"7287","sample060","RRR","RBR",0,1,1
"7288","sample061","BBB","GGG",1,0,1
"7289","sample061","BBB","RRG",1,1,2
"7290","sample061","BBG","BBB",1,2,3
"7291","sample061","BBG","BRB",1,5,6
"7292","sample061","BBG","GBG",2,1,3
"7293","sample061","BBG","GGB",2,5,7
"7294","sample061","BBG","GGG",4,5,9
"7295","sample061","BBG","GRG",1,0,1
"7296","sample061","BBG","RRG",1,1,2
"7297","sample061","BGG","RBG",1,1,2
"7298","sample061","BGG","RRR",1,1,2
"7299","sample061","BRR","BGB",1,0,1
"7300","sample061","GBB","BBB",12,3,15
"7301","sample061","GBB","BRB",1,2,3
"7302","sample061","GBB","BRR",1,1,2
"7303","sample061","GBB","GGG",7,9,16
"7304","sample061","GBB","GGR",1,1,2
"7305","sample061","GBB","RBG",3,1,4
"7306","sample061","GBB","RBR",1,0,1
"7307","sample061","GBB","RGG",1,0,1
"7308","sample061","GBB","RGR",2,0,2
"7309","sample061","GBB","RRR",1,3,4
"7310","sample061","GBG","BRB",1,0,1
"7311","sample061","GBG","BRR",1,0,1
"7312","sample061","GBG","GGG",4,2,6
"7313","sample061","GBG","RBB",1,0,1
"7314","sample061","GBG","RGR",1,0,1
"7315","sample061","GBG","RRG",1,0,1
"7316","sample061","GGB","BBB",3,1,4
"7317","sample061","GGB","BBR",1,0,1
"7318","sample061","GGB","BRR",1,2,3
"7319","sample061","GGB","GBG",1,0,1
"7320","sample061","GGB","GGG",13,11,24
"7321","sample061","GGB","RGG",1,2,3
"7322","sample061","GGB","RRG",1,0,1
"7323","sample061","GGB","RRR",1,0,1
"7324","sample061","GGG","BBB",8,7,15
"7325","sample061","GGG","BGG",1,0,1
"7326","sample061","GGG","BRB",1,0,1
"7327","sample061","GGG","GGB",5,0,5
"7328","sample061","GGG","GGR",1,3,4
"7329","sample061","GGG","RBB",1,1,2
"7330","sample061","GGG","RGR",1,1,2
"7331","sample061","GGG","RRG",1,1,2
"7332","sample061","GGR","BRR",1,0,1
"7333","sample061","GGR","GRR",1,0,1
"7334","sample061","GRG","BBB",3,3,6
"7335","sample061","GRG","GGB",2,3,5
"7336","sample061","GRG","GGG",3,1,4
"7337","sample061","GRG","RGR",1,1,2
"7338","sample061","GRG","RRG",2,1,3
"7339","sample061","GRR","BGB",1,1,2
"7340","sample061","RBG","BBB",2,1,3
"7341","sample061","RBG","RBB",1,0,1
"7342","sample061","RBR","BGB",2,2,4
"7343","sample061","RBR","BRB",1,0,1
"7344","sample061","RBR","BRR",1,0,1
"7345","sample061","RBR","GRR",4,0,4
"7346","sample061","RBR","RGG",2,1,3
"7347","sample061","RBR","RGR",1,0,1
"7348","sample061","RGG","BBR",1,1,2
"7349","sample061","RGR","BBB",2,1,3
"7350","sample061","RGR","BBR",1,0,1
"7351","sample061","RGR","BGB",2,0,2
"7352","sample061","RGR","BGG",2,0,2
"7353","sample061","RGR","BRR",1,0,1
"7354","sample061","RGR","GGB",2,1,3
"7355","sample061","RGR","RGG",1,0,1
"7356","sample061","RRG","BBB",2,7,9
"7357","sample061","RRG","BGB",1,2,3
"7358","sample061","RRG","BRB",2,6,8
"7359","sample061","RRG","BRR",1,4,5
"7360","sample061","RRG","GGG",2,3,5
"7361","sample061","RRG","GRG",1,0,1
"7362","sample061","RRG","GRR",3,2,5
"7363","sample061","RRG","RBB",1,0,1
"7364","sample061","RRR","BBR",1,0,1
"7365","sample061","RRR","BGB",2,0,2
"7366","sample061","RRR","BGG",1,0,1
"7367","sample061","RRR","BRB",1,0,1
"7368","sample061","RRR","BRR",1,0,1
"7369","sample061","RRR","RBB",1,1,2
"7370","sample061","RRR","RGR",1,0,1
"7371","sample061","RRR","RRG",2,1,3
"7372","sample061","BBB","RBG",0,1,1
"7373","sample061","BBG","RBB",0,1,1
"7374","sample061","GBB","GGB",0,5,5
"7375","sample061","GBB","GRG",0,1,1
"7376","sample061","GBG","BBB",0,1,1
"7377","sample061","GBG","RBG",0,1,1
"7378","sample061","GGB","BGG",0,1,1
"7379","sample061","GGB","GGR",0,2,2
"7380","sample061","GGB","RBB",0,1,1
"7381","sample061","GGB","RBG",0,2,2
"7382","sample061","GGB","RBR",0,2,2
"7383","sample061","GGG","BGB",0,1,1
"7384","sample061","GGG","RBG",0,1,1
"7385","sample061","GGG","RBR",0,1,1
"7386","sample061","GGR","BGG",0,1,1
"7387","sample061","GRG","GGR",0,2,2
"7388","sample061","GRG","GRR",0,1,1
"7389","sample061","GRG","RBR",0,1,1
"7390","sample061","GRR","BGG",0,1,1
"7391","sample061","GRR","BRB",0,1,1
"7392","sample061","GRR","GGG",0,1,1
"7393","sample061","RBG","RGR",0,1,1
"7394","sample061","RBR","BBB",0,1,1
"7395","sample061","RBR","GGB",0,1,1
"7396","sample061","RBR","RRR",0,1,1
"7397","sample061","RGG","BGB",0,1,1
"7398","sample061","RGG","GGR",0,1,1
"7399","sample061","RGG","GRR",0,3,3
"7400","sample061","RGR","GGG",0,1,1
"7401","sample061","RGR","RBB",0,1,1
"7402","sample061","RRG","BBR",0,1,1
"7403","sample061","RRG","GGR",0,2,2
"7404","sample061","RRG","RGG",0,1,1
"7405","sample062","BBB","GGG",1,0,1
"7406","sample062","BBB","RRG",1,0,1
"7407","sample062","BBG","BBB",1,1,2
"7408","sample062","BBG","BRB",1,3,4
"7409","sample062","BBG","GBG",2,3,5
"7410","sample062","BBG","GGB",2,2,4
"7411","sample062","BBG","GGG",4,10,14
"7412","sample062","BBG","GRG",1,1,2
"7413","sample062","BBG","RRG",1,0,1
"7414","sample062","BGG","RBG",1,0,1
"7415","sample062","BGG","RRR",1,0,1
"7416","sample062","BRR","BGB",1,0,1
"7417","sample062","GBB","BBB",12,7,19
"7418","sample062","GBB","BRB",1,0,1
"7419","sample062","GBB","BRR",1,1,2
"7420","sample062","GBB","GGG",7,12,19
"7421","sample062","GBB","GGR",1,2,3
"7422","sample062","GBB","RBG",3,4,7
"7423","sample062","GBB","RBR",1,0,1
"7424","sample062","GBB","RGG",1,0,1
"7425","sample062","GBB","RGR",2,0,2
"7426","sample062","GBB","RRR",1,2,3
"7427","sample062","GBG","BRB",1,0,1
"7428","sample062","GBG","BRR",1,0,1
"7429","sample062","GBG","GGG",4,2,6
"7430","sample062","GBG","RBB",1,0,1
"7431","sample062","GBG","RGR",1,0,1
"7432","sample062","GBG","RRG",1,0,1
"7433","sample062","GGB","BBB",3,4,7
"7434","sample062","GGB","BBR",1,1,2
"7435","sample062","GGB","BRR",1,2,3
"7436","sample062","GGB","GBG",1,0,1
"7437","sample062","GGB","GGG",13,7,20
"7438","sample062","GGB","RGG",1,2,3
"7439","sample062","GGB","RRG",1,1,2
"7440","sample062","GGB","RRR",1,0,1
"7441","sample062","GGG","BBB",8,2,10
"7442","sample062","GGG","BGG",1,0,1
"7443","sample062","GGG","BRB",1,1,2
"7444","sample062","GGG","GGB",5,0,5
"7445","sample062","GGG","GGR",1,3,4
"7446","sample062","GGG","RBB",1,0,1
"7447","sample062","GGG","RGR",1,5,6
"7448","sample062","GGG","RRG",1,2,3
"7449","sample062","GGR","BRR",1,0,1
"7450","sample062","GGR","GRR",1,0,1
"7451","sample062","GRG","BBB",3,2,5
"7452","sample062","GRG","GGB",2,0,2
"7453","sample062","GRG","GGG",3,1,4
"7454","sample062","GRG","RGR",1,0,1
"7455","sample062","GRG","RRG",2,0,2
"7456","sample062","GRR","BGB",1,0,1
"7457","sample062","RBG","BBB",2,1,3
"7458","sample062","RBG","RBB",1,0,1
"7459","sample062","RBR","BGB",2,1,3
"7460","sample062","RBR","BRB",1,0,1
"7461","sample062","RBR","BRR",1,2,3
"7462","sample062","RBR","GRR",4,2,6
"7463","sample062","RBR","RGG",2,0,2
"7464","sample062","RBR","RGR",1,0,1
"7465","sample062","RGG","BBR",1,0,1
"7466","sample062","RGR","BBB",2,0,2
"7467","sample062","RGR","BBR",1,0,1
"7468","sample062","RGR","BGB",2,1,3
"7469","sample062","RGR","BGG",2,0,2
"7470","sample062","RGR","BRR",1,1,2
"7471","sample062","RGR","GGB",2,2,4
"7472","sample062","RGR","RGG",1,1,2
"7473","sample062","RRG","BBB",2,7,9
"7474","sample062","RRG","BGB",1,0,1
"7475","sample062","RRG","BRB",2,3,5
"7476","sample062","RRG","BRR",1,2,3
"7477","sample062","RRG","GGG",2,3,5
"7478","sample062","RRG","GRG",1,0,1
"7479","sample062","RRG","GRR",3,2,5
"7480","sample062","RRG","RBB",1,0,1
"7481","sample062","RRR","BBR",1,0,1
"7482","sample062","RRR","BGB",2,0,2
"7483","sample062","RRR","BGG",1,0,1
"7484","sample062","RRR","BRB",1,0,1
"7485","sample062","RRR","BRR",1,1,2
"7486","sample062","RRR","RBB",1,1,2
"7487","sample062","RRR","RGR",1,1,2
"7488","sample062","RRR","RRG",2,0,2
"7489","sample062","BBB","RRR",0,1,1
"7490","sample062","BBG","RRR",0,2,2
"7491","sample062","BGB","RRG",0,1,1
"7492","sample062","BGG","BBB",0,1,1
"7493","sample062","BGG","RGR",0,1,1
"7494","sample062","BRB","BBB",0,2,2
"7495","sample062","BRR","BBB",0,1,1
"7496","sample062","GBB","GGB",0,4,4
"7497","sample062","GBG","BBB",0,1,1
"7498","sample062","GBG","BBR",0,1,1
"7499","sample062","GBG","GGB",0,1,1
"7500","sample062","GBG","RGG",0,1,1
"7501","sample062","GGB","BGB",0,1,1
"7502","sample062","GGB","BRB",0,1,1
"7503","sample062","GGB","GBB",0,1,1
"7504","sample062","GGB","GGR",0,1,1
"7505","sample062","GGB","RBB",0,1,1
"7506","sample062","GGB","RBR",0,1,1
"7507","sample062","GGG","BGB",0,1,1
"7508","sample062","GGG","BRR",0,1,1
"7509","sample062","GGG","RBG",0,1,1
"7510","sample062","GGG","RBR",0,1,1
"7511","sample062","GGG","RRR",0,1,1
"7512","sample062","GGR","BBB",0,2,2
"7513","sample062","GRG","BRB",0,1,1
"7514","sample062","GRR","GGR",0,1,1
"7515","sample062","RBG","BBG",0,1,1
"7516","sample062","RBG","BRR",0,1,1
"7517","sample062","RBG","GRR",0,1,1
"7518","sample062","RBG","RGR",0,1,1
"7519","sample062","RBR","BBB",0,3,3
"7520","sample062","RBR","GGB",0,1,1
"7521","sample062","RGG","BBB",0,1,1
"7522","sample062","RGG","GGR",0,1,1
"7523","sample062","RGR","GGG",0,1,1
"7524","sample062","RRG","GGR",0,1,1
"7525","sample062","RRR","GGR",0,1,1
"7526","sample062","RRR","GRR",0,1,1
"7527","sample063","BBB","GGG",1,1,2
"7528","sample063","BBB","RRG",1,0,1
"7529","sample063","BBG","BBB",1,0,1
"7530","sample063","BBG","BRB",1,2,3
"7531","sample063","BBG","GBG",2,3,5
"7532","sample063","BBG","GGB",2,3,5
"7533","sample063","BBG","GGG",4,5,9
"7534","sample063","BBG","GRG",1,2,3
"7535","sample063","BBG","RRG",1,0,1
"7536","sample063","BGG","RBG",1,0,1
"7537","sample063","BGG","RRR",1,0,1
"7538","sample063","BRR","BGB",1,1,2
"7539","sample063","GBB","BBB",12,5,17
"7540","sample063","GBB","BRB",1,0,1
"7541","sample063","GBB","BRR",1,2,3
"7542","sample063","GBB","GGG",7,10,17
"7543","sample063","GBB","GGR",1,0,1
"7544","sample063","GBB","RBG",3,1,4
"7545","sample063","GBB","RBR",1,0,1
"7546","sample063","GBB","RGG",1,0,1
"7547","sample063","GBB","RGR",2,0,2
"7548","sample063","GBB","RRR",1,0,1
"7549","sample063","GBG","BRB",1,0,1
"7550","sample063","GBG","BRR",1,0,1
"7551","sample063","GBG","GGG",4,1,5
"7552","sample063","GBG","RBB",1,0,1
"7553","sample063","GBG","RGR",1,0,1
"7554","sample063","GBG","RRG",1,0,1
"7555","sample063","GGB","BBB",3,2,5
"7556","sample063","GGB","BBR",1,1,2
"7557","sample063","GGB","BRR",1,1,2
"7558","sample063","GGB","GBG",1,0,1
"7559","sample063","GGB","GGG",13,11,24
"7560","sample063","GGB","RGG",1,1,2
"7561","sample063","GGB","RRG",1,2,3
"7562","sample063","GGB","RRR",1,3,4
"7563","sample063","GGG","BBB",8,5,13
"7564","sample063","GGG","BGG",1,2,3
"7565","sample063","GGG","BRB",1,0,1
"7566","sample063","GGG","GGB",5,0,5
"7567","sample063","GGG","GGR",1,2,3
"7568","sample063","GGG","RBB",1,0,1
"7569","sample063","GGG","RGR",1,2,3
"7570","sample063","GGG","RRG",1,2,3
"7571","sample063","GGR","BRR",1,0,1
"7572","sample063","GGR","GRR",1,0,1
"7573","sample063","GRG","BBB",3,0,3
"7574","sample063","GRG","GGB",2,5,7
"7575","sample063","GRG","GGG",3,2,5
"7576","sample063","GRG","RGR",1,0,1
"7577","sample063","GRG","RRG",2,1,3
"7578","sample063","GRR","BGB",1,0,1
"7579","sample063","RBG","BBB",2,0,2
"7580","sample063","RBG","RBB",1,0,1
"7581","sample063","RBR","BGB",2,0,2
"7582","sample063","RBR","BRB",1,0,1
"7583","sample063","RBR","BRR",1,0,1
"7584","sample063","RBR","GRR",4,0,4
"7585","sample063","RBR","RGG",2,0,2
"7586","sample063","RBR","RGR",1,0,1
"7587","sample063","RGG","BBR",1,0,1
"7588","sample063","RGR","BBB",2,3,5
"7589","sample063","RGR","BBR",1,0,1
"7590","sample063","RGR","BGB",2,1,3
"7591","sample063","RGR","BGG",2,0,2
"7592","sample063","RGR","BRR",1,1,2
"7593","sample063","RGR","GGB",2,1,3
"7594","sample063","RGR","RGG",1,0,1
"7595","sample063","RRG","BBB",2,6,8
"7596","sample063","RRG","BGB",1,2,3
"7597","sample063","RRG","BRB",2,7,9
"7598","sample063","RRG","BRR",1,1,2
"7599","sample063","RRG","GGG",2,2,4
"7600","sample063","RRG","GRG",1,0,1
"7601","sample063","RRG","GRR",3,0,3
"7602","sample063","RRG","RBB",1,1,2
"7603","sample063","RRR","BBR",1,0,1
"7604","sample063","RRR","BGB",2,0,2
"7605","sample063","RRR","BGG",1,0,1
"7606","sample063","RRR","BRB",1,0,1
"7607","sample063","RRR","BRR",1,0,1
"7608","sample063","RRR","RBB",1,1,2
"7609","sample063","RRR","RGR",1,1,2
"7610","sample063","RRR","RRG",2,0,2
"7611","sample063","BBG","RBG",0,1,1
"7612","sample063","BBG","RRR",0,1,1
"7613","sample063","BGG","BBB",0,1,1
"7614","sample063","BGG","BBR",0,1,1
"7615","sample063","BGG","RGG",0,1,1
"7616","sample063","BRB","BBB",0,3,3
"7617","sample063","BRB","BBR",0,1,1
"7618","sample063","BRB","BRR",0,1,1
"7619","sample063","BRB","GGR",0,1,1
"7620","sample063","BRR","BBB",0,1,1
"7621","sample063","GBB","GBG",0,1,1
"7622","sample063","GBB","GGB",0,5,5
"7623","sample063","GBB","GRG",0,1,1
"7624","sample063","GBG","BBB",0,1,1
"7625","sample063","GGB","BGB",0,2,2
"7626","sample063","GGB","GRR",0,2,2
"7627","sample063","GGB","RBB",0,1,1
"7628","sample063","GGB","RBG",0,2,2
"7629","sample063","GGB","RBR",0,2,2
"7630","sample063","GGG","BRR",0,2,2
"7631","sample063","GGG","RBR",0,2,2
"7632","sample063","GGG","RGG",0,1,1
"7633","sample063","GGR","BGG",0,1,1
"7634","sample063","GGR","RBB",0,1,1
"7635","sample063","GRG","BGG",0,1,1
"7636","sample063","GRG","GGR",0,1,1
"7637","sample063","GRG","RBG",0,1,1
"7638","sample063","RBB","BBB",0,1,1
"7639","sample063","RBB","GRR",0,1,1
"7640","sample063","RBR","BBB",0,1,1
"7641","sample063","RBR","BGG",0,1,1
"7642","sample063","RBR","GGB",0,1,1
"7643","sample063","RBR","RBB",0,1,1
"7644","sample063","RBR","RRR",0,1,1
"7645","sample063","RGG","BRR",0,1,1
"7646","sample063","RGG","GGG",0,1,1
"7647","sample063","RGG","GRR",0,1,1
"7648","sample063","RGR","GGR",0,1,1
"7649","sample063","RGR","RBB",0,1,1
"7650","sample063","RGR","RRG",0,1,1
"7651","sample063","RRG","GGR",0,1,1
"7652","sample063","RRR","GRR",0,1,1
"7653","sample063","RRR","RGG",0,1,1
"7654","sample064","BBB","GGG",1,0,1
"7655","sample064","BBB","RRG",1,1,2
"7656","sample064","BBG","BBB",1,1,2
"7657","sample064","BBG","BRB",1,1,2
"7658","sample064","BBG","GBG",2,0,2
"7659","sample064","BBG","GGB",2,2,4
"7660","sample064","BBG","GGG",4,7,11
"7661","sample064","BBG","GRG",1,0,1
"7662","sample064","BBG","RRG",1,0,1
"7663","sample064","BGG","RBG",1,0,1
"7664","sample064","BGG","RRR",1,0,1
"7665","sample064","BRR","BGB",1,0,1
"7666","sample064","GBB","BBB",12,9,21
"7667","sample064","GBB","BRB",1,2,3
"7668","sample064","GBB","BRR",1,1,2
"7669","sample064","GBB","GGG",7,9,16
"7670","sample064","GBB","GGR",1,0,1
"7671","sample064","GBB","RBG",3,3,6
"7672","sample064","GBB","RBR",1,0,1
"7673","sample064","GBB","RGG",1,0,1
"7674","sample064","GBB","RGR",2,0,2
"7675","sample064","GBB","RRR",1,1,2
"7676","sample064","GBG","BRB",1,0,1
"7677","sample064","GBG","BRR",1,0,1
"7678","sample064","GBG","GGG",4,3,7
"7679","sample064","GBG","RBB",1,0,1
"7680","sample064","GBG","RGR",1,0,1
"7681","sample064","GBG","RRG",1,0,1
"7682","sample064","GGB","BBB",3,0,3
"7683","sample064","GGB","BBR",1,0,1
"7684","sample064","GGB","BRR",1,4,5
"7685","sample064","GGB","GBG",1,0,1
"7686","sample064","GGB","GGG",13,4,17
"7687","sample064","GGB","RGG",1,1,2
"7688","sample064","GGB","RRG",1,1,2
"7689","sample064","GGB","RRR",1,0,1
"7690","sample064","GGG","BBB",8,2,10
"7691","sample064","GGG","BGG",1,3,4
"7692","sample064","GGG","BRB",1,0,1
"7693","sample064","GGG","GGB",5,0,5
"7694","sample064","GGG","GGR",1,1,2
"7695","sample064","GGG","RBB",1,2,3
"7696","sample064","GGG","RGR",1,2,3
"7697","sample064","GGG","RRG",1,4,5
"7698","sample064","GGR","BRR",1,0,1
"7699","sample064","GGR","GRR",1,0,1
"7700","sample064","GRG","BBB",3,1,4
"7701","sample064","GRG","GGB",2,2,4
"7702","sample064","GRG","GGG",3,2,5
"7703","sample064","GRG","RGR",1,1,2
"7704","sample064","GRG","RRG",2,1,3
"7705","sample064","GRR","BGB",1,0,1
"7706","sample064","RBG","BBB",2,1,3
"7707","sample064","RBG","RBB",1,0,1
"7708","sample064","RBR","BGB",2,0,2
"7709","sample064","RBR","BRB",1,0,1
"7710","sample064","RBR","BRR",1,0,1
"7711","sample064","RBR","GRR",4,1,5
"7712","sample064","RBR","RGG",2,0,2
"7713","sample064","RBR","RGR",1,0,1
"7714","sample064","RGG","BBR",1,0,1
"7715","sample064","RGR","BBB",2,0,2
"7716","sample064","RGR","BBR",1,0,1
"7717","sample064","RGR","BGB",2,0,2
"7718","sample064","RGR","BGG",2,0,2
"7719","sample064","RGR","BRR",1,0,1
"7720","sample064","RGR","GGB",2,2,4
"7721","sample064","RGR","RGG",1,0,1
"7722","sample064","RRG","BBB",2,8,10
"7723","sample064","RRG","BGB",1,3,4
"7724","sample064","RRG","BRB",2,8,10
"7725","sample064","RRG","BRR",1,4,5
"7726","sample064","RRG","GGG",2,3,5
"7727","sample064","RRG","GRG",1,0,1
"7728","sample064","RRG","GRR",3,0,3
"7729","sample064","RRG","RBB",1,1,2
"7730","sample064","RRR","BBR",1,0,1
"7731","sample064","RRR","BGB",2,0,2
"7732","sample064","RRR","BGG",1,0,1
"7733","sample064","RRR","BRB",1,0,1
"7734","sample064","RRR","BRR",1,0,1
"7735","sample064","RRR","RBB",1,1,2
"7736","sample064","RRR","RGR",1,2,3
"7737","sample064","RRR","RRG",2,0,2
"7738","sample064","BBB","BRB",0,1,1
"7739","sample064","BBG","RBG",0,2,2
"7740","sample064","BBG","RBR",0,1,1
"7741","sample064","BGG","RGG",0,1,1
"7742","sample064","BRB","BBB",0,1,1
"7743","sample064","BRB","BRR",0,1,1
"7744","sample064","BRB","GGG",0,1,1
"7745","sample064","BRB","RBG",0,1,1
"7746","sample064","BRR","BBB",0,1,1
"7747","sample064","GBB","BGG",0,1,1
"7748","sample064","GBB","GGB",0,2,2
"7749","sample064","GBB","RRG",0,1,1
"7750","sample064","GBG","BBB",0,1,1
"7751","sample064","GBG","RGG",0,1,1
"7752","sample064","GGB","BGG",0,3,3
"7753","sample064","GGB","BRB",0,1,1
"7754","sample064","GGB","GRR",0,1,1
"7755","sample064","GGB","RBB",0,1,1
"7756","sample064","GGB","RBG",0,2,2
"7757","sample064","GGB","RGR",0,1,1
"7758","sample064","GGG","BRR",0,1,1
"7759","sample064","GGG","RBR",0,3,3
"7760","sample064","GGR","BBB",0,1,1
"7761","sample064","GGR","BBR",0,1,1
"7762","sample064","GGR","BGG",0,1,1
"7763","sample064","GRG","BBR",0,1,1
"7764","sample064","GRG","RBR",0,1,1
"7765","sample064","GRR","BGG",0,2,2
"7766","sample064","GRR","BRB",0,1,1
"7767","sample064","RBB","BRB",0,1,1
"7768","sample064","RBG","GRR",0,1,1
"7769","sample064","RBR","BBB",0,4,4
"7770","sample064","RBR","GGB",0,2,2
"7771","sample064","RGG","BBB",0,1,1
"7772","sample064","RGG","RBB",0,1,1
"7773","sample064","RGR","GGG",0,1,1
"7774","sample064","RGR","GGR",0,1,1
"7775","sample064","RGR","RBB",0,1,1
"7776","sample064","RGR","RRG",0,3,3
"7777","sample064","RRG","BBR",0,1,1
"7778","sample064","RRR","GGR",0,1,1
"7779","sample065","BBB","GGG",1,0,1
"7780","sample065","BBB","RRG",1,0,1
"7781","sample065","BBG","BBB",1,1,2
"7782","sample065","BBG","BRB",1,4,5
"7783","sample065","BBG","GBG",2,2,4
"7784","sample065","BBG","GGB",2,5,7
"7785","sample065","BBG","GGG",4,6,10
"7786","sample065","BBG","GRG",1,1,2
"7787","sample065","BBG","RRG",1,0,1
"7788","sample065","BGG","RBG",1,0,1
"7789","sample065","BGG","RRR",1,0,1
"7790","sample065","BRR","BGB",1,0,1
"7791","sample065","GBB","BBB",12,5,17
"7792","sample065","GBB","BRB",1,2,3
"7793","sample065","GBB","BRR",1,1,2
"7794","sample065","GBB","GGG",7,7,14
"7795","sample065","GBB","GGR",1,1,2
"7796","sample065","GBB","RBG",3,0,3
"7797","sample065","GBB","RBR",1,0,1
"7798","sample065","GBB","RGG",1,0,1
"7799","sample065","GBB","RGR",2,0,2
"7800","sample065","GBB","RRR",1,0,1
"7801","sample065","GBG","BRB",1,1,2
"7802","sample065","GBG","BRR",1,0,1
"7803","sample065","GBG","GGG",4,1,5
"7804","sample065","GBG","RBB",1,0,1
"7805","sample065","GBG","RGR",1,0,1
"7806","sample065","GBG","RRG",1,1,2
"7807","sample065","GGB","BBB",3,3,6
"7808","sample065","GGB","BBR",1,1,2
"7809","sample065","GGB","BRR",1,4,5
"7810","sample065","GGB","GBG",1,0,1
"7811","sample065","GGB","GGG",13,6,19
"7812","sample065","GGB","RGG",1,0,1
"7813","sample065","GGB","RRG",1,1,2
"7814","sample065","GGB","RRR",1,1,2
"7815","sample065","GGG","BBB",8,2,10
"7816","sample065","GGG","BGG",1,1,2
"7817","sample065","GGG","BRB",1,0,1
"7818","sample065","GGG","GGB",5,1,6
"7819","sample065","GGG","GGR",1,3,4
"7820","sample065","GGG","RBB",1,0,1
"7821","sample065","GGG","RGR",1,4,5
"7822","sample065","GGG","RRG",1,6,7
"7823","sample065","GGR","BRR",1,0,1
"7824","sample065","GGR","GRR",1,0,1
"7825","sample065","GRG","BBB",3,1,4
"7826","sample065","GRG","GGB",2,3,5
"7827","sample065","GRG","GGG",3,1,4
"7828","sample065","GRG","RGR",1,0,1
"7829","sample065","GRG","RRG",2,0,2
"7830","sample065","GRR","BGB",1,0,1
"7831","sample065","RBG","BBB",2,0,2
"7832","sample065","RBG","RBB",1,0,1
"7833","sample065","RBR","BGB",2,0,2
"7834","sample065","RBR","BRB",1,0,1
"7835","sample065","RBR","BRR",1,0,1
"7836","sample065","RBR","GRR",4,0,4
"7837","sample065","RBR","RGG",2,3,5
"7838","sample065","RBR","RGR",1,0,1
"7839","sample065","RGG","BBR",1,1,2
"7840","sample065","RGR","BBB",2,2,4
"7841","sample065","RGR","BBR",1,0,1
"7842","sample065","RGR","BGB",2,0,2
"7843","sample065","RGR","BGG",2,0,2
"7844","sample065","RGR","BRR",1,1,2
"7845","sample065","RGR","GGB",2,1,3
"7846","sample065","RGR","RGG",1,0,1
"7847","sample065","RRG","BBB",2,4,6
"7848","sample065","RRG","BGB",1,2,3
"7849","sample065","RRG","BRB",2,7,9
"7850","sample065","RRG","BRR",1,2,3
"7851","sample065","RRG","GGG",2,1,3
"7852","sample065","RRG","GRG",1,0,1
"7853","sample065","RRG","GRR",3,3,6
"7854","sample065","RRG","RBB",1,0,1
"7855","sample065","RRR","BBR",1,0,1
"7856","sample065","RRR","BGB",2,0,2
"7857","sample065","RRR","BGG",1,0,1
"7858","sample065","RRR","BRB",1,0,1
"7859","sample065","RRR","BRR",1,1,2
"7860","sample065","RRR","RBB",1,0,1
"7861","sample065","RRR","RGR",1,0,1
"7862","sample065","RRR","RRG",2,1,3
"7863","sample065","BBB","GRR",0,1,1
"7864","sample065","BBG","RBG",0,2,2
"7865","sample065","BGB","BBB",0,1,1
"7866","sample065","BGG","RGR",0,1,1
"7867","sample065","BRB","BBB",0,2,2
"7868","sample065","BRR","BBB",0,4,4
"7869","sample065","GBB","GBG",0,2,2
"7870","sample065","GBB","GGB",0,5,5
"7871","sample065","GBB","GRR",0,1,1
"7872","sample065","GBB","RRG",0,1,1
"7873","sample065","GBG","BBB",0,1,1
"7874","sample065","GBG","GGB",0,2,2
"7875","sample065","GBG","RBG",0,1,1
"7876","sample065","GGB","BGG",0,1,1
"7877","sample065","GGB","GGR",0,2,2
"7878","sample065","GGB","RBG",0,1,1
"7879","sample065","GGB","RGR",0,1,1
"7880","sample065","GGG","BRR",0,2,2
"7881","sample065","GGG","RBG",0,1,1
"7882","sample065","GGG","RBR",0,4,4
"7883","sample065","GGG","RRR",0,1,1
"7884","sample065","GGR","BBB",0,1,1
"7885","sample065","GGR","RBB",0,1,1
"7886","sample065","GRG","GGR",0,1,1
"7887","sample065","GRR","BRR",0,1,1
"7888","sample065","RBG","GRR",0,1,1
"7889","sample065","RBR","BBB",0,2,2
"7890","sample065","RBR","GGB",0,2,2
"7891","sample065","RBR","RBB",0,1,1
"7892","sample065","RGG","BGB",0,1,1
"7893","sample065","RGG","GGR",0,1,1
"7894","sample065","RGG","GRR",0,3,3
"7895","sample065","RGR","RRG",0,1,1
"7896","sample065","RRG","BBR",0,1,1
"7897","sample065","RRG","BGG",0,1,1
"7898","sample066","BBB","GGG",1,0,1
"7899","sample066","BBB","RRG",1,2,3
"7900","sample066","BBG","BBB",1,0,1
"7901","sample066","BBG","BRB",1,3,4
"7902","sample066","BBG","GBG",2,2,4
"7903","sample066","BBG","GGB",2,5,7
"7904","sample066","BBG","GGG",4,6,10
"7905","sample066","BBG","GRG",1,1,2
"7906","sample066","BBG","RRG",1,0,1
"7907","sample066","BGG","RBG",1,0,1
"7908","sample066","BGG","RRR",1,0,1
"7909","sample066","BRR","BGB",1,0,1
"7910","sample066","GBB","BBB",12,4,16
"7911","sample066","GBB","BRB",1,1,2
"7912","sample066","GBB","BRR",1,0,1
"7913","sample066","GBB","GGG",7,14,21
"7914","sample066","GBB","GGR",1,0,1
"7915","sample066","GBB","RBG",3,0,3
"7916","sample066","GBB","RBR",1,0,1
"7917","sample066","GBB","RGG",1,0,1
"7918","sample066","GBB","RGR",2,0,2
"7919","sample066","GBB","RRR",1,1,2
"7920","sample066","GBG","BRB",1,0,1
"7921","sample066","GBG","BRR",1,0,1
"7922","sample066","GBG","GGG",4,1,5
"7923","sample066","GBG","RBB",1,0,1
"7924","sample066","GBG","RGR",1,1,2
"7925","sample066","GBG","RRG",1,0,1
"7926","sample066","GGB","BBB",3,4,7
"7927","sample066","GGB","BBR",1,0,1
"7928","sample066","GGB","BRR",1,5,6
"7929","sample066","GGB","GBG",1,0,1
"7930","sample066","GGB","GGG",13,9,22
"7931","sample066","GGB","RGG",1,0,1
"7932","sample066","GGB","RRG",1,1,2
"7933","sample066","GGB","RRR",1,0,1
"7934","sample066","GGG","BBB",8,5,13
"7935","sample066","GGG","BGG",1,0,1
"7936","sample066","GGG","BRB",1,1,2
"7937","sample066","GGG","GGB",5,0,5
"7938","sample066","GGG","GGR",1,0,1
"7939","sample066","GGG","RBB",1,2,3
"7940","sample066","GGG","RGR",1,1,2
"7941","sample066","GGG","RRG",1,5,6
"7942","sample066","GGR","BRR",1,0,1
"7943","sample066","GGR","GRR",1,0,1
"7944","sample066","GRG","BBB",3,1,4
"7945","sample066","GRG","GGB",2,0,2
"7946","sample066","GRG","GGG",3,2,5
"7947","sample066","GRG","RGR",1,0,1
"7948","sample066","GRG","RRG",2,0,2
"7949","sample066","GRR","BGB",1,0,1
"7950","sample066","RBG","BBB",2,1,3
"7951","sample066","RBG","RBB",1,1,2
"7952","sample066","RBR","BGB",2,0,2
"7953","sample066","RBR","BRB",1,0,1
"7954","sample066","RBR","BRR",1,1,2
"7955","sample066","RBR","GRR",4,1,5
"7956","sample066","RBR","RGG",2,4,6
"7957","sample066","RBR","RGR",1,0,1
"7958","sample066","RGG","BBR",1,0,1
"7959","sample066","RGR","BBB",2,1,3
"7960","sample066","RGR","BBR",1,0,1
"7961","sample066","RGR","BGB",2,1,3
"7962","sample066","RGR","BGG",2,0,2
"7963","sample066","RGR","BRR",1,2,3
"7964","sample066","RGR","GGB",2,1,3
"7965","sample066","RGR","RGG",1,0,1
"7966","sample066","RRG","BBB",2,6,8
"7967","sample066","RRG","BGB",1,1,2
"7968","sample066","RRG","BRB",2,5,7
"7969","sample066","RRG","BRR",1,0,1
"7970","sample066","RRG","GGG",2,6,8
"7971","sample066","RRG","GRG",1,0,1
"7972","sample066","RRG","GRR",3,0,3
"7973","sample066","RRG","RBB",1,0,1
"7974","sample066","RRR","BBR",1,0,1
"7975","sample066","RRR","BGB",2,0,2
"7976","sample066","RRR","BGG",1,0,1
"7977","sample066","RRR","BRB",1,0,1
"7978","sample066","RRR","BRR",1,0,1
"7979","sample066","RRR","RBB",1,0,1
"7980","sample066","RRR","RGR",1,0,1
"7981","sample066","RRR","RRG",2,0,2
"7982","sample066","BBG","GBB",0,1,1
"7983","sample066","BBG","RBG",0,2,2
"7984","sample066","BBG","RRR",0,1,1
"7985","sample066","BGG","BBB",0,1,1
"7986","sample066","BRB","BBB",0,2,2
"7987","sample066","BRB","GGR",0,1,1
"7988","sample066","BRR","BBB",0,1,1
"7989","sample066","BRR","RBB",0,1,1
"7990","sample066","GBB","BGG",0,1,1
"7991","sample066","GBB","GGB",0,4,4
"7992","sample066","GBB","GRG",0,1,1
"7993","sample066","GBB","RBB",0,1,1
"7994","sample066","GBG","BBB",0,1,1
"7995","sample066","GGB","BGB",0,1,1
"7996","sample066","GGB","GGR",0,2,2
"7997","sample066","GGB","GRR",0,1,1
"7998","sample066","GGB","RBG",0,1,1
"7999","sample066","GGB","RBR",0,1,1
"8000","sample066","GGB","RGR",0,1,1
"8001","sample066","GGG","BGB",0,1,1
"8002","sample066","GGG","RBG",0,3,3
"8003","sample066","GGG","RBR",0,4,4
"8004","sample066","GGG","RRR",0,1,1
"8005","sample066","GRG","BGG",0,1,1
"8006","sample066","GRG","GGR",0,1,1
"8007","sample066","GRR","BGG",0,1,1
"8008","sample066","RBB","RGG",0,1,1
"8009","sample066","RBG","RGR",0,1,1
"8010","sample066","RBR","BBB",0,2,2
"8011","sample066","RBR","BGG",0,1,1
"8012","sample066","RBR","GGB",0,2,2
"8013","sample066","RBR","RBB",0,1,1
"8014","sample066","RBR","RRR",0,1,1
"8015","sample066","RGG","BBB",0,2,2
"8016","sample066","RGG","BGB",0,1,1
"8017","sample066","RGG","GGR",0,1,1
"8018","sample066","RGR","GGR",0,1,1
"8019","sample066","RRG","GGR",0,1,1
"8020","sample067","BBB","GGG",1,0,1
"8021","sample067","BBB","RRG",1,0,1
"8022","sample067","BBG","BBB",1,1,2
"8023","sample067","BBG","BRB",1,5,6
"8024","sample067","BBG","GBG",2,1,3
"8025","sample067","BBG","GGB",2,5,7
"8026","sample067","BBG","GGG",4,9,13
"8027","sample067","BBG","GRG",1,1,2
"8028","sample067","BBG","RRG",1,0,1
"8029","sample067","BGG","RBG",1,1,2
"8030","sample067","BGG","RRR",1,0,1
"8031","sample067","BRR","BGB",1,0,1
"8032","sample067","GBB","BBB",12,1,13
"8033","sample067","GBB","BRB",1,1,2
"8034","sample067","GBB","BRR",1,0,1
"8035","sample067","GBB","GGG",7,17,24
"8036","sample067","GBB","GGR",1,0,1
"8037","sample067","GBB","RBG",3,1,4
"8038","sample067","GBB","RBR",1,0,1
"8039","sample067","GBB","RGG",1,0,1
"8040","sample067","GBB","RGR",2,0,2
"8041","sample067","GBB","RRR",1,2,3
"8042","sample067","GBG","BRB",1,0,1
"8043","sample067","GBG","BRR",1,0,1
"8044","sample067","GBG","GGG",4,0,4
"8045","sample067","GBG","RBB",1,0,1
"8046","sample067","GBG","RGR",1,0,1
"8047","sample067","GBG","RRG",1,0,1
"8048","sample067","GGB","BBB",3,3,6
"8049","sample067","GGB","BBR",1,0,1
"8050","sample067","GGB","BRR",1,2,3
"8051","sample067","GGB","GBG",1,0,1
"8052","sample067","GGB","GGG",13,10,23
"8053","sample067","GGB","RGG",1,1,2
"8054","sample067","GGB","RRG",1,0,1
"8055","sample067","GGB","RRR",1,1,2
"8056","sample067","GGG","BBB",8,9,17
"8057","sample067","GGG","BGG",1,2,3
"8058","sample067","GGG","BRB",1,1,2
"8059","sample067","GGG","GGB",5,0,5
"8060","sample067","GGG","GGR",1,1,2
"8061","sample067","GGG","RBB",1,4,5
"8062","sample067","GGG","RGR",1,1,2
"8063","sample067","GGG","RRG",1,2,3
"8064","sample067","GGR","BRR",1,0,1
"8065","sample067","GGR","GRR",1,0,1
"8066","sample067","GRG","BBB",3,2,5
"8067","sample067","GRG","GGB",2,0,2
"8068","sample067","GRG","GGG",3,1,4
"8069","sample067","GRG","RGR",1,0,1
"8070","sample067","GRG","RRG",2,0,2
"8071","sample067","GRR","BGB",1,0,1
"8072","sample067","RBG","BBB",2,1,3
"8073","sample067","RBG","RBB",1,1,2
"8074","sample067","RBR","BGB",2,0,2
"8075","sample067","RBR","BRB",1,0,1
"8076","sample067","RBR","BRR",1,0,1
"8077","sample067","RBR","GRR",4,0,4
"8078","sample067","RBR","RGG",2,2,4
"8079","sample067","RBR","RGR",1,0,1
"8080","sample067","RGG","BBR",1,0,1
"8081","sample067","RGR","BBB",2,1,3
"8082","sample067","RGR","BBR",1,0,1
"8083","sample067","RGR","BGB",2,1,3
"8084","sample067","RGR","BGG",2,0,2
"8085","sample067","RGR","BRR",1,1,2
"8086","sample067","RGR","GGB",2,2,4
"8087","sample067","RGR","RGG",1,0,1
"8088","sample067","RRG","BBB",2,2,4
"8089","sample067","RRG","BGB",1,2,3
"8090","sample067","RRG","BRB",2,3,5
"8091","sample067","RRG","BRR",1,2,3
"8092","sample067","RRG","GGG",2,3,5
"8093","sample067","RRG","GRG",1,0,1
"8094","sample067","RRG","GRR",3,1,4
"8095","sample067","RRG","RBB",1,1,2
"8096","sample067","RRR","BBR",1,0,1
"8097","sample067","RRR","BGB",2,0,2
"8098","sample067","RRR","BGG",1,0,1
"8099","sample067","RRR","BRB",1,0,1
"8100","sample067","RRR","BRR",1,0,1
"8101","sample067","RRR","RBB",1,1,2
"8102","sample067","RRR","RGR",1,0,1
"8103","sample067","RRR","RRG",2,0,2
"8104","sample067","BBB","RRR",0,1,1
"8105","sample067","BBG","BGG",0,1,1
"8106","sample067","BBG","RBG",0,1,1
"8107","sample067","BBG","RRR",0,1,1
"8108","sample067","BGG","BBB",0,1,1
"8109","sample067","BGG","BBR",0,1,1
"8110","sample067","BGG","RGG",0,1,1
"8111","sample067","BRB","BBB",0,2,2
"8112","sample067","BRB","RBG",0,1,1
"8113","sample067","BRB","RGR",0,1,1
"8114","sample067","BRR","BBB",0,2,2
"8115","sample067","BRR","RBB",0,1,1
"8116","sample067","GBB","GBG",0,2,2
"8117","sample067","GBB","GRG",0,1,1
"8118","sample067","GBG","BBB",0,1,1
"8119","sample067","GBG","RGG",0,1,1
"8120","sample067","GGB","BGG",0,1,1
"8121","sample067","GGB","GGR",0,2,2
"8122","sample067","GGG","BRR",0,4,4
"8123","sample067","GGG","GRR",0,1,1
"8124","sample067","GGG","RBR",0,1,1
"8125","sample067","GGG","RRR",0,1,1
"8126","sample067","GRR","BBR",0,1,1
"8127","sample067","GRR","BGG",0,1,1
"8128","sample067","GRR","BRR",0,1,1
"8129","sample067","GRR","GGR",0,1,1
"8130","sample067","RBR","BBB",0,3,3
"8131","sample067","RBR","GGB",0,1,1
"8132","sample067","RGG","BBB",0,2,2
"8133","sample067","RGG","BGB",0,1,1
"8134","sample067","RGG","BRR",0,1,1
"8135","sample067","RGG","GRR",0,1,1
"8136","sample067","RGG","RBB",0,1,1
"8137","sample067","RGR","GGG",0,1,1
"8138","sample067","RGR","GGR",0,1,1
"8139","sample067","RGR","RBB",0,1,1
"8140","sample067","RGR","RRG",0,1,1
"8141","sample067","RRG","BGG",0,1,1
"8142","sample067","RRR","GRR",0,1,1
"8143","sample067","RRR","RBR",0,2,2
"8144","sample068","BBB","GGG",1,1,2
"8145","sample068","BBB","RRG",1,1,2
"8146","sample068","BBG","BBB",1,0,1
"8147","sample068","BBG","BRB",1,3,4
"8148","sample068","BBG","GBG",2,1,3
"8149","sample068","BBG","GGB",2,1,3
"8150","sample068","BBG","GGG",4,6,10
"8151","sample068","BBG","GRG",1,0,1
"8152","sample068","BBG","RRG",1,1,2
"8153","sample068","BGG","RBG",1,0,1
"8154","sample068","BGG","RRR",1,0,1
"8155","sample068","BRR","BGB",1,0,1
"8156","sample068","GBB","BBB",12,6,18
"8157","sample068","GBB","BRB",1,1,2
"8158","sample068","GBB","BRR",1,0,1
"8159","sample068","GBB","GGG",7,11,18
"8160","sample068","GBB","GGR",1,0,1
"8161","sample068","GBB","RBG",3,4,7
"8162","sample068","GBB","RBR",1,0,1
"8163","sample068","GBB","RGG",1,0,1
"8164","sample068","GBB","RGR",2,0,2
"8165","sample068","GBB","RRR",1,2,3
"8166","sample068","GBG","BRB",1,0,1
"8167","sample068","GBG","BRR",1,0,1
"8168","sample068","GBG","GGG",4,3,7
"8169","sample068","GBG","RBB",1,0,1
"8170","sample068","GBG","RGR",1,1,2
"8171","sample068","GBG","RRG",1,0,1
"8172","sample068","GGB","BBB",3,1,4
"8173","sample068","GGB","BBR",1,0,1
"8174","sample068","GGB","BRR",1,1,2
"8175","sample068","GGB","GBG",1,0,1
"8176","sample068","GGB","GGG",13,5,18
"8177","sample068","GGB","RGG",1,1,2
"8178","sample068","GGB","RRG",1,0,1
"8179","sample068","GGB","RRR",1,1,2
"8180","sample068","GGG","BBB",8,12,20
"8181","sample068","GGG","BGG",1,0,1
"8182","sample068","GGG","BRB",1,1,2
"8183","sample068","GGG","GGB",5,0,5
"8184","sample068","GGG","GGR",1,1,2
"8185","sample068","GGG","RBB",1,2,3
"8186","sample068","GGG","RGR",1,3,4
"8187","sample068","GGG","RRG",1,6,7
"8188","sample068","GGR","BRR",1,0,1
"8189","sample068","GGR","GRR",1,0,1
"8190","sample068","GRG","BBB",3,0,3
"8191","sample068","GRG","GGB",2,0,2
"8192","sample068","GRG","GGG",3,1,4
"8193","sample068","GRG","RGR",1,0,1
"8194","sample068","GRG","RRG",2,0,2
"8195","sample068","GRR","BGB",1,0,1
"8196","sample068","RBG","BBB",2,4,6
"8197","sample068","RBG","RBB",1,0,1
"8198","sample068","RBR","BGB",2,1,3
"8199","sample068","RBR","BRB",1,0,1
"8200","sample068","RBR","BRR",1,1,2
"8201","sample068","RBR","GRR",4,0,4
"8202","sample068","RBR","RGG",2,2,4
"8203","sample068","RBR","RGR",1,0,1
"8204","sample068","RGG","BBR",1,0,1
"8205","sample068","RGR","BBB",2,0,2
"8206","sample068","RGR","BBR",1,0,1
"8207","sample068","RGR","BGB",2,1,3
"8208","sample068","RGR","BGG",2,0,2
"8209","sample068","RGR","BRR",1,1,2
"8210","sample068","RGR","GGB",2,1,3
"8211","sample068","RGR","RGG",1,0,1
"8212","sample068","RRG","BBB",2,6,8
"8213","sample068","RRG","BGB",1,1,2
"8214","sample068","RRG","BRB",2,3,5
"8215","sample068","RRG","BRR",1,3,4
"8216","sample068","RRG","GGG",2,1,3
"8217","sample068","RRG","GRG",1,0,1
"8218","sample068","RRG","GRR",3,1,4
"8219","sample068","RRG","RBB",1,0,1
"8220","sample068","RRR","BBR",1,0,1
"8221","sample068","RRR","BGB",2,0,2
"8222","sample068","RRR","BGG",1,0,1
"8223","sample068","RRR","BRB",1,1,2
"8224","sample068","RRR","BRR",1,0,1
"8225","sample068","RRR","RBB",1,0,1
"8226","sample068","RRR","RGR",1,0,1
"8227","sample068","RRR","RRG",2,0,2
"8228","sample068","BBB","BRB",0,1,1
"8229","sample068","BBB","RRR",0,1,1
"8230","sample068","BBG","BGB",0,1,1
"8231","sample068","BBG","BGG",0,1,1
"8232","sample068","BBG","GRR",0,1,1
"8233","sample068","BBG","RRR",0,4,4
"8234","sample068","BGG","BBB",0,1,1
"8235","sample068","BRB","BBB",0,1,1
"8236","sample068","BRR","BBB",0,1,1
"8237","sample068","BRR","BGG",0,1,1
"8238","sample068","GBB","GGB",0,2,2
"8239","sample068","GBB","GRG",0,1,1
"8240","sample068","GBG","GGB",0,1,1
"8241","sample068","GGB","BGB",0,1,1
"8242","sample068","GGB","GGR",0,1,1
"8243","sample068","GGB","GRR",0,1,1
"8244","sample068","GGB","RBB",0,1,1
"8245","sample068","GGB","RBG",0,2,2
"8246","sample068","GGB","RBR",0,2,2
"8247","sample068","GGB","RGR",0,1,1
"8248","sample068","GGG","GRR",0,1,1
"8249","sample068","GGG","RBG",0,2,2
"8250","sample068","GGG","RBR",0,1,1
"8251","sample068","GGG","RGG",0,2,2
"8252","sample068","GGG","RRR",0,1,1
"8253","sample068","GRG","BBR",0,1,1
"8254","sample068","GRG","BRB",0,1,1
"8255","sample068","GRG","GGR",0,1,1
"8256","sample068","GRR","BBB",0,1,1
"8257","sample068","GRR","BGG",0,1,1
"8258","sample068","RBR","BBB",0,3,3
"8259","sample068","RBR","GGB",0,1,1
"8260","sample068","RBR","RBB",0,1,1
"8261","sample068","RGG","BBB",0,1,1
"8262","sample068","RGG","GGR",0,1,1
"8263","sample068","RGG","GRR",0,2,2
"8264","sample068","RGR","GGG",0,1,1
"8265","sample068","RGR","GGR",0,1,1
"8266","sample068","RGR","RBB",0,1,1
"8267","sample068","RRG","BBR",0,1,1
"8268","sample068","RRG","BGG",0,1,1
"8269","sample068","RRG","GGR",0,2,2
"8270","sample068","RRG","RGG",0,1,1
"8271","sample068","RRG","RGR",0,1,1
"8272","sample069","BBB","GGG",1,0,1
"8273","sample069","BBB","RRG",1,2,3
"8274","sample069","BBG","BBB",1,0,1
"8275","sample069","BBG","BRB",1,3,4
"8276","sample069","BBG","GBG",2,2,4
"8277","sample069","BBG","GGB",2,4,6
"8278","sample069","BBG","GGG",4,5,9
"8279","sample069","BBG","GRG",1,1,2
"8280","sample069","BBG","RRG",1,0,1
"8281","sample069","BGG","RBG",1,0,1
"8282","sample069","BGG","RRR",1,0,1
"8283","sample069","BRR","BGB",1,0,1
"8284","sample069","GBB","BBB",12,8,20
"8285","sample069","GBB","BRB",1,3,4
"8286","sample069","GBB","BRR",1,1,2
"8287","sample069","GBB","GGG",7,15,22
"8288","sample069","GBB","GGR",1,1,2
"8289","sample069","GBB","RBG",3,1,4
"8290","sample069","GBB","RBR",1,0,1
"8291","sample069","GBB","RGG",1,0,1
"8292","sample069","GBB","RGR",2,0,2
"8293","sample069","GBB","RRR",1,1,2
"8294","sample069","GBG","BRB",1,0,1
"8295","sample069","GBG","BRR",1,0,1
"8296","sample069","GBG","GGG",4,1,5
"8297","sample069","GBG","RBB",1,0,1
"8298","sample069","GBG","RGR",1,0,1
"8299","sample069","GBG","RRG",1,1,2
"8300","sample069","GGB","BBB",3,1,4
"8301","sample069","GGB","BBR",1,1,2
"8302","sample069","GGB","BRR",1,3,4
"8303","sample069","GGB","GBG",1,0,1
"8304","sample069","GGB","GGG",13,6,19
"8305","sample069","GGB","RGG",1,1,2
"8306","sample069","GGB","RRG",1,0,1
"8307","sample069","GGB","RRR",1,2,3
"8308","sample069","GGG","BBB",8,4,12
"8309","sample069","GGG","BGG",1,2,3
"8310","sample069","GGG","BRB",1,0,1
"8311","sample069","GGG","GGB",5,0,5
"8312","sample069","GGG","GGR",1,0,1
"8313","sample069","GGG","RBB",1,2,3
"8314","sample069","GGG","RGR",1,1,2
"8315","sample069","GGG","RRG",1,6,7
"8316","sample069","GGR","BRR",1,0,1
"8317","sample069","GGR","GRR",1,0,1
"8318","sample069","GRG","BBB",3,2,5
"8319","sample069","GRG","GGB",2,3,5
"8320","sample069","GRG","GGG",3,1,4
"8321","sample069","GRG","RGR",1,0,1
"8322","sample069","GRG","RRG",2,2,4
"8323","sample069","GRR","BGB",1,1,2
"8324","sample069","RBG","BBB",2,1,3
"8325","sample069","RBG","RBB",1,0,1
"8326","sample069","RBR","BGB",2,0,2
"8327","sample069","RBR","BRB",1,0,1
"8328","sample069","RBR","BRR",1,2,3
"8329","sample069","RBR","GRR",4,1,5
"8330","sample069","RBR","RGG",2,0,2
"8331","sample069","RBR","RGR",1,0,1
"8332","sample069","RGG","BBR",1,0,1
"8333","sample069","RGR","BBB",2,1,3
"8334","sample069","RGR","BBR",1,1,2
"8335","sample069","RGR","BGB",2,0,2
"8336","sample069","RGR","BGG",2,0,2
"8337","sample069","RGR","BRR",1,1,2
"8338","sample069","RGR","GGB",2,2,4
"8339","sample069","RGR","RGG",1,1,2
"8340","sample069","RRG","BBB",2,3,5
"8341","sample069","RRG","BGB",1,1,2
"8342","sample069","RRG","BRB",2,6,8
"8343","sample069","RRG","BRR",1,3,4
"8344","sample069","RRG","GGG",2,1,3
"8345","sample069","RRG","GRG",1,0,1
"8346","sample069","RRG","GRR",3,0,3
"8347","sample069","RRG","RBB",1,0,1
"8348","sample069","RRR","BBR",1,0,1
"8349","sample069","RRR","BGB",2,1,3
"8350","sample069","RRR","BGG",1,0,1
"8351","sample069","RRR","BRB",1,0,1
"8352","sample069","RRR","BRR",1,0,1
"8353","sample069","RRR","RBB",1,1,2
"8354","sample069","RRR","RGR",1,0,1
"8355","sample069","RRR","RRG",2,0,2
"8356","sample069","BBG","BGB",0,1,1
"8357","sample069","BBG","RRR",0,2,2
"8358","sample069","BGG","BBB",0,1,1
"8359","sample069","BGG","RGR",0,1,1
"8360","sample069","BRB","BBB",0,1,1
"8361","sample069","BRB","BRR",0,1,1
"8362","sample069","BRB","RRR",0,1,1
"8363","sample069","BRR","BBB",0,1,1
"8364","sample069","GBB","BGG",0,1,1
"8365","sample069","GBB","GGB",0,1,1
"8366","sample069","GBB","RBB",0,1,1
"8367","sample069","GBG","GGB",0,2,2
"8368","sample069","GGB","BGG",0,2,2
"8369","sample069","GGB","GGR",0,1,1
"8370","sample069","GGB","RBB",0,1,1
"8371","sample069","GGB","RBG",0,1,1
"8372","sample069","GGB","RBR",0,2,2
"8373","sample069","GGG","BRR",0,1,1
"8374","sample069","GGG","RBG",0,1,1
"8375","sample069","GGG","RBR",0,2,2
"8376","sample069","GGG","RGG",0,1,1
"8377","sample069","GRG","BRB",0,1,1
"8378","sample069","GRG","GGR",0,1,1
"8379","sample069","GRR","BRR",0,1,1
"8380","sample069","RBG","GRR",0,1,1
"8381","sample069","RBG","RGR",0,1,1
"8382","sample069","RBR","BBB",0,2,2
"8383","sample069","RBR","BBR",0,1,1
"8384","sample069","RBR","GGB",0,1,1
"8385","sample069","RGG","BBB",0,2,2
"8386","sample069","RGG","BGB",0,1,1
"8387","sample069","RGG","BRR",0,1,1
"8388","sample069","RGG","GGR",0,1,1
"8389","sample069","RGR","GGR",0,1,1
"8390","sample069","RGR","RBB",0,1,1
"8391","sample069","RRG","BBR",0,1,1
"8392","sample069","RRG","BGG",0,1,1
"8393","sample069","RRR","GRR",0,1,1
"8394","sample069","RRR","RBR",0,2,2
"8395","sample070","BBB","GGG",1,0,1
"8396","sample070","BBB","RRG",1,0,1
"8397","sample070","BBG","BBB",1,1,2
"8398","sample070","BBG","BRB",1,3,4
"8399","sample070","BBG","GBG",2,2,4
"8400","sample070","BBG","GGB",2,4,6
"8401","sample070","BBG","GGG",4,7,11
"8402","sample070","BBG","GRG",1,2,3
"8403","sample070","BBG","RRG",1,1,2
"8404","sample070","BGG","RBG",1,0,1
"8405","sample070","BGG","RRR",1,0,1
"8406","sample070","BRR","BGB",1,0,1
"8407","sample070","GBB","BBB",12,7,19
"8408","sample070","GBB","BRB",1,0,1
"8409","sample070","GBB","BRR",1,0,1
"8410","sample070","GBB","GGG",7,11,18
"8411","sample070","GBB","GGR",1,1,2
"8412","sample070","GBB","RBG",3,1,4
"8413","sample070","GBB","RBR",1,0,1
"8414","sample070","GBB","RGG",1,0,1
"8415","sample070","GBB","RGR",2,0,2
"8416","sample070","GBB","RRR",1,0,1
"8417","sample070","GBG","BRB",1,0,1
"8418","sample070","GBG","BRR",1,0,1
"8419","sample070","GBG","GGG",4,0,4
"8420","sample070","GBG","RBB",1,0,1
"8421","sample070","GBG","RGR",1,1,2
"8422","sample070","GBG","RRG",1,0,1
"8423","sample070","GGB","BBB",3,5,8
"8424","sample070","GGB","BBR",1,1,2
"8425","sample070","GGB","BRR",1,4,5
"8426","sample070","GGB","GBG",1,0,1
"8427","sample070","GGB","GGG",13,7,20
"8428","sample070","GGB","RGG",1,0,1
"8429","sample070","GGB","RRG",1,2,3
"8430","sample070","GGB","RRR",1,1,2
"8431","sample070","GGG","BBB",8,3,11
"8432","sample070","GGG","BGG",1,0,1
"8433","sample070","GGG","BRB",1,0,1
"8434","sample070","GGG","GGB",5,0,5
"8435","sample070","GGG","GGR",1,0,1
"8436","sample070","GGG","RBB",1,1,2
"8437","sample070","GGG","RGR",1,3,4
"8438","sample070","GGG","RRG",1,1,2
"8439","sample070","GGR","BRR",1,0,1
"8440","sample070","GGR","GRR",1,0,1
"8441","sample070","GRG","BBB",3,3,6
"8442","sample070","GRG","GGB",2,0,2
"8443","sample070","GRG","GGG",3,3,6
"8444","sample070","GRG","RGR",1,0,1
"8445","sample070","GRG","RRG",2,0,2
"8446","sample070","GRR","BGB",1,0,1
"8447","sample070","RBG","BBB",2,1,3
"8448","sample070","RBG","RBB",1,0,1
"8449","sample070","RBR","BGB",2,1,3
"8450","sample070","RBR","BRB",1,0,1
"8451","sample070","RBR","BRR",1,0,1
"8452","sample070","RBR","GRR",4,1,5
"8453","sample070","RBR","RGG",2,0,2
"8454","sample070","RBR","RGR",1,0,1
"8455","sample070","RGG","BBR",1,0,1
"8456","sample070","RGR","BBB",2,1,3
"8457","sample070","RGR","BBR",1,0,1
"8458","sample070","RGR","BGB",2,1,3
"8459","sample070","RGR","BGG",2,0,2
"8460","sample070","RGR","BRR",1,3,4
"8461","sample070","RGR","GGB",2,1,3
"8462","sample070","RGR","RGG",1,0,1
"8463","sample070","RRG","BBB",2,7,9
"8464","sample070","RRG","BGB",1,2,3
"8465","sample070","RRG","BRB",2,4,6
"8466","sample070","RRG","BRR",1,1,2
"8467","sample070","RRG","GGG",2,1,3
"8468","sample070","RRG","GRG",1,0,1
"8469","sample070","RRG","GRR",3,2,5
"8470","sample070","RRG","RBB",1,1,2
"8471","sample070","RRR","BBR",1,0,1
"8472","sample070","RRR","BGB",2,0,2
"8473","sample070","RRR","BGG",1,0,1
"8474","sample070","RRR","BRB",1,0,1
"8475","sample070","RRR","BRR",1,0,1
"8476","sample070","RRR","RBB",1,0,1
"8477","sample070","RRR","RGR",1,0,1
"8478","sample070","RRR","RRG",2,0,2
"8479","sample070","BBB","GRR",0,1,1
"8480","sample070","BBG","BGB",0,1,1
"8481","sample070","BBG","BGG",0,1,1
"8482","sample070","BBG","GBB",0,1,1
"8483","sample070","BBG","RBB",0,1,1
"8484","sample070","BBG","RBG",0,1,1
"8485","sample070","BBG","RBR",0,1,1
"8486","sample070","BBG","RRR",0,2,2
"8487","sample070","BGG","BBB",0,1,1
"8488","sample070","BGG","BBR",0,1,1
"8489","sample070","BGG","RGG",0,1,1
"8490","sample070","BGG","RGR",0,1,1
"8491","sample070","BRB","BBB",0,3,3
"8492","sample070","BRB","BRR",0,1,1
"8493","sample070","BRB","RBG",0,1,1
"8494","sample070","GBB","GGB",0,1,1
"8495","sample070","GBB","GRR",0,1,1
"8496","sample070","GBB","RRG",0,2,2
"8497","sample070","GBG","BBB",0,2,2
"8498","sample070","GBG","GGB",0,1,1
"8499","sample070","GGB","BGG",0,1,1
"8500","sample070","GGB","RBB",0,1,1
"8501","sample070","GGB","RBR",0,2,2
"8502","sample070","GGG","BGB",0,1,1
"8503","sample070","GGG","RBR",0,5,5
"8504","sample070","GGG","RGG",0,2,2
"8505","sample070","GGR","BBB",0,1,1
"8506","sample070","GGR","BBR",0,1,1
"8507","sample070","GRG","BRR",0,1,1
"8508","sample070","GRG","GGR",0,1,1
"8509","sample070","GRG","RBG",0,1,1
"8510","sample070","GRR","BGG",0,1,1
"8511","sample070","GRR","BRR",0,1,1
"8512","sample070","RBB","BBR",0,1,1
"8513","sample070","RBR","BBB",0,1,1
"8514","sample070","RBR","BBR",0,1,1
"8515","sample070","RBR","BGG",0,1,1
"8516","sample070","RBR","GGB",0,2,2
"8517","sample070","RGG","BBB",0,1,1
"8518","sample070","RGG","BRR",0,1,1
"8519","sample070","RGG","GGG",0,1,1
"8520","sample070","RGG","GRR",0,1,1
"8521","sample070","RGR","GGG",0,1,1
"8522","sample070","RGR","RBB",0,1,1
"8523","sample070","RRG","BBR",0,1,1
"8524","sample070","RRG","GGR",0,1,1
"8525","sample071","BBB","GGG",1,0,1
"8526","sample071","BBB","RRG",1,0,1
"8527","sample071","BBG","BBB",1,1,2
"8528","sample071","BBG","BRB",1,3,4
"8529","sample071","BBG","GBG",2,2,4
"8530","sample071","BBG","GGB",2,5,7
"8531","sample071","BBG","GGG",4,2,6
"8532","sample071","BBG","GRG",1,5,6
"8533","sample071","BBG","RRG",1,0,1
"8534","sample071","BGG","RBG",1,0,1
"8535","sample071","BGG","RRR",1,0,1
"8536","sample071","BRR","BGB",1,0,1
"8537","sample071","GBB","BBB",12,6,18
"8538","sample071","GBB","BRB",1,0,1
"8539","sample071","GBB","BRR",1,1,2
"8540","sample071","GBB","GGG",7,12,19
"8541","sample071","GBB","GGR",1,0,1
"8542","sample071","GBB","RBG",3,0,3
"8543","sample071","GBB","RBR",1,0,1
"8544","sample071","GBB","RGG",1,0,1
"8545","sample071","GBB","RGR",2,0,2
"8546","sample071","GBB","RRR",1,1,2
"8547","sample071","GBG","BRB",1,0,1
"8548","sample071","GBG","BRR",1,0,1
"8549","sample071","GBG","GGG",4,3,7
"8550","sample071","GBG","RBB",1,0,1
"8551","sample071","GBG","RGR",1,1,2
"8552","sample071","GBG","RRG",1,1,2
"8553","sample071","GGB","BBB",3,2,5
"8554","sample071","GGB","BBR",1,0,1
"8555","sample071","GGB","BRR",1,1,2
"8556","sample071","GGB","GBG",1,0,1
"8557","sample071","GGB","GGG",13,9,22
"8558","sample071","GGB","RGG",1,1,2
"8559","sample071","GGB","RRG",1,1,2
"8560","sample071","GGB","RRR",1,0,1
"8561","sample071","GGG","BBB",8,3,11
"8562","sample071","GGG","BGG",1,2,3
"8563","sample071","GGG","BRB",1,2,3
"8564","sample071","GGG","GGB",5,0,5
"8565","sample071","GGG","GGR",1,2,3
"8566","sample071","GGG","RBB",1,2,3
"8567","sample071","GGG","RGR",1,1,2
"8568","sample071","GGG","RRG",1,6,7
"8569","sample071","GGR","BRR",1,0,1
"8570","sample071","GGR","GRR",1,0,1
"8571","sample071","GRG","BBB",3,0,3
"8572","sample071","GRG","GGB",2,4,6
"8573","sample071","GRG","GGG",3,0,3
"8574","sample071","GRG","RGR",1,0,1
"8575","sample071","GRG","RRG",2,1,3
"8576","sample071","GRR","BGB",1,0,1
"8577","sample071","RBG","BBB",2,1,3
"8578","sample071","RBG","RBB",1,0,1
"8579","sample071","RBR","BGB",2,1,3
"8580","sample071","RBR","BRB",1,0,1
"8581","sample071","RBR","BRR",1,0,1
"8582","sample071","RBR","GRR",4,1,5
"8583","sample071","RBR","RGG",2,1,3
"8584","sample071","RBR","RGR",1,0,1
"8585","sample071","RGG","BBR",1,0,1
"8586","sample071","RGR","BBB",2,0,2
"8587","sample071","RGR","BBR",1,0,1
"8588","sample071","RGR","BGB",2,0,2
"8589","sample071","RGR","BGG",2,0,2
"8590","sample071","RGR","BRR",1,0,1
"8591","sample071","RGR","GGB",2,2,4
"8592","sample071","RGR","RGG",1,0,1
"8593","sample071","RRG","BBB",2,5,7
"8594","sample071","RRG","BGB",1,3,4
"8595","sample071","RRG","BRB",2,9,11
"8596","sample071","RRG","BRR",1,1,2
"8597","sample071","RRG","GGG",2,4,6
"8598","sample071","RRG","GRG",1,0,1
"8599","sample071","RRG","GRR",3,1,4
"8600","sample071","RRG","RBB",1,0,1
"8601","sample071","RRR","BBR",1,0,1
"8602","sample071","RRR","BGB",2,0,2
"8603","sample071","RRR","BGG",1,0,1
"8604","sample071","RRR","BRB",1,0,1
"8605","sample071","RRR","BRR",1,0,1
"8606","sample071","RRR","RBB",1,1,2
"8607","sample071","RRR","RGR",1,0,1
"8608","sample071","RRR","RRG",2,0,2
"8609","sample071","BBG","RBG",0,2,2
"8610","sample071","BBG","RRR",0,1,1
"8611","sample071","BRB","BBB",0,3,3
"8612","sample071","BRB","BRR",0,3,3
"8613","sample071","BRB","RRR",0,1,1
"8614","sample071","BRR","BRB",0,1,1
"8615","sample071","GBB","GBG",0,2,2
"8616","sample071","GBB","GGB",0,5,5
"8617","sample071","GBB","GRR",0,1,1
"8618","sample071","GBB","RRG",0,1,1
"8619","sample071","GBG","BBB",0,1,1
"8620","sample071","GGB","BGB",0,2,2
"8621","sample071","GGB","BGG",0,1,1
"8622","sample071","GGB","GGR",0,1,1
"8623","sample071","GGB","RBB",0,1,1
"8624","sample071","GGB","RBG",0,1,1
"8625","sample071","GGB","RBR",0,1,1
"8626","sample071","GGB","RGR",0,1,1
"8627","sample071","GGG","BGB",0,1,1
"8628","sample071","GGG","RBG",0,2,2
"8629","sample071","GGG","RBR",0,1,1
"8630","sample071","GGG","RGG",0,2,2
"8631","sample071","GGR","BBB",0,1,1
"8632","sample071","RBB","RGG",0,1,1
"8633","sample071","RBG","BRR",0,1,1
"8634","sample071","RBR","BBB",0,1,1
"8635","sample071","RBR","BGG",0,1,1
"8636","sample071","RBR","GGB",0,3,3
"8637","sample071","RGG","BRR",0,1,1
"8638","sample071","RGG","GRR",0,1,1
"8639","sample071","RGR","RRG",0,2,2
"8640","sample071","RRG","BBR",0,1,1
"8641","sample071","RRG","GGR",0,1,1
"8642","sample071","RRR","GRR",0,1,1
"8643","sample072","BBB","GGG",1,0,1
"8644","sample072","BBB","RRG",1,1,2
"8645","sample072","BBG","BBB",1,0,1
"8646","sample072","BBG","BRB",1,3,4
"8647","sample072","BBG","GBG",2,1,3
"8648","sample072","BBG","GGB",2,9,11
"8649","sample072","BBG","GGG",4,5,9
"8650","sample072","BBG","GRG",1,2,3
"8651","sample072","BBG","RRG",1,0,1
"8652","sample072","BGG","RBG",1,0,1
"8653","sample072","BGG","RRR",1,0,1
"8654","sample072","BRR","BGB",1,0,1
"8655","sample072","GBB","BBB",12,5,17
"8656","sample072","GBB","BRB",1,1,2
"8657","sample072","GBB","BRR",1,0,1
"8658","sample072","GBB","GGG",7,17,24
"8659","sample072","GBB","GGR",1,0,1
"8660","sample072","GBB","RBG",3,0,3
"8661","sample072","GBB","RBR",1,0,1
"8662","sample072","GBB","RGG",1,0,1
"8663","sample072","GBB","RGR",2,0,2
"8664","sample072","GBB","RRR",1,3,4
"8665","sample072","GBG","BRB",1,0,1
"8666","sample072","GBG","BRR",1,0,1
"8667","sample072","GBG","GGG",4,3,7
"8668","sample072","GBG","RBB",1,0,1
"8669","sample072","GBG","RGR",1,0,1
"8670","sample072","GBG","RRG",1,1,2
"8671","sample072","GGB","BBB",3,2,5
"8672","sample072","GGB","BBR",1,0,1
"8673","sample072","GGB","BRR",1,0,1
"8674","sample072","GGB","GBG",1,0,1
"8675","sample072","GGB","GGG",13,11,24
"8676","sample072","GGB","RGG",1,1,2
"8677","sample072","GGB","RRG",1,0,1
"8678","sample072","GGB","RRR",1,2,3
"8679","sample072","GGG","BBB",8,0,8
"8680","sample072","GGG","BGG",1,0,1
"8681","sample072","GGG","BRB",1,1,2
"8682","sample072","GGG","GGB",5,0,5
"8683","sample072","GGG","GGR",1,2,3
"8684","sample072","GGG","RBB",1,3,4
"8685","sample072","GGG","RGR",1,1,2
"8686","sample072","GGG","RRG",1,2,3
"8687","sample072","GGR","BRR",1,0,1
"8688","sample072","GGR","GRR",1,0,1
"8689","sample072","GRG","BBB",3,2,5
"8690","sample072","GRG","GGB",2,3,5
"8691","sample072","GRG","GGG",3,1,4
"8692","sample072","GRG","RGR",1,1,2
"8693","sample072","GRG","RRG",2,0,2
"8694","sample072","GRR","BGB",1,0,1
"8695","sample072","RBG","BBB",2,0,2
"8696","sample072","RBG","RBB",1,1,2
"8697","sample072","RBR","BGB",2,0,2
"8698","sample072","RBR","BRB",1,0,1
"8699","sample072","RBR","BRR",1,2,3
"8700","sample072","RBR","GRR",4,1,5
"8701","sample072","RBR","RGG",2,1,3
"8702","sample072","RBR","RGR",1,0,1
"8703","sample072","RGG","BBR",1,0,1
"8704","sample072","RGR","BBB",2,1,3
"8705","sample072","RGR","BBR",1,0,1
"8706","sample072","RGR","BGB",2,1,3
"8707","sample072","RGR","BGG",2,0,2
"8708","sample072","RGR","BRR",1,1,2
"8709","sample072","RGR","GGB",2,1,3
"8710","sample072","RGR","RGG",1,0,1
"8711","sample072","RRG","BBB",2,6,8
"8712","sample072","RRG","BGB",1,3,4
"8713","sample072","RRG","BRB",2,4,6
"8714","sample072","RRG","BRR",1,3,4
"8715","sample072","RRG","GGG",2,1,3
"8716","sample072","RRG","GRG",1,0,1
"8717","sample072","RRG","GRR",3,2,5
"8718","sample072","RRG","RBB",1,0,1
"8719","sample072","RRR","BBR",1,0,1
"8720","sample072","RRR","BGB",2,0,2
"8721","sample072","RRR","BGG",1,0,1
"8722","sample072","RRR","BRB",1,0,1
"8723","sample072","RRR","BRR",1,0,1
"8724","sample072","RRR","RBB",1,0,1
"8725","sample072","RRR","RGR",1,0,1
"8726","sample072","RRR","RRG",2,0,2
"8727","sample072","BBG","RRR",0,1,1
"8728","sample072","BGG","RGG",0,1,1
"8729","sample072","BGG","RGR",0,1,1
"8730","sample072","BRB","BBB",0,3,3
"8731","sample072","BRB","BRR",0,1,1
"8732","sample072","BRB","GGG",0,1,1
"8733","sample072","BRR","BBB",0,2,2
"8734","sample072","GBB","GGB",0,4,4
"8735","sample072","GBB","GRG",0,2,2
"8736","sample072","GBG","BBR",0,1,1
"8737","sample072","GBG","GGB",0,1,1
"8738","sample072","GGB","BGB",0,1,1
"8739","sample072","GGB","GGR",0,1,1
"8740","sample072","GGB","RBG",0,1,1
"8741","sample072","GGB","RBR",0,1,1
"8742","sample072","GGG","BRR",0,1,1
"8743","sample072","GGG","RBR",0,4,4
"8744","sample072","GGG","RRR",0,1,1
"8745","sample072","GGR","BBB",0,1,1
"8746","sample072","GGR","BBR",0,1,1
"8747","sample072","GRG","BGG",0,1,1
"8748","sample072","GRG","BRR",0,1,1
"8749","sample072","GRG","GBG",0,1,1
"8750","sample072","GRR","BRB",0,1,1
"8751","sample072","GRR","BRR",0,1,1
"8752","sample072","GRR","GGG",0,1,1
"8753","sample072","RBG","RBR",0,1,1
"8754","sample072","RBR","BBB",0,2,2
"8755","sample072","RBR","GGB",0,1,1
"8756","sample072","RBR","RBB",0,2,2
"8757","sample072","RGG","BBB",0,1,1
"8758","sample072","RGG","BRR",0,1,1
"8759","sample072","RGG","GGR",0,1,1
"8760","sample072","RGG","GRR",0,1,1
"8761","sample072","RGR","GGR",0,1,1
"8762","sample072","RRG","BBR",0,1,1
"8763","sample072","RRG","GGR",0,1,1
"8764","sample073","BBB","GGG",1,0,1
"8765","sample073","BBB","RRG",1,0,1
"8766","sample073","BBG","BBB",1,3,4
"8767","sample073","BBG","BRB",1,1,2
"8768","sample073","BBG","GBG",2,0,2
"8769","sample073","BBG","GGB",2,3,5
"8770","sample073","BBG","GGG",4,5,9
"8771","sample073","BBG","GRG",1,0,1
"8772","sample073","BBG","RRG",1,1,2
"8773","sample073","BGG","RBG",1,0,1
"8774","sample073","BGG","RRR",1,0,1
"8775","sample073","BRR","BGB",1,0,1
"8776","sample073","GBB","BBB",12,7,19
"8777","sample073","GBB","BRB",1,2,3
"8778","sample073","GBB","BRR",1,0,1
"8779","sample073","GBB","GGG",7,16,23
"8780","sample073","GBB","GGR",1,1,2
"8781","sample073","GBB","RBG",3,1,4
"8782","sample073","GBB","RBR",1,0,1
"8783","sample073","GBB","RGG",1,0,1
"8784","sample073","GBB","RGR",2,0,2
"8785","sample073","GBB","RRR",1,2,3
"8786","sample073","GBG","BRB",1,1,2
"8787","sample073","GBG","BRR",1,0,1
"8788","sample073","GBG","GGG",4,0,4
"8789","sample073","GBG","RBB",1,0,1
"8790","sample073","GBG","RGR",1,1,2
"8791","sample073","GBG","RRG",1,0,1
"8792","sample073","GGB","BBB",3,1,4
"8793","sample073","GGB","BBR",1,1,2
"8794","sample073","GGB","BRR",1,2,3
"8795","sample073","GGB","GBG",1,0,1
"8796","sample073","GGB","GGG",13,6,19
"8797","sample073","GGB","RGG",1,1,2
"8798","sample073","GGB","RRG",1,2,3
"8799","sample073","GGB","RRR",1,1,2
"8800","sample073","GGG","BBB",8,6,14
"8801","sample073","GGG","BGG",1,0,1
"8802","sample073","GGG","BRB",1,0,1
"8803","sample073","GGG","GGB",5,0,5
"8804","sample073","GGG","GGR",1,3,4
"8805","sample073","GGG","RBB",1,2,3
"8806","sample073","GGG","RGR",1,2,3
"8807","sample073","GGG","RRG",1,0,1
"8808","sample073","GGR","BRR",1,0,1
"8809","sample073","GGR","GRR",1,0,1
"8810","sample073","GRG","BBB",3,3,6
"8811","sample073","GRG","GGB",2,1,3
"8812","sample073","GRG","GGG",3,3,6
"8813","sample073","GRG","RGR",1,1,2
"8814","sample073","GRG","RRG",2,2,4
"8815","sample073","GRR","BGB",1,0,1
"8816","sample073","RBG","BBB",2,3,5
"8817","sample073","RBG","RBB",1,0,1
"8818","sample073","RBR","BGB",2,0,2
"8819","sample073","RBR","BRB",1,0,1
"8820","sample073","RBR","BRR",1,1,2
"8821","sample073","RBR","GRR",4,0,4
"8822","sample073","RBR","RGG",2,2,4
"8823","sample073","RBR","RGR",1,0,1
"8824","sample073","RGG","BBR",1,0,1
"8825","sample073","RGR","BBB",2,1,3
"8826","sample073","RGR","BBR",1,0,1
"8827","sample073","RGR","BGB",2,3,5
"8828","sample073","RGR","BGG",2,0,2
"8829","sample073","RGR","BRR",1,1,2
"8830","sample073","RGR","GGB",2,4,6
"8831","sample073","RGR","RGG",1,0,1
"8832","sample073","RRG","BBB",2,8,10
"8833","sample073","RRG","BGB",1,1,2
"8834","sample073","RRG","BRB",2,5,7
"8835","sample073","RRG","BRR",1,4,5
"8836","sample073","RRG","GGG",2,0,2
"8837","sample073","RRG","GRG",1,0,1
"8838","sample073","RRG","GRR",3,1,4
"8839","sample073","RRG","RBB",1,0,1
"8840","sample073","RRR","BBR",1,0,1
"8841","sample073","RRR","BGB",2,0,2
"8842","sample073","RRR","BGG",1,0,1
"8843","sample073","RRR","BRB",1,0,1
"8844","sample073","RRR","BRR",1,0,1
"8845","sample073","RRR","RBB",1,0,1
"8846","sample073","RRR","RGR",1,1,2
"8847","sample073","RRR","RRG",2,1,3
"8848","sample073","BBB","GRR",0,1,1
"8849","sample073","BBG","RBG",0,2,2
"8850","sample073","BBG","RBR",0,1,1
"8851","sample073","BGB","RRG",0,1,1
"8852","sample073","BGG","BBB",0,1,1
"8853","sample073","BRR","BBB",0,2,2
"8854","sample073","BRR","RBB",0,1,1
"8855","sample073","GBB","GBG",0,1,1
"8856","sample073","GBB","GGB",0,5,5
"8857","sample073","GBB","GRG",0,2,2
"8858","sample073","GGB","BGB",0,1,1
"8859","sample073","GGB","BGG",0,1,1
"8860","sample073","GGB","BRB",0,1,1
"8861","sample073","GGB","RBB",0,1,1
"8862","sample073","GGB","RBR",0,1,1
"8863","sample073","GGG","GRR",0,1,1
"8864","sample073","GGG","RBR",0,3,3
"8865","sample073","GGG","RGG",0,1,1
"8866","sample073","GRG","BRR",0,1,1
"8867","sample073","RBB","BBB",0,1,1
"8868","sample073","RBR","BBB",0,4,4
"8869","sample073","RBR","BGG",0,2,2
"8870","sample073","RBR","GGB",0,2,2
"8871","sample073","RBR","RRR",0,1,1
"8872","sample073","RGG","BBB",0,1,1
"8873","sample073","RGG","GRR",0,1,1
"8874","sample073","RGG","RBB",0,1,1
"8875","sample073","RRG","RGG",0,1,1
"8876","sample073","RRR","RGG",0,1,1
"8877","sample074","BBB","GGG",1,1,2
"8878","sample074","BBB","RRG",1,0,1
"8879","sample074","BBG","BBB",1,0,1
"8880","sample074","BBG","BRB",1,2,3
"8881","sample074","BBG","GBG",2,0,2
"8882","sample074","BBG","GGB",2,7,9
"8883","sample074","BBG","GGG",4,3,7
"8884","sample074","BBG","GRG",1,1,2
"8885","sample074","BBG","RRG",1,0,1
"8886","sample074","BGG","RBG",1,0,1
"8887","sample074","BGG","RRR",1,0,1
"8888","sample074","BRR","BGB",1,0,1
"8889","sample074","GBB","BBB",12,7,19
"8890","sample074","GBB","BRB",1,1,2
"8891","sample074","GBB","BRR",1,0,1
"8892","sample074","GBB","GGG",7,10,17
"8893","sample074","GBB","GGR",1,1,2
"8894","sample074","GBB","RBG",3,1,4
"8895","sample074","GBB","RBR",1,0,1
"8896","sample074","GBB","RGG",1,0,1
"8897","sample074","GBB","RGR",2,0,2
"8898","sample074","GBB","RRR",1,1,2
"8899","sample074","GBG","BRB",1,3,4
"8900","sample074","GBG","BRR",1,0,1
"8901","sample074","GBG","GGG",4,4,8
"8902","sample074","GBG","RBB",1,0,1
"8903","sample074","GBG","RGR",1,0,1
"8904","sample074","GBG","RRG",1,0,1
"8905","sample074","GGB","BBB",3,1,4
"8906","sample074","GGB","BBR",1,0,1
"8907","sample074","GGB","BRR",1,4,5
"8908","sample074","GGB","GBG",1,0,1
"8909","sample074","GGB","GGG",13,6,19
"8910","sample074","GGB","RGG",1,1,2
"8911","sample074","GGB","RRG",1,0,1
"8912","sample074","GGB","RRR",1,0,1
"8913","sample074","GGG","BBB",8,7,15
"8914","sample074","GGG","BGG",1,1,2
"8915","sample074","GGG","BRB",1,1,2
"8916","sample074","GGG","GGB",5,1,6
"8917","sample074","GGG","GGR",1,1,2
"8918","sample074","GGG","RBB",1,2,3
"8919","sample074","GGG","RGR",1,1,2
"8920","sample074","GGG","RRG",1,4,5
"8921","sample074","GGR","BRR",1,0,1
"8922","sample074","GGR","GRR",1,0,1
"8923","sample074","GRG","BBB",3,2,5
"8924","sample074","GRG","GGB",2,2,4
"8925","sample074","GRG","GGG",3,3,6
"8926","sample074","GRG","RGR",1,0,1
"8927","sample074","GRG","RRG",2,0,2
"8928","sample074","GRR","BGB",1,0,1
"8929","sample074","RBG","BBB",2,2,4
"8930","sample074","RBG","RBB",1,0,1
"8931","sample074","RBR","BGB",2,1,3
"8932","sample074","RBR","BRB",1,0,1
"8933","sample074","RBR","BRR",1,0,1
"8934","sample074","RBR","GRR",4,0,4
"8935","sample074","RBR","RGG",2,0,2
"8936","sample074","RBR","RGR",1,0,1
"8937","sample074","RGG","BBR",1,0,1
"8938","sample074","RGR","BBB",2,0,2
"8939","sample074","RGR","BBR",1,0,1
"8940","sample074","RGR","BGB",2,1,3
"8941","sample074","RGR","BGG",2,0,2
"8942","sample074","RGR","BRR",1,0,1
"8943","sample074","RGR","GGB",2,4,6
"8944","sample074","RGR","RGG",1,0,1
"8945","sample074","RRG","BBB",2,3,5
"8946","sample074","RRG","BGB",1,0,1
"8947","sample074","RRG","BRB",2,4,6
"8948","sample074","RRG","BRR",1,1,2
"8949","sample074","RRG","GGG",2,5,7
"8950","sample074","RRG","GRG",1,0,1
"8951","sample074","RRG","GRR",3,1,4
"8952","sample074","RRG","RBB",1,0,1
"8953","sample074","RRR","BBR",1,0,1
"8954","sample074","RRR","BGB",2,0,2
"8955","sample074","RRR","BGG",1,0,1
"8956","sample074","RRR","BRB",1,0,1
"8957","sample074","RRR","BRR",1,0,1
"8958","sample074","RRR","RBB",1,0,1
"8959","sample074","RRR","RGR",1,0,1
"8960","sample074","RRR","RRG",2,0,2
"8961","sample074","BBB","GRR",0,2,2
"8962","sample074","BBB","RRR",0,2,2
"8963","sample074","BBG","RBG",0,1,1
"8964","sample074","BGB","BBB",0,1,1
"8965","sample074","BGG","BBR",0,1,1
"8966","sample074","BGG","RGG",0,2,2
"8967","sample074","BRB","BBB",0,2,2
"8968","sample074","BRB","RBG",0,1,1
"8969","sample074","BRB","RGR",0,1,1
"8970","sample074","BRR","BBB",0,3,3
"8971","sample074","GBB","GGB",0,5,5
"8972","sample074","GBB","GRR",0,1,1
"8973","sample074","GBG","BBR",0,1,1
"8974","sample074","GGB","BGB",0,1,1
"8975","sample074","GGB","BGG",0,1,1
"8976","sample074","GGB","GGR",0,1,1
"8977","sample074","GGB","RBB",0,2,2
"8978","sample074","GGG","BGB",0,1,1
"8979","sample074","GGG","RBG",0,1,1
"8980","sample074","GGG","RBR",0,3,3
"8981","sample074","GGG","RRR",0,1,1
"8982","sample074","GGR","BBB",0,1,1
"8983","sample074","GGR","BBR",0,1,1
"8984","sample074","GRG","BGG",0,1,1
"8985","sample074","GRG","BRR",0,1,1
"8986","sample074","GRR","GGG",0,1,1
"8987","sample074","GRR","GGR",0,1,1
"8988","sample074","RBB","GRR",0,1,1
"8989","sample074","RBR","BBB",0,1,1
"8990","sample074","RBR","BGG",0,2,2
"8991","sample074","RBR","GGB",0,2,2
"8992","sample074","RGG","BBB",0,2,2
"8993","sample074","RGG","GGG",0,1,1
"8994","sample074","RGG","GRR",0,2,2
"8995","sample074","RGR","GGG",0,1,1
"8996","sample074","RGR","GGR",0,2,2
"8997","sample074","RGR","RBB",0,1,1
"8998","sample074","RRG","BBR",0,2,2
"8999","sample074","RRG","GGR",0,1,1
"9000","sample074","RRR","GGR",0,1,1
"9001","sample075","BBB","GGG",1,1,2
"9002","sample075","BBB","RRG",1,1,2
"9003","sample075","BBG","BBB",1,1,2
"9004","sample075","BBG","BRB",1,1,2
"9005","sample075","BBG","GBG",2,0,2
"9006","sample075","BBG","GGB",2,4,6
"9007","sample075","BBG","GGG",4,6,10
"9008","sample075","BBG","GRG",1,0,1
"9009","sample075","BBG","RRG",1,1,2
"9010","sample075","BGG","RBG",1,0,1
"9011","sample075","BGG","RRR",1,0,1
"9012","sample075","BRR","BGB",1,0,1
"9013","sample075","GBB","BBB",12,7,19
"9014","sample075","GBB","BRB",1,1,2
"9015","sample075","GBB","BRR",1,0,1
"9016","sample075","GBB","GGG",7,15,22
"9017","sample075","GBB","GGR",1,0,1
"9018","sample075","GBB","RBG",3,3,6
"9019","sample075","GBB","RBR",1,0,1
"9020","sample075","GBB","RGG",1,0,1
"9021","sample075","GBB","RGR",2,0,2
"9022","sample075","GBB","RRR",1,2,3
"9023","sample075","GBG","BRB",1,1,2
"9024","sample075","GBG","BRR",1,0,1
"9025","sample075","GBG","GGG",4,1,5
"9026","sample075","GBG","RBB",1,0,1
"9027","sample075","GBG","RGR",1,1,2
"9028","sample075","GBG","RRG",1,1,2
"9029","sample075","GGB","BBB",3,3,6
"9030","sample075","GGB","BBR",1,0,1
"9031","sample075","GGB","BRR",1,1,2
"9032","sample075","GGB","GBG",1,0,1
"9033","sample075","GGB","GGG",13,9,22
"9034","sample075","GGB","RGG",1,0,1
"9035","sample075","GGB","RRG",1,1,2
"9036","sample075","GGB","RRR",1,0,1
"9037","sample075","GGG","BBB",8,3,11
"9038","sample075","GGG","BGG",1,1,2
"9039","sample075","GGG","BRB",1,0,1
"9040","sample075","GGG","GGB",5,0,5
"9041","sample075","GGG","GGR",1,3,4
"9042","sample075","GGG","RBB",1,2,3
"9043","sample075","GGG","RGR",1,0,1
"9044","sample075","GGG","RRG",1,4,5
"9045","sample075","GGR","BRR",1,0,1
"9046","sample075","GGR","GRR",1,0,1
"9047","sample075","GRG","BBB",3,1,4
"9048","sample075","GRG","GGB",2,2,4
"9049","sample075","GRG","GGG",3,1,4
"9050","sample075","GRG","RGR",1,0,1
"9051","sample075","GRG","RRG",2,1,3
"9052","sample075","GRR","BGB",1,0,1
"9053","sample075","RBG","BBB",2,0,2
"9054","sample075","RBG","RBB",1,0,1
"9055","sample075","RBR","BGB",2,1,3
"9056","sample075","RBR","BRB",1,0,1
"9057","sample075","RBR","BRR",1,0,1
"9058","sample075","RBR","GRR",4,0,4
"9059","sample075","RBR","RGG",2,0,2
"9060","sample075","RBR","RGR",1,0,1
"9061","sample075","RGG","BBR",1,0,1
"9062","sample075","RGR","BBB",2,1,3
"9063","sample075","RGR","BBR",1,0,1
"9064","sample075","RGR","BGB",2,3,5
"9065","sample075","RGR","BGG",2,1,3
"9066","sample075","RGR","BRR",1,0,1
"9067","sample075","RGR","GGB",2,3,5
"9068","sample075","RGR","RGG",1,0,1
"9069","sample075","RRG","BBB",2,1,3
"9070","sample075","RRG","BGB",1,0,1
"9071","sample075","RRG","BRB",2,5,7
"9072","sample075","RRG","BRR",1,5,6
"9073","sample075","RRG","GGG",2,3,5
"9074","sample075","RRG","GRG",1,0,1
"9075","sample075","RRG","GRR",3,2,5
"9076","sample075","RRG","RBB",1,0,1
"9077","sample075","RRR","BBR",1,0,1
"9078","sample075","RRR","BGB",2,0,2
"9079","sample075","RRR","BGG",1,0,1
"9080","sample075","RRR","BRB",1,0,1
"9081","sample075","RRR","BRR",1,0,1
"9082","sample075","RRR","RBB",1,0,1
"9083","sample075","RRR","RGR",1,1,2
"9084","sample075","RRR","RRG",2,0,2
"9085","sample075","BBB","RRR",0,1,1
"9086","sample075","BBG","BGB",0,1,1
"9087","sample075","BBG","GRR",0,1,1
"9088","sample075","BBG","RBG",0,1,1
"9089","sample075","BBG","RRR",0,2,2
"9090","sample075","BGG","BBB",0,1,1
"9091","sample075","BGG","RGG",0,1,1
"9092","sample075","BRB","BBB",0,1,1
"9093","sample075","BRR","BBB",0,4,4
"9094","sample075","GBB","GBG",0,1,1
"9095","sample075","GBB","GGB",0,4,4
"9096","sample075","GBB","GRG",0,1,1
"9097","sample075","GBB","RBB",0,1,1
"9098","sample075","GBB","RRG",0,1,1
"9099","sample075","GBG","BBB",0,2,2
"9100","sample075","GGB","BGB",0,1,1
"9101","sample075","GGB","GBB",0,1,1
"9102","sample075","GGB","GGR",0,1,1
"9103","sample075","GGB","RGR",0,2,2
"9104","sample075","GGG","BRR",0,1,1
"9105","sample075","GGG","RBR",0,4,4
"9106","sample075","GGG","RGG",0,1,1
"9107","sample075","GRG","BRB",0,1,1
"9108","sample075","GRG","GGR",0,2,2
"9109","sample075","GRR","BBR",0,1,1
"9110","sample075","GRR","BGG",0,1,1
"9111","sample075","GRR","BRB",0,1,1
"9112","sample075","RBB","BRB",0,1,1
"9113","sample075","RBG","GBB",0,1,1
"9114","sample075","RBG","GRR",0,1,1
"9115","sample075","RBR","BBB",0,3,3
"9116","sample075","RBR","GGB",0,1,1
"9117","sample075","RBR","RBB",0,1,1
"9118","sample075","RGG","BGB",0,1,1
"9119","sample075","RGG","GRR",0,2,2
"9120","sample075","RGR","GGG",0,1,1
"9121","sample075","RGR","RBB",0,2,2
"9122","sample075","RRG","GGR",0,1,1
"9123","sample076","BBB","GGG",1,0,1
"9124","sample076","BBB","RRG",1,0,1
"9125","sample076","BBG","BBB",1,0,1
"9126","sample076","BBG","BRB",1,2,3
"9127","sample076","BBG","GBG",2,2,4
"9128","sample076","BBG","GGB",2,3,5
"9129","sample076","BBG","GGG",4,1,5
"9130","sample076","BBG","GRG",1,2,3
"9131","sample076","BBG","RRG",1,0,1
"9132","sample076","BGG","RBG",1,0,1
"9133","sample076","BGG","RRR",1,0,1
"9134","sample076","BRR","BGB",1,0,1
"9135","sample076","GBB","BBB",12,3,15
"9136","sample076","GBB","BRB",1,1,2
"9137","sample076","GBB","BRR",1,0,1
"9138","sample076","GBB","GGG",7,9,16
"9139","sample076","GBB","GGR",1,0,1
"9140","sample076","GBB","RBG",3,2,5
"9141","sample076","GBB","RBR",1,0,1
"9142","sample076","GBB","RGG",1,0,1
"9143","sample076","GBB","RGR",2,0,2
"9144","sample076","GBB","RRR",1,0,1
"9145","sample076","GBG","BRB",1,0,1
"9146","sample076","GBG","BRR",1,0,1
"9147","sample076","GBG","GGG",4,1,5
"9148","sample076","GBG","RBB",1,0,1
"9149","sample076","GBG","RGR",1,0,1
"9150","sample076","GBG","RRG",1,0,1
"9151","sample076","GGB","BBB",3,3,6
"9152","sample076","GGB","BBR",1,1,2
"9153","sample076","GGB","BRR",1,6,7
"9154","sample076","GGB","GBG",1,0,1
"9155","sample076","GGB","GGG",13,11,24
"9156","sample076","GGB","RGG",1,2,3
"9157","sample076","GGB","RRG",1,0,1
"9158","sample076","GGB","RRR",1,0,1
"9159","sample076","GGG","BBB",8,6,14
"9160","sample076","GGG","BGG",1,2,3
"9161","sample076","GGG","BRB",1,1,2
"9162","sample076","GGG","GGB",5,0,5
"9163","sample076","GGG","GGR",1,1,2
"9164","sample076","GGG","RBB",1,2,3
"9165","sample076","GGG","RGR",1,2,3
"9166","sample076","GGG","RRG",1,3,4
"9167","sample076","GGR","BRR",1,0,1
"9168","sample076","GGR","GRR",1,0,1
"9169","sample076","GRG","BBB",3,1,4
"9170","sample076","GRG","GGB",2,5,7
"9171","sample076","GRG","GGG",3,1,4
"9172","sample076","GRG","RGR",1,1,2
"9173","sample076","GRG","RRG",2,1,3
"9174","sample076","GRR","BGB",1,1,2
"9175","sample076","RBG","BBB",2,1,3
"9176","sample076","RBG","RBB",1,0,1
"9177","sample076","RBR","BGB",2,1,3
"9178","sample076","RBR","BRB",1,0,1
"9179","sample076","RBR","BRR",1,0,1
"9180","sample076","RBR","GRR",4,0,4
"9181","sample076","RBR","RGG",2,1,3
"9182","sample076","RBR","RGR",1,0,1
"9183","sample076","RGG","BBR",1,0,1
"9184","sample076","RGR","BBB",2,0,2
"9185","sample076","RGR","BBR",1,0,1
"9186","sample076","RGR","BGB",2,1,3
"9187","sample076","RGR","BGG",2,0,2
"9188","sample076","RGR","BRR",1,1,2
"9189","sample076","RGR","GGB",2,1,3
"9190","sample076","RGR","RGG",1,1,2
"9191","sample076","RRG","BBB",2,5,7
"9192","sample076","RRG","BGB",1,2,3
"9193","sample076","RRG","BRB",2,11,13
"9194","sample076","RRG","BRR",1,4,5
"9195","sample076","RRG","GGG",2,3,5
"9196","sample076","RRG","GRG",1,0,1
"9197","sample076","RRG","GRR",3,1,4
"9198","sample076","RRG","RBB",1,0,1
"9199","sample076","RRR","BBR",1,0,1
"9200","sample076","RRR","BGB",2,1,3
"9201","sample076","RRR","BGG",1,0,1
"9202","sample076","RRR","BRB",1,1,2
"9203","sample076","RRR","BRR",1,0,1
"9204","sample076","RRR","RBB",1,0,1
"9205","sample076","RRR","RGR",1,1,2
"9206","sample076","RRR","RRG",2,0,2
"9207","sample076","BBG","BGB",0,1,1
"9208","sample076","BBG","BGG",0,1,1
"9209","sample076","BBG","RBB",0,1,1
"9210","sample076","BRB","BBB",0,1,1
"9211","sample076","BRB","GGG",0,1,1
"9212","sample076","BRB","RBB",0,1,1
"9213","sample076","BRR","BBB",0,3,3
"9214","sample076","BRR","RBB",0,1,1
"9215","sample076","GBB","GBG",0,1,1
"9216","sample076","GBB","GGB",0,3,3
"9217","sample076","GBB","GRR",0,1,1
"9218","sample076","GGB","BGG",0,1,1
"9219","sample076","GGB","GGR",0,1,1
"9220","sample076","GGB","RBB",0,1,1
"9221","sample076","GGB","RBG",0,1,1
"9222","sample076","GGB","RBR",0,1,1
"9223","sample076","GGG","BGB",0,1,1
"9224","sample076","GGG","BRR",0,1,1
"9225","sample076","GGG","RBG",0,1,1
"9226","sample076","GGG","RBR",0,7,7
"9227","sample076","GRG","BBR",0,1,1
"9228","sample076","GRG","BGG",0,1,1
"9229","sample076","GRG","GBG",0,1,1
"9230","sample076","GRR","BRR",0,1,1
"9231","sample076","RBB","RGG",0,1,1
"9232","sample076","RBG","RGR",0,1,1
"9233","sample076","RBR","BBB",0,1,1
"9234","sample076","RBR","BBR",0,1,1
"9235","sample076","RBR","BGG",0,1,1
"9236","sample076","RBR","GGB",0,1,1
"9237","sample076","RGG","BBB",0,2,2
"9238","sample076","RGG","GRR",0,1,1
"9239","sample076","RGR","RBB",0,1,1
"9240","sample076","RGR","RRG",0,1,1
"9241","sample076","RRG","BGG",0,2,2
"9242","sample076","RRR","GRR",0,1,1
"9243","sample077","BBB","GGG",1,0,1
"9244","sample077","BBB","RRG",1,0,1
"9245","sample077","BBG","BBB",1,0,1
"9246","sample077","BBG","BRB",1,3,4
"9247","sample077","BBG","GBG",2,0,2
"9248","sample077","BBG","GGB",2,4,6
"9249","sample077","BBG","GGG",4,5,9
"9250","sample077","BBG","GRG",1,3,4
"9251","sample077","BBG","RRG",1,1,2
"9252","sample077","BGG","RBG",1,0,1
"9253","sample077","BGG","RRR",1,0,1
"9254","sample077","BRR","BGB",1,0,1
"9255","sample077","GBB","BBB",12,5,17
"9256","sample077","GBB","BRB",1,2,3
"9257","sample077","GBB","BRR",1,0,1
"9258","sample077","GBB","GGG",7,6,13
"9259","sample077","GBB","GGR",1,2,3
"9260","sample077","GBB","RBG",3,2,5
"9261","sample077","GBB","RBR",1,0,1
"9262","sample077","GBB","RGG",1,0,1
"9263","sample077","GBB","RGR",2,0,2
"9264","sample077","GBB","RRR",1,1,2
"9265","sample077","GBG","BRB",1,3,4
"9266","sample077","GBG","BRR",1,0,1
"9267","sample077","GBG","GGG",4,1,5
"9268","sample077","GBG","RBB",1,0,1
"9269","sample077","GBG","RGR",1,0,1
"9270","sample077","GBG","RRG",1,0,1
"9271","sample077","GGB","BBB",3,1,4
"9272","sample077","GGB","BBR",1,0,1
"9273","sample077","GGB","BRR",1,4,5
"9274","sample077","GGB","GBG",1,0,1
"9275","sample077","GGB","GGG",13,10,23
"9276","sample077","GGB","RGG",1,2,3
"9277","sample077","GGB","RRG",1,0,1
"9278","sample077","GGB","RRR",1,0,1
"9279","sample077","GGG","BBB",8,2,10
"9280","sample077","GGG","BGG",1,1,2
"9281","sample077","GGG","BRB",1,1,2
"9282","sample077","GGG","GGB",5,0,5
"9283","sample077","GGG","GGR",1,0,1
"9284","sample077","GGG","RBB",1,1,2
"9285","sample077","GGG","RGR",1,3,4
"9286","sample077","GGG","RRG",1,1,2
"9287","sample077","GGR","BRR",1,0,1
"9288","sample077","GGR","GRR",1,0,1
"9289","sample077","GRG","BBB",3,1,4
"9290","sample077","GRG","GGB",2,2,4
"9291","sample077","GRG","GGG",3,3,6
"9292","sample077","GRG","RGR",1,1,2
"9293","sample077","GRG","RRG",2,0,2
"9294","sample077","GRR","BGB",1,1,2
"9295","sample077","RBG","BBB",2,2,4
"9296","sample077","RBG","RBB",1,0,1
"9297","sample077","RBR","BGB",2,0,2
"9298","sample077","RBR","BRB",1,0,1
"9299","sample077","RBR","BRR",1,1,2
"9300","sample077","RBR","GRR",4,2,6
"9301","sample077","RBR","RGG",2,0,2
"9302","sample077","RBR","RGR",1,0,1
"9303","sample077","RGG","BBR",1,1,2
"9304","sample077","RGR","BBB",2,0,2
"9305","sample077","RGR","BBR",1,0,1
"9306","sample077","RGR","BGB",2,1,3
"9307","sample077","RGR","BGG",2,0,2
"9308","sample077","RGR","BRR",1,0,1
"9309","sample077","RGR","GGB",2,5,7
"9310","sample077","RGR","RGG",1,0,1
"9311","sample077","RRG","BBB",2,4,6
"9312","sample077","RRG","BGB",1,2,3
"9313","sample077","RRG","BRB",2,4,6
"9314","sample077","RRG","BRR",1,1,2
"9315","sample077","RRG","GGG",2,5,7
"9316","sample077","RRG","GRG",1,0,1
"9317","sample077","RRG","GRR",3,1,4
"9318","sample077","RRG","RBB",1,0,1
"9319","sample077","RRR","BBR",1,0,1
"9320","sample077","RRR","BGB",2,0,2
"9321","sample077","RRR","BGG",1,0,1
"9322","sample077","RRR","BRB",1,0,1
"9323","sample077","RRR","BRR",1,0,1
"9324","sample077","RRR","RBB",1,0,1
"9325","sample077","RRR","RGR",1,0,1
"9326","sample077","RRR","RRG",2,1,3
"9327","sample077","BBG","RBB",0,1,1
"9328","sample077","BBG","RRR",0,1,1
"9329","sample077","BGB","RRG",0,1,1
"9330","sample077","BGG","BBB",0,1,1
"9331","sample077","BRB","BBB",0,3,3
"9332","sample077","BRR","BBB",0,3,3
"9333","sample077","BRR","BGG",0,1,1
"9334","sample077","GBB","BGG",0,1,1
"9335","sample077","GBB","GBG",0,1,1
"9336","sample077","GBB","GGB",0,7,7
"9337","sample077","GBB","GRG",0,1,1
"9338","sample077","GBG","GGB",0,1,1
"9339","sample077","GBG","RGG",0,1,1
"9340","sample077","GGB","BGB",0,1,1
"9341","sample077","GGB","BGG",0,1,1
"9342","sample077","GGB","GGR",0,4,4
"9343","sample077","GGB","RBB",0,1,1
"9344","sample077","GGB","RBG",0,1,1
"9345","sample077","GGG","BGB",0,1,1
"9346","sample077","GGG","GRR",0,2,2
"9347","sample077","GGG","RBG",0,1,1
"9348","sample077","GGG","RBR",0,4,4
"9349","sample077","GRG","BRB",0,2,2
"9350","sample077","GRG","GGR",0,1,1
"9351","sample077","GRR","GGG",0,1,1
"9352","sample077","RBG","RBR",0,1,1
"9353","sample077","RBR","BBB",0,4,4
"9354","sample077","RGG","BBB",0,1,1
"9355","sample077","RGG","BGB",0,1,1
"9356","sample077","RGG","GGR",0,1,1
"9357","sample077","RGG","GRR",0,1,1
"9358","sample077","RGR","GGR",0,1,1
"9359","sample077","RGR","RBB",0,1,1
"9360","sample077","RGR","RRG",0,1,1
"9361","sample077","RRG","GGR",0,2,2
"9362","sample077","RRR","GRR",0,1,1
"9363","sample078","BBB","GGG",1,0,1
"9364","sample078","BBB","RRG",1,0,1
"9365","sample078","BBG","BBB",1,1,2
"9366","sample078","BBG","BRB",1,2,3
"9367","sample078","BBG","GBG",2,1,3
"9368","sample078","BBG","GGB",2,5,7
"9369","sample078","BBG","GGG",4,3,7
"9370","sample078","BBG","GRG",1,0,1
"9371","sample078","BBG","RRG",1,0,1
"9372","sample078","BGG","RBG",1,0,1
"9373","sample078","BGG","RRR",1,0,1
"9374","sample078","BRR","BGB",1,1,2
"9375","sample078","GBB","BBB",12,7,19
"9376","sample078","GBB","BRB",1,2,3
"9377","sample078","GBB","BRR",1,1,2
"9378","sample078","GBB","GGG",7,15,22
"9379","sample078","GBB","GGR",1,1,2
"9380","sample078","GBB","RBG",3,2,5
"9381","sample078","GBB","RBR",1,0,1
"9382","sample078","GBB","RGG",1,0,1
"9383","sample078","GBB","RGR",2,0,2
"9384","sample078","GBB","RRR",1,1,2
"9385","sample078","GBG","BRB",1,0,1
"9386","sample078","GBG","BRR",1,0,1
"9387","sample078","GBG","GGG",4,2,6
"9388","sample078","GBG","RBB",1,0,1
"9389","sample078","GBG","RGR",1,0,1
"9390","sample078","GBG","RRG",1,1,2
"9391","sample078","GGB","BBB",3,2,5
"9392","sample078","GGB","BBR",1,0,1
"9393","sample078","GGB","BRR",1,3,4
"9394","sample078","GGB","GBG",1,0,1
"9395","sample078","GGB","GGG",13,5,18
"9396","sample078","GGB","RGG",1,0,1
"9397","sample078","GGB","RRG",1,0,1
"9398","sample078","GGB","RRR",1,0,1
"9399","sample078","GGG","BBB",8,4,12
"9400","sample078","GGG","BGG",1,1,2
"9401","sample078","GGG","BRB",1,1,2
"9402","sample078","GGG","GGB",5,0,5
"9403","sample078","GGG","GGR",1,1,2
"9404","sample078","GGG","RBB",1,2,3
"9405","sample078","GGG","RGR",1,0,1
"9406","sample078","GGG","RRG",1,5,6
"9407","sample078","GGR","BRR",1,0,1
"9408","sample078","GGR","GRR",1,0,1
"9409","sample078","GRG","BBB",3,3,6
"9410","sample078","GRG","GGB",2,2,4
"9411","sample078","GRG","GGG",3,0,3
"9412","sample078","GRG","RGR",1,1,2
"9413","sample078","GRG","RRG",2,2,4
"9414","sample078","GRR","BGB",1,0,1
"9415","sample078","RBG","BBB",2,3,5
"9416","sample078","RBG","RBB",1,0,1
"9417","sample078","RBR","BGB",2,1,3
"9418","sample078","RBR","BRB",1,0,1
"9419","sample078","RBR","BRR",1,0,1
"9420","sample078","RBR","GRR",4,1,5
"9421","sample078","RBR","RGG",2,1,3
"9422","sample078","RBR","RGR",1,0,1
"9423","sample078","RGG","BBR",1,0,1
"9424","sample078","RGR","BBB",2,0,2
"9425","sample078","RGR","BBR",1,0,1
"9426","sample078","RGR","BGB",2,2,4
"9427","sample078","RGR","BGG",2,0,2
"9428","sample078","RGR","BRR",1,0,1
"9429","sample078","RGR","GGB",2,0,2
"9430","sample078","RGR","RGG",1,0,1
"9431","sample078","RRG","BBB",2,7,9
"9432","sample078","RRG","BGB",1,2,3
"9433","sample078","RRG","BRB",2,5,7
"9434","sample078","RRG","BRR",1,4,5
"9435","sample078","RRG","GGG",2,1,3
"9436","sample078","RRG","GRG",1,0,1
"9437","sample078","RRG","GRR",3,1,4
"9438","sample078","RRG","RBB",1,0,1
"9439","sample078","RRR","BBR",1,0,1
"9440","sample078","RRR","BGB",2,1,3
"9441","sample078","RRR","BGG",1,0,1
"9442","sample078","RRR","BRB",1,1,2
"9443","sample078","RRR","BRR",1,0,1
"9444","sample078","RRR","RBB",1,0,1
"9445","sample078","RRR","RGR",1,0,1
"9446","sample078","RRR","RRG",2,0,2
"9447","sample078","BBB","BRB",0,1,1
"9448","sample078","BBG","RBG",0,1,1
"9449","sample078","BBG","RRR",0,2,2
"9450","sample078","BGG","GRG",0,1,1
"9451","sample078","BRB","BBB",0,2,2
"9452","sample078","BRB","BBR",0,1,1
"9453","sample078","BRB","BRR",0,1,1
"9454","sample078","BRB","GGR",0,1,1
"9455","sample078","BRB","RRR",0,1,1
"9456","sample078","BRR","BBB",0,2,2
"9457","sample078","GBB","GBG",0,1,1
"9458","sample078","GBB","GGB",0,3,3
"9459","sample078","GBB","GRG",0,3,3
"9460","sample078","GBG","BBB",0,1,1
"9461","sample078","GBG","GGB",0,1,1
"9462","sample078","GGB","BGG",0,2,2
"9463","sample078","GGB","GGR",0,1,1
"9464","sample078","GGB","GRR",0,1,1
"9465","sample078","GGG","RBR",0,5,5
"9466","sample078","GGG","RGG",0,1,1
"9467","sample078","GGG","RRR",0,1,1
"9468","sample078","GRG","BGG",0,1,1
"9469","sample078","GRR","BGG",0,1,1
"9470","sample078","GRR","BRR",0,1,1
"9471","sample078","RBG","RBR",0,1,1
"9472","sample078","RBR","BBB",0,3,3
"9473","sample078","RBR","GGB",0,2,2
"9474","sample078","RBR","RBB",0,1,1
"9475","sample078","RGG","BBB",0,1,1
"9476","sample078","RGG","BRR",0,1,1
"9477","sample078","RGG","GGR",0,1,1
"9478","sample078","RGG","GRR",0,1,1
"9479","sample078","RGG","RBB",0,1,1
"9480","sample078","RGR","GGR",0,1,1
"9481","sample078","RRG","BBR",0,1,1
"9482","sample078","RRG","BGG",0,1,1
"9483","sample078","RRG","GGR",0,1,1
"9484","sample078","RRG","RGR",0,1,1
"9485","sample079","BBB","GGG",1,0,1
"9486","sample079","BBB","RRG",1,0,1
"9487","sample079","BBG","BBB",1,0,1
"9488","sample079","BBG","BRB",1,2,3
"9489","sample079","BBG","GBG",2,0,2
"9490","sample079","BBG","GGB",2,4,6
"9491","sample079","BBG","GGG",4,8,12
"9492","sample079","BBG","GRG",1,2,3
"9493","sample079","BBG","RRG",1,0,1
"9494","sample079","BGG","RBG",1,1,2
"9495","sample079","BGG","RRR",1,0,1
"9496","sample079","BRR","BGB",1,0,1
"9497","sample079","GBB","BBB",12,5,17
"9498","sample079","GBB","BRB",1,1,2
"9499","sample079","GBB","BRR",1,1,2
"9500","sample079","GBB","GGG",7,6,13
"9501","sample079","GBB","GGR",1,0,1
"9502","sample079","GBB","RBG",3,1,4
"9503","sample079","GBB","RBR",1,0,1
"9504","sample079","GBB","RGG",1,0,1
"9505","sample079","GBB","RGR",2,0,2
"9506","sample079","GBB","RRR",1,1,2
"9507","sample079","GBG","BRB",1,0,1
"9508","sample079","GBG","BRR",1,0,1
"9509","sample079","GBG","GGG",4,4,8
"9510","sample079","GBG","RBB",1,0,1
"9511","sample079","GBG","RGR",1,0,1
"9512","sample079","GBG","RRG",1,0,1
"9513","sample079","GGB","BBB",3,1,4
"9514","sample079","GGB","BBR",1,0,1
"9515","sample079","GGB","BRR",1,2,3
"9516","sample079","GGB","GBG",1,0,1
"9517","sample079","GGB","GGG",13,8,21
"9518","sample079","GGB","RGG",1,1,2
"9519","sample079","GGB","RRG",1,1,2
"9520","sample079","GGB","RRR",1,0,1
"9521","sample079","GGG","BBB",8,5,13
"9522","sample079","GGG","BGG",1,1,2
"9523","sample079","GGG","BRB",1,1,2
"9524","sample079","GGG","GGB",5,1,6
"9525","sample079","GGG","GGR",1,2,3
"9526","sample079","GGG","RBB",1,1,2
"9527","sample079","GGG","RGR",1,3,4
"9528","sample079","GGG","RRG",1,5,6
"9529","sample079","GGR","BRR",1,0,1
"9530","sample079","GGR","GRR",1,0,1
"9531","sample079","GRG","BBB",3,1,4
"9532","sample079","GRG","GGB",2,1,3
"9533","sample079","GRG","GGG",3,1,4
"9534","sample079","GRG","RGR",1,1,2
"9535","sample079","GRG","RRG",2,0,2
"9536","sample079","GRR","BGB",1,0,1
"9537","sample079","RBG","BBB",2,3,5
"9538","sample079","RBG","RBB",1,0,1
"9539","sample079","RBR","BGB",2,0,2
"9540","sample079","RBR","BRB",1,0,1
"9541","sample079","RBR","BRR",1,0,1
"9542","sample079","RBR","GRR",4,0,4
"9543","sample079","RBR","RGG",2,1,3
"9544","sample079","RBR","RGR",1,0,1
"9545","sample079","RGG","BBR",1,0,1
"9546","sample079","RGR","BBB",2,0,2
"9547","sample079","RGR","BBR",1,0,1
"9548","sample079","RGR","BGB",2,0,2
"9549","sample079","RGR","BGG",2,0,2
"9550","sample079","RGR","BRR",1,0,1
"9551","sample079","RGR","GGB",2,3,5
"9552","sample079","RGR","RGG",1,0,1
"9553","sample079","RRG","BBB",2,5,7
"9554","sample079","RRG","BGB",1,2,3
"9555","sample079","RRG","BRB",2,2,4
"9556","sample079","RRG","BRR",1,4,5
"9557","sample079","RRG","GGG",2,2,4
"9558","sample079","RRG","GRG",1,0,1
"9559","sample079","RRG","GRR",3,3,6
"9560","sample079","RRG","RBB",1,0,1
"9561","sample079","RRR","BBR",1,0,1
"9562","sample079","RRR","BGB",2,0,2
"9563","sample079","RRR","BGG",1,0,1
"9564","sample079","RRR","BRB",1,0,1
"9565","sample079","RRR","BRR",1,1,2
"9566","sample079","RRR","RBB",1,1,2
"9567","sample079","RRR","RGR",1,0,1
"9568","sample079","RRR","RRG",2,0,2
"9569","sample079","BBG","BGG",0,1,1
"9570","sample079","BBG","GRR",0,1,1
"9571","sample079","BBG","RBG",0,1,1
"9572","sample079","BBG","RRR",0,3,3
"9573","sample079","BGB","BBB",0,1,1
"9574","sample079","BGG","BBR",0,1,1
"9575","sample079","BRB","BBB",0,2,2
"9576","sample079","BRR","BBB",0,3,3
"9577","sample079","BRR","RBB",0,1,1
"9578","sample079","GBB","GGB",0,5,5
"9579","sample079","GBB","GRR",0,1,1
"9580","sample079","GBG","BBB",0,1,1
"9581","sample079","GGB","BGG",0,1,1
"9582","sample079","GGB","GGR",0,3,3
"9583","sample079","GGB","RBB",0,1,1
"9584","sample079","GGB","RBR",0,1,1
"9585","sample079","GGG","RBG",0,1,1
"9586","sample079","GGG","RBR",0,6,6
"9587","sample079","GGG","RRR",0,1,1
"9588","sample079","GGR","BBB",0,2,2
"9589","sample079","GGR","BBR",0,1,1
"9590","sample079","GGR","BGG",0,1,1
"9591","sample079","GGR","RBB",0,1,1
"9592","sample079","GRG","BRB",0,1,1
"9593","sample079","GRG","GGR",0,2,2
"9594","sample079","GRR","BGG",0,1,1
"9595","sample079","GRR","BRR",0,1,1
"9596","sample079","RBB","BBB",0,1,1
"9597","sample079","RBG","GBB",0,1,1
"9598","sample079","RBG","GRR",0,1,1
"9599","sample079","RBR","BBB",0,4,4
"9600","sample079","RBR","GGB",0,1,1
"9601","sample079","RBR","RBB",0,1,1
"9602","sample079","RGG","BBB",0,2,2
"9603","sample079","RGG","GGR",0,1,1
"9604","sample079","RGR","GGG",0,1,1
"9605","sample079","RGR","RRG",0,1,1
"9606","sample079","RRG","BBR",0,1,1
"9607","sample079","RRG","GGR",0,1,1
"9608","sample080","BBB","GGG",1,0,1
"9609","sample080","BBB","RRG",1,2,3
"9610","sample080","BBG","BBB",1,1,2
"9611","sample080","BBG","BRB",1,5,6
"9612","sample080","BBG","GBG",2,0,2
"9613","sample080","BBG","GGB",2,5,7
"9614","sample080","BBG","GGG",4,4,8
"9615","sample080","BBG","GRG",1,2,3
"9616","sample080","BBG","RRG",1,0,1
"9617","sample080","BGG","RBG",1,0,1
"9618","sample080","BGG","RRR",1,0,1
"9619","sample080","BRR","BGB",1,0,1
"9620","sample080","GBB","BBB",12,6,18
"9621","sample080","GBB","BRB",1,0,1
"9622","sample080","GBB","BRR",1,0,1
"9623","sample080","GBB","GGG",7,12,19
"9624","sample080","GBB","GGR",1,1,2
"9625","sample080","GBB","RBG",3,1,4
"9626","sample080","GBB","RBR",1,0,1
"9627","sample080","GBB","RGG",1,0,1
"9628","sample080","GBB","RGR",2,1,3
"9629","sample080","GBB","RRR",1,3,4
"9630","sample080","GBG","BRB",1,1,2
"9631","sample080","GBG","BRR",1,0,1
"9632","sample080","GBG","GGG",4,1,5
"9633","sample080","GBG","RBB",1,0,1
"9634","sample080","GBG","RGR",1,0,1
"9635","sample080","GBG","RRG",1,1,2
"9636","sample080","GGB","BBB",3,4,7
"9637","sample080","GGB","BBR",1,0,1
"9638","sample080","GGB","BRR",1,1,2
"9639","sample080","GGB","GBG",1,0,1
"9640","sample080","GGB","GGG",13,10,23
"9641","sample080","GGB","RGG",1,1,2
"9642","sample080","GGB","RRG",1,0,1
"9643","sample080","GGB","RRR",1,1,2
"9644","sample080","GGG","BBB",8,5,13
"9645","sample080","GGG","BGG",1,2,3
"9646","sample080","GGG","BRB",1,0,1
"9647","sample080","GGG","GGB",5,1,6
"9648","sample080","GGG","GGR",1,2,3
"9649","sample080","GGG","RBB",1,1,2
"9650","sample080","GGG","RGR",1,3,4
"9651","sample080","GGG","RRG",1,3,4
"9652","sample080","GGR","BRR",1,0,1
"9653","sample080","GGR","GRR",1,0,1
"9654","sample080","GRG","BBB",3,2,5
"9655","sample080","GRG","GGB",2,0,2
"9656","sample080","GRG","GGG",3,0,3
"9657","sample080","GRG","RGR",1,0,1
"9658","sample080","GRG","RRG",2,0,2
"9659","sample080","GRR","BGB",1,0,1
"9660","sample080","RBG","BBB",2,0,2
"9661","sample080","RBG","RBB",1,0,1
"9662","sample080","RBR","BGB",2,1,3
"9663","sample080","RBR","BRB",1,0,1
"9664","sample080","RBR","BRR",1,0,1
"9665","sample080","RBR","GRR",4,1,5
"9666","sample080","RBR","RGG",2,0,2
"9667","sample080","RBR","RGR",1,0,1
"9668","sample080","RGG","BBR",1,0,1
"9669","sample080","RGR","BBB",2,0,2
"9670","sample080","RGR","BBR",1,0,1
"9671","sample080","RGR","BGB",2,1,3
"9672","sample080","RGR","BGG",2,0,2
"9673","sample080","RGR","BRR",1,0,1
"9674","sample080","RGR","GGB",2,1,3
"9675","sample080","RGR","RGG",1,0,1
"9676","sample080","RRG","BBB",2,8,10
"9677","sample080","RRG","BGB",1,1,2
"9678","sample080","RRG","BRB",2,2,4
"9679","sample080","RRG","BRR",1,5,6
"9680","sample080","RRG","GGG",2,4,6
"9681","sample080","RRG","GRG",1,0,1
"9682","sample080","RRG","GRR",3,1,4
"9683","sample080","RRG","RBB",1,1,2
"9684","sample080","RRR","BBR",1,0,1
"9685","sample080","RRR","BGB",2,1,3
"9686","sample080","RRR","BGG",1,0,1
"9687","sample080","RRR","BRB",1,0,1
"9688","sample080","RRR","BRR",1,0,1
"9689","sample080","RRR","RBB",1,0,1
"9690","sample080","RRR","RGR",1,1,2
"9691","sample080","RRR","RRG",2,0,2
"9692","sample080","BBB","RRR",0,1,1
"9693","sample080","BBG","BGB",0,1,1
"9694","sample080","BBG","GBB",0,1,1
"9695","sample080","BGB","BBB",0,1,1
"9696","sample080","BRB","BBB",0,2,2
"9697","sample080","BRB","BRR",0,1,1
"9698","sample080","BRR","BBB",0,2,2
"9699","sample080","GBB","GGB",0,3,3
"9700","sample080","GBB","GRG",0,1,1
"9701","sample080","GBB","GRR",0,1,1
"9702","sample080","GBG","BBB",0,1,1
"9703","sample080","GGB","BGG",0,1,1
"9704","sample080","GGB","GGR",0,3,3
"9705","sample080","GGB","RBB",0,1,1
"9706","sample080","GGB","RBR",0,1,1
"9707","sample080","GGG","BGB",0,1,1
"9708","sample080","GGG","GRR",0,1,1
"9709","sample080","GGG","RBR",0,5,5
"9710","sample080","GRR","BGG",0,2,2
"9711","sample080","GRR","BRB",0,1,1
"9712","sample080","RBG","BBG",0,1,1
"9713","sample080","RBG","BRR",0,1,1
"9714","sample080","RBG","GRR",0,1,1
"9715","sample080","RBR","BBB",0,2,2
"9716","sample080","RBR","BGG",0,2,2
"9717","sample080","RBR","GGB",0,2,2
"9718","sample080","RGG","BBB",0,2,2
"9719","sample080","RGG","BGB",0,1,1
"9720","sample080","RGG","GRR",0,1,1
"9721","sample080","RGR","GGR",0,1,1
"9722","sample080","RGR","RBB",0,1,1
"9723","sample080","RGR","RRG",0,1,1
"9724","sample080","RRG","BBR",0,1,1
"9725","sample080","RRG","GGR",0,1,1
"9726","sample080","RRG","RGG",0,1,1
"9727","sample081","BBB","GGG",1,1,2
"9728","sample081","BBB","RRG",1,0,1
"9729","sample081","BBG","BBB",1,0,1
"9730","sample081","BBG","BRB",1,2,3
"9731","sample081","BBG","GBG",2,0,2
"9732","sample081","BBG","GGB",2,4,6
"9733","sample081","BBG","GGG",4,3,7
"9734","sample081","BBG","GRG",1,2,3
"9735","sample081","BBG","RRG",1,0,1
"9736","sample081","BGG","RBG",1,0,1
"9737","sample081","BGG","RRR",1,0,1
"9738","sample081","BRR","BGB",1,0,1
"9739","sample081","GBB","BBB",12,10,22
"9740","sample081","GBB","BRB",1,1,2
"9741","sample081","GBB","BRR",1,0,1
"9742","sample081","GBB","GGG",7,11,18
"9743","sample081","GBB","GGR",1,0,1
"9744","sample081","GBB","RBG",3,2,5
"9745","sample081","GBB","RBR",1,0,1
"9746","sample081","GBB","RGG",1,0,1
"9747","sample081","GBB","RGR",2,1,3
"9748","sample081","GBB","RRR",1,1,2
"9749","sample081","GBG","BRB",1,0,1
"9750","sample081","GBG","BRR",1,0,1
"9751","sample081","GBG","GGG",4,2,6
"9752","sample081","GBG","RBB",1,0,1
"9753","sample081","GBG","RGR",1,0,1
"9754","sample081","GBG","RRG",1,1,2
"9755","sample081","GGB","BBB",3,2,5
"9756","sample081","GGB","BBR",1,0,1
"9757","sample081","GGB","BRR",1,2,3
"9758","sample081","GGB","GBG",1,0,1
"9759","sample081","GGB","GGG",13,8,21
"9760","sample081","GGB","RGG",1,1,2
"9761","sample081","GGB","RRG",1,1,2
"9762","sample081","GGB","RRR",1,0,1
"9763","sample081","GGG","BBB",8,5,13
"9764","sample081","GGG","BGG",1,0,1
"9765","sample081","GGG","BRB",1,3,4
"9766","sample081","GGG","GGB",5,1,6
"9767","sample081","GGG","GGR",1,0,1
"9768","sample081","GGG","RBB",1,2,3
"9769","sample081","GGG","RGR",1,2,3
"9770","sample081","GGG","RRG",1,6,7
"9771","sample081","GGR","BRR",1,0,1
"9772","sample081","GGR","GRR",1,0,1
"9773","sample081","GRG","BBB",3,2,5
"9774","sample081","GRG","GGB",2,3,5
"9775","sample081","GRG","GGG",3,2,5
"9776","sample081","GRG","RGR",1,1,2
"9777","sample081","GRG","RRG",2,1,3
"9778","sample081","GRR","BGB",1,0,1
"9779","sample081","RBG","BBB",2,1,3
"9780","sample081","RBG","RBB",1,0,1
"9781","sample081","RBR","BGB",2,1,3
"9782","sample081","RBR","BRB",1,0,1
"9783","sample081","RBR","BRR",1,1,2
"9784","sample081","RBR","GRR",4,2,6
"9785","sample081","RBR","RGG",2,1,3
"9786","sample081","RBR","RGR",1,0,1
"9787","sample081","RGG","BBR",1,0,1
"9788","sample081","RGR","BBB",2,1,3
"9789","sample081","RGR","BBR",1,0,1
"9790","sample081","RGR","BGB",2,2,4
"9791","sample081","RGR","BGG",2,1,3
"9792","sample081","RGR","BRR",1,2,3
"9793","sample081","RGR","GGB",2,0,2
"9794","sample081","RGR","RGG",1,0,1
"9795","sample081","RRG","BBB",2,4,6
"9796","sample081","RRG","BGB",1,1,2
"9797","sample081","RRG","BRB",2,12,14
"9798","sample081","RRG","BRR",1,0,1
"9799","sample081","RRG","GGG",2,1,3
"9800","sample081","RRG","GRG",1,0,1
"9801","sample081","RRG","GRR",3,2,5
"9802","sample081","RRG","RBB",1,0,1
"9803","sample081","RRR","BBR",1,0,1
"9804","sample081","RRR","BGB",2,0,2
"9805","sample081","RRR","BGG",1,0,1
"9806","sample081","RRR","BRB",1,0,1
"9807","sample081","RRR","BRR",1,0,1
"9808","sample081","RRR","RBB",1,0,1
"9809","sample081","RRR","RGR",1,0,1
"9810","sample081","RRR","RRG",2,0,2
"9811","sample081","BBB","BRB",0,1,1
"9812","sample081","BBB","RRR",0,1,1
"9813","sample081","BGG","BBR",0,1,1
"9814","sample081","BGG","RGG",0,1,1
"9815","sample081","BGG","RGR",0,1,1
"9816","sample081","BRB","BBB",0,1,1
"9817","sample081","BRB","BBR",0,1,1
"9818","sample081","BRR","BBB",0,1,1
"9819","sample081","GBB","GGB",0,1,1
"9820","sample081","GBB","RBB",0,1,1
"9821","sample081","GBG","GGB",0,1,1
"9822","sample081","GBG","RGG",0,1,1
"9823","sample081","GGB","BGB",0,1,1
"9824","sample081","GGB","GGR",0,2,2
"9825","sample081","GGB","RBG",0,1,1
"9826","sample081","GGB","RBR",0,1,1
"9827","sample081","GGG","BRR",0,2,2
"9828","sample081","GGG","GRR",0,1,1
"9829","sample081","GGG","RBR",0,2,2
"9830","sample081","GGG","RGG",0,1,1
"9831","sample081","GRG","BGG",0,1,1
"9832","sample081","GRG","BRB",0,2,2
"9833","sample081","GRG","GGR",0,1,1
"9834","sample081","GRR","BRB",0,1,1
"9835","sample081","GRR","GGR",0,1,1
"9836","sample081","RBB","BBB",0,1,1
"9837","sample081","RBB","BBR",0,1,1
"9838","sample081","RBR","BBB",0,1,1
"9839","sample081","RBR","BBR",0,1,1
"9840","sample081","RBR","BGG",0,1,1
"9841","sample081","RBR","GGB",0,1,1
"9842","sample081","RBR","RBB",0,1,1
"9843","sample081","RGG","BBB",0,2,2
"9844","sample081","RGG","GRR",0,2,2
"9845","sample081","RGR","GGR",0,1,1
"9846","sample081","RGR","RBB",0,2,2
"9847","sample081","RRG","GGR",0,1,1
"9848","sample081","RRG","RGR",0,1,1
"9849","sample082","BBB","GGG",1,0,1
"9850","sample082","BBB","RRG",1,0,1
"9851","sample082","BBG","BBB",1,0,1
"9852","sample082","BBG","BRB",1,6,7
"9853","sample082","BBG","GBG",2,3,5
"9854","sample082","BBG","GGB",2,6,8
"9855","sample082","BBG","GGG",4,5,9
"9856","sample082","BBG","GRG",1,0,1
"9857","sample082","BBG","RRG",1,0,1
"9858","sample082","BGG","RBG",1,0,1
"9859","sample082","BGG","RRR",1,0,1
"9860","sample082","BRR","BGB",1,0,1
"9861","sample082","GBB","BBB",12,5,17
"9862","sample082","GBB","BRB",1,1,2
"9863","sample082","GBB","BRR",1,1,2
"9864","sample082","GBB","GGG",7,18,25
"9865","sample082","GBB","GGR",1,0,1
"9866","sample082","GBB","RBG",3,2,5
"9867","sample082","GBB","RBR",1,0,1
"9868","sample082","GBB","RGG",1,0,1
"9869","sample082","GBB","RGR",2,0,2
"9870","sample082","GBB","RRR",1,2,3
"9871","sample082","GBG","BRB",1,1,2
"9872","sample082","GBG","BRR",1,0,1
"9873","sample082","GBG","GGG",4,6,10
"9874","sample082","GBG","RBB",1,0,1
"9875","sample082","GBG","RGR",1,0,1
"9876","sample082","GBG","RRG",1,1,2
"9877","sample082","GGB","BBB",3,4,7
"9878","sample082","GGB","BBR",1,0,1
"9879","sample082","GGB","BRR",1,2,3
"9880","sample082","GGB","GBG",1,0,1
"9881","sample082","GGB","GGG",13,9,22
"9882","sample082","GGB","RGG",1,0,1
"9883","sample082","GGB","RRG",1,0,1
"9884","sample082","GGB","RRR",1,0,1
"9885","sample082","GGG","BBB",8,3,11
"9886","sample082","GGG","BGG",1,2,3
"9887","sample082","GGG","BRB",1,0,1
"9888","sample082","GGG","GGB",5,0,5
"9889","sample082","GGG","GGR",1,0,1
"9890","sample082","GGG","RBB",1,1,2
"9891","sample082","GGG","RGR",1,0,1
"9892","sample082","GGG","RRG",1,2,3
"9893","sample082","GGR","BRR",1,0,1
"9894","sample082","GGR","GRR",1,0,1
"9895","sample082","GRG","BBB",3,0,3
"9896","sample082","GRG","GGB",2,3,5
"9897","sample082","GRG","GGG",3,1,4
"9898","sample082","GRG","RGR",1,0,1
"9899","sample082","GRG","RRG",2,0,2
"9900","sample082","GRR","BGB",1,0,1
"9901","sample082","RBG","BBB",2,0,2
"9902","sample082","RBG","RBB",1,0,1
"9903","sample082","RBR","BGB",2,1,3
"9904","sample082","RBR","BRB",1,0,1
"9905","sample082","RBR","BRR",1,1,2
"9906","sample082","RBR","GRR",4,1,5
"9907","sample082","RBR","RGG",2,1,3
"9908","sample082","RBR","RGR",1,0,1
"9909","sample082","RGG","BBR",1,0,1
"9910","sample082","RGR","BBB",2,1,3
"9911","sample082","RGR","BBR",1,1,2
"9912","sample082","RGR","BGB",2,1,3
"9913","sample082","RGR","BGG",2,0,2
"9914","sample082","RGR","BRR",1,0,1
"9915","sample082","RGR","GGB",2,0,2
"9916","sample082","RGR","RGG",1,0,1
"9917","sample082","RRG","BBB",2,6,8
"9918","sample082","RRG","BGB",1,0,1
"9919","sample082","RRG","BRB",2,6,8
"9920","sample082","RRG","BRR",1,1,2
"9921","sample082","RRG","GGG",2,1,3
"9922","sample082","RRG","GRG",1,0,1
"9923","sample082","RRG","GRR",3,0,3
"9924","sample082","RRG","RBB",1,0,1
"9925","sample082","RRR","BBR",1,0,1
"9926","sample082","RRR","BGB",2,0,2
"9927","sample082","RRR","BGG",1,0,1
"9928","sample082","RRR","BRB",1,0,1
"9929","sample082","RRR","BRR",1,1,2
"9930","sample082","RRR","RBB",1,0,1
"9931","sample082","RRR","RGR",1,0,1
"9932","sample082","RRR","RRG",2,0,2
"9933","sample082","BBB","GRR",0,1,1
"9934","sample082","BBG","BGB",0,1,1
"9935","sample082","BGG","RGG",0,1,1
"9936","sample082","BRB","BBB",0,1,1
"9937","sample082","BRB","BRR",0,1,1
"9938","sample082","BRB","GGR",0,1,1
"9939","sample082","BRB","RBB",0,1,1
"9940","sample082","BRR","BBB",0,1,1
"9941","sample082","BRR","BRB",0,1,1
"9942","sample082","BRR","RBB",0,1,1
"9943","sample082","GBB","GGB",0,4,4
"9944","sample082","GBB","RRG",0,1,1
"9945","sample082","GBG","BBB",0,1,1
"9946","sample082","GBG","BBR",0,1,1
"9947","sample082","GBG","GGB",0,1,1
"9948","sample082","GGB","GBB",0,1,1
"9949","sample082","GGB","RBB",0,1,1
"9950","sample082","GGB","RBG",0,2,2
"9951","sample082","GGB","RGR",0,1,1
"9952","sample082","GGG","RBG",0,1,1
"9953","sample082","GGG","RBR",0,2,2
"9954","sample082","GGG","RGG",0,2,2
"9955","sample082","GGG","RRR",0,1,1
"9956","sample082","GGR","BGG",0,1,1
"9957","sample082","GRG","BRB",0,1,1
"9958","sample082","GRG","BRR",0,1,1
"9959","sample082","GRG","GBG",0,1,1
"9960","sample082","GRG","GGR",0,3,3
"9961","sample082","GRR","BBR",0,1,1
"9962","sample082","GRR","BGG",0,1,1
"9963","sample082","GRR","BRR",0,1,1
"9964","sample082","RBR","BBB",0,2,2
"9965","sample082","RBR","GGB",0,3,3
"9966","sample082","RBR","RRR",0,1,1
"9967","sample082","RGG","BRR",0,1,1
"9968","sample082","RGG","RBB",0,1,1
"9969","sample082","RGR","GGR",0,2,2
"9970","sample082","RGR","RRG",0,2,2
"9971","sample082","RRG","BBR",0,2,2
"9972","sample082","RRR","RBR",0,1,1
"9973","sample083","BBB","GGG",1,1,2
"9974","sample083","BBB","RRG",1,0,1
"9975","sample083","BBG","BBB",1,1,2
"9976","sample083","BBG","BRB",1,4,5
"9977","sample083","BBG","GBG",2,2,4
"9978","sample083","BBG","GGB",2,2,4
"9979","sample083","BBG","GGG",4,9,13
"9980","sample083","BBG","GRG",1,1,2
"9981","sample083","BBG","RRG",1,0,1
"9982","sample083","BGG","RBG",1,1,2
"9983","sample083","BGG","RRR",1,0,1
"9984","sample083","BRR","BGB",1,0,1
"9985","sample083","GBB","BBB",12,5,17
"9986","sample083","GBB","BRB",1,1,2
"9987","sample083","GBB","BRR",1,0,1
"9988","sample083","GBB","GGG",7,14,21
"9989","sample083","GBB","GGR",1,1,2
"9990","sample083","GBB","RBG",3,1,4
"9991","sample083","GBB","RBR",1,0,1
"9992","sample083","GBB","RGG",1,0,1
"9993","sample083","GBB","RGR",2,0,2
"9994","sample083","GBB","RRR",1,0,1
"9995","sample083","GBG","BRB",1,0,1
"9996","sample083","GBG","BRR",1,0,1
"9997","sample083","GBG","GGG",4,1,5
"9998","sample083","GBG","RBB",1,0,1
"9999","sample083","GBG","RGR",1,0,1
"10000","sample083","GBG","RRG",1,2,3
"10001","sample083","GGB","BBB",3,2,5
"10002","sample083","GGB","BBR",1,0,1
"10003","sample083","GGB","BRR",1,0,1
"10004","sample083","GGB","GBG",1,0,1
"10005","sample083","GGB","GGG",13,9,22
"10006","sample083","GGB","RGG",1,1,2
"10007","sample083","GGB","RRG",1,0,1
"10008","sample083","GGB","RRR",1,1,2
"10009","sample083","GGG","BBB",8,5,13
"10010","sample083","GGG","BGG",1,1,2
"10011","sample083","GGG","BRB",1,0,1
"10012","sample083","GGG","GGB",5,1,6
"10013","sample083","GGG","GGR",1,1,2
"10014","sample083","GGG","RBB",1,1,2
"10015","sample083","GGG","RGR",1,1,2
"10016","sample083","GGG","RRG",1,3,4
"10017","sample083","GGR","BRR",1,0,1
"10018","sample083","GGR","GRR",1,0,1
"10019","sample083","GRG","BBB",3,1,4
"10020","sample083","GRG","GGB",2,2,4
"10021","sample083","GRG","GGG",3,2,5
"10022","sample083","GRG","RGR",1,0,1
"10023","sample083","GRG","RRG",2,2,4
"10024","sample083","GRR","BGB",1,1,2
"10025","sample083","RBG","BBB",2,0,2
"10026","sample083","RBG","RBB",1,0,1
"10027","sample083","RBR","BGB",2,0,2
"10028","sample083","RBR","BRB",1,0,1
"10029","sample083","RBR","BRR",1,1,2
"10030","sample083","RBR","GRR",4,0,4
"10031","sample083","RBR","RGG",2,2,4
"10032","sample083","RBR","RGR",1,0,1
"10033","sample083","RGG","BBR",1,1,2
"10034","sample083","RGR","BBB",2,2,4
"10035","sample083","RGR","BBR",1,0,1
"10036","sample083","RGR","BGB",2,1,3
"10037","sample083","RGR","BGG",2,1,3
"10038","sample083","RGR","BRR",1,1,2
"10039","sample083","RGR","GGB",2,3,5
"10040","sample083","RGR","RGG",1,1,2
"10041","sample083","RRG","BBB",2,3,5
"10042","sample083","RRG","BGB",1,1,2
"10043","sample083","RRG","BRB",2,7,9
"10044","sample083","RRG","BRR",1,2,3
"10045","sample083","RRG","GGG",2,1,3
"10046","sample083","RRG","GRG",1,0,1
"10047","sample083","RRG","GRR",3,0,3
"10048","sample083","RRG","RBB",1,0,1
"10049","sample083","RRR","BBR",1,0,1
"10050","sample083","RRR","BGB",2,0,2
"10051","sample083","RRR","BGG",1,0,1
"10052","sample083","RRR","BRB",1,0,1
"10053","sample083","RRR","BRR",1,0,1
"10054","sample083","RRR","RBB",1,0,1
"10055","sample083","RRR","RGR",1,0,1
"10056","sample083","RRR","RRG",2,0,2
"10057","sample083","BBG","RBR",0,1,1
"10058","sample083","BGG","GRG",0,1,1
"10059","sample083","BRB","BBB",0,1,1
"10060","sample083","BRB","BBR",0,1,1
"10061","sample083","BRB","BRR",0,1,1
"10062","sample083","BRR","BBB",0,2,2
"10063","sample083","BRR","BRB",0,1,1
"10064","sample083","GBB","GGB",0,3,3
"10065","sample083","GBG","RGG",0,1,1
"10066","sample083","GGB","BGG",0,1,1
"10067","sample083","GGB","GBB",0,1,1
"10068","sample083","GGB","RBB",0,1,1
"10069","sample083","GGG","BGB",0,1,1
"10070","sample083","GGG","BRR",0,1,1
"10071","sample083","GGG","RBG",0,1,1
"10072","sample083","GGG","RBR",0,4,4
"10073","sample083","GGG","RGG",0,1,1
"10074","sample083","GGG","RRR",0,1,1
"10075","sample083","GGR","BBB",0,1,1
"10076","sample083","GGR","RBB",0,1,1
"10077","sample083","GRG","BBR",0,1,1
"10078","sample083","GRG","GRR",0,1,1
"10079","sample083","GRR","GGG",0,1,1
"10080","sample083","RBG","GBB",0,1,1
"10081","sample083","RBG","GRR",0,1,1
"10082","sample083","RBG","RBR",0,1,1
"10083","sample083","RBR","BBB",0,3,3
"10084","sample083","RBR","BBR",0,1,1
"10085","sample083","RBR","GGB",0,4,4
"10086","sample083","RGG","BRR",0,1,1
"10087","sample083","RGG","GGR",0,1,1
"10088","sample083","RGG","GRR",0,1,1
"10089","sample083","RGR","RBB",0,1,1
"10090","sample083","RRG","BBR",0,1,1
"10091","sample083","RRG","BGG",0,1,1
"10092","sample083","RRG","GGR",0,4,4
"10093","sample083","RRG","RGR",0,1,1
"10094","sample083","RRR","GGR",0,1,1
"10095","sample083","RRR","GRR",0,1,1
"10096","sample084","BBB","GGG",1,0,1
"10097","sample084","BBB","RRG",1,1,2
"10098","sample084","BBG","BBB",1,0,1
"10099","sample084","BBG","BRB",1,1,2
"10100","sample084","BBG","GBG",2,3,5
"10101","sample084","BBG","GGB",2,3,5
"10102","sample084","BBG","GGG",4,6,10
"10103","sample084","BBG","GRG",1,1,2
"10104","sample084","BBG","RRG",1,0,1
"10105","sample084","BGG","RBG",1,0,1
"10106","sample084","BGG","RRR",1,0,1
"10107","sample084","BRR","BGB",1,0,1
"10108","sample084","GBB","BBB",12,7,19
"10109","sample084","GBB","BRB",1,1,2
"10110","sample084","GBB","BRR",1,0,1
"10111","sample084","GBB","GGG",7,10,17
"10112","sample084","GBB","GGR",1,1,2
"10113","sample084","GBB","RBG",3,1,4
"10114","sample084","GBB","RBR",1,0,1
"10115","sample084","GBB","RGG",1,0,1
"10116","sample084","GBB","RGR",2,0,2
"10117","sample084","GBB","RRR",1,0,1
"10118","sample084","GBG","BRB",1,2,3
"10119","sample084","GBG","BRR",1,0,1
"10120","sample084","GBG","GGG",4,0,4
"10121","sample084","GBG","RBB",1,0,1
"10122","sample084","GBG","RGR",1,0,1
"10123","sample084","GBG","RRG",1,0,1
"10124","sample084","GGB","BBB",3,2,5
"10125","sample084","GGB","BBR",1,0,1
"10126","sample084","GGB","BRR",1,2,3
"10127","sample084","GGB","GBG",1,0,1
"10128","sample084","GGB","GGG",13,5,18
"10129","sample084","GGB","RGG",1,1,2
"10130","sample084","GGB","RRG",1,0,1
"10131","sample084","GGB","RRR",1,1,2
"10132","sample084","GGG","BBB",8,5,13
"10133","sample084","GGG","BGG",1,0,1
"10134","sample084","GGG","BRB",1,1,2
"10135","sample084","GGG","GGB",5,1,6
"10136","sample084","GGG","GGR",1,2,3
"10137","sample084","GGG","RBB",1,1,2
"10138","sample084","GGG","RGR",1,2,3
"10139","sample084","GGG","RRG",1,3,4
"10140","sample084","GGR","BRR",1,0,1
"10141","sample084","GGR","GRR",1,0,1
"10142","sample084","GRG","BBB",3,1,4
"10143","sample084","GRG","GGB",2,4,6
"10144","sample084","GRG","GGG",3,2,5
"10145","sample084","GRG","RGR",1,1,2
"10146","sample084","GRG","RRG",2,1,3
"10147","sample084","GRR","BGB",1,0,1
"10148","sample084","RBG","BBB",2,1,3
"10149","sample084","RBG","RBB",1,0,1
"10150","sample084","RBR","BGB",2,1,3
"10151","sample084","RBR","BRB",1,0,1
"10152","sample084","RBR","BRR",1,0,1
"10153","sample084","RBR","GRR",4,1,5
"10154","sample084","RBR","RGG",2,3,5
"10155","sample084","RBR","RGR",1,0,1
"10156","sample084","RGG","BBR",1,0,1
"10157","sample084","RGR","BBB",2,1,3
"10158","sample084","RGR","BBR",1,0,1
"10159","sample084","RGR","BGB",2,0,2
"10160","sample084","RGR","BGG",2,0,2
"10161","sample084","RGR","BRR",1,0,1
"10162","sample084","RGR","GGB",2,2,4
"10163","sample084","RGR","RGG",1,0,1
"10164","sample084","RRG","BBB",2,2,4
"10165","sample084","RRG","BGB",1,0,1
"10166","sample084","RRG","BRB",2,6,8
"10167","sample084","RRG","BRR",1,1,2
"10168","sample084","RRG","GGG",2,3,5
"10169","sample084","RRG","GRG",1,0,1
"10170","sample084","RRG","GRR",3,2,5
"10171","sample084","RRG","RBB",1,0,1
"10172","sample084","RRR","BBR",1,0,1
"10173","sample084","RRR","BGB",2,0,2
"10174","sample084","RRR","BGG",1,0,1
"10175","sample084","RRR","BRB",1,1,2
"10176","sample084","RRR","BRR",1,0,1
"10177","sample084","RRR","RBB",1,1,2
"10178","sample084","RRR","RGR",1,0,1
"10179","sample084","RRR","RRG",2,0,2
"10180","sample084","BBG","BGB",0,1,1
"10181","sample084","BBG","GBB",0,1,1
"10182","sample084","BBG","RBR",0,1,1
"10183","sample084","BGB","RRG",0,1,1
"10184","sample084","BGG","BBB",0,1,1
"10185","sample084","BGG","RGG",0,2,2
"10186","sample084","BGG","RGR",0,1,1
"10187","sample084","BRB","BBB",0,3,3
"10188","sample084","BRB","BRR",0,1,1
"10189","sample084","BRB","GGR",0,1,1
"10190","sample084","BRB","RGR",0,1,1
"10191","sample084","BRR","BBB",0,3,3
"10192","sample084","BRR","RBB",0,1,1
"10193","sample084","GBB","GGB",0,6,6
"10194","sample084","GBB","GRG",0,2,2
"10195","sample084","GBB","RRG",0,1,1
"10196","sample084","GBG","BBR",0,1,1
"10197","sample084","GBG","RGG",0,1,1
"10198","sample084","GGB","BGB",0,2,2
"10199","sample084","GGB","BGG",0,1,1
"10200","sample084","GGB","BRB",0,1,1
"10201","sample084","GGB","GGR",0,2,2
"10202","sample084","GGB","RBB",0,2,2
"10203","sample084","GGB","RBR",0,1,1
"10204","sample084","GGB","RGR",0,1,1
"10205","sample084","GGG","BRR",0,1,1
"10206","sample084","GGG","RBG",0,2,2
"10207","sample084","GGG","RBR",0,3,3
"10208","sample084","GGG","RGG",0,1,1
"10209","sample084","GRG","RBR",0,1,1
"10210","sample084","GRR","BBB",0,1,1
"10211","sample084","GRR","BRB",0,1,1
"10212","sample084","RBG","GRR",0,1,1
"10213","sample084","RBR","BBB",0,3,3
"10214","sample084","RBR","GGB",0,4,4
"10215","sample084","RGG","GGR",0,1,1
"10216","sample084","RGR","GGG",0,1,1
"10217","sample084","RGR","RBB",0,1,1
"10218","sample084","RGR","RRG",0,1,1
"10219","sample084","RRG","RGR",0,1,1
"10220","sample084","RRR","RBR",0,1,1
"10221","sample085","BBB","GGG",1,0,1
"10222","sample085","BBB","RRG",1,0,1
"10223","sample085","BBG","BBB",1,1,2
"10224","sample085","BBG","BRB",1,1,2
"10225","sample085","BBG","GBG",2,2,4
"10226","sample085","BBG","GGB",2,5,7
"10227","sample085","BBG","GGG",4,4,8
"10228","sample085","BBG","GRG",1,2,3
"10229","sample085","BBG","RRG",1,0,1
"10230","sample085","BGG","RBG",1,0,1
"10231","sample085","BGG","RRR",1,0,1
"10232","sample085","BRR","BGB",1,0,1
"10233","sample085","GBB","BBB",12,5,17
"10234","sample085","GBB","BRB",1,1,2
"10235","sample085","GBB","BRR",1,1,2
"10236","sample085","GBB","GGG",7,12,19
"10237","sample085","GBB","GGR",1,1,2
"10238","sample085","GBB","RBG",3,0,3
"10239","sample085","GBB","RBR",1,0,1
"10240","sample085","GBB","RGG",1,0,1
"10241","sample085","GBB","RGR",2,1,3
"10242","sample085","GBB","RRR",1,3,4
"10243","sample085","GBG","BRB",1,0,1
"10244","sample085","GBG","BRR",1,0,1
"10245","sample085","GBG","GGG",4,1,5
"10246","sample085","GBG","RBB",1,0,1
"10247","sample085","GBG","RGR",1,0,1
"10248","sample085","GBG","RRG",1,0,1
"10249","sample085","GGB","BBB",3,1,4
"10250","sample085","GGB","BBR",1,1,2
"10251","sample085","GGB","BRR",1,4,5
"10252","sample085","GGB","GBG",1,0,1
"10253","sample085","GGB","GGG",13,7,20
"10254","sample085","GGB","RGG",1,1,2
"10255","sample085","GGB","RRG",1,1,2
"10256","sample085","GGB","RRR",1,0,1
"10257","sample085","GGG","BBB",8,5,13
"10258","sample085","GGG","BGG",1,2,3
"10259","sample085","GGG","BRB",1,0,1
"10260","sample085","GGG","GGB",5,0,5
"10261","sample085","GGG","GGR",1,2,3
"10262","sample085","GGG","RBB",1,1,2
"10263","sample085","GGG","RGR",1,0,1
"10264","sample085","GGG","RRG",1,3,4
"10265","sample085","GGR","BRR",1,0,1
"10266","sample085","GGR","GRR",1,0,1
"10267","sample085","GRG","BBB",3,3,6
"10268","sample085","GRG","GGB",2,2,4
"10269","sample085","GRG","GGG",3,1,4
"10270","sample085","GRG","RGR",1,1,2
"10271","sample085","GRG","RRG",2,1,3
"10272","sample085","GRR","BGB",1,1,2
"10273","sample085","RBG","BBB",2,3,5
"10274","sample085","RBG","RBB",1,0,1
"10275","sample085","RBR","BGB",2,0,2
"10276","sample085","RBR","BRB",1,0,1
"10277","sample085","RBR","BRR",1,0,1
"10278","sample085","RBR","GRR",4,1,5
"10279","sample085","RBR","RGG",2,1,3
"10280","sample085","RBR","RGR",1,0,1
"10281","sample085","RGG","BBR",1,0,1
"10282","sample085","RGR","BBB",2,0,2
"10283","sample085","RGR","BBR",1,0,1
"10284","sample085","RGR","BGB",2,1,3
"10285","sample085","RGR","BGG",2,0,2
"10286","sample085","RGR","BRR",1,0,1
"10287","sample085","RGR","GGB",2,3,5
"10288","sample085","RGR","RGG",1,0,1
"10289","sample085","RRG","BBB",2,4,6
"10290","sample085","RRG","BGB",1,5,6
"10291","sample085","RRG","BRB",2,2,4
"10292","sample085","RRG","BRR",1,5,6
"10293","sample085","RRG","GGG",2,4,6
"10294","sample085","RRG","GRG",1,0,1
"10295","sample085","RRG","GRR",3,5,8
"10296","sample085","RRG","RBB",1,0,1
"10297","sample085","RRR","BBR",1,0,1
"10298","sample085","RRR","BGB",2,0,2
"10299","sample085","RRR","BGG",1,0,1
"10300","sample085","RRR","BRB",1,0,1
"10301","sample085","RRR","BRR",1,1,2
"10302","sample085","RRR","RBB",1,0,1
"10303","sample085","RRR","RGR",1,1,2
"10304","sample085","RRR","RRG",2,0,2
"10305","sample085","BBG","RRR",0,3,3
"10306","sample085","BGG","BBB",0,1,1
"10307","sample085","BRB","BBB",0,1,1
"10308","sample085","BRB","RBB",0,1,1
"10309","sample085","BRR","BBB",0,2,2
"10310","sample085","BRR","BRB",0,1,1
"10311","sample085","GBB","GBG",0,1,1
"10312","sample085","GBB","GGB",0,1,1
"10313","sample085","GBG","BBB",0,1,1
"10314","sample085","GBG","GGB",0,1,1
"10315","sample085","GBG","RGG",0,1,1
"10316","sample085","GGB","RBG",0,1,1
"10317","sample085","GGB","RBR",0,1,1
"10318","sample085","GGG","BRR",0,1,1
"10319","sample085","GGG","RBG",0,1,1
"10320","sample085","GGG","RBR",0,6,6
"10321","sample085","GGG","RRR",0,1,1
"10322","sample085","GGR","BBB",0,1,1
"10323","sample085","GRG","BRR",0,1,1
"10324","sample085","GRG","GGR",0,2,2
"10325","sample085","GRR","BRR",0,2,2
"10326","sample085","GRR","GGR",0,1,1
"10327","sample085","RBG","BBG",0,1,1
"10328","sample085","RBG","GBB",0,1,1
"10329","sample085","RBR","BBB",0,1,1
"10330","sample085","RBR","GGB",0,2,2
"10331","sample085","RGG","BBB",0,2,2
"10332","sample085","RGG","BRR",0,1,1
"10333","sample085","RGG","GRR",0,2,2
"10334","sample085","RGR","GGR",0,1,1
"10335","sample085","RGR","RBB",0,1,1
"10336","sample085","RGR","RRG",0,1,1
"10337","sample085","RRG","BGG",0,1,1
"10338","sample085","RRG","RGG",0,1,1
"10339","sample086","BBB","GGG",1,0,1
"10340","sample086","BBB","RRG",1,0,1
"10341","sample086","BBG","BBB",1,0,1
"10342","sample086","BBG","BRB",1,6,7
"10343","sample086","BBG","GBG",2,1,3
"10344","sample086","BBG","GGB",2,0,2
"10345","sample086","BBG","GGG",4,8,12
"10346","sample086","BBG","GRG",1,0,1
"10347","sample086","BBG","RRG",1,0,1
"10348","sample086","BGG","RBG",1,0,1
"10349","sample086","BGG","RRR",1,0,1
"10350","sample086","BRR","BGB",1,0,1
"10351","sample086","GBB","BBB",12,8,20
"10352","sample086","GBB","BRB",1,1,2
"10353","sample086","GBB","BRR",1,0,1
"10354","sample086","GBB","GGG",7,16,23
"10355","sample086","GBB","GGR",1,1,2
"10356","sample086","GBB","RBG",3,2,5
"10357","sample086","GBB","RBR",1,0,1
"10358","sample086","GBB","RGG",1,0,1
"10359","sample086","GBB","RGR",2,0,2
"10360","sample086","GBB","RRR",1,2,3
"10361","sample086","GBG","BRB",1,0,1
"10362","sample086","GBG","BRR",1,0,1
"10363","sample086","GBG","GGG",4,1,5
"10364","sample086","GBG","RBB",1,0,1
"10365","sample086","GBG","RGR",1,0,1
"10366","sample086","GBG","RRG",1,0,1
"10367","sample086","GGB","BBB",3,1,4
"10368","sample086","GGB","BBR",1,0,1
"10369","sample086","GGB","BRR",1,3,4
"10370","sample086","GGB","GBG",1,0,1
"10371","sample086","GGB","GGG",13,6,19
"10372","sample086","GGB","RGG",1,0,1
"10373","sample086","GGB","RRG",1,0,1
"10374","sample086","GGB","RRR",1,1,2
"10375","sample086","GGG","BBB",8,3,11
"10376","sample086","GGG","BGG",1,0,1
"10377","sample086","GGG","BRB",1,0,1
"10378","sample086","GGG","GGB",5,0,5
"10379","sample086","GGG","GGR",1,3,4
"10380","sample086","GGG","RBB",1,2,3
"10381","sample086","GGG","RGR",1,3,4
"10382","sample086","GGG","RRG",1,3,4
"10383","sample086","GGR","BRR",1,0,1
"10384","sample086","GGR","GRR",1,0,1
"10385","sample086","GRG","BBB",3,0,3
"10386","sample086","GRG","GGB",2,1,3
"10387","sample086","GRG","GGG",3,3,6
"10388","sample086","GRG","RGR",1,0,1
"10389","sample086","GRG","RRG",2,0,2
"10390","sample086","GRR","BGB",1,1,2
"10391","sample086","RBG","BBB",2,1,3
"10392","sample086","RBG","RBB",1,0,1
"10393","sample086","RBR","BGB",2,0,2
"10394","sample086","RBR","BRB",1,0,1
"10395","sample086","RBR","BRR",1,0,1
"10396","sample086","RBR","GRR",4,1,5
"10397","sample086","RBR","RGG",2,1,3
"10398","sample086","RBR","RGR",1,0,1
"10399","sample086","RGG","BBR",1,1,2
"10400","sample086","RGR","BBB",2,2,4
"10401","sample086","RGR","BBR",1,0,1
"10402","sample086","RGR","BGB",2,1,3
"10403","sample086","RGR","BGG",2,0,2
"10404","sample086","RGR","BRR",1,1,2
"10405","sample086","RGR","GGB",2,2,4
"10406","sample086","RGR","RGG",1,0,1
"10407","sample086","RRG","BBB",2,7,9
"10408","sample086","RRG","BGB",1,0,1
"10409","sample086","RRG","BRB",2,5,7
"10410","sample086","RRG","BRR",1,4,5
"10411","sample086","RRG","GGG",2,5,7
"10412","sample086","RRG","GRG",1,0,1
"10413","sample086","RRG","GRR",3,1,4
"10414","sample086","RRG","RBB",1,0,1
"10415","sample086","RRR","BBR",1,0,1
"10416","sample086","RRR","BGB",2,0,2
"10417","sample086","RRR","BGG",1,0,1
"10418","sample086","RRR","BRB",1,0,1
"10419","sample086","RRR","BRR",1,0,1
"10420","sample086","RRR","RBB",1,0,1
"10421","sample086","RRR","RGR",1,0,1
"10422","sample086","RRR","RRG",2,1,3
"10423","sample086","BBB","RRR",0,1,1
"10424","sample086","BBG","RBG",0,1,1
"10425","sample086","BBG","RRR",0,2,2
"10426","sample086","BGB","BBB",0,1,1
"10427","sample086","BGG","RGG",0,1,1
"10428","sample086","BRB","GGG",0,1,1
"10429","sample086","BRR","BBB",0,2,2
"10430","sample086","GBB","GGB",0,6,6
"10431","sample086","GBB","GRG",0,1,1
"10432","sample086","GBG","GGB",0,1,1
"10433","sample086","GGB","BGG",0,1,1
"10434","sample086","GGB","GBB",0,1,1
"10435","sample086","GGB","GGR",0,2,2
"10436","sample086","GGB","RBB",0,1,1
"10437","sample086","GGB","RBG",0,1,1
"10438","sample086","GGG","RBG",0,2,2
"10439","sample086","GGG","RBR",0,2,2
"10440","sample086","GGR","BBB",0,1,1
"10441","sample086","GGR","BGG",0,1,1
"10442","sample086","GRG","BRB",0,1,1
"10443","sample086","GRG","GBG",0,1,1
"10444","sample086","GRR","GGR",0,1,1
"10445","sample086","RBG","BRR",0,1,1
"10446","sample086","RBG","GRR",0,1,1
"10447","sample086","RBG","RGR",0,1,1
"10448","sample086","RBR","BBB",0,1,1
"10449","sample086","RBR","BGG",0,1,1
"10450","sample086","RBR","GGB",0,3,3
"10451","sample086","RGG","BBB",0,2,2
"10452","sample086","RGG","BRR",0,1,1
"10453","sample086","RGG","RBB",0,1,1
"10454","sample086","RGR","GGG",0,1,1
"10455","sample086","RGR","GGR",0,1,1
"10456","sample086","RGR","RRG",0,1,1
"10457","sample086","RRG","GGR",0,2,2
"10458","sample086","RRG","RGG",0,1,1
"10459","sample086","RRR","RBR",0,1,1
"10460","sample087","BBB","GGG",1,1,2
"10461","sample087","BBB","RRG",1,1,2
"10462","sample087","BBG","BBB",1,0,1
"10463","sample087","BBG","BRB",1,2,3
"10464","sample087","BBG","GBG",2,1,3
"10465","sample087","BBG","GGB",2,8,10
"10466","sample087","BBG","GGG",4,8,12
"10467","sample087","BBG","GRG",1,4,5
"10468","sample087","BBG","RRG",1,1,2
"10469","sample087","BGG","RBG",1,0,1
"10470","sample087","BGG","RRR",1,0,1
"10471","sample087","BRR","BGB",1,1,2
"10472","sample087","GBB","BBB",12,8,20
"10473","sample087","GBB","BRB",1,1,2
"10474","sample087","GBB","BRR",1,0,1
"10475","sample087","GBB","GGG",7,11,18
"10476","sample087","GBB","GGR",1,0,1
"10477","sample087","GBB","RBG",3,1,4
"10478","sample087","GBB","RBR",1,0,1
"10479","sample087","GBB","RGG",1,0,1
"10480","sample087","GBB","RGR",2,0,2
"10481","sample087","GBB","RRR",1,1,2
"10482","sample087","GBG","BRB",1,1,2
"10483","sample087","GBG","BRR",1,0,1
"10484","sample087","GBG","GGG",4,2,6
"10485","sample087","GBG","RBB",1,0,1
"10486","sample087","GBG","RGR",1,1,2
"10487","sample087","GBG","RRG",1,0,1
"10488","sample087","GGB","BBB",3,1,4
"10489","sample087","GGB","BBR",1,1,2
"10490","sample087","GGB","BRR",1,2,3
"10491","sample087","GGB","GBG",1,0,1
"10492","sample087","GGB","GGG",13,12,25
"10493","sample087","GGB","RGG",1,1,2
"10494","sample087","GGB","RRG",1,0,1
"10495","sample087","GGB","RRR",1,1,2
"10496","sample087","GGG","BBB",8,3,11
"10497","sample087","GGG","BGG",1,2,3
"10498","sample087","GGG","BRB",1,1,2
"10499","sample087","GGG","GGB",5,0,5
"10500","sample087","GGG","GGR",1,1,2
"10501","sample087","GGG","RBB",1,1,2
"10502","sample087","GGG","RGR",1,2,3
"10503","sample087","GGG","RRG",1,2,3
"10504","sample087","GGR","BRR",1,0,1
"10505","sample087","GGR","GRR",1,0,1
"10506","sample087","GRG","BBB",3,1,4
"10507","sample087","GRG","GGB",2,0,2
"10508","sample087","GRG","GGG",3,3,6
"10509","sample087","GRG","RGR",1,0,1
"10510","sample087","GRG","RRG",2,0,2
"10511","sample087","GRR","BGB",1,0,1
"10512","sample087","RBG","BBB",2,1,3
"10513","sample087","RBG","RBB",1,0,1
"10514","sample087","RBR","BGB",2,1,3
"10515","sample087","RBR","BRB",1,0,1
"10516","sample087","RBR","BRR",1,0,1
"10517","sample087","RBR","GRR",4,0,4
"10518","sample087","RBR","RGG",2,2,4
"10519","sample087","RBR","RGR",1,0,1
"10520","sample087","RGG","BBR",1,0,1
"10521","sample087","RGR","BBB",2,0,2
"10522","sample087","RGR","BBR",1,0,1
"10523","sample087","RGR","BGB",2,0,2
"10524","sample087","RGR","BGG",2,1,3
"10525","sample087","RGR","BRR",1,1,2
"10526","sample087","RGR","GGB",2,0,2
"10527","sample087","RGR","RGG",1,0,1
"10528","sample087","RRG","BBB",2,3,5
"10529","sample087","RRG","BGB",1,2,3
"10530","sample087","RRG","BRB",2,5,7
"10531","sample087","RRG","BRR",1,5,6
"10532","sample087","RRG","GGG",2,2,4
"10533","sample087","RRG","GRG",1,0,1
"10534","sample087","RRG","GRR",3,2,5
"10535","sample087","RRG","RBB",1,0,1
"10536","sample087","RRR","BBR",1,0,1
"10537","sample087","RRR","BGB",2,1,3
"10538","sample087","RRR","BGG",1,0,1
"10539","sample087","RRR","BRB",1,0,1
"10540","sample087","RRR","BRR",1,0,1
"10541","sample087","RRR","RBB",1,1,2
"10542","sample087","RRR","RGR",1,0,1
"10543","sample087","RRR","RRG",2,0,2
"10544","sample087","BBB","RBG",0,1,1
"10545","sample087","BBG","BGG",0,1,1
"10546","sample087","BBG","RBG",0,1,1
"10547","sample087","BRB","BBB",0,1,1
"10548","sample087","BRB","BRR",0,1,1
"10549","sample087","BRB","GGR",0,1,1
"10550","sample087","BRR","BBB",0,2,2
"10551","sample087","GBB","GGB",0,2,2
"10552","sample087","GBB","GRG",0,1,1
"10553","sample087","GBG","BBB",0,1,1
"10554","sample087","GGB","BGB",0,1,1
"10555","sample087","GGB","BGG",0,1,1
"10556","sample087","GGB","BRB",0,1,1
"10557","sample087","GGB","RBB",0,1,1
"10558","sample087","GGB","RBG",0,1,1
"10559","sample087","GGG","BRR",0,2,2
"10560","sample087","GGG","RBG",0,1,1
"10561","sample087","GGG","RBR",0,3,3
"10562","sample087","GGR","BBB",0,1,1
"10563","sample087","GGR","BBR",0,1,1
"10564","sample087","GGR","BGG",0,1,1
"10565","sample087","GRG","BRB",0,1,1
"10566","sample087","GRG","BRR",0,1,1
"10567","sample087","GRG","GGR",0,2,2
"10568","sample087","GRR","BGG",0,1,1
"10569","sample087","RBB","GRR",0,1,1
"10570","sample087","RBG","GBB",0,1,1
"10571","sample087","RBG","GRR",0,1,1
"10572","sample087","RBR","BBR",0,1,1
"10573","sample087","RBR","BGG",0,1,1
"10574","sample087","RBR","GGB",0,2,2
"10575","sample087","RGG","BBB",0,2,2
"10576","sample087","RGG","GGR",0,1,1
"10577","sample087","RGR","GGR",0,1,1
"10578","sample087","RGR","RBB",0,1,1
"10579","sample087","RRR","GGR",0,1,1
"10580","sample087","RRR","GRR",0,1,1
"10581","sample087","RRR","RBR",0,1,1
"10582","sample088","BBB","GGG",1,0,1
"10583","sample088","BBB","RRG",1,1,2
"10584","sample088","BBG","BBB",1,0,1
"10585","sample088","BBG","BRB",1,5,6
"10586","sample088","BBG","GBG",2,0,2
"10587","sample088","BBG","GGB",2,2,4
"10588","sample088","BBG","GGG",4,7,11
"10589","sample088","BBG","GRG",1,3,4
"10590","sample088","BBG","RRG",1,0,1
"10591","sample088","BGG","RBG",1,0,1
"10592","sample088","BGG","RRR",1,0,1
"10593","sample088","BRR","BGB",1,0,1
"10594","sample088","GBB","BBB",12,7,19
"10595","sample088","GBB","BRB",1,2,3
"10596","sample088","GBB","BRR",1,1,2
"10597","sample088","GBB","GGG",7,9,16
"10598","sample088","GBB","GGR",1,0,1
"10599","sample088","GBB","RBG",3,3,6
"10600","sample088","GBB","RBR",1,0,1
"10601","sample088","GBB","RGG",1,0,1
"10602","sample088","GBB","RGR",2,0,2
"10603","sample088","GBB","RRR",1,4,5
"10604","sample088","GBG","BRB",1,0,1
"10605","sample088","GBG","BRR",1,0,1
"10606","sample088","GBG","GGG",4,1,5
"10607","sample088","GBG","RBB",1,0,1
"10608","sample088","GBG","RGR",1,1,2
"10609","sample088","GBG","RRG",1,0,1
"10610","sample088","GGB","BBB",3,3,6
"10611","sample088","GGB","BBR",1,1,2
"10612","sample088","GGB","BRR",1,1,2
"10613","sample088","GGB","GBG",1,0,1
"10614","sample088","GGB","GGG",13,7,20
"10615","sample088","GGB","RGG",1,0,1
"10616","sample088","GGB","RRG",1,1,2
"10617","sample088","GGB","RRR",1,2,3
"10618","sample088","GGG","BBB",8,7,15
"10619","sample088","GGG","BGG",1,0,1
"10620","sample088","GGG","BRB",1,0,1
"10621","sample088","GGG","GGB",5,0,5
"10622","sample088","GGG","GGR",1,1,2
"10623","sample088","GGG","RBB",1,3,4
"10624","sample088","GGG","RGR",1,3,4
"10625","sample088","GGG","RRG",1,3,4
"10626","sample088","GGR","BRR",1,0,1
"10627","sample088","GGR","GRR",1,0,1
"10628","sample088","GRG","BBB",3,1,4
"10629","sample088","GRG","GGB",2,0,2
"10630","sample088","GRG","GGG",3,2,5
"10631","sample088","GRG","RGR",1,0,1
"10632","sample088","GRG","RRG",2,0,2
"10633","sample088","GRR","BGB",1,0,1
"10634","sample088","RBG","BBB",2,1,3
"10635","sample088","RBG","RBB",1,0,1
"10636","sample088","RBR","BGB",2,0,2
"10637","sample088","RBR","BRB",1,0,1
"10638","sample088","RBR","BRR",1,1,2
"10639","sample088","RBR","GRR",4,1,5
"10640","sample088","RBR","RGG",2,0,2
"10641","sample088","RBR","RGR",1,0,1
"10642","sample088","RGG","BBR",1,0,1
"10643","sample088","RGR","BBB",2,2,4
"10644","sample088","RGR","BBR",1,0,1
"10645","sample088","RGR","BGB",2,1,3
"10646","sample088","RGR","BGG",2,1,3
"10647","sample088","RGR","BRR",1,1,2
"10648","sample088","RGR","GGB",2,4,6
"10649","sample088","RGR","RGG",1,0,1
"10650","sample088","RRG","BBB",2,3,5
"10651","sample088","RRG","BGB",1,1,2
"10652","sample088","RRG","BRB",2,8,10
"10653","sample088","RRG","BRR",1,2,3
"10654","sample088","RRG","GGG",2,1,3
"10655","sample088","RRG","GRG",1,0,1
"10656","sample088","RRG","GRR",3,2,5
"10657","sample088","RRG","RBB",1,0,1
"10658","sample088","RRR","BBR",1,0,1
"10659","sample088","RRR","BGB",2,0,2
"10660","sample088","RRR","BGG",1,0,1
"10661","sample088","RRR","BRB",1,0,1
"10662","sample088","RRR","BRR",1,0,1
"10663","sample088","RRR","RBB",1,0,1
"10664","sample088","RRR","RGR",1,0,1
"10665","sample088","RRR","RRG",2,0,2
"10666","sample088","BBG","BGG",0,1,1
"10667","sample088","BBG","RRR",0,1,1
"10668","sample088","BRB","BBB",0,2,2
"10669","sample088","BRB","GGR",0,1,1
"10670","sample088","BRB","RBG",0,1,1
"10671","sample088","BRB","RGR",0,1,1
"10672","sample088","BRR","BGG",0,1,1
"10673","sample088","BRR","BRB",0,1,1
"10674","sample088","GBB","GBG",0,1,1
"10675","sample088","GBB","GGB",0,4,4
"10676","sample088","GBB","GRG",0,1,1
"10677","sample088","GBB","RRG",0,1,1
"10678","sample088","GBG","BBR",0,1,1
"10679","sample088","GBG","RGG",0,1,1
"10680","sample088","GGB","BGB",0,1,1
"10681","sample088","GGB","BGG",0,1,1
"10682","sample088","GGB","BRB",0,1,1
"10683","sample088","GGB","GRR",0,1,1
"10684","sample088","GGB","RBR",0,1,1
"10685","sample088","GGG","BRR",0,1,1
"10686","sample088","GGG","GRR",0,1,1
"10687","sample088","GGG","RBR",0,3,3
"10688","sample088","GGG","RRR",0,1,1
"10689","sample088","GRG","BBR",0,1,1
"10690","sample088","GRG","GBG",0,1,1
"10691","sample088","GRR","BGG",0,1,1
"10692","sample088","RBG","BBG",0,1,1
"10693","sample088","RBR","BBB",0,2,2
"10694","sample088","RBR","GGB",0,2,2
"10695","sample088","RBR","RRR",0,1,1
"10696","sample088","RGG","BGB",0,1,1
"10697","sample088","RGG","BRR",0,1,1
"10698","sample088","RGG","GRR",0,1,1
"10699","sample088","RGR","GGR",0,1,1
"10700","sample088","RGR","RBB",0,1,1
"10701","sample088","RRG","BBR",0,2,2
"10702","sample088","RRG","GGR",0,2,2
"10703","sample088","RRG","RGR",0,1,1
"10704","sample088","RRR","GRR",0,1,1
"10705","sample088","RRR","RGG",0,1,1
"10706","sample089","BBB","GGG",1,1,2
"10707","sample089","BBB","RRG",1,2,3
"10708","sample089","BBG","BBB",1,1,2
"10709","sample089","BBG","BRB",1,4,5
"10710","sample089","BBG","GBG",2,1,3
"10711","sample089","BBG","GGB",2,6,8
"10712","sample089","BBG","GGG",4,3,7
"10713","sample089","BBG","GRG",1,2,3
"10714","sample089","BBG","RRG",1,1,2
"10715","sample089","BGG","RBG",1,0,1
"10716","sample089","BGG","RRR",1,0,1
"10717","sample089","BRR","BGB",1,0,1
"10718","sample089","GBB","BBB",12,4,16
"10719","sample089","GBB","BRB",1,3,4
"10720","sample089","GBB","BRR",1,0,1
"10721","sample089","GBB","GGG",7,19,26
"10722","sample089","GBB","GGR",1,1,2
"10723","sample089","GBB","RBG",3,0,3
"10724","sample089","GBB","RBR",1,0,1
"10725","sample089","GBB","RGG",1,0,1
"10726","sample089","GBB","RGR",2,0,2
"10727","sample089","GBB","RRR",1,1,2
"10728","sample089","GBG","BRB",1,1,2
"10729","sample089","GBG","BRR",1,0,1
"10730","sample089","GBG","GGG",4,2,6
"10731","sample089","GBG","RBB",1,0,1
"10732","sample089","GBG","RGR",1,1,2
"10733","sample089","GBG","RRG",1,0,1
"10734","sample089","GGB","BBB",3,3,6
"10735","sample089","GGB","BBR",1,0,1
"10736","sample089","GGB","BRR",1,3,4
"10737","sample089","GGB","GBG",1,0,1
"10738","sample089","GGB","GGG",13,4,17
"10739","sample089","GGB","RGG",1,2,3
"10740","sample089","GGB","RRG",1,0,1
"10741","sample089","GGB","RRR",1,0,1
"10742","sample089","GGG","BBB",8,2,10
"10743","sample089","GGG","BGG",1,1,2
"10744","sample089","GGG","BRB",1,0,1
"10745","sample089","GGG","GGB",5,0,5
"10746","sample089","GGG","GGR",1,3,4
"10747","sample089","GGG","RBB",1,0,1
"10748","sample089","GGG","RGR",1,1,2
"10749","sample089","GGG","RRG",1,2,3
"10750","sample089","GGR","BRR",1,0,1
"10751","sample089","GGR","GRR",1,0,1
"10752","sample089","GRG","BBB",3,1,4
"10753","sample089","GRG","GGB",2,3,5
"10754","sample089","GRG","GGG",3,2,5
"10755","sample089","GRG","RGR",1,0,1
"10756","sample089","GRG","RRG",2,1,3
"10757","sample089","GRR","BGB",1,0,1
"10758","sample089","RBG","BBB",2,2,4
"10759","sample089","RBG","RBB",1,0,1
"10760","sample089","RBR","BGB",2,0,2
"10761","sample089","RBR","BRB",1,0,1
"10762","sample089","RBR","BRR",1,0,1
"10763","sample089","RBR","GRR",4,1,5
"10764","sample089","RBR","RGG",2,2,4
"10765","sample089","RBR","RGR",1,0,1
"10766","sample089","RGG","BBR",1,0,1
"10767","sample089","RGR","BBB",2,0,2
"10768","sample089","RGR","BBR",1,0,1
"10769","sample089","RGR","BGB",2,2,4
"10770","sample089","RGR","BGG",2,1,3
"10771","sample089","RGR","BRR",1,0,1
"10772","sample089","RGR","GGB",2,2,4
"10773","sample089","RGR","RGG",1,0,1
"10774","sample089","RRG","BBB",2,3,5
"10775","sample089","RRG","BGB",1,1,2
"10776","sample089","RRG","BRB",2,10,12
"10777","sample089","RRG","BRR",1,4,5
"10778","sample089","RRG","GGG",2,2,4
"10779","sample089","RRG","GRG",1,0,1
"10780","sample089","RRG","GRR",3,0,3
"10781","sample089","RRG","RBB",1,0,1
"10782","sample089","RRR","BBR",1,0,1
"10783","sample089","RRR","BGB",2,1,3
"10784","sample089","RRR","BGG",1,0,1
"10785","sample089","RRR","BRB",1,0,1
"10786","sample089","RRR","BRR",1,0,1
"10787","sample089","RRR","RBB",1,0,1
"10788","sample089","RRR","RGR",1,1,2
"10789","sample089","RRR","RRG",2,0,2
"10790","sample089","BBB","BRB",0,1,1
"10791","sample089","BBG","BGG",0,1,1
"10792","sample089","BBG","GRR",0,1,1
"10793","sample089","BBG","RBB",0,1,1
"10794","sample089","BBG","RBG",0,1,1
"10795","sample089","BBG","RRR",0,2,2
"10796","sample089","BGG","BBB",0,1,1
"10797","sample089","BGG","RGG",0,1,1
"10798","sample089","BRB","BBB",0,2,2
"10799","sample089","BRB","BBR",0,1,1
"10800","sample089","BRB","RBB",0,1,1
"10801","sample089","BRR","BBB",0,1,1
"10802","sample089","GBB","GBG",0,1,1
"10803","sample089","GBB","GGB",0,4,4
"10804","sample089","GBB","GRG",0,1,1
"10805","sample089","GBB","GRR",0,1,1
"10806","sample089","GBG","GGB",0,2,2
"10807","sample089","GBG","RGG",0,1,1
"10808","sample089","GGB","RBB",0,1,1
"10809","sample089","GGB","RBG",0,1,1
"10810","sample089","GGG","RBG",0,1,1
"10811","sample089","GGG","RBR",0,1,1
"10812","sample089","GRG","BRB",0,1,1
"10813","sample089","GRG","BRR",0,1,1
"10814","sample089","GRR","BRR",0,1,1
"10815","sample089","RBG","GRR",0,1,1
"10816","sample089","RBG","RBR",0,1,1
"10817","sample089","RBR","BBB",0,3,3
"10818","sample089","RBR","GGB",0,1,1
"10819","sample089","RBR","RBB",0,2,2
"10820","sample089","RGG","BBB",0,1,1
"10821","sample089","RGG","BRR",0,1,1
"10822","sample089","RGG","GRR",0,2,2
"10823","sample089","RRG","BBR",0,1,1
"10824","sample089","RRG","GGR",0,1,1
"10825","sample089","RRR","GRR",0,2,2
"10826","sample090","BBB","GGG",1,0,1
"10827","sample090","BBB","RRG",1,0,1
"10828","sample090","BBG","BBB",1,1,2
"10829","sample090","BBG","BRB",1,2,3
"10830","sample090","BBG","GBG",2,0,2
"10831","sample090","BBG","GGB",2,3,5
"10832","sample090","BBG","GGG",4,7,11
"10833","sample090","BBG","GRG",1,0,1
"10834","sample090","BBG","RRG",1,0,1
"10835","sample090","BGG","RBG",1,0,1
"10836","sample090","BGG","RRR",1,0,1
"10837","sample090","BRR","BGB",1,1,2
"10838","sample090","GBB","BBB",12,8,20
"10839","sample090","GBB","BRB",1,1,2
"10840","sample090","GBB","BRR",1,0,1
"10841","sample090","GBB","GGG",7,15,22
"10842","sample090","GBB","GGR",1,1,2
"10843","sample090","GBB","RBG",3,1,4
"10844","sample090","GBB","RBR",1,0,1
"10845","sample090","GBB","RGG",1,0,1
"10846","sample090","GBB","RGR",2,0,2
"10847","sample090","GBB","RRR",1,0,1
"10848","sample090","GBG","BRB",1,1,2
"10849","sample090","GBG","BRR",1,0,1
"10850","sample090","GBG","GGG",4,3,7
"10851","sample090","GBG","RBB",1,0,1
"10852","sample090","GBG","RGR",1,0,1
"10853","sample090","GBG","RRG",1,1,2
"10854","sample090","GGB","BBB",3,1,4
"10855","sample090","GGB","BBR",1,0,1
"10856","sample090","GGB","BRR",1,2,3
"10857","sample090","GGB","GBG",1,0,1
"10858","sample090","GGB","GGG",13,7,20
"10859","sample090","GGB","RGG",1,1,2
"10860","sample090","GGB","RRG",1,1,2
"10861","sample090","GGB","RRR",1,0,1
"10862","sample090","GGG","BBB",8,9,17
"10863","sample090","GGG","BGG",1,0,1
"10864","sample090","GGG","BRB",1,0,1
"10865","sample090","GGG","GGB",5,0,5
"10866","sample090","GGG","GGR",1,0,1
"10867","sample090","GGG","RBB",1,1,2
"10868","sample090","GGG","RGR",1,1,2
"10869","sample090","GGG","RRG",1,4,5
"10870","sample090","GGR","BRR",1,0,1
"10871","sample090","GGR","GRR",1,0,1
"10872","sample090","GRG","BBB",3,2,5
"10873","sample090","GRG","GGB",2,1,3
"10874","sample090","GRG","GGG",3,3,6
"10875","sample090","GRG","RGR",1,0,1
"10876","sample090","GRG","RRG",2,1,3
"10877","sample090","GRR","BGB",1,0,1
"10878","sample090","RBG","BBB",2,0,2
"10879","sample090","RBG","RBB",1,0,1
"10880","sample090","RBR","BGB",2,2,4
"10881","sample090","RBR","BRB",1,0,1
"10882","sample090","RBR","BRR",1,1,2
"10883","sample090","RBR","GRR",4,0,4
"10884","sample090","RBR","RGG",2,2,4
"10885","sample090","RBR","RGR",1,0,1
"10886","sample090","RGG","BBR",1,0,1
"10887","sample090","RGR","BBB",2,1,3
"10888","sample090","RGR","BBR",1,1,2
"10889","sample090","RGR","BGB",2,2,4
"10890","sample090","RGR","BGG",2,0,2
"10891","sample090","RGR","BRR",1,0,1
"10892","sample090","RGR","GGB",2,3,5
"10893","sample090","RGR","RGG",1,0,1
"10894","sample090","RRG","BBB",2,3,5
"10895","sample090","RRG","BGB",1,0,1
"10896","sample090","RRG","BRB",2,6,8
"10897","sample090","RRG","BRR",1,3,4
"10898","sample090","RRG","GGG",2,2,4
"10899","sample090","RRG","GRG",1,0,1
"10900","sample090","RRG","GRR",3,2,5
"10901","sample090","RRG","RBB",1,0,1
"10902","sample090","RRR","BBR",1,0,1
"10903","sample090","RRR","BGB",2,0,2
"10904","sample090","RRR","BGG",1,0,1
"10905","sample090","RRR","BRB",1,0,1
"10906","sample090","RRR","BRR",1,1,2
"10907","sample090","RRR","RBB",1,0,1
"10908","sample090","RRR","RGR",1,1,2
"10909","sample090","RRR","RRG",2,0,2
"10910","sample090","BBG","RBG",0,2,2
"10911","sample090","BBG","RRR",0,1,1
"10912","sample090","BGG","BBB",0,1,1
"10913","sample090","BRB","BBB",0,2,2
"10914","sample090","BRB","RGR",0,1,1
"10915","sample090","BRR","BBB",0,2,2
"10916","sample090","GBB","GGB",0,4,4
"10917","sample090","GBB","GRG",0,2,2
"10918","sample090","GBB","RBB",0,1,1
"10919","sample090","GBB","RRG",0,1,1
"10920","sample090","GBG","GGB",0,1,1
"10921","sample090","GGG","BGB",0,1,1
"10922","sample090","GGG","BRR",0,2,2
"10923","sample090","GGG","GRR",0,2,2
"10924","sample090","GGG","RBG",0,2,2
"10925","sample090","GGG","RBR",0,3,3
"10926","sample090","GGR","BBB",0,1,1
"10927","sample090","GRG","BBR",0,1,1
"10928","sample090","GRG","GGR",0,1,1
"10929","sample090","GRG","GRR",0,1,1
"10930","sample090","GRR","BRR",0,1,1
"10931","sample090","RBR","BBB",0,3,3
"10932","sample090","RBR","BGG",0,1,1
"10933","sample090","RBR","GGB",0,2,2
"10934","sample090","RBR","RBB",0,2,2
"10935","sample090","RBR","RRR",0,1,1
"10936","sample090","RGG","BBB",0,2,2
"10937","sample090","RGG","BRR",0,1,1
"10938","sample090","RGG","GRR",0,1,1
"10939","sample090","RGR","RBB",0,1,1
"10940","sample090","RGR","RRG",0,1,1
"10941","sample090","RRG","BBR",0,1,1
"10942","sample090","RRR","RBR",0,1,1
"10943","sample090","RRR","RGG",0,1,1
"10944","sample091","BBB","GGG",1,0,1
"10945","sample091","BBB","RRG",1,2,3
"10946","sample091","BBG","BBB",1,0,1
"10947","sample091","BBG","BRB",1,2,3
"10948","sample091","BBG","GBG",2,0,2
"10949","sample091","BBG","GGB",2,3,5
"10950","sample091","BBG","GGG",4,6,10
"10951","sample091","BBG","GRG",1,1,2
"10952","sample091","BBG","RRG",1,0,1
"10953","sample091","BGG","RBG",1,1,2
"10954","sample091","BGG","RRR",1,0,1
"10955","sample091","BRR","BGB",1,0,1
"10956","sample091","GBB","BBB",12,3,15
"10957","sample091","GBB","BRB",1,1,2
"10958","sample091","GBB","BRR",1,0,1
"10959","sample091","GBB","GGG",7,17,24
"10960","sample091","GBB","GGR",1,1,2
"10961","sample091","GBB","RBG",3,2,5
"10962","sample091","GBB","RBR",1,0,1
"10963","sample091","GBB","RGG",1,0,1
"10964","sample091","GBB","RGR",2,0,2
"10965","sample091","GBB","RRR",1,2,3
"10966","sample091","GBG","BRB",1,0,1
"10967","sample091","GBG","BRR",1,0,1
"10968","sample091","GBG","GGG",4,1,5
"10969","sample091","GBG","RBB",1,0,1
"10970","sample091","GBG","RGR",1,0,1
"10971","sample091","GBG","RRG",1,2,3
"10972","sample091","GGB","BBB",3,6,9
"10973","sample091","GGB","BBR",1,0,1
"10974","sample091","GGB","BRR",1,5,6
"10975","sample091","GGB","GBG",1,0,1
"10976","sample091","GGB","GGG",13,6,19
"10977","sample091","GGB","RGG",1,0,1
"10978","sample091","GGB","RRG",1,0,1
"10979","sample091","GGB","RRR",1,1,2
"10980","sample091","GGG","BBB",8,5,13
"10981","sample091","GGG","BGG",1,1,2
"10982","sample091","GGG","BRB",1,0,1
"10983","sample091","GGG","GGB",5,0,5
"10984","sample091","GGG","GGR",1,0,1
"10985","sample091","GGG","RBB",1,1,2
"10986","sample091","GGG","RGR",1,2,3
"10987","sample091","GGG","RRG",1,3,4
"10988","sample091","GGR","BRR",1,0,1
"10989","sample091","GGR","GRR",1,0,1
"10990","sample091","GRG","BBB",3,2,5
"10991","sample091","GRG","GGB",2,1,3
"10992","sample091","GRG","GGG",3,5,8
"10993","sample091","GRG","RGR",1,0,1
"10994","sample091","GRG","RRG",2,0,2
"10995","sample091","GRR","BGB",1,0,1
"10996","sample091","RBG","BBB",2,0,2
"10997","sample091","RBG","RBB",1,0,1
"10998","sample091","RBR","BGB",2,0,2
"10999","sample091","RBR","BRB",1,0,1
"11000","sample091","RBR","BRR",1,2,3
"11001","sample091","RBR","GRR",4,1,5
"11002","sample091","RBR","RGG",2,2,4
"11003","sample091","RBR","RGR",1,0,1
"11004","sample091","RGG","BBR",1,0,1
"11005","sample091","RGR","BBB",2,0,2
"11006","sample091","RGR","BBR",1,0,1
"11007","sample091","RGR","BGB",2,2,4
"11008","sample091","RGR","BGG",2,0,2
"11009","sample091","RGR","BRR",1,0,1
"11010","sample091","RGR","GGB",2,1,3
"11011","sample091","RGR","RGG",1,1,2
"11012","sample091","RRG","BBB",2,4,6
"11013","sample091","RRG","BGB",1,0,1
"11014","sample091","RRG","BRB",2,12,14
"11015","sample091","RRG","BRR",1,2,3
"11016","sample091","RRG","GGG",2,5,7
"11017","sample091","RRG","GRG",1,0,1
"11018","sample091","RRG","GRR",3,2,5
"11019","sample091","RRG","RBB",1,0,1
"11020","sample091","RRR","BBR",1,0,1
"11021","sample091","RRR","BGB",2,0,2
"11022","sample091","RRR","BGG",1,0,1
"11023","sample091","RRR","BRB",1,0,1
"11024","sample091","RRR","BRR",1,0,1
"11025","sample091","RRR","RBB",1,1,2
"11026","sample091","RRR","RGR",1,0,1
"11027","sample091","RRR","RRG",2,0,2
"11028","sample091","BBB","GRR",0,1,1
"11029","sample091","BBB","RBG",0,1,1
"11030","sample091","BBG","GBB",0,1,1
"11031","sample091","BBG","RBB",0,1,1
"11032","sample091","BBG","RRR",0,1,1
"11033","sample091","BGB","BBB",0,1,1
"11034","sample091","BRR","BBB",0,2,2
"11035","sample091","BRR","BRB",0,1,1
"11036","sample091","GBB","BGG",0,1,1
"11037","sample091","GBB","GRG",0,2,2
"11038","sample091","GBG","BBB",0,1,1
"11039","sample091","GBG","GGB",0,1,1
"11040","sample091","GBG","RBG",0,1,1
"11041","sample091","GGB","BGB",0,1,1
"11042","sample091","GGB","GRR",0,1,1
"11043","sample091","GGG","RBG",0,1,1
"11044","sample091","GGG","RBR",0,3,3
"11045","sample091","GGR","BBR",0,1,1
"11046","sample091","GRG","BGG",0,1,1
"11047","sample091","GRG","GGR",0,2,2
"11048","sample091","GRR","BBR",0,1,1
"11049","sample091","RBB","BBB",0,1,1
"11050","sample091","RBB","BBR",0,1,1
"11051","sample091","RBG","BRR",0,1,1
"11052","sample091","RBR","BBB",0,2,2
"11053","sample091","RBR","GGB",0,1,1
"11054","sample091","RGG","BBB",0,1,1
"11055","sample091","RGG","BRR",0,2,2
"11056","sample091","RGG","GGR",0,1,1
"11057","sample091","RGG","GRR",0,1,1
"11058","sample091","RGR","RBB",0,2,2
"11059","sample091","RRG","BBR",0,1,1
"11060","sample091","RRG","GGR",0,1,1
"11061","sample091","RRG","RGG",0,1,1
"11062","sample091","RRR","GRR",0,1,1
"11063","sample092","BBB","GGG",1,0,1
"11064","sample092","BBB","RRG",1,0,1
"11065","sample092","BBG","BBB",1,0,1
"11066","sample092","BBG","BRB",1,2,3
"11067","sample092","BBG","GBG",2,2,4
"11068","sample092","BBG","GGB",2,7,9
"11069","sample092","BBG","GGG",4,6,10
"11070","sample092","BBG","GRG",1,1,2
"11071","sample092","BBG","RRG",1,0,1
"11072","sample092","BGG","RBG",1,0,1
"11073","sample092","BGG","RRR",1,0,1
"11074","sample092","BRR","BGB",1,0,1
"11075","sample092","GBB","BBB",12,3,15
"11076","sample092","GBB","BRB",1,2,3
"11077","sample092","GBB","BRR",1,0,1
"11078","sample092","GBB","GGG",7,10,17
"11079","sample092","GBB","GGR",1,0,1
"11080","sample092","GBB","RBG",3,2,5
"11081","sample092","GBB","RBR",1,0,1
"11082","sample092","GBB","RGG",1,0,1
"11083","sample092","GBB","RGR",2,0,2
"11084","sample092","GBB","RRR",1,1,2
"11085","sample092","GBG","BRB",1,0,1
"11086","sample092","GBG","BRR",1,0,1
"11087","sample092","GBG","GGG",4,0,4
"11088","sample092","GBG","RBB",1,0,1
"11089","sample092","GBG","RGR",1,0,1
"11090","sample092","GBG","RRG",1,0,1
"11091","sample092","GGB","BBB",3,3,6
"11092","sample092","GGB","BBR",1,0,1
"11093","sample092","GGB","BRR",1,1,2
"11094","sample092","GGB","GBG",1,0,1
"11095","sample092","GGB","GGG",13,12,25
"11096","sample092","GGB","RGG",1,2,3
"11097","sample092","GGB","RRG",1,1,2
"11098","sample092","GGB","RRR",1,1,2
"11099","sample092","GGG","BBB",8,4,12
"11100","sample092","GGG","BGG",1,1,2
"11101","sample092","GGG","BRB",1,0,1
"11102","sample092","GGG","GGB",5,0,5
"11103","sample092","GGG","GGR",1,2,3
"11104","sample092","GGG","RBB",1,2,3
"11105","sample092","GGG","RGR",1,0,1
"11106","sample092","GGG","RRG",1,3,4
"11107","sample092","GGR","BRR",1,0,1
"11108","sample092","GGR","GRR",1,0,1
"11109","sample092","GRG","BBB",3,0,3
"11110","sample092","GRG","GGB",2,2,4
"11111","sample092","GRG","GGG",3,1,4
"11112","sample092","GRG","RGR",1,1,2
"11113","sample092","GRG","RRG",2,1,3
"11114","sample092","GRR","BGB",1,0,1
"11115","sample092","RBG","BBB",2,2,4
"11116","sample092","RBG","RBB",1,0,1
"11117","sample092","RBR","BGB",2,0,2
"11118","sample092","RBR","BRB",1,0,1
"11119","sample092","RBR","BRR",1,1,2
"11120","sample092","RBR","GRR",4,0,4
"11121","sample092","RBR","RGG",2,2,4
"11122","sample092","RBR","RGR",1,0,1
"11123","sample092","RGG","BBR",1,0,1
"11124","sample092","RGR","BBB",2,1,3
"11125","sample092","RGR","BBR",1,0,1
"11126","sample092","RGR","BGB",2,0,2
"11127","sample092","RGR","BGG",2,1,3
"11128","sample092","RGR","BRR",1,3,4
"11129","sample092","RGR","GGB",2,0,2
"11130","sample092","RGR","RGG",1,0,1
"11131","sample092","RRG","BBB",2,5,7
"11132","sample092","RRG","BGB",1,3,4
"11133","sample092","RRG","BRB",2,1,3
"11134","sample092","RRG","BRR",1,4,5
"11135","sample092","RRG","GGG",2,2,4
"11136","sample092","RRG","GRG",1,0,1
"11137","sample092","RRG","GRR",3,2,5
"11138","sample092","RRG","RBB",1,0,1
"11139","sample092","RRR","BBR",1,0,1
"11140","sample092","RRR","BGB",2,0,2
"11141","sample092","RRR","BGG",1,0,1
"11142","sample092","RRR","BRB",1,0,1
"11143","sample092","RRR","BRR",1,0,1
"11144","sample092","RRR","RBB",1,1,2
"11145","sample092","RRR","RGR",1,0,1
"11146","sample092","RRR","RRG",2,1,3
"11147","sample092","BBB","BRB",0,1,1
"11148","sample092","BBB","RBG",0,1,1
"11149","sample092","BBG","GRR",0,1,1
"11150","sample092","BBG","RRR",0,1,1
"11151","sample092","BGB","BBB",0,1,1
"11152","sample092","BGG","GRG",0,1,1
"11153","sample092","BRB","BBB",0,2,2
"11154","sample092","BRB","GGR",0,1,1
"11155","sample092","BRR","BBB",0,3,3
"11156","sample092","BRR","BGG",0,1,1
"11157","sample092","BRR","BRB",0,1,1
"11158","sample092","BRR","RBB",0,2,2
"11159","sample092","GBB","GBG",0,1,1
"11160","sample092","GBB","GGB",0,5,5
"11161","sample092","GBB","GRG",0,1,1
"11162","sample092","GBG","GGB",0,1,1
"11163","sample092","GGB","BGB",0,2,2
"11164","sample092","GGB","BGG",0,1,1
"11165","sample092","GGB","RBB",0,1,1
"11166","sample092","GGB","RBG",0,3,3
"11167","sample092","GGB","RBR",0,1,1
"11168","sample092","GGG","RBR",0,2,2
"11169","sample092","GGR","BGG",0,1,1
"11170","sample092","GRG","GGR",0,1,1
"11171","sample092","GRR","BBR",0,1,1
"11172","sample092","GRR","BRR",0,1,1
"11173","sample092","GRR","GGR",0,1,1
"11174","sample092","RBB","BRB",0,1,1
"11175","sample092","RBB","GRR",0,1,1
"11176","sample092","RBR","BBB",0,2,2
"11177","sample092","RBR","BBR",0,1,1
"11178","sample092","RBR","BGG",0,1,1
"11179","sample092","RBR","GGB",0,1,1
"11180","sample092","RBR","RBB",0,2,2
"11181","sample092","RGG","BBB",0,2,2
"11182","sample092","RGG","GGR",0,1,1
"11183","sample092","RGG","GRR",0,1,1
"11184","sample092","RGR","RBB",0,1,1
"11185","sample092","RGR","RRG",0,1,1
"11186","sample092","RRG","BGG",0,1,1
"11187","sample092","RRG","GGR",0,2,2
"11188","sample092","RRR","RGG",0,1,1
"11189","sample093","BBB","GGG",1,0,1
"11190","sample093","BBB","RRG",1,0,1
"11191","sample093","BBG","BBB",1,0,1
"11192","sample093","BBG","BRB",1,4,5
"11193","sample093","BBG","GBG",2,0,2
"11194","sample093","BBG","GGB",2,5,7
"11195","sample093","BBG","GGG",4,5,9
"11196","sample093","BBG","GRG",1,3,4
"11197","sample093","BBG","RRG",1,0,1
"11198","sample093","BGG","RBG",1,0,1
"11199","sample093","BGG","RRR",1,0,1
"11200","sample093","BRR","BGB",1,0,1
"11201","sample093","GBB","BBB",12,6,18
"11202","sample093","GBB","BRB",1,2,3
"11203","sample093","GBB","BRR",1,0,1
"11204","sample093","GBB","GGG",7,14,21
"11205","sample093","GBB","GGR",1,0,1
"11206","sample093","GBB","RBG",3,2,5
"11207","sample093","GBB","RBR",1,0,1
"11208","sample093","GBB","RGG",1,0,1
"11209","sample093","GBB","RGR",2,0,2
"11210","sample093","GBB","RRR",1,0,1
"11211","sample093","GBG","BRB",1,1,2
"11212","sample093","GBG","BRR",1,0,1
"11213","sample093","GBG","GGG",4,2,6
"11214","sample093","GBG","RBB",1,0,1
"11215","sample093","GBG","RGR",1,0,1
"11216","sample093","GBG","RRG",1,0,1
"11217","sample093","GGB","BBB",3,2,5
"11218","sample093","GGB","BBR",1,1,2
"11219","sample093","GGB","BRR",1,2,3
"11220","sample093","GGB","GBG",1,0,1
"11221","sample093","GGB","GGG",13,9,22
"11222","sample093","GGB","RGG",1,0,1
"11223","sample093","GGB","RRG",1,0,1
"11224","sample093","GGB","RRR",1,0,1
"11225","sample093","GGG","BBB",8,6,14
"11226","sample093","GGG","BGG",1,1,2
"11227","sample093","GGG","BRB",1,1,2
"11228","sample093","GGG","GGB",5,0,5
"11229","sample093","GGG","GGR",1,2,3
"11230","sample093","GGG","RBB",1,2,3
"11231","sample093","GGG","RGR",1,3,4
"11232","sample093","GGG","RRG",1,5,6
"11233","sample093","GGR","BRR",1,0,1
"11234","sample093","GGR","GRR",1,0,1
"11235","sample093","GRG","BBB",3,1,4
"11236","sample093","GRG","GGB",2,7,9
"11237","sample093","GRG","GGG",3,0,3
"11238","sample093","GRG","RGR",1,0,1
"11239","sample093","GRG","RRG",2,0,2
"11240","sample093","GRR","BGB",1,1,2
"11241","sample093","RBG","BBB",2,0,2
"11242","sample093","RBG","RBB",1,0,1
"11243","sample093","RBR","BGB",2,0,2
"11244","sample093","RBR","BRB",1,0,1
"11245","sample093","RBR","BRR",1,0,1
"11246","sample093","RBR","GRR",4,0,4
"11247","sample093","RBR","RGG",2,2,4
"11248","sample093","RBR","RGR",1,0,1
"11249","sample093","RGG","BBR",1,1,2
"11250","sample093","RGR","BBB",2,0,2
"11251","sample093","RGR","BBR",1,0,1
"11252","sample093","RGR","BGB",2,0,2
"11253","sample093","RGR","BGG",2,0,2
"11254","sample093","RGR","BRR",1,0,1
"11255","sample093","RGR","GGB",2,0,2
"11256","sample093","RGR","RGG",1,0,1
"11257","sample093","RRG","BBB",2,5,7
"11258","sample093","RRG","BGB",1,5,6
"11259","sample093","RRG","BRB",2,9,11
"11260","sample093","RRG","BRR",1,1,2
"11261","sample093","RRG","GGG",2,1,3
"11262","sample093","RRG","GRG",1,0,1
"11263","sample093","RRG","GRR",3,3,6
"11264","sample093","RRG","RBB",1,0,1
"11265","sample093","RRR","BBR",1,0,1
"11266","sample093","RRR","BGB",2,0,2
"11267","sample093","RRR","BGG",1,0,1
"11268","sample093","RRR","BRB",1,1,2
"11269","sample093","RRR","BRR",1,0,1
"11270","sample093","RRR","RBB",1,1,2
"11271","sample093","RRR","RGR",1,0,1
"11272","sample093","RRR","RRG",2,0,2
"11273","sample093","BBB","RBG",0,1,1
"11274","sample093","BBG","BGB",0,1,1
"11275","sample093","BBG","GBB",0,1,1
"11276","sample093","BGG","RGR",0,1,1
"11277","sample093","BRB","BBB",0,3,3
"11278","sample093","BRB","GGG",0,1,1
"11279","sample093","BRB","RBG",0,1,1
"11280","sample093","GBB","GGB",0,2,2
"11281","sample093","GBB","GRG",0,1,1
"11282","sample093","GGB","BRB",0,1,1
"11283","sample093","GGB","RBB",0,1,1
"11284","sample093","GGB","RBG",0,3,3
"11285","sample093","GGB","RBR",0,1,1
"11286","sample093","GGB","RGR",0,1,1
"11287","sample093","GGG","BRR",0,1,1
"11288","sample093","GGG","GRR",0,1,1
"11289","sample093","GGG","RBG",0,2,2
"11290","sample093","GGG","RBR",0,2,2
"11291","sample093","GGR","BBR",0,1,1
"11292","sample093","GRG","BRB",0,1,1
"11293","sample093","GRG","GGR",0,1,1
"11294","sample093","RBB","RGG",0,1,1
"11295","sample093","RBG","BBG",0,1,1
"11296","sample093","RBR","BBB",0,3,3
"11297","sample093","RBR","GGB",0,2,2
"11298","sample093","RBR","RBB",0,1,1
"11299","sample093","RGG","BGB",0,1,1
"11300","sample093","RGR","RBB",0,1,1
"11301","sample093","RGR","RRG",0,2,2
"11302","sample093","RRG","GGR",0,3,3
"11303","sample093","RRR","GRR",0,1,1
"11304","sample094","BBB","GGG",1,0,1
"11305","sample094","BBB","RRG",1,0,1
"11306","sample094","BBG","BBB",1,2,3
"11307","sample094","BBG","BRB",1,4,5
"11308","sample094","BBG","GBG",2,2,4
"11309","sample094","BBG","GGB",2,6,8
"11310","sample094","BBG","GGG",4,9,13
"11311","sample094","BBG","GRG",1,1,2
"11312","sample094","BBG","RRG",1,0,1
"11313","sample094","BGG","RBG",1,1,2
"11314","sample094","BGG","RRR",1,0,1
"11315","sample094","BRR","BGB",1,1,2
"11316","sample094","GBB","BBB",12,7,19
"11317","sample094","GBB","BRB",1,0,1
"11318","sample094","GBB","BRR",1,1,2
"11319","sample094","GBB","GGG",7,11,18
"11320","sample094","GBB","GGR",1,0,1
"11321","sample094","GBB","RBG",3,1,4
"11322","sample094","GBB","RBR",1,0,1
"11323","sample094","GBB","RGG",1,0,1
"11324","sample094","GBB","RGR",2,0,2
"11325","sample094","GBB","RRR",1,2,3
"11326","sample094","GBG","BRB",1,2,3
"11327","sample094","GBG","BRR",1,0,1
"11328","sample094","GBG","GGG",4,3,7
"11329","sample094","GBG","RBB",1,0,1
"11330","sample094","GBG","RGR",1,1,2
"11331","sample094","GBG","RRG",1,0,1
"11332","sample094","GGB","BBB",3,0,3
"11333","sample094","GGB","BBR",1,0,1
"11334","sample094","GGB","BRR",1,1,2
"11335","sample094","GGB","GBG",1,0,1
"11336","sample094","GGB","GGG",13,7,20
"11337","sample094","GGB","RGG",1,1,2
"11338","sample094","GGB","RRG",1,0,1
"11339","sample094","GGB","RRR",1,1,2
"11340","sample094","GGG","BBB",8,5,13
"11341","sample094","GGG","BGG",1,2,3
"11342","sample094","GGG","BRB",1,0,1
"11343","sample094","GGG","GGB",5,0,5
"11344","sample094","GGG","GGR",1,4,5
"11345","sample094","GGG","RBB",1,1,2
"11346","sample094","GGG","RGR",1,0,1
"11347","sample094","GGG","RRG",1,3,4
"11348","sample094","GGR","BRR",1,0,1
"11349","sample094","GGR","GRR",1,0,1
"11350","sample094","GRG","BBB",3,1,4
"11351","sample094","GRG","GGB",2,1,3
"11352","sample094","GRG","GGG",3,2,5
"11353","sample094","GRG","RGR",1,0,1
"11354","sample094","GRG","RRG",2,0,2
"11355","sample094","GRR","BGB",1,0,1
"11356","sample094","RBG","BBB",2,2,4
"11357","sample094","RBG","RBB",1,0,1
"11358","sample094","RBR","BGB",2,1,3
"11359","sample094","RBR","BRB",1,0,1
"11360","sample094","RBR","BRR",1,0,1
"11361","sample094","RBR","GRR",4,1,5
"11362","sample094","RBR","RGG",2,1,3
"11363","sample094","RBR","RGR",1,0,1
"11364","sample094","RGG","BBR",1,0,1
"11365","sample094","RGR","BBB",2,1,3
"11366","sample094","RGR","BBR",1,0,1
"11367","sample094","RGR","BGB",2,0,2
"11368","sample094","RGR","BGG",2,0,2
"11369","sample094","RGR","BRR",1,0,1
"11370","sample094","RGR","GGB",2,4,6
"11371","sample094","RGR","RGG",1,0,1
"11372","sample094","RRG","BBB",2,3,5
"11373","sample094","RRG","BGB",1,1,2
"11374","sample094","RRG","BRB",2,4,6
"11375","sample094","RRG","BRR",1,3,4
"11376","sample094","RRG","GGG",2,1,3
"11377","sample094","RRG","GRG",1,0,1
"11378","sample094","RRG","GRR",3,3,6
"11379","sample094","RRG","RBB",1,1,2
"11380","sample094","RRR","BBR",1,0,1
"11381","sample094","RRR","BGB",2,0,2
"11382","sample094","RRR","BGG",1,0,1
"11383","sample094","RRR","BRB",1,0,1
"11384","sample094","RRR","BRR",1,0,1
"11385","sample094","RRR","RBB",1,1,2
"11386","sample094","RRR","RGR",1,0,1
"11387","sample094","RRR","RRG",2,0,2
"11388","sample094","BBB","RBG",0,1,1
"11389","sample094","BBG","GBB",0,1,1
"11390","sample094","BBG","GRR",0,1,1
"11391","sample094","BGG","BBB",0,1,1
"11392","sample094","BGG","GRG",0,1,1
"11393","sample094","BRB","BBB",0,1,1
"11394","sample094","BRB","BRR",0,1,1
"11395","sample094","GBB","GGB",0,2,2
"11396","sample094","GBB","RBB",0,1,1
"11397","sample094","GGB","BGB",0,1,1
"11398","sample094","GGB","GRR",0,1,1
"11399","sample094","GGB","RBB",0,2,2
"11400","sample094","GGB","RBG",0,1,1
"11401","sample094","GGB","RBR",0,1,1
"11402","sample094","GGG","BRR",0,1,1
"11403","sample094","GGG","RBR",0,2,2
"11404","sample094","GGG","RRR",0,3,3
"11405","sample094","GGR","BBR",0,1,1
"11406","sample094","GRG","BGG",0,1,1
"11407","sample094","GRG","BRB",0,1,1
"11408","sample094","GRG","BRR",0,1,1
"11409","sample094","GRG","GGR",0,1,1
"11410","sample094","GRG","RBG",0,1,1
"11411","sample094","GRG","RBR",0,1,1
"11412","sample094","GRR","GGR",0,1,1
"11413","sample094","RBB","BRB",0,1,1
"11414","sample094","RBR","BGG",0,1,1
"11415","sample094","RBR","GGB",0,2,2
"11416","sample094","RBR","RBB",0,1,1
"11417","sample094","RGG","BBB",0,1,1
"11418","sample094","RGG","BRR",0,1,1
"11419","sample094","RGG","GGR",0,1,1
"11420","sample094","RGG","GRR",0,2,2
"11421","sample094","RGR","GGG",0,1,1
"11422","sample094","RGR","GGR",0,1,1
"11423","sample094","RGR","RBB",0,3,3
"11424","sample094","RRG","BBR",0,1,1
"11425","sample094","RRG","GGR",0,1,1
"11426","sample094","RRG","RGG",0,1,1
"11427","sample094","RRR","GRR",0,2,2
"11428","sample095","BBB","GGG",1,0,1
"11429","sample095","BBB","RRG",1,0,1
"11430","sample095","BBG","BBB",1,1,2
"11431","sample095","BBG","BRB",1,2,3
"11432","sample095","BBG","GBG",2,0,2
"11433","sample095","BBG","GGB",2,0,2
"11434","sample095","BBG","GGG",4,4,8
"11435","sample095","BBG","GRG",1,1,2
"11436","sample095","BBG","RRG",1,0,1
"11437","sample095","BGG","RBG",1,1,2
"11438","sample095","BGG","RRR",1,1,2
"11439","sample095","BRR","BGB",1,0,1
"11440","sample095","GBB","BBB",12,4,16
"11441","sample095","GBB","BRB",1,3,4
"11442","sample095","GBB","BRR",1,0,1
"11443","sample095","GBB","GGG",7,15,22
"11444","sample095","GBB","GGR",1,0,1
"11445","sample095","GBB","RBG",3,3,6
"11446","sample095","GBB","RBR",1,0,1
"11447","sample095","GBB","RGG",1,0,1
"11448","sample095","GBB","RGR",2,0,2
"11449","sample095","GBB","RRR",1,2,3
"11450","sample095","GBG","BRB",1,1,2
"11451","sample095","GBG","BRR",1,0,1
"11452","sample095","GBG","GGG",4,2,6
"11453","sample095","GBG","RBB",1,0,1
"11454","sample095","GBG","RGR",1,0,1
"11455","sample095","GBG","RRG",1,1,2
"11456","sample095","GGB","BBB",3,1,4
"11457","sample095","GGB","BBR",1,2,3
"11458","sample095","GGB","BRR",1,1,2
"11459","sample095","GGB","GBG",1,0,1
"11460","sample095","GGB","GGG",13,8,21
"11461","sample095","GGB","RGG",1,1,2
"11462","sample095","GGB","RRG",1,2,3
"11463","sample095","GGB","RRR",1,1,2
"11464","sample095","GGG","BBB",8,8,16
"11465","sample095","GGG","BGG",1,0,1
"11466","sample095","GGG","BRB",1,1,2
"11467","sample095","GGG","GGB",5,0,5
"11468","sample095","GGG","GGR",1,2,3
"11469","sample095","GGG","RBB",1,0,1
"11470","sample095","GGG","RGR",1,2,3
"11471","sample095","GGG","RRG",1,4,5
"11472","sample095","GGR","BRR",1,0,1
"11473","sample095","GGR","GRR",1,0,1
"11474","sample095","GRG","BBB",3,3,6
"11475","sample095","GRG","GGB",2,2,4
"11476","sample095","GRG","GGG",3,0,3
"11477","sample095","GRG","RGR",1,0,1
"11478","sample095","GRG","RRG",2,1,3
"11479","sample095","GRR","BGB",1,0,1
"11480","sample095","RBG","BBB",2,1,3
"11481","sample095","RBG","RBB",1,0,1
"11482","sample095","RBR","BGB",2,1,3
"11483","sample095","RBR","BRB",1,0,1
"11484","sample095","RBR","BRR",1,0,1
"11485","sample095","RBR","GRR",4,1,5
"11486","sample095","RBR","RGG",2,1,3
"11487","sample095","RBR","RGR",1,0,1
"11488","sample095","RGG","BBR",1,1,2
"11489","sample095","RGR","BBB",2,0,2
"11490","sample095","RGR","BBR",1,0,1
"11491","sample095","RGR","BGB",2,1,3
"11492","sample095","RGR","BGG",2,0,2
"11493","sample095","RGR","BRR",1,0,1
"11494","sample095","RGR","GGB",2,2,4
"11495","sample095","RGR","RGG",1,0,1
"11496","sample095","RRG","BBB",2,10,12
"11497","sample095","RRG","BGB",1,1,2
"11498","sample095","RRG","BRB",2,6,8
"11499","sample095","RRG","BRR",1,5,6
"11500","sample095","RRG","GGG",2,3,5
"11501","sample095","RRG","GRG",1,0,1
"11502","sample095","RRG","GRR",3,1,4
"11503","sample095","RRG","RBB",1,0,1
"11504","sample095","RRR","BBR",1,0,1
"11505","sample095","RRR","BGB",2,0,2
"11506","sample095","RRR","BGG",1,0,1
"11507","sample095","RRR","BRB",1,0,1
"11508","sample095","RRR","BRR",1,0,1
"11509","sample095","RRR","RBB",1,0,1
"11510","sample095","RRR","RGR",1,1,2
"11511","sample095","RRR","RRG",2,0,2
"11512","sample095","BBB","RRR",0,1,1
"11513","sample095","BBG","GRR",0,1,1
"11514","sample095","BBG","RBR",0,1,1
"11515","sample095","BGB","RRG",0,1,1
"11516","sample095","BGG","GRG",0,1,1
"11517","sample095","BGG","RGR",0,1,1
"11518","sample095","BRB","BBB",0,2,2
"11519","sample095","BRB","RBB",0,1,1
"11520","sample095","BRR","BBB",0,1,1
"11521","sample095","GBB","BGG",0,1,1
"11522","sample095","GBB","GBG",0,1,1
"11523","sample095","GBB","GGB",0,3,3
"11524","sample095","GBB","GRG",0,3,3
"11525","sample095","GBG","RBG",0,1,1
"11526","sample095","GGB","GGR",0,1,1
"11527","sample095","GGB","GRR",0,1,1
"11528","sample095","GGG","BGB",0,1,1
"11529","sample095","GGG","BRR",0,2,2
"11530","sample095","GGG","RBG",0,2,2
"11531","sample095","GGG","RBR",0,1,1
"11532","sample095","GGG","RGG",0,1,1
"11533","sample095","GGG","RRR",0,1,1
"11534","sample095","GRG","BBR",0,1,1
"11535","sample095","GRR","BGG",0,1,1
"11536","sample095","GRR","BRR",0,1,1
"11537","sample095","GRR","GGR",0,1,1
"11538","sample095","RBG","BRR",0,1,1
"11539","sample095","RBR","BBB",0,1,1
"11540","sample095","RBR","GGB",0,2,2
"11541","sample095","RBR","RBB",0,1,1
"11542","sample095","RGG","GRR",0,2,2
"11543","sample095","RGR","RBB",0,1,1
"11544","sample095","RGR","RRG",0,1,1
"11545","sample095","RRG","GGR",0,1,1
"11546","sample095","RRR","GGR",0,1,1
"11547","sample095","RRR","RGG",0,1,1
"11548","sample096","BBB","GGG",1,1,2
"11549","sample096","BBB","RRG",1,0,1
"11550","sample096","BBG","BBB",1,0,1
"11551","sample096","BBG","BRB",1,3,4
"11552","sample096","BBG","GBG",2,1,3
"11553","sample096","BBG","GGB",2,4,6
"11554","sample096","BBG","GGG",4,3,7
"11555","sample096","BBG","GRG",1,5,6
"11556","sample096","BBG","RRG",1,1,2
"11557","sample096","BGG","RBG",1,0,1
"11558","sample096","BGG","RRR",1,0,1
"11559","sample096","BRR","BGB",1,0,1
"11560","sample096","GBB","BBB",12,10,22
"11561","sample096","GBB","BRB",1,2,3
"11562","sample096","GBB","BRR",1,0,1
"11563","sample096","GBB","GGG",7,7,14
"11564","sample096","GBB","GGR",1,0,1
"11565","sample096","GBB","RBG",3,3,6
"11566","sample096","GBB","RBR",1,0,1
"11567","sample096","GBB","RGG",1,0,1
"11568","sample096","GBB","RGR",2,0,2
"11569","sample096","GBB","RRR",1,1,2
"11570","sample096","GBG","BRB",1,0,1
"11571","sample096","GBG","BRR",1,0,1
"11572","sample096","GBG","GGG",4,0,4
"11573","sample096","GBG","RBB",1,0,1
"11574","sample096","GBG","RGR",1,0,1
"11575","sample096","GBG","RRG",1,0,1
"11576","sample096","GGB","BBB",3,1,4
"11577","sample096","GGB","BBR",1,0,1
"11578","sample096","GGB","BRR",1,3,4
"11579","sample096","GGB","GBG",1,0,1
"11580","sample096","GGB","GGG",13,9,22
"11581","sample096","GGB","RGG",1,1,2
"11582","sample096","GGB","RRG",1,1,2
"11583","sample096","GGB","RRR",1,1,2
"11584","sample096","GGG","BBB",8,8,16
"11585","sample096","GGG","BGG",1,1,2
"11586","sample096","GGG","BRB",1,1,2
"11587","sample096","GGG","GGB",5,0,5
"11588","sample096","GGG","GGR",1,2,3
"11589","sample096","GGG","RBB",1,1,2
"11590","sample096","GGG","RGR",1,1,2
"11591","sample096","GGG","RRG",1,4,5
"11592","sample096","GGR","BRR",1,0,1
"11593","sample096","GGR","GRR",1,0,1
"11594","sample096","GRG","BBB",3,3,6
"11595","sample096","GRG","GGB",2,2,4
"11596","sample096","GRG","GGG",3,1,4
"11597","sample096","GRG","RGR",1,0,1
"11598","sample096","GRG","RRG",2,0,2
"11599","sample096","GRR","BGB",1,1,2
"11600","sample096","RBG","BBB",2,1,3
"11601","sample096","RBG","RBB",1,0,1
"11602","sample096","RBR","BGB",2,1,3
"11603","sample096","RBR","BRB",1,0,1
"11604","sample096","RBR","BRR",1,0,1
"11605","sample096","RBR","GRR",4,2,6
"11606","sample096","RBR","RGG",2,2,4
"11607","sample096","RBR","RGR",1,0,1
"11608","sample096","RGG","BBR",1,0,1
"11609","sample096","RGR","BBB",2,0,2
"11610","sample096","RGR","BBR",1,1,2
"11611","sample096","RGR","BGB",2,0,2
"11612","sample096","RGR","BGG",2,0,2
"11613","sample096","RGR","BRR",1,0,1
"11614","sample096","RGR","GGB",2,4,6
"11615","sample096","RGR","RGG",1,0,1
"11616","sample096","RRG","BBB",2,5,7
"11617","sample096","RRG","BGB",1,1,2
"11618","sample096","RRG","BRB",2,5,7
"11619","sample096","RRG","BRR",1,0,1
"11620","sample096","RRG","GGG",2,2,4
"11621","sample096","RRG","GRG",1,0,1
"11622","sample096","RRG","GRR",3,0,3
"11623","sample096","RRG","RBB",1,0,1
"11624","sample096","RRR","BBR",1,0,1
"11625","sample096","RRR","BGB",2,0,2
"11626","sample096","RRR","BGG",1,0,1
"11627","sample096","RRR","BRB",1,0,1
"11628","sample096","RRR","BRR",1,0,1
"11629","sample096","RRR","RBB",1,0,1
"11630","sample096","RRR","RGR",1,0,1
"11631","sample096","RRR","RRG",2,2,4
"11632","sample096","BBB","RRR",0,1,1
"11633","sample096","BBG","RGR",0,1,1
"11634","sample096","BGG","BBB",0,2,2
"11635","sample096","BGG","BBR",0,1,1
"11636","sample096","BRB","BBB",0,2,2
"11637","sample096","BRB","BBR",0,1,1
"11638","sample096","BRB","BRR",0,1,1
"11639","sample096","BRR","BBB",0,1,1
"11640","sample096","GBB","GBG",0,2,2
"11641","sample096","GBB","GGB",0,4,4
"11642","sample096","GBB","GRG",0,1,1
"11643","sample096","GBG","BBB",0,1,1
"11644","sample096","GBG","BBR",0,1,1
"11645","sample096","GGB","BGG",0,1,1
"11646","sample096","GGB","GGR",0,1,1
"11647","sample096","GGB","GRR",0,1,1
"11648","sample096","GGB","RBB",0,1,1
"11649","sample096","GGB","RGR",0,2,2
"11650","sample096","GGG","BGB",0,1,1
"11651","sample096","GGG","BRR",0,2,2
"11652","sample096","GGG","RBG",0,1,1
"11653","sample096","GGG","RBR",0,2,2
"11654","sample096","GGG","RGG",0,1,1
"11655","sample096","GRR","BBB",0,1,1
"11656","sample096","GRR","BBR",0,1,1
"11657","sample096","GRR","GGR",0,1,1
"11658","sample096","RBG","RGR",0,1,1
"11659","sample096","RBR","BBB",0,6,6
"11660","sample096","RBR","GGB",0,1,1
"11661","sample096","RGG","GGG",0,1,1
"11662","sample096","RGG","GRR",0,1,1
"11663","sample096","RGR","RRG",0,1,1
"11664","sample096","RRG","BBR",0,1,1
"11665","sample096","RRG","BGG",0,1,1
"11666","sample096","RRR","GRR",0,2,2
"11667","sample096","RRR","RBR",0,1,1
"11668","sample096","RRR","RGG",0,1,1
"11669","sample097","BBB","GGG",1,1,2
"11670","sample097","BBB","RRG",1,1,2
"11671","sample097","BBG","BBB",1,0,1
"11672","sample097","BBG","BRB",1,2,3
"11673","sample097","BBG","GBG",2,3,5
"11674","sample097","BBG","GGB",2,7,9
"11675","sample097","BBG","GGG",4,6,10
"11676","sample097","BBG","GRG",1,1,2
"11677","sample097","BBG","RRG",1,0,1
"11678","sample097","BGG","RBG",1,0,1
"11679","sample097","BGG","RRR",1,0,1
"11680","sample097","BRR","BGB",1,0,1
"11681","sample097","GBB","BBB",12,3,15
"11682","sample097","GBB","BRB",1,1,2
"11683","sample097","GBB","BRR",1,1,2
"11684","sample097","GBB","GGG",7,10,17
"11685","sample097","GBB","GGR",1,0,1
"11686","sample097","GBB","RBG",3,2,5
"11687","sample097","GBB","RBR",1,0,1
"11688","sample097","GBB","RGG",1,0,1
"11689","sample097","GBB","RGR",2,0,2
"11690","sample097","GBB","RRR",1,2,3
"11691","sample097","GBG","BRB",1,1,2
"11692","sample097","GBG","BRR",1,0,1
"11693","sample097","GBG","GGG",4,0,4
"11694","sample097","GBG","RBB",1,0,1
"11695","sample097","GBG","RGR",1,0,1
"11696","sample097","GBG","RRG",1,0,1
"11697","sample097","GGB","BBB",3,4,7
"11698","sample097","GGB","BBR",1,0,1
"11699","sample097","GGB","BRR",1,3,4
"11700","sample097","GGB","GBG",1,0,1
"11701","sample097","GGB","GGG",13,6,19
"11702","sample097","GGB","RGG",1,0,1
"11703","sample097","GGB","RRG",1,1,2
"11704","sample097","GGB","RRR",1,1,2
"11705","sample097","GGG","BBB",8,5,13
"11706","sample097","GGG","BGG",1,1,2
"11707","sample097","GGG","BRB",1,0,1
"11708","sample097","GGG","GGB",5,1,6
"11709","sample097","GGG","GGR",1,1,2
"11710","sample097","GGG","RBB",1,0,1
"11711","sample097","GGG","RGR",1,2,3
"11712","sample097","GGG","RRG",1,3,4
"11713","sample097","GGR","BRR",1,0,1
"11714","sample097","GGR","GRR",1,0,1
"11715","sample097","GRG","BBB",3,1,4
"11716","sample097","GRG","GGB",2,1,3
"11717","sample097","GRG","GGG",3,1,4
"11718","sample097","GRG","RGR",1,0,1
"11719","sample097","GRG","RRG",2,2,4
"11720","sample097","GRR","BGB",1,0,1
"11721","sample097","RBG","BBB",2,1,3
"11722","sample097","RBG","RBB",1,0,1
"11723","sample097","RBR","BGB",2,0,2
"11724","sample097","RBR","BRB",1,0,1
"11725","sample097","RBR","BRR",1,1,2
"11726","sample097","RBR","GRR",4,0,4
"11727","sample097","RBR","RGG",2,2,4
"11728","sample097","RBR","RGR",1,0,1
"11729","sample097","RGG","BBR",1,1,2
"11730","sample097","RGR","BBB",2,0,2
"11731","sample097","RGR","BBR",1,0,1
"11732","sample097","RGR","BGB",2,2,4
"11733","sample097","RGR","BGG",2,0,2
"11734","sample097","RGR","BRR",1,2,3
"11735","sample097","RGR","GGB",2,0,2
"11736","sample097","RGR","RGG",1,1,2
"11737","sample097","RRG","BBB",2,10,12
"11738","sample097","RRG","BGB",1,0,1
"11739","sample097","RRG","BRB",2,6,8
"11740","sample097","RRG","BRR",1,4,5
"11741","sample097","RRG","GGG",2,2,4
"11742","sample097","RRG","GRG",1,0,1
"11743","sample097","RRG","GRR",3,3,6
"11744","sample097","RRG","RBB",1,0,1
"11745","sample097","RRR","BBR",1,0,1
"11746","sample097","RRR","BGB",2,0,2
"11747","sample097","RRR","BGG",1,0,1
"11748","sample097","RRR","BRB",1,1,2
"11749","sample097","RRR","BRR",1,0,1
"11750","sample097","RRR","RBB",1,0,1
"11751","sample097","RRR","RGR",1,1,2
"11752","sample097","RRR","RRG",2,0,2
"11753","sample097","BBB","GRR",0,1,1
"11754","sample097","BBG","BGB",0,1,1
"11755","sample097","BBG","RBB",0,1,1
"11756","sample097","BBG","RBR",0,1,1
"11757","sample097","BBG","RRR",0,1,1
"11758","sample097","BGG","BBB",0,1,1
"11759","sample097","BGG","BBR",0,1,1
"11760","sample097","BGG","RGG",0,1,1
"11761","sample097","BRB","BBB",0,2,2
"11762","sample097","BRR","BBB",0,2,2
"11763","sample097","GBB","BGG",0,1,1
"11764","sample097","GBB","GGB",0,2,2
"11765","sample097","GBB","GRG",0,2,2
"11766","sample097","GBB","GRR",0,1,1
"11767","sample097","GBB","RBB",0,1,1
"11768","sample097","GGB","GGR",0,2,2
"11769","sample097","GGB","RBG",0,3,3
"11770","sample097","GGB","RBR",0,1,1
"11771","sample097","GGG","BGB",0,1,1
"11772","sample097","GGG","BRR",0,1,1
"11773","sample097","GGG","RBG",0,2,2
"11774","sample097","GGG","RRR",0,1,1
"11775","sample097","GRG","BRB",0,1,1
"11776","sample097","GRG","GGR",0,1,1
"11777","sample097","GRG","GRR",0,1,1
"11778","sample097","GRR","BGG",0,1,1
"11779","sample097","RBG","GRR",0,1,1
"11780","sample097","RBR","BBB",0,3,3
"11781","sample097","RBR","GGB",0,2,2
"11782","sample097","RBR","RBB",0,1,1
"11783","sample097","RGG","BBB",0,1,1
"11784","sample097","RGG","BRR",0,1,1
"11785","sample097","RGG","GRR",0,3,3
"11786","sample097","RGG","RBB",0,1,1
"11787","sample097","RRG","GGR",0,1,1
"11788","sample097","RRR","GRR",0,1,1
"11789","sample098","BBB","GGG",1,1,2
"11790","sample098","BBB","RRG",1,0,1
"11791","sample098","BBG","BBB",1,0,1
"11792","sample098","BBG","BRB",1,3,4
"11793","sample098","BBG","GBG",2,1,3
"11794","sample098","BBG","GGB",2,4,6
"11795","sample098","BBG","GGG",4,6,10
"11796","sample098","BBG","GRG",1,2,3
"11797","sample098","BBG","RRG",1,0,1
"11798","sample098","BGG","RBG",1,0,1
"11799","sample098","BGG","RRR",1,0,1
"11800","sample098","BRR","BGB",1,0,1
"11801","sample098","GBB","BBB",12,1,13
"11802","sample098","GBB","BRB",1,3,4
"11803","sample098","GBB","BRR",1,0,1
"11804","sample098","GBB","GGG",7,16,23
"11805","sample098","GBB","GGR",1,0,1
"11806","sample098","GBB","RBG",3,1,4
"11807","sample098","GBB","RBR",1,0,1
"11808","sample098","GBB","RGG",1,0,1
"11809","sample098","GBB","RGR",2,0,2
"11810","sample098","GBB","RRR",1,4,5
"11811","sample098","GBG","BRB",1,0,1
"11812","sample098","GBG","BRR",1,0,1
"11813","sample098","GBG","GGG",4,1,5
"11814","sample098","GBG","RBB",1,0,1
"11815","sample098","GBG","RGR",1,1,2
"11816","sample098","GBG","RRG",1,0,1
"11817","sample098","GGB","BBB",3,0,3
"11818","sample098","GGB","BBR",1,2,3
"11819","sample098","GGB","BRR",1,1,2
"11820","sample098","GGB","GBG",1,0,1
"11821","sample098","GGB","GGG",13,9,22
"11822","sample098","GGB","RGG",1,2,3
"11823","sample098","GGB","RRG",1,0,1
"11824","sample098","GGB","RRR",1,1,2
"11825","sample098","GGG","BBB",8,6,14
"11826","sample098","GGG","BGG",1,2,3
"11827","sample098","GGG","BRB",1,1,2
"11828","sample098","GGG","GGB",5,0,5
"11829","sample098","GGG","GGR",1,0,1
"11830","sample098","GGG","RBB",1,2,3
"11831","sample098","GGG","RGR",1,2,3
"11832","sample098","GGG","RRG",1,2,3
"11833","sample098","GGR","BRR",1,0,1
"11834","sample098","GGR","GRR",1,0,1
"11835","sample098","GRG","BBB",3,1,4
"11836","sample098","GRG","GGB",2,2,4
"11837","sample098","GRG","GGG",3,0,3
"11838","sample098","GRG","RGR",1,0,1
"11839","sample098","GRG","RRG",2,0,2
"11840","sample098","GRR","BGB",1,0,1
"11841","sample098","RBG","BBB",2,1,3
"11842","sample098","RBG","RBB",1,0,1
"11843","sample098","RBR","BGB",2,0,2
"11844","sample098","RBR","BRB",1,0,1
"11845","sample098","RBR","BRR",1,1,2
"11846","sample098","RBR","GRR",4,0,4
"11847","sample098","RBR","RGG",2,2,4
"11848","sample098","RBR","RGR",1,0,1
"11849","sample098","RGG","BBR",1,1,2
"11850","sample098","RGR","BBB",2,1,3
"11851","sample098","RGR","BBR",1,0,1
"11852","sample098","RGR","BGB",2,0,2
"11853","sample098","RGR","BGG",2,0,2
"11854","sample098","RGR","BRR",1,1,2
"11855","sample098","RGR","GGB",2,1,3
"11856","sample098","RGR","RGG",1,1,2
"11857","sample098","RRG","BBB",2,5,7
"11858","sample098","RRG","BGB",1,1,2
"11859","sample098","RRG","BRB",2,6,8
"11860","sample098","RRG","BRR",1,1,2
"11861","sample098","RRG","GGG",2,3,5
"11862","sample098","RRG","GRG",1,0,1
"11863","sample098","RRG","GRR",3,2,5
"11864","sample098","RRG","RBB",1,0,1
"11865","sample098","RRR","BBR",1,0,1
"11866","sample098","RRR","BGB",2,0,2
"11867","sample098","RRR","BGG",1,0,1
"11868","sample098","RRR","BRB",1,0,1
"11869","sample098","RRR","BRR",1,0,1
"11870","sample098","RRR","RBB",1,0,1
"11871","sample098","RRR","RGR",1,0,1
"11872","sample098","RRR","RRG",2,0,2
"11873","sample098","BBB","GRR",0,1,1
"11874","sample098","BGB","RRG",0,1,1
"11875","sample098","BGG","RGG",0,2,2
"11876","sample098","BRB","BBB",0,2,2
"11877","sample098","BRB","RBB",0,1,1
"11878","sample098","BRR","BRB",0,1,1
"11879","sample098","GBB","GBG",0,1,1
"11880","sample098","GBB","GGB",0,4,4
"11881","sample098","GBB","GRG",0,1,1
"11882","sample098","GBG","BBR",0,1,1
"11883","sample098","GBG","RBG",0,1,1
"11884","sample098","GGB","GGR",0,1,1
"11885","sample098","GGB","RBB",0,1,1
"11886","sample098","GGB","RBG",0,2,2
"11887","sample098","GGG","BGB",0,1,1
"11888","sample098","GGG","BRR",0,2,2
"11889","sample098","GGG","RBG",0,1,1
"11890","sample098","GGG","RBR",0,2,2
"11891","sample098","GGG","RGG",0,1,1
"11892","sample098","GGG","RRR",0,1,1
"11893","sample098","GGR","BBB",0,1,1
"11894","sample098","GGR","BGG",0,1,1
"11895","sample098","GRG","BGG",0,1,1
"11896","sample098","GRG","BRB",0,1,1
"11897","sample098","GRG","GGR",0,1,1
"11898","sample098","GRG","GRR",0,1,1
"11899","sample098","GRG","RBR",0,1,1
"11900","sample098","GRR","BBB",0,1,1
"11901","sample098","GRR","BRR",0,2,2
"11902","sample098","GRR","GGG",0,1,1
"11903","sample098","RBB","BBB",0,1,1
"11904","sample098","RBB","RGG",0,1,1
"11905","sample098","RBG","BBG",0,1,1
"11906","sample098","RBR","BBB",0,3,3
"11907","sample098","RBR","GGB",0,1,1
"11908","sample098","RBR","RBB",0,1,1
"11909","sample098","RGG","BGB",0,1,1
"11910","sample098","RGG","GGG",0,1,1
"11911","sample098","RGG","GGR",0,1,1
"11912","sample098","RGG","GRR",0,1,1
"11913","sample098","RGG","RBB",0,1,1
"11914","sample098","RGR","GGG",0,1,1
"11915","sample098","RGR","RBB",0,1,1
"11916","sample098","RRG","GGR",0,1,1
"11917","sample098","RRG","RGR",0,1,1
"11918","sample099","BBB","GGG",1,0,1
"11919","sample099","BBB","RRG",1,0,1
"11920","sample099","BBG","BBB",1,2,3
"11921","sample099","BBG","BRB",1,2,3
"11922","sample099","BBG","GBG",2,1,3
"11923","sample099","BBG","GGB",2,3,5
"11924","sample099","BBG","GGG",4,5,9
"11925","sample099","BBG","GRG",1,0,1
"11926","sample099","BBG","RRG",1,0,1
"11927","sample099","BGG","RBG",1,0,1
"11928","sample099","BGG","RRR",1,0,1
"11929","sample099","BRR","BGB",1,1,2
"11930","sample099","GBB","BBB",12,6,18
"11931","sample099","GBB","BRB",1,0,1
"11932","sample099","GBB","BRR",1,0,1
"11933","sample099","GBB","GGG",7,13,20
"11934","sample099","GBB","GGR",1,0,1
"11935","sample099","GBB","RBG",3,1,4
"11936","sample099","GBB","RBR",1,0,1
"11937","sample099","GBB","RGG",1,0,1
"11938","sample099","GBB","RGR",2,0,2
"11939","sample099","GBB","RRR",1,3,4
"11940","sample099","GBG","BRB",1,1,2
"11941","sample099","GBG","BRR",1,0,1
"11942","sample099","GBG","GGG",4,3,7
"11943","sample099","GBG","RBB",1,0,1
"11944","sample099","GBG","RGR",1,0,1
"11945","sample099","GBG","RRG",1,0,1
"11946","sample099","GGB","BBB",3,3,6
"11947","sample099","GGB","BBR",1,0,1
"11948","sample099","GGB","BRR",1,5,6
"11949","sample099","GGB","GBG",1,0,1
"11950","sample099","GGB","GGG",13,4,17
"11951","sample099","GGB","RGG",1,3,4
"11952","sample099","GGB","RRG",1,0,1
"11953","sample099","GGB","RRR",1,1,2
"11954","sample099","GGG","BBB",8,7,15
"11955","sample099","GGG","BGG",1,1,2
"11956","sample099","GGG","BRB",1,0,1
"11957","sample099","GGG","GGB",5,0,5
"11958","sample099","GGG","GGR",1,1,2
"11959","sample099","GGG","RBB",1,2,3
"11960","sample099","GGG","RGR",1,2,3
"11961","sample099","GGG","RRG",1,5,6
"11962","sample099","GGR","BRR",1,0,1
"11963","sample099","GGR","GRR",1,0,1
"11964","sample099","GRG","BBB",3,0,3
"11965","sample099","GRG","GGB",2,2,4
"11966","sample099","GRG","GGG",3,1,4
"11967","sample099","GRG","RGR",1,0,1
"11968","sample099","GRG","RRG",2,1,3
"11969","sample099","GRR","BGB",1,0,1
"11970","sample099","RBG","BBB",2,1,3
"11971","sample099","RBG","RBB",1,0,1
"11972","sample099","RBR","BGB",2,1,3
"11973","sample099","RBR","BRB",1,0,1
"11974","sample099","RBR","BRR",1,0,1
"11975","sample099","RBR","GRR",4,1,5
"11976","sample099","RBR","RGG",2,3,5
"11977","sample099","RBR","RGR",1,0,1
"11978","sample099","RGG","BBR",1,0,1
"11979","sample099","RGR","BBB",2,0,2
"11980","sample099","RGR","BBR",1,0,1
"11981","sample099","RGR","BGB",2,0,2
"11982","sample099","RGR","BGG",2,0,2
"11983","sample099","RGR","BRR",1,2,3
"11984","sample099","RGR","GGB",2,2,4
"11985","sample099","RGR","RGG",1,0,1
"11986","sample099","RRG","BBB",2,6,8
"11987","sample099","RRG","BGB",1,1,2
"11988","sample099","RRG","BRB",2,9,11
"11989","sample099","RRG","BRR",1,3,4
"11990","sample099","RRG","GGG",2,0,2
"11991","sample099","RRG","GRG",1,0,1
"11992","sample099","RRG","GRR",3,1,4
"11993","sample099","RRG","RBB",1,0,1
"11994","sample099","RRR","BBR",1,0,1
"11995","sample099","RRR","BGB",2,0,2
"11996","sample099","RRR","BGG",1,0,1
"11997","sample099","RRR","BRB",1,1,2
"11998","sample099","RRR","BRR",1,0,1
"11999","sample099","RRR","RBB",1,0,1
"12000","sample099","RRR","RGR",1,0,1
"12001","sample099","RRR","RRG",2,1,3
"12002","sample099","BBG","BGG",0,1,1
"12003","sample099","BBG","GRR",0,1,1
"12004","sample099","BBG","RRR",0,2,2
"12005","sample099","BGG","BBB",0,2,2
"12006","sample099","BGG","RGG",0,1,1
"12007","sample099","BRB","BBB",0,2,2
"12008","sample099","BRR","BBB",0,2,2
"12009","sample099","BRR","BRB",0,1,1
"12010","sample099","GBB","GBG",0,1,1
"12011","sample099","GBB","GGB",0,4,4
"12012","sample099","GBB","RBB",0,1,1
"12013","sample099","GBG","BBB",0,1,1
"12014","sample099","GBG","RGG",0,1,1
"12015","sample099","GGB","BGG",0,1,1
"12016","sample099","GGB","GGR",0,1,1
"12017","sample099","GGB","GRR",0,1,1
"12018","sample099","GGB","RBB",0,1,1
"12019","sample099","GGB","RGR",0,1,1
"12020","sample099","GGG","RBR",0,2,2
"12021","sample099","GRG","BGG",0,1,1
"12022","sample099","GRG","BRB",0,1,1
"12023","sample099","GRG","GGR",0,2,2
"12024","sample099","GRG","RBG",0,1,1
"12025","sample099","GRR","BBR",0,1,1
"12026","sample099","GRR","BRR",0,1,1
"12027","sample099","GRR","GGR",0,1,1
"12028","sample099","RBB","GRR",0,1,1
"12029","sample099","RBR","BGG",0,1,1
"12030","sample099","RBR","GGB",0,2,2
"12031","sample099","RBR","RBB",0,1,1
"12032","sample099","RGG","BRR",0,1,1
"12033","sample099","RGR","RRG",0,1,1
"12034","sample099","RRG","BBR",0,3,3
"12035","sample099","RRG","GGR",0,2,2
"12036","sample099","RRR","GRR",0,1,1
"12037","sample099","RRR","RBR",0,1,1
"12038","sample100","BBB","GGG",1,0,1
"12039","sample100","BBB","RRG",1,0,1
"12040","sample100","BBG","BBB",1,0,1
"12041","sample100","BBG","BRB",1,2,3
"12042","sample100","BBG","GBG",2,2,4
"12043","sample100","BBG","GGB",2,2,4
"12044","sample100","BBG","GGG",4,7,11
"12045","sample100","BBG","GRG",1,2,3
"12046","sample100","BBG","RRG",1,0,1
"12047","sample100","BGG","RBG",1,0,1
"12048","sample100","BGG","RRR",1,0,1
"12049","sample100","BRR","BGB",1,0,1
"12050","sample100","GBB","BBB",12,7,19
"12051","sample100","GBB","BRB",1,2,3
"12052","sample100","GBB","BRR",1,0,1
"12053","sample100","GBB","GGG",7,11,18
"12054","sample100","GBB","GGR",1,1,2
"12055","sample100","GBB","RBG",3,1,4
"12056","sample100","GBB","RBR",1,0,1
"12057","sample100","GBB","RGG",1,0,1
"12058","sample100","GBB","RGR",2,0,2
"12059","sample100","GBB","RRR",1,0,1
"12060","sample100","GBG","BRB",1,2,3
"12061","sample100","GBG","BRR",1,0,1
"12062","sample100","GBG","GGG",4,0,4
"12063","sample100","GBG","RBB",1,0,1
"12064","sample100","GBG","RGR",1,0,1
"12065","sample100","GBG","RRG",1,1,2
"12066","sample100","GGB","BBB",3,3,6
"12067","sample100","GGB","BBR",1,0,1
"12068","sample100","GGB","BRR",1,2,3
"12069","sample100","GGB","GBG",1,0,1
"12070","sample100","GGB","GGG",13,10,23
"12071","sample100","GGB","RGG",1,0,1
"12072","sample100","GGB","RRG",1,1,2
"12073","sample100","GGB","RRR",1,1,2
"12074","sample100","GGG","BBB",8,3,11
"12075","sample100","GGG","BGG",1,1,2
"12076","sample100","GGG","BRB",1,2,3
"12077","sample100","GGG","GGB",5,1,6
"12078","sample100","GGG","GGR",1,0,1
"12079","sample100","GGG","RBB",1,2,3
"12080","sample100","GGG","RGR",1,1,2
"12081","sample100","GGG","RRG",1,2,3
"12082","sample100","GGR","BRR",1,0,1
"12083","sample100","GGR","GRR",1,0,1
"12084","sample100","GRG","BBB",3,3,6
"12085","sample100","GRG","GGB",2,5,7
"12086","sample100","GRG","GGG",3,1,4
"12087","sample100","GRG","RGR",1,0,1
"12088","sample100","GRG","RRG",2,1,3
"12089","sample100","GRR","BGB",1,0,1
"12090","sample100","RBG","BBB",2,0,2
"12091","sample100","RBG","RBB",1,0,1
"12092","sample100","RBR","BGB",2,0,2
"12093","sample100","RBR","BRB",1,0,1
"12094","sample100","RBR","BRR",1,3,4
"12095","sample100","RBR","GRR",4,1,5
"12096","sample100","RBR","RGG",2,4,6
"12097","sample100","RBR","RGR",1,0,1
"12098","sample100","RGG","BBR",1,0,1
"12099","sample100","RGR","BBB",2,2,4
"12100","sample100","RGR","BBR",1,0,1
"12101","sample100","RGR","BGB",2,1,3
"12102","sample100","RGR","BGG",2,0,2
"12103","sample100","RGR","BRR",1,1,2
"12104","sample100","RGR","GGB",2,1,3
"12105","sample100","RGR","RGG",1,0,1
"12106","sample100","RRG","BBB",2,4,6
"12107","sample100","RRG","BGB",1,2,3
"12108","sample100","RRG","BRB",2,5,7
"12109","sample100","RRG","BRR",1,0,1
"12110","sample100","RRG","GGG",2,2,4
"12111","sample100","RRG","GRG",1,0,1
"12112","sample100","RRG","GRR",3,3,6
"12113","sample100","RRG","RBB",1,0,1
"12114","sample100","RRR","BBR",1,0,1
"12115","sample100","RRR","BGB",2,0,2
"12116","sample100","RRR","BGG",1,0,1
"12117","sample100","RRR","BRB",1,1,2
"12118","sample100","RRR","BRR",1,0,1
"12119","sample100","RRR","RBB",1,0,1
"12120","sample100","RRR","RGR",1,0,1
"12121","sample100","RRR","RRG",2,0,2
"12122","sample100","BBG","RRR",0,2,2
"12123","sample100","BGG","RGG",0,1,1
"12124","sample100","BRB","BBB",0,5,5
"12125","sample100","BRB","GGR",0,1,1
"12126","sample100","BRB","RBB",0,1,1
"12127","sample100","BRB","RGR",0,1,1
"12128","sample100","BRR","BBB",0,1,1
"12129","sample100","GBB","BGG",0,1,1
"12130","sample100","GBB","GBG",0,1,1
"12131","sample100","GBB","GGB",0,1,1
"12132","sample100","GBB","GRG",0,1,1
"12133","sample100","GBB","GRR",0,1,1
"12134","sample100","GBG","GGB",0,1,1
"12135","sample100","GBG","RGG",0,1,1
"12136","sample100","GGB","BGG",0,1,1
"12137","sample100","GGB","GGR",0,1,1
"12138","sample100","GGB","GRR",0,1,1
"12139","sample100","GGB","RBB",0,1,1
"12140","sample100","GGB","RBR",0,1,1
"12141","sample100","GGG","GRR",0,1,1
"12142","sample100","GGG","RBR",0,4,4
"12143","sample100","GGG","RGG",0,1,1
"12144","sample100","GRG","GBG",0,1,1
"12145","sample100","GRG","GGR",0,1,1
"12146","sample100","GRG","RBR",0,1,1
"12147","sample100","GRR","BRR",0,1,1
"12148","sample100","RBB","BBB",0,1,1
"12149","sample100","RBG","GRR",0,1,1
"12150","sample100","RBR","BBB",0,5,5
"12151","sample100","RBR","GGB",0,1,1
"12152","sample100","RGG","BRR",0,1,1
"12153","sample100","RGG","GRR",0,1,1
"12154","sample100","RGR","GGR",0,1,1
"12155","sample100","RGR","RBB",0,2,2
"12156","sample100","RRG","BBR",0,1,1
"12157","sample100","RRG","GGR",0,1,1
"12158","sample100","RRG","RGR",0,1,1
"12159","sample100","RRR","RGG",0,1,1
