"","runID","actor","subject","crowd","displace","total.DC"
"1","run001","BBB","GGG",1,1,2
"2","run001","BBB","RRG",1,0,1
"3","run001","BBG","BBB",1,1,2
"4","run001","BBG","BRB",1,1,2
"5","run001","BBG","GBG",2,1,3
"6","run001","BBG","GGB",2,2,4
"7","run001","BBG","GGG",4,4,8
"8","run001","BBG","GRG",1,3,4
"9","run001","BBG","RRG",1,0,1
"10","run001","BGG","RBG",1,0,1
"11","run001","BGG","RRR",1,0,1
"12","run001","BRR","BGB",1,0,1
"13","run001","GBB","BBB",12,6,18
"14","run001","GBB","BRB",1,2,3
"15","run001","GBB","BRR",1,1,2
"16","run001","GBB","GGG",7,9,16
"17","run001","GBB","GGR",1,1,2
"18","run001","GBB","RBG",3,0,3
"19","run001","GBB","RBR",1,0,1
"20","run001","GBB","RGG",1,0,1
"21","run001","GBB","RGR",2,0,2
"22","run001","GBB","RRR",1,0,1
"23","run001","GBG","BRB",1,2,3
"24","run001","GBG","BRR",1,0,1
"25","run001","GBG","GGG",4,3,7
"26","run001","GBG","RBB",1,0,1
"27","run001","GBG","RGR",1,1,2
"28","run001","GBG","RRG",1,1,2
"29","run001","GGB","BBB",3,1,4
"30","run001","GGB","BBR",1,1,2
"31","run001","GGB","BRR",1,5,6
"32","run001","GGB","GBG",1,0,1
"33","run001","GGB","GGG",13,5,18
"34","run001","GGB","RGG",1,0,1
"35","run001","GGB","RRG",1,1,2
"36","run001","GGB","RRR",1,1,2
"37","run001","GGG","BBB",8,3,11
"38","run001","GGG","BGG",1,2,3
"39","run001","GGG","BRB",1,0,1
"40","run001","GGG","GGB",5,0,5
"41","run001","GGG","GGR",1,1,2
"42","run001","GGG","RBB",1,1,2
"43","run001","GGG","RGR",1,2,3
"44","run001","GGG","RRG",1,1,2
"45","run001","GGR","BRR",1,0,1
"46","run001","GGR","GRR",1,0,1
"47","run001","GRG","BBB",3,0,3
"48","run001","GRG","GGB",2,2,4
"49","run001","GRG","GGG",3,1,4
"50","run001","GRG","RGR",1,0,1
"51","run001","GRG","RRG",2,1,3
"52","run001","GRR","BGB",1,0,1
"53","run001","RBG","BBB",2,0,2
"54","run001","RBG","RBB",1,1,2
"55","run001","RBR","BGB",2,0,2
"56","run001","RBR","BRB",1,0,1
"57","run001","RBR","BRR",1,0,1
"58","run001","RBR","GRR",4,0,4
"59","run001","RBR","RGG",2,3,5
"60","run001","RBR","RGR",1,0,1
"61","run001","RGG","BBR",1,0,1
"62","run001","RGR","BBB",2,0,2
"63","run001","RGR","BBR",1,0,1
"64","run001","RGR","BGB",2,0,2
"65","run001","RGR","BGG",2,1,3
"66","run001","RGR","BRR",1,0,1
"67","run001","RGR","GGB",2,2,4
"68","run001","RGR","RGG",1,0,1
"69","run001","RRG","BBB",2,5,7
"70","run001","RRG","BGB",1,1,2
"71","run001","RRG","BRB",2,13,15
"72","run001","RRG","BRR",1,1,2
"73","run001","RRG","GGG",2,4,6
"74","run001","RRG","GRG",1,0,1
"75","run001","RRG","GRR",3,3,6
"76","run001","RRG","RBB",1,0,1
"77","run001","RRR","BBR",1,0,1
"78","run001","RRR","BGB",2,1,3
"79","run001","RRR","BGG",1,0,1
"80","run001","RRR","BRB",1,0,1
"81","run001","RRR","BRR",1,0,1
"82","run001","RRR","RBB",1,1,2
"83","run001","RRR","RGR",1,0,1
"84","run001","RRR","RRG",2,0,2
"85","run001","BBG","GRR",0,1,1
"86","run001","BBG","RBB",0,1,1
"87","run001","BBG","RRR",0,1,1
"88","run001","BGB","BBB",0,1,1
"89","run001","BGB","RRG",0,1,1
"90","run001","BRB","BBB",0,3,3
"91","run001","BRR","BBB",0,1,1
"92","run001","GBB","GBG",0,1,1
"93","run001","GBB","GGB",0,2,2
"94","run001","GBB","GRG",0,1,1
"95","run001","GBB","RRG",0,1,1
"96","run001","GBG","BBB",0,1,1
"97","run001","GBG","GGB",0,1,1
"98","run001","GGB","BGB",0,3,3
"99","run001","GGB","GGR",0,2,2
"100","run001","GGB","GRR",0,1,1
"101","run001","GGB","RBB",0,1,1
"102","run001","GGG","GRR",0,2,2
"103","run001","GGG","RBR",0,5,5
"104","run001","GGG","RRR",0,1,1
"105","run001","GGR","BBB",0,1,1
"106","run001","GGR","BBR",0,1,1
"107","run001","GRG","GBG",0,1,1
"108","run001","GRG","GGR",0,1,1
"109","run001","GRG","RBG",0,1,1
"110","run001","GRG","RBR",0,1,1
"111","run001","GRR","BGG",0,2,2
"112","run001","GRR","BRB",0,1,1
"113","run001","GRR","BRR",0,1,1
"114","run001","RBG","GRR",0,1,1
"115","run001","RBG","RBR",0,1,1
"116","run001","RBR","BBB",0,3,3
"117","run001","RBR","GGB",0,2,2
"118","run001","RGG","GGG",0,1,1
"119","run001","RGG","GGR",0,1,1
"120","run001","RGG","GRR",0,3,3
"121","run001","RGR","GGR",0,1,1
"122","run001","RGR","RRG",0,3,3
"123","run002","BBB","GGG",1,1,2
"124","run002","BBB","RRG",1,0,1
"125","run002","BBG","BBB",1,1,2
"126","run002","BBG","BRB",1,4,5
"127","run002","BBG","GBG",2,1,3
"128","run002","BBG","GGB",2,4,6
"129","run002","BBG","GGG",4,9,13
"130","run002","BBG","GRG",1,2,3
"131","run002","BBG","RRG",1,0,1
"132","run002","BGG","RBG",1,0,1
"133","run002","BGG","RRR",1,0,1
"134","run002","BRR","BGB",1,0,1
"135","run002","GBB","BBB",12,7,19
"136","run002","GBB","BRB",1,1,2
"137","run002","GBB","BRR",1,1,2
"138","run002","GBB","GGG",7,10,17
"139","run002","GBB","GGR",1,0,1
"140","run002","GBB","RBG",3,3,6
"141","run002","GBB","RBR",1,0,1
"142","run002","GBB","RGG",1,0,1
"143","run002","GBB","RGR",2,0,2
"144","run002","GBB","RRR",1,3,4
"145","run002","GBG","BRB",1,0,1
"146","run002","GBG","BRR",1,0,1
"147","run002","GBG","GGG",4,1,5
"148","run002","GBG","RBB",1,0,1
"149","run002","GBG","RGR",1,0,1
"150","run002","GBG","RRG",1,0,1
"151","run002","GGB","BBB",3,2,5
"152","run002","GGB","BBR",1,0,1
"153","run002","GGB","BRR",1,2,3
"154","run002","GGB","GBG",1,0,1
"155","run002","GGB","GGG",13,9,22
"156","run002","GGB","RGG",1,1,2
"157","run002","GGB","RRG",1,1,2
"158","run002","GGB","RRR",1,0,1
"159","run002","GGG","BBB",8,6,14
"160","run002","GGG","BGG",1,2,3
"161","run002","GGG","BRB",1,0,1
"162","run002","GGG","GGB",5,0,5
"163","run002","GGG","GGR",1,2,3
"164","run002","GGG","RBB",1,2,3
"165","run002","GGG","RGR",1,2,3
"166","run002","GGG","RRG",1,3,4
"167","run002","GGR","BRR",1,0,1
"168","run002","GGR","GRR",1,0,1
"169","run002","GRG","BBB",3,3,6
"170","run002","GRG","GGB",2,2,4
"171","run002","GRG","GGG",3,1,4
"172","run002","GRG","RGR",1,0,1
"173","run002","GRG","RRG",2,0,2
"174","run002","GRR","BGB",1,0,1
"175","run002","RBG","BBB",2,1,3
"176","run002","RBG","RBB",1,0,1
"177","run002","RBR","BGB",2,1,3
"178","run002","RBR","BRB",1,0,1
"179","run002","RBR","BRR",1,1,2
"180","run002","RBR","GRR",4,0,4
"181","run002","RBR","RGG",2,0,2
"182","run002","RBR","RGR",1,0,1
"183","run002","RGG","BBR",1,0,1
"184","run002","RGR","BBB",2,0,2
"185","run002","RGR","BBR",1,0,1
"186","run002","RGR","BGB",2,0,2
"187","run002","RGR","BGG",2,0,2
"188","run002","RGR","BRR",1,0,1
"189","run002","RGR","GGB",2,1,3
"190","run002","RGR","RGG",1,0,1
"191","run002","RRG","BBB",2,6,8
"192","run002","RRG","BGB",1,0,1
"193","run002","RRG","BRB",2,9,11
"194","run002","RRG","BRR",1,1,2
"195","run002","RRG","GGG",2,3,5
"196","run002","RRG","GRG",1,0,1
"197","run002","RRG","GRR",3,3,6
"198","run002","RRG","RBB",1,0,1
"199","run002","RRR","BBR",1,0,1
"200","run002","RRR","BGB",2,0,2
"201","run002","RRR","BGG",1,0,1
"202","run002","RRR","BRB",1,0,1
"203","run002","RRR","BRR",1,0,1
"204","run002","RRR","RBB",1,0,1
"205","run002","RRR","RGR",1,0,1
"206","run002","RRR","RRG",2,0,2
"207","run002","BBG","BGG",0,1,1
"208","run002","BBG","GBB",0,1,1
"209","run002","BBG","RBG",0,1,1
"210","run002","BBG","RGR",0,1,1
"211","run002","BGB","RRG",0,1,1
"212","run002","BGG","BBB",0,1,1
"213","run002","BGG","RGG",0,1,1
"214","run002","BGG","RGR",0,1,1
"215","run002","BRB","BBB",0,2,2
"216","run002","BRB","BRR",0,1,1
"217","run002","BRB","RBB",0,1,1
"218","run002","BRB","RBG",0,1,1
"219","run002","BRR","BBB",0,2,2
"220","run002","GBB","GGB",0,4,4
"221","run002","GBB","GRG",0,2,2
"222","run002","GBB","RBB",0,1,1
"223","run002","GBG","BBB",0,2,2
"224","run002","GBG","BBR",0,1,1
"225","run002","GGB","GGR",0,3,3
"226","run002","GGB","GRR",0,1,1
"227","run002","GGB","RBG",0,1,1
"228","run002","GGB","RGR",0,1,1
"229","run002","GGG","BRR",0,2,2
"230","run002","GGG","RBG",0,1,1
"231","run002","GGG","RBR",0,1,1
"232","run002","GGR","RBB",0,1,1
"233","run002","GRG","BRB",0,1,1
"234","run002","RBB","BRB",0,1,1
"235","run002","RBG","RBR",0,1,1
"236","run002","RBR","BBB",0,1,1
"237","run002","RBR","GGB",0,1,1
"238","run002","RBR","RBB",0,1,1
"239","run002","RGG","BBB",0,1,1
"240","run002","RGG","GRR",0,3,3
"241","run002","RGR","GGG",0,1,1
"242","run002","RRG","RGG",0,1,1
"243","run003","BBB","GGG",1,0,1
"244","run003","BBB","RRG",1,0,1
"245","run003","BBG","BBB",1,0,1
"246","run003","BBG","BRB",1,4,5
"247","run003","BBG","GBG",2,4,6
"248","run003","BBG","GGB",2,2,4
"249","run003","BBG","GGG",4,4,8
"250","run003","BBG","GRG",1,0,1
"251","run003","BBG","RRG",1,1,2
"252","run003","BGG","RBG",1,0,1
"253","run003","BGG","RRR",1,0,1
"254","run003","BRR","BGB",1,0,1
"255","run003","GBB","BBB",12,5,17
"256","run003","GBB","BRB",1,2,3
"257","run003","GBB","BRR",1,0,1
"258","run003","GBB","GGG",7,12,19
"259","run003","GBB","GGR",1,0,1
"260","run003","GBB","RBG",3,3,6
"261","run003","GBB","RBR",1,0,1
"262","run003","GBB","RGG",1,0,1
"263","run003","GBB","RGR",2,1,3
"264","run003","GBB","RRR",1,0,1
"265","run003","GBG","BRB",1,1,2
"266","run003","GBG","BRR",1,0,1
"267","run003","GBG","GGG",4,1,5
"268","run003","GBG","RBB",1,0,1
"269","run003","GBG","RGR",1,0,1
"270","run003","GBG","RRG",1,1,2
"271","run003","GGB","BBB",3,0,3
"272","run003","GGB","BBR",1,0,1
"273","run003","GGB","BRR",1,4,5
"274","run003","GGB","GBG",1,0,1
"275","run003","GGB","GGG",13,3,16
"276","run003","GGB","RGG",1,1,2
"277","run003","GGB","RRG",1,2,3
"278","run003","GGB","RRR",1,1,2
"279","run003","GGG","BBB",8,3,11
"280","run003","GGG","BGG",1,1,2
"281","run003","GGG","BRB",1,2,3
"282","run003","GGG","GGB",5,0,5
"283","run003","GGG","GGR",1,0,1
"284","run003","GGG","RBB",1,1,2
"285","run003","GGG","RGR",1,2,3
"286","run003","GGG","RRG",1,6,7
"287","run003","GGR","BRR",1,0,1
"288","run003","GGR","GRR",1,0,1
"289","run003","GRG","BBB",3,0,3
"290","run003","GRG","GGB",2,3,5
"291","run003","GRG","GGG",3,1,4
"292","run003","GRG","RGR",1,2,3
"293","run003","GRG","RRG",2,0,2
"294","run003","GRR","BGB",1,0,1
"295","run003","RBG","BBB",2,1,3
"296","run003","RBG","RBB",1,0,1
"297","run003","RBR","BGB",2,0,2
"298","run003","RBR","BRB",1,0,1
"299","run003","RBR","BRR",1,1,2
"300","run003","RBR","GRR",4,1,5
"301","run003","RBR","RGG",2,0,2
"302","run003","RBR","RGR",1,0,1
"303","run003","RGG","BBR",1,1,2
"304","run003","RGR","BBB",2,1,3
"305","run003","RGR","BBR",1,0,1
"306","run003","RGR","BGB",2,0,2
"307","run003","RGR","BGG",2,1,3
"308","run003","RGR","BRR",1,0,1
"309","run003","RGR","GGB",2,1,3
"310","run003","RGR","RGG",1,1,2
"311","run003","RRG","BBB",2,4,6
"312","run003","RRG","BGB",1,3,4
"313","run003","RRG","BRB",2,7,9
"314","run003","RRG","BRR",1,4,5
"315","run003","RRG","GGG",2,1,3
"316","run003","RRG","GRG",1,0,1
"317","run003","RRG","GRR",3,1,4
"318","run003","RRG","RBB",1,1,2
"319","run003","RRR","BBR",1,0,1
"320","run003","RRR","BGB",2,0,2
"321","run003","RRR","BGG",1,0,1
"322","run003","RRR","BRB",1,1,2
"323","run003","RRR","BRR",1,0,1
"324","run003","RRR","RBB",1,1,2
"325","run003","RRR","RGR",1,0,1
"326","run003","RRR","RRG",2,0,2
"327","run003","BBB","GRR",0,1,1
"328","run003","BBB","RRR",0,1,1
"329","run003","BBG","BGG",0,1,1
"330","run003","BBG","RBG",0,1,1
"331","run003","BBG","RRR",0,1,1
"332","run003","BGG","BBB",0,1,1
"333","run003","BRB","BBB",0,2,2
"334","run003","BRB","RBG",0,1,1
"335","run003","GBB","BGG",0,1,1
"336","run003","GBB","GGB",0,2,2
"337","run003","GBB","GRG",0,2,2
"338","run003","GBB","RBB",0,1,1
"339","run003","GBG","BBB",0,1,1
"340","run003","GGB","BGG",0,3,3
"341","run003","GGB","BRB",0,1,1
"342","run003","GGB","GRR",0,3,3
"343","run003","GGB","RBB",0,2,2
"344","run003","GGB","RBR",0,2,2
"345","run003","GGG","BRR",0,2,2
"346","run003","GGG","RBG",0,1,1
"347","run003","GGG","RBR",0,3,3
"348","run003","GGR","RBB",0,1,1
"349","run003","GRG","BGG",0,1,1
"350","run003","GRG","BRB",0,1,1
"351","run003","GRG","GGR",0,1,1
"352","run003","GRR","BRR",0,1,1
"353","run003","RBB","BBB",0,1,1
"354","run003","RBG","RGR",0,1,1
"355","run003","RBR","BBB",0,1,1
"356","run003","RBR","BBR",0,1,1
"357","run003","RBR","BGG",0,2,2
"358","run003","RGG","BBB",0,1,1
"359","run003","RGG","GGR",0,1,1
"360","run003","RGG","GRR",0,1,1
"361","run003","RGR","RBB",0,1,1
"362","run003","RRG","BBR",0,2,2
"363","run003","RRG","GGR",0,2,2
"364","run003","RRG","RGG",0,1,1
"365","run003","RRG","RGR",0,1,1
"366","run003","RRR","GRR",0,1,1
"367","run003","RRR","RBR",0,1,1
"368","run004","BBB","GGG",1,0,1
"369","run004","BBB","RRG",1,1,2
"370","run004","BBG","BBB",1,0,1
"371","run004","BBG","BRB",1,3,4
"372","run004","BBG","GBG",2,0,2
"373","run004","BBG","GGB",2,1,3
"374","run004","BBG","GGG",4,8,12
"375","run004","BBG","GRG",1,1,2
"376","run004","BBG","RRG",1,0,1
"377","run004","BGG","RBG",1,0,1
"378","run004","BGG","RRR",1,0,1
"379","run004","BRR","BGB",1,0,1
"380","run004","GBB","BBB",12,3,15
"381","run004","GBB","BRB",1,1,2
"382","run004","GBB","BRR",1,0,1
"383","run004","GBB","GGG",7,13,20
"384","run004","GBB","GGR",1,0,1
"385","run004","GBB","RBG",3,3,6
"386","run004","GBB","RBR",1,0,1
"387","run004","GBB","RGG",1,0,1
"388","run004","GBB","RGR",2,1,3
"389","run004","GBB","RRR",1,0,1
"390","run004","GBG","BRB",1,0,1
"391","run004","GBG","BRR",1,0,1
"392","run004","GBG","GGG",4,1,5
"393","run004","GBG","RBB",1,0,1
"394","run004","GBG","RGR",1,1,2
"395","run004","GBG","RRG",1,0,1
"396","run004","GGB","BBB",3,4,7
"397","run004","GGB","BBR",1,0,1
"398","run004","GGB","BRR",1,3,4
"399","run004","GGB","GBG",1,0,1
"400","run004","GGB","GGG",13,4,17
"401","run004","GGB","RGG",1,0,1
"402","run004","GGB","RRG",1,1,2
"403","run004","GGB","RRR",1,1,2
"404","run004","GGG","BBB",8,5,13
"405","run004","GGG","BGG",1,0,1
"406","run004","GGG","BRB",1,1,2
"407","run004","GGG","GGB",5,0,5
"408","run004","GGG","GGR",1,0,1
"409","run004","GGG","RBB",1,2,3
"410","run004","GGG","RGR",1,2,3
"411","run004","GGG","RRG",1,3,4
"412","run004","GGR","BRR",1,0,1
"413","run004","GGR","GRR",1,0,1
"414","run004","GRG","BBB",3,2,5
"415","run004","GRG","GGB",2,2,4
"416","run004","GRG","GGG",3,1,4
"417","run004","GRG","RGR",1,0,1
"418","run004","GRG","RRG",2,0,2
"419","run004","GRR","BGB",1,0,1
"420","run004","RBG","BBB",2,0,2
"421","run004","RBG","RBB",1,1,2
"422","run004","RBR","BGB",2,0,2
"423","run004","RBR","BRB",1,0,1
"424","run004","RBR","BRR",1,2,3
"425","run004","RBR","GRR",4,0,4
"426","run004","RBR","RGG",2,3,5
"427","run004","RBR","RGR",1,0,1
"428","run004","RGG","BBR",1,1,2
"429","run004","RGR","BBB",2,0,2
"430","run004","RGR","BBR",1,1,2
"431","run004","RGR","BGB",2,0,2
"432","run004","RGR","BGG",2,0,2
"433","run004","RGR","BRR",1,1,2
"434","run004","RGR","GGB",2,3,5
"435","run004","RGR","RGG",1,0,1
"436","run004","RRG","BBB",2,3,5
"437","run004","RRG","BGB",1,3,4
"438","run004","RRG","BRB",2,3,5
"439","run004","RRG","BRR",1,3,4
"440","run004","RRG","GGG",2,2,4
"441","run004","RRG","GRG",1,0,1
"442","run004","RRG","GRR",3,1,4
"443","run004","RRG","RBB",1,0,1
"444","run004","RRR","BBR",1,0,1
"445","run004","RRR","BGB",2,0,2
"446","run004","RRR","BGG",1,0,1
"447","run004","RRR","BRB",1,0,1
"448","run004","RRR","BRR",1,0,1
"449","run004","RRR","RBB",1,0,1
"450","run004","RRR","RGR",1,1,2
"451","run004","RRR","RRG",2,0,2
"452","run004","BBB","RBG",0,1,1
"453","run004","BBG","BGG",0,1,1
"454","run004","BBG","RRR",0,1,1
"455","run004","BGB","BBB",0,1,1
"456","run004","BGG","BBB",0,2,2
"457","run004","BRB","BBB",0,5,5
"458","run004","BRB","BRR",0,2,2
"459","run004","BRB","GGR",0,1,1
"460","run004","BRR","BBB",0,5,5
"461","run004","BRR","BGG",0,1,1
"462","run004","GBB","BGG",0,1,1
"463","run004","GBB","GBG",0,1,1
"464","run004","GBB","GGB",0,2,2
"465","run004","GBB","GRG",0,1,1
"466","run004","GBB","RBB",0,1,1
"467","run004","GBB","RRG",0,1,1
"468","run004","GBG","GGB",0,1,1
"469","run004","GGB","BGB",0,1,1
"470","run004","GGB","BGG",0,1,1
"471","run004","GGB","GBB",0,1,1
"472","run004","GGB","RBB",0,1,1
"473","run004","GGB","RBG",0,2,2
"474","run004","GGB","RGR",0,1,1
"475","run004","GGG","BGB",0,1,1
"476","run004","GGG","BRR",0,2,2
"477","run004","GGG","RBG",0,1,1
"478","run004","GGG","RBR",0,3,3
"479","run004","GGG","RGG",0,1,1
"480","run004","GGR","BBB",0,1,1
"481","run004","GRG","BBR",0,1,1
"482","run004","GRG","BRB",0,1,1
"483","run004","GRG","BRR",0,1,1
"484","run004","GRG","GGR",0,1,1
"485","run004","GRR","BRR",0,1,1
"486","run004","RBB","RGG",0,1,1
"487","run004","RBG","GRR",0,1,1
"488","run004","RBR","GGB",0,2,2
"489","run004","RGG","BBB",0,1,1
"490","run004","RGG","BRR",0,1,1
"491","run004","RGG","GGG",0,1,1
"492","run004","RGG","GRR",0,1,1
"493","run004","RGR","GGR",0,1,1
"494","run004","RRG","BBR",0,1,1
"495","run004","RRG","BGG",0,1,1
"496","run004","RRG","GGR",0,1,1
"497","run004","RRG","RGG",0,1,1
"498","run004","RRG","RGR",0,1,1
"499","run004","RRR","RBR",0,1,1
"500","run005","BBB","GGG",1,0,1
"501","run005","BBB","RRG",1,0,1
"502","run005","BBG","BBB",1,1,2
"503","run005","BBG","BRB",1,1,2
"504","run005","BBG","GBG",2,1,3
"505","run005","BBG","GGB",2,3,5
"506","run005","BBG","GGG",4,8,12
"507","run005","BBG","GRG",1,0,1
"508","run005","BBG","RRG",1,0,1
"509","run005","BGG","RBG",1,0,1
"510","run005","BGG","RRR",1,0,1
"511","run005","BRR","BGB",1,1,2
"512","run005","GBB","BBB",12,7,19
"513","run005","GBB","BRB",1,2,3
"514","run005","GBB","BRR",1,0,1
"515","run005","GBB","GGG",7,15,22
"516","run005","GBB","GGR",1,1,2
"517","run005","GBB","RBG",3,1,4
"518","run005","GBB","RBR",1,0,1
"519","run005","GBB","RGG",1,0,1
"520","run005","GBB","RGR",2,1,3
"521","run005","GBB","RRR",1,1,2
"522","run005","GBG","BRB",1,2,3
"523","run005","GBG","BRR",1,0,1
"524","run005","GBG","GGG",4,1,5
"525","run005","GBG","RBB",1,0,1
"526","run005","GBG","RGR",1,1,2
"527","run005","GBG","RRG",1,1,2
"528","run005","GGB","BBB",3,5,8
"529","run005","GGB","BBR",1,0,1
"530","run005","GGB","BRR",1,2,3
"531","run005","GGB","GBG",1,0,1
"532","run005","GGB","GGG",13,8,21
"533","run005","GGB","RGG",1,1,2
"534","run005","GGB","RRG",1,0,1
"535","run005","GGB","RRR",1,0,1
"536","run005","GGG","BBB",8,5,13
"537","run005","GGG","BGG",1,0,1
"538","run005","GGG","BRB",1,1,2
"539","run005","GGG","GGB",5,0,5
"540","run005","GGG","GGR",1,0,1
"541","run005","GGG","RBB",1,2,3
"542","run005","GGG","RGR",1,2,3
"543","run005","GGG","RRG",1,6,7
"544","run005","GGR","BRR",1,0,1
"545","run005","GGR","GRR",1,0,1
"546","run005","GRG","BBB",3,0,3
"547","run005","GRG","GGB",2,0,2
"548","run005","GRG","GGG",3,2,5
"549","run005","GRG","RGR",1,0,1
"550","run005","GRG","RRG",2,1,3
"551","run005","GRR","BGB",1,0,1
"552","run005","RBG","BBB",2,2,4
"553","run005","RBG","RBB",1,1,2
"554","run005","RBR","BGB",2,0,2
"555","run005","RBR","BRB",1,0,1
"556","run005","RBR","BRR",1,1,2
"557","run005","RBR","GRR",4,0,4
"558","run005","RBR","RGG",2,0,2
"559","run005","RBR","RGR",1,0,1
"560","run005","RGG","BBR",1,0,1
"561","run005","RGR","BBB",2,1,3
"562","run005","RGR","BBR",1,0,1
"563","run005","RGR","BGB",2,0,2
"564","run005","RGR","BGG",2,0,2
"565","run005","RGR","BRR",1,0,1
"566","run005","RGR","GGB",2,0,2
"567","run005","RGR","RGG",1,0,1
"568","run005","RRG","BBB",2,4,6
"569","run005","RRG","BGB",1,2,3
"570","run005","RRG","BRB",2,6,8
"571","run005","RRG","BRR",1,2,3
"572","run005","RRG","GGG",2,1,3
"573","run005","RRG","GRG",1,0,1
"574","run005","RRG","GRR",3,3,6
"575","run005","RRG","RBB",1,0,1
"576","run005","RRR","BBR",1,0,1
"577","run005","RRR","BGB",2,0,2
"578","run005","RRR","BGG",1,0,1
"579","run005","RRR","BRB",1,1,2
"580","run005","RRR","BRR",1,0,1
"581","run005","RRR","RBB",1,0,1
"582","run005","RRR","RGR",1,1,2
"583","run005","RRR","RRG",2,0,2
"584","run005","BBB","GRR",0,2,2
"585","run005","BBG","RRR",0,1,1
"586","run005","BGG","BBB",0,2,2
"587","run005","BGG","RGG",0,1,1
"588","run005","BRB","BBB",0,2,2
"589","run005","BRB","GGG",0,1,1
"590","run005","BRR","RBB",0,1,1
"591","run005","GBB","GGB",0,4,4
"592","run005","GBB","RRG",0,1,1
"593","run005","GGB","BGB",0,1,1
"594","run005","GGB","GGR",0,1,1
"595","run005","GGB","RBG",0,2,2
"596","run005","GGB","RBR",0,1,1
"597","run005","GGG","BRR",0,3,3
"598","run005","GGG","RBR",0,5,5
"599","run005","GGG","RRR",0,1,1
"600","run005","GRG","GGR",0,2,2
"601","run005","GRR","BRR",0,1,1
"602","run005","GRR","GGR",0,1,1
"603","run005","RBR","BBB",0,5,5
"604","run005","RBR","BGG",0,2,2
"605","run005","RBR","GGB",0,2,2
"606","run005","RBR","RBB",0,1,1
"607","run005","RGG","BBB",0,2,2
"608","run005","RGG","GGR",0,1,1
"609","run005","RGR","GGG",0,1,1
"610","run005","RGR","RRG",0,1,1
"611","run005","RRG","BBR",0,1,1
"612","run005","RRG","BGG",0,1,1
"613","run005","RRG","GGR",0,1,1
"614","run005","RRR","RBR",0,1,1
"615","run006","BBB","GGG",1,0,1
"616","run006","BBB","RRG",1,1,2
"617","run006","BBG","BBB",1,2,3
"618","run006","BBG","BRB",1,6,7
"619","run006","BBG","GBG",2,0,2
"620","run006","BBG","GGB",2,3,5
"621","run006","BBG","GGG",4,6,10
"622","run006","BBG","GRG",1,1,2
"623","run006","BBG","RRG",1,1,2
"624","run006","BGG","RBG",1,0,1
"625","run006","BGG","RRR",1,0,1
"626","run006","BRR","BGB",1,0,1
"627","run006","GBB","BBB",12,9,21
"628","run006","GBB","BRB",1,1,2
"629","run006","GBB","BRR",1,0,1
"630","run006","GBB","GGG",7,14,21
"631","run006","GBB","GGR",1,0,1
"632","run006","GBB","RBG",3,2,5
"633","run006","GBB","RBR",1,0,1
"634","run006","GBB","RGG",1,0,1
"635","run006","GBB","RGR",2,0,2
"636","run006","GBB","RRR",1,1,2
"637","run006","GBG","BRB",1,1,2
"638","run006","GBG","BRR",1,0,1
"639","run006","GBG","GGG",4,1,5
"640","run006","GBG","RBB",1,0,1
"641","run006","GBG","RGR",1,0,1
"642","run006","GBG","RRG",1,0,1
"643","run006","GGB","BBB",3,0,3
"644","run006","GGB","BBR",1,0,1
"645","run006","GGB","BRR",1,3,4
"646","run006","GGB","GBG",1,0,1
"647","run006","GGB","GGG",13,7,20
"648","run006","GGB","RGG",1,2,3
"649","run006","GGB","RRG",1,1,2
"650","run006","GGB","RRR",1,0,1
"651","run006","GGG","BBB",8,4,12
"652","run006","GGG","BGG",1,2,3
"653","run006","GGG","BRB",1,0,1
"654","run006","GGG","GGB",5,0,5
"655","run006","GGG","GGR",1,1,2
"656","run006","GGG","RBB",1,2,3
"657","run006","GGG","RGR",1,3,4
"658","run006","GGG","RRG",1,5,6
"659","run006","GGR","BRR",1,0,1
"660","run006","GGR","GRR",1,0,1
"661","run006","GRG","BBB",3,0,3
"662","run006","GRG","GGB",2,2,4
"663","run006","GRG","GGG",3,2,5
"664","run006","GRG","RGR",1,0,1
"665","run006","GRG","RRG",2,0,2
"666","run006","GRR","BGB",1,0,1
"667","run006","RBG","BBB",2,1,3
"668","run006","RBG","RBB",1,0,1
"669","run006","RBR","BGB",2,2,4
"670","run006","RBR","BRB",1,0,1
"671","run006","RBR","BRR",1,1,2
"672","run006","RBR","GRR",4,0,4
"673","run006","RBR","RGG",2,2,4
"674","run006","RBR","RGR",1,0,1
"675","run006","RGG","BBR",1,0,1
"676","run006","RGR","BBB",2,1,3
"677","run006","RGR","BBR",1,0,1
"678","run006","RGR","BGB",2,0,2
"679","run006","RGR","BGG",2,1,3
"680","run006","RGR","BRR",1,1,2
"681","run006","RGR","GGB",2,2,4
"682","run006","RGR","RGG",1,0,1
"683","run006","RRG","BBB",2,5,7
"684","run006","RRG","BGB",1,2,3
"685","run006","RRG","BRB",2,5,7
"686","run006","RRG","BRR",1,0,1
"687","run006","RRG","GGG",2,3,5
"688","run006","RRG","GRG",1,0,1
"689","run006","RRG","GRR",3,2,5
"690","run006","RRG","RBB",1,0,1
"691","run006","RRR","BBR",1,0,1
"692","run006","RRR","BGB",2,1,3
"693","run006","RRR","BGG",1,0,1
"694","run006","RRR","BRB",1,1,2
"695","run006","RRR","BRR",1,0,1
"696","run006","RRR","RBB",1,0,1
"697","run006","RRR","RGR",1,0,1
"698","run006","RRR","RRG",2,1,3
"699","run006","BBB","RBG",0,1,1
"700","run006","BBB","RRR",0,1,1
"701","run006","BBG","GBB",0,1,1
"702","run006","BBG","RRR",0,1,1
"703","run006","BGG","BBB",0,2,2
"704","run006","BRR","BBB",0,3,3
"705","run006","BRR","BGG",0,1,1
"706","run006","BRR","RBB",0,1,1
"707","run006","GBB","GGB",0,3,3
"708","run006","GBB","GRG",0,1,1
"709","run006","GBG","RBG",0,1,1
"710","run006","GGB","BGG",0,1,1
"711","run006","GGB","GGR",0,3,3
"712","run006","GGB","GRR",0,1,1
"713","run006","GGG","RBG",0,1,1
"714","run006","GGG","RBR",0,2,2
"715","run006","GGG","RGG",0,1,1
"716","run006","GRG","BGG",0,1,1
"717","run006","GRG","BRB",0,1,1
"718","run006","GRG","GGR",0,2,2
"719","run006","GRR","BBB",0,1,1
"720","run006","GRR","BGG",0,1,1
"721","run006","GRR","BRB",0,1,1
"722","run006","GRR","BRR",0,1,1
"723","run006","RBB","BBR",0,1,1
"724","run006","RBG","GBB",0,1,1
"725","run006","RBR","BBB",0,1,1
"726","run006","RBR","GGB",0,3,3
"727","run006","RBR","RRR",0,1,1
"728","run006","RGG","GRR",0,1,1
"729","run006","RRG","BBR",0,2,2
"730","run006","RRG","GGR",0,2,2
"731","run006","RRR","GRR",0,1,1
"732","run007","BBB","GGG",1,0,1
"733","run007","BBB","RRG",1,1,2
"734","run007","BBG","BBB",1,0,1
"735","run007","BBG","BRB",1,1,2
"736","run007","BBG","GBG",2,0,2
"737","run007","BBG","GGB",2,3,5
"738","run007","BBG","GGG",4,3,7
"739","run007","BBG","GRG",1,0,1
"740","run007","BBG","RRG",1,0,1
"741","run007","BGG","RBG",1,0,1
"742","run007","BGG","RRR",1,0,1
"743","run007","BRR","BGB",1,0,1
"744","run007","GBB","BBB",12,4,16
"745","run007","GBB","BRB",1,1,2
"746","run007","GBB","BRR",1,0,1
"747","run007","GBB","GGG",7,17,24
"748","run007","GBB","GGR",1,0,1
"749","run007","GBB","RBG",3,1,4
"750","run007","GBB","RBR",1,0,1
"751","run007","GBB","RGG",1,0,1
"752","run007","GBB","RGR",2,0,2
"753","run007","GBB","RRR",1,1,2
"754","run007","GBG","BRB",1,0,1
"755","run007","GBG","BRR",1,0,1
"756","run007","GBG","GGG",4,2,6
"757","run007","GBG","RBB",1,0,1
"758","run007","GBG","RGR",1,1,2
"759","run007","GBG","RRG",1,1,2
"760","run007","GGB","BBB",3,1,4
"761","run007","GGB","BBR",1,0,1
"762","run007","GGB","BRR",1,2,3
"763","run007","GGB","GBG",1,0,1
"764","run007","GGB","GGG",13,15,28
"765","run007","GGB","RGG",1,0,1
"766","run007","GGB","RRG",1,0,1
"767","run007","GGB","RRR",1,2,3
"768","run007","GGG","BBB",8,5,13
"769","run007","GGG","BGG",1,1,2
"770","run007","GGG","BRB",1,1,2
"771","run007","GGG","GGB",5,0,5
"772","run007","GGG","GGR",1,0,1
"773","run007","GGG","RBB",1,0,1
"774","run007","GGG","RGR",1,2,3
"775","run007","GGG","RRG",1,6,7
"776","run007","GGR","BRR",1,0,1
"777","run007","GGR","GRR",1,0,1
"778","run007","GRG","BBB",3,0,3
"779","run007","GRG","GGB",2,2,4
"780","run007","GRG","GGG",3,3,6
"781","run007","GRG","RGR",1,0,1
"782","run007","GRG","RRG",2,0,2
"783","run007","GRR","BGB",1,0,1
"784","run007","RBG","BBB",2,3,5
"785","run007","RBG","RBB",1,0,1
"786","run007","RBR","BGB",2,0,2
"787","run007","RBR","BRB",1,0,1
"788","run007","RBR","BRR",1,1,2
"789","run007","RBR","GRR",4,1,5
"790","run007","RBR","RGG",2,0,2
"791","run007","RBR","RGR",1,0,1
"792","run007","RGG","BBR",1,0,1
"793","run007","RGR","BBB",2,2,4
"794","run007","RGR","BBR",1,0,1
"795","run007","RGR","BGB",2,0,2
"796","run007","RGR","BGG",2,1,3
"797","run007","RGR","BRR",1,0,1
"798","run007","RGR","GGB",2,0,2
"799","run007","RGR","RGG",1,0,1
"800","run007","RRG","BBB",2,4,6
"801","run007","RRG","BGB",1,3,4
"802","run007","RRG","BRB",2,8,10
"803","run007","RRG","BRR",1,4,5
"804","run007","RRG","GGG",2,3,5
"805","run007","RRG","GRG",1,0,1
"806","run007","RRG","GRR",3,2,5
"807","run007","RRG","RBB",1,0,1
"808","run007","RRR","BBR",1,0,1
"809","run007","RRR","BGB",2,1,3
"810","run007","RRR","BGG",1,0,1
"811","run007","RRR","BRB",1,0,1
"812","run007","RRR","BRR",1,0,1
"813","run007","RRR","RBB",1,0,1
"814","run007","RRR","RGR",1,0,1
"815","run007","RRR","RRG",2,0,2
"816","run007","BBG","BGB",0,1,1
"817","run007","BBG","BGG",0,1,1
"818","run007","BBG","GBB",0,1,1
"819","run007","BBG","RGR",0,1,1
"820","run007","BBG","RRR",0,1,1
"821","run007","BGB","BBB",0,1,1
"822","run007","BGG","BBB",0,1,1
"823","run007","BRB","BBB",0,2,2
"824","run007","BRB","BRR",0,1,1
"825","run007","BRB","GGG",0,1,1
"826","run007","BRB","RRR",0,1,1
"827","run007","BRR","BBB",0,1,1
"828","run007","GBB","GGB",0,1,1
"829","run007","GBB","GRG",0,1,1
"830","run007","GBB","RBB",0,1,1
"831","run007","GBB","RRG",0,1,1
"832","run007","GBG","BBB",0,1,1
"833","run007","GGB","BGB",0,1,1
"834","run007","GGB","GGR",0,1,1
"835","run007","GGB","GRR",0,2,2
"836","run007","GGB","RBR",0,1,1
"837","run007","GGG","BGB",0,1,1
"838","run007","GGG","BRR",0,2,2
"839","run007","GGG","GRR",0,1,1
"840","run007","GGG","RBG",0,1,1
"841","run007","GGG","RBR",0,3,3
"842","run007","GGR","BBB",0,1,1
"843","run007","GRG","BGG",0,1,1
"844","run007","GRR","BRR",0,1,1
"845","run007","GRR","GGG",0,1,1
"846","run007","RBB","BBR",0,1,1
"847","run007","RBB","GRR",0,1,1
"848","run007","RBB","RGG",0,1,1
"849","run007","RBG","GRR",0,1,1
"850","run007","RBR","BBB",0,4,4
"851","run007","RBR","BGG",0,1,1
"852","run007","RBR","RRR",0,1,1
"853","run007","RGG","BBB",0,1,1
"854","run007","RGG","GGR",0,1,1
"855","run007","RGR","GGR",0,2,2
"856","run007","RGR","RRG",0,1,1
"857","run007","RRG","BBR",0,1,1
"858","run008","BBB","GGG",1,0,1
"859","run008","BBB","RRG",1,0,1
"860","run008","BBG","BBB",1,1,2
"861","run008","BBG","BRB",1,2,3
"862","run008","BBG","GBG",2,0,2
"863","run008","BBG","GGB",2,3,5
"864","run008","BBG","GGG",4,3,7
"865","run008","BBG","GRG",1,2,3
"866","run008","BBG","RRG",1,0,1
"867","run008","BGG","RBG",1,0,1
"868","run008","BGG","RRR",1,0,1
"869","run008","BRR","BGB",1,0,1
"870","run008","GBB","BBB",12,5,17
"871","run008","GBB","BRB",1,0,1
"872","run008","GBB","BRR",1,1,2
"873","run008","GBB","GGG",7,15,22
"874","run008","GBB","GGR",1,0,1
"875","run008","GBB","RBG",3,3,6
"876","run008","GBB","RBR",1,0,1
"877","run008","GBB","RGG",1,0,1
"878","run008","GBB","RGR",2,0,2
"879","run008","GBB","RRR",1,1,2
"880","run008","GBG","BRB",1,1,2
"881","run008","GBG","BRR",1,0,1
"882","run008","GBG","GGG",4,1,5
"883","run008","GBG","RBB",1,0,1
"884","run008","GBG","RGR",1,1,2
"885","run008","GBG","RRG",1,2,3
"886","run008","GGB","BBB",3,3,6
"887","run008","GGB","BBR",1,1,2
"888","run008","GGB","BRR",1,2,3
"889","run008","GGB","GBG",1,0,1
"890","run008","GGB","GGG",13,11,24
"891","run008","GGB","RGG",1,2,3
"892","run008","GGB","RRG",1,0,1
"893","run008","GGB","RRR",1,0,1
"894","run008","GGG","BBB",8,2,10
"895","run008","GGG","BGG",1,1,2
"896","run008","GGG","BRB",1,0,1
"897","run008","GGG","GGB",5,0,5
"898","run008","GGG","GGR",1,2,3
"899","run008","GGG","RBB",1,0,1
"900","run008","GGG","RGR",1,4,5
"901","run008","GGG","RRG",1,5,6
"902","run008","GGR","BRR",1,0,1
"903","run008","GGR","GRR",1,0,1
"904","run008","GRG","BBB",3,2,5
"905","run008","GRG","GGB",2,4,6
"906","run008","GRG","GGG",3,2,5
"907","run008","GRG","RGR",1,1,2
"908","run008","GRG","RRG",2,0,2
"909","run008","GRR","BGB",1,0,1
"910","run008","RBG","BBB",2,0,2
"911","run008","RBG","RBB",1,0,1
"912","run008","RBR","BGB",2,1,3
"913","run008","RBR","BRB",1,0,1
"914","run008","RBR","BRR",1,1,2
"915","run008","RBR","GRR",4,0,4
"916","run008","RBR","RGG",2,1,3
"917","run008","RBR","RGR",1,0,1
"918","run008","RGG","BBR",1,0,1
"919","run008","RGR","BBB",2,0,2
"920","run008","RGR","BBR",1,1,2
"921","run008","RGR","BGB",2,0,2
"922","run008","RGR","BGG",2,1,3
"923","run008","RGR","BRR",1,0,1
"924","run008","RGR","GGB",2,0,2
"925","run008","RGR","RGG",1,0,1
"926","run008","RRG","BBB",2,6,8
"927","run008","RRG","BGB",1,1,2
"928","run008","RRG","BRB",2,3,5
"929","run008","RRG","BRR",1,2,3
"930","run008","RRG","GGG",2,4,6
"931","run008","RRG","GRG",1,0,1
"932","run008","RRG","GRR",3,1,4
"933","run008","RRG","RBB",1,1,2
"934","run008","RRR","BBR",1,0,1
"935","run008","RRR","BGB",2,0,2
"936","run008","RRR","BGG",1,0,1
"937","run008","RRR","BRB",1,0,1
"938","run008","RRR","BRR",1,0,1
"939","run008","RRR","RBB",1,0,1
"940","run008","RRR","RGR",1,0,1
"941","run008","RRR","RRG",2,0,2
"942","run008","BBB","BRB",0,1,1
"943","run008","BBG","GBB",0,1,1
"944","run008","BRB","BBB",0,3,3
"945","run008","BRB","BRR",0,2,2
"946","run008","BRB","GGR",0,1,1
"947","run008","BRB","RRR",0,1,1
"948","run008","BRR","BBB",0,3,3
"949","run008","GBB","GBG",0,2,2
"950","run008","GBB","GGB",0,3,3
"951","run008","GBB","RRG",0,1,1
"952","run008","GBG","BBB",0,1,1
"953","run008","GBG","GGB",0,1,1
"954","run008","GBG","RBG",0,1,1
"955","run008","GGB","BRB",0,1,1
"956","run008","GGB","GRR",0,1,1
"957","run008","GGB","RBB",0,1,1
"958","run008","GGB","RBR",0,1,1
"959","run008","GGB","RGR",0,1,1
"960","run008","GGG","BRR",0,1,1
"961","run008","GGG","RBG",0,1,1
"962","run008","GGG","RBR",0,3,3
"963","run008","GGG","RGG",0,1,1
"964","run008","GGR","BBB",0,1,1
"965","run008","GGR","BBR",0,1,1
"966","run008","GGR","RBB",0,1,1
"967","run008","GRG","BRB",0,1,1
"968","run008","GRG","GGR",0,1,1
"969","run008","GRG","GRR",0,1,1
"970","run008","GRR","BBR",0,1,1
"971","run008","GRR","BGG",0,1,1
"972","run008","RBB","BRB",0,1,1
"973","run008","RBG","RGR",0,1,1
"974","run008","RBR","BBB",0,3,3
"975","run008","RBR","GGB",0,2,2
"976","run008","RGG","BBB",0,2,2
"977","run008","RGG","BRR",0,1,1
"978","run008","RGG","GGG",0,1,1
"979","run008","RGG","GGR",0,1,1
"980","run008","RRR","GRR",0,1,1
"981","run008","RRR","RBR",0,1,1
"982","run009","BBB","GGG",1,0,1
"983","run009","BBB","RRG",1,0,1
"984","run009","BBG","BBB",1,1,2
"985","run009","BBG","BRB",1,3,4
"986","run009","BBG","GBG",2,2,4
"987","run009","BBG","GGB",2,5,7
"988","run009","BBG","GGG",4,4,8
"989","run009","BBG","GRG",1,1,2
"990","run009","BBG","RRG",1,0,1
"991","run009","BGG","RBG",1,0,1
"992","run009","BGG","RRR",1,0,1
"993","run009","BRR","BGB",1,0,1
"994","run009","GBB","BBB",12,1,13
"995","run009","GBB","BRB",1,2,3
"996","run009","GBB","BRR",1,1,2
"997","run009","GBB","GGG",7,12,19
"998","run009","GBB","GGR",1,0,1
"999","run009","GBB","RBG",3,2,5
"1000","run009","GBB","RBR",1,0,1
"1001","run009","GBB","RGG",1,0,1
"1002","run009","GBB","RGR",2,0,2
"1003","run009","GBB","RRR",1,3,4
"1004","run009","GBG","BRB",1,0,1
"1005","run009","GBG","BRR",1,0,1
"1006","run009","GBG","GGG",4,5,9
"1007","run009","GBG","RBB",1,0,1
"1008","run009","GBG","RGR",1,1,2
"1009","run009","GBG","RRG",1,0,1
"1010","run009","GGB","BBB",3,3,6
"1011","run009","GGB","BBR",1,1,2
"1012","run009","GGB","BRR",1,4,5
"1013","run009","GGB","GBG",1,0,1
"1014","run009","GGB","GGG",13,5,18
"1015","run009","GGB","RGG",1,1,2
"1016","run009","GGB","RRG",1,1,2
"1017","run009","GGB","RRR",1,2,3
"1018","run009","GGG","BBB",8,9,17
"1019","run009","GGG","BGG",1,0,1
"1020","run009","GGG","BRB",1,0,1
"1021","run009","GGG","GGB",5,0,5
"1022","run009","GGG","GGR",1,0,1
"1023","run009","GGG","RBB",1,1,2
"1024","run009","GGG","RGR",1,1,2
"1025","run009","GGG","RRG",1,4,5
"1026","run009","GGR","BRR",1,0,1
"1027","run009","GGR","GRR",1,0,1
"1028","run009","GRG","BBB",3,1,4
"1029","run009","GRG","GGB",2,3,5
"1030","run009","GRG","GGG",3,1,4
"1031","run009","GRG","RGR",1,1,2
"1032","run009","GRG","RRG",2,2,4
"1033","run009","GRR","BGB",1,1,2
"1034","run009","RBG","BBB",2,2,4
"1035","run009","RBG","RBB",1,0,1
"1036","run009","RBR","BGB",2,1,3
"1037","run009","RBR","BRB",1,0,1
"1038","run009","RBR","BRR",1,1,2
"1039","run009","RBR","GRR",4,1,5
"1040","run009","RBR","RGG",2,2,4
"1041","run009","RBR","RGR",1,0,1
"1042","run009","RGG","BBR",1,0,1
"1043","run009","RGR","BBB",2,0,2
"1044","run009","RGR","BBR",1,0,1
"1045","run009","RGR","BGB",2,2,4
"1046","run009","RGR","BGG",2,0,2
"1047","run009","RGR","BRR",1,0,1
"1048","run009","RGR","GGB",2,3,5
"1049","run009","RGR","RGG",1,0,1
"1050","run009","RRG","BBB",2,4,6
"1051","run009","RRG","BGB",1,1,2
"1052","run009","RRG","BRB",2,6,8
"1053","run009","RRG","BRR",1,1,2
"1054","run009","RRG","GGG",2,3,5
"1055","run009","RRG","GRG",1,0,1
"1056","run009","RRG","GRR",3,0,3
"1057","run009","RRG","RBB",1,0,1
"1058","run009","RRR","BBR",1,0,1
"1059","run009","RRR","BGB",2,0,2
"1060","run009","RRR","BGG",1,0,1
"1061","run009","RRR","BRB",1,0,1
"1062","run009","RRR","BRR",1,1,2
"1063","run009","RRR","RBB",1,0,1
"1064","run009","RRR","RGR",1,0,1
"1065","run009","RRR","RRG",2,0,2
"1066","run009","BBB","RBG",0,1,1
"1067","run009","BBB","RRR",0,1,1
"1068","run009","BBG","BGB",0,1,1
"1069","run009","BBG","GRR",0,1,1
"1070","run009","BBG","RBG",0,2,2
"1071","run009","BBG","RRR",0,2,2
"1072","run009","BGB","BBB",0,1,1
"1073","run009","BGG","BBR",0,1,1
"1074","run009","BGG","RGG",0,1,1
"1075","run009","BRB","BBB",0,2,2
"1076","run009","BRB","BBR",0,1,1
"1077","run009","BRR","BBB",0,1,1
"1078","run009","BRR","RBB",0,1,1
"1079","run009","GBB","GBG",0,1,1
"1080","run009","GBB","GGB",0,1,1
"1081","run009","GBB","GRG",0,1,1
"1082","run009","GBG","BBB",0,2,2
"1083","run009","GGB","BGG",0,1,1
"1084","run009","GGB","GGR",0,1,1
"1085","run009","GGB","RBG",0,1,1
"1086","run009","GGB","RBR",0,1,1
"1087","run009","GGG","RBR",0,3,3
"1088","run009","GGG","RRR",0,1,1
"1089","run009","GGR","BBR",0,1,1
"1090","run009","GGR","RBB",0,1,1
"1091","run009","GRG","BRR",0,1,1
"1092","run009","GRG","GGR",0,1,1
"1093","run009","GRR","BGG",0,1,1
"1094","run009","GRR","BRB",0,1,1
"1095","run009","GRR","GGR",0,1,1
"1096","run009","RBB","BBR",0,1,1
"1097","run009","RBG","GRR",0,1,1
"1098","run009","RBG","RBR",0,1,1
"1099","run009","RBR","BBB",0,3,3
"1100","run009","RGG","BRR",0,1,1
"1101","run009","RGG","GRR",0,4,4
"1102","run009","RRR","GRR",0,1,1
"1103","run010","BBB","GGG",1,0,1
"1104","run010","BBB","RRG",1,0,1
"1105","run010","BBG","BBB",1,0,1
"1106","run010","BBG","BRB",1,1,2
"1107","run010","BBG","GBG",2,1,3
"1108","run010","BBG","GGB",2,4,6
"1109","run010","BBG","GGG",4,7,11
"1110","run010","BBG","GRG",1,1,2
"1111","run010","BBG","RRG",1,0,1
"1112","run010","BGG","RBG",1,0,1
"1113","run010","BGG","RRR",1,0,1
"1114","run010","BRR","BGB",1,0,1
"1115","run010","GBB","BBB",12,5,17
"1116","run010","GBB","BRB",1,2,3
"1117","run010","GBB","BRR",1,1,2
"1118","run010","GBB","GGG",7,15,22
"1119","run010","GBB","GGR",1,0,1
"1120","run010","GBB","RBG",3,1,4
"1121","run010","GBB","RBR",1,0,1
"1122","run010","GBB","RGG",1,0,1
"1123","run010","GBB","RGR",2,0,2
"1124","run010","GBB","RRR",1,1,2
"1125","run010","GBG","BRB",1,1,2
"1126","run010","GBG","BRR",1,0,1
"1127","run010","GBG","GGG",4,1,5
"1128","run010","GBG","RBB",1,0,1
"1129","run010","GBG","RGR",1,0,1
"1130","run010","GBG","RRG",1,0,1
"1131","run010","GGB","BBB",3,2,5
"1132","run010","GGB","BBR",1,0,1
"1133","run010","GGB","BRR",1,2,3
"1134","run010","GGB","GBG",1,0,1
"1135","run010","GGB","GGG",13,3,16
"1136","run010","GGB","RGG",1,2,3
"1137","run010","GGB","RRG",1,2,3
"1138","run010","GGB","RRR",1,1,2
"1139","run010","GGG","BBB",8,2,10
"1140","run010","GGG","BGG",1,0,1
"1141","run010","GGG","BRB",1,0,1
"1142","run010","GGG","GGB",5,0,5
"1143","run010","GGG","GGR",1,0,1
"1144","run010","GGG","RBB",1,2,3
"1145","run010","GGG","RGR",1,3,4
"1146","run010","GGG","RRG",1,5,6
"1147","run010","GGR","BRR",1,0,1
"1148","run010","GGR","GRR",1,0,1
"1149","run010","GRG","BBB",3,1,4
"1150","run010","GRG","GGB",2,3,5
"1151","run010","GRG","GGG",3,2,5
"1152","run010","GRG","RGR",1,0,1
"1153","run010","GRG","RRG",2,0,2
"1154","run010","GRR","BGB",1,1,2
"1155","run010","RBG","BBB",2,3,5
"1156","run010","RBG","RBB",1,0,1
"1157","run010","RBR","BGB",2,1,3
"1158","run010","RBR","BRB",1,0,1
"1159","run010","RBR","BRR",1,1,2
"1160","run010","RBR","GRR",4,2,6
"1161","run010","RBR","RGG",2,3,5
"1162","run010","RBR","RGR",1,0,1
"1163","run010","RGG","BBR",1,0,1
"1164","run010","RGR","BBB",2,1,3
"1165","run010","RGR","BBR",1,0,1
"1166","run010","RGR","BGB",2,0,2
"1167","run010","RGR","BGG",2,0,2
"1168","run010","RGR","BRR",1,1,2
"1169","run010","RGR","GGB",2,1,3
"1170","run010","RGR","RGG",1,1,2
"1171","run010","RRG","BBB",2,5,7
"1172","run010","RRG","BGB",1,3,4
"1173","run010","RRG","BRB",2,4,6
"1174","run010","RRG","BRR",1,0,1
"1175","run010","RRG","GGG",2,1,3
"1176","run010","RRG","GRG",1,0,1
"1177","run010","RRG","GRR",3,2,5
"1178","run010","RRG","RBB",1,0,1
"1179","run010","RRR","BBR",1,0,1
"1180","run010","RRR","BGB",2,1,3
"1181","run010","RRR","BGG",1,0,1
"1182","run010","RRR","BRB",1,1,2
"1183","run010","RRR","BRR",1,0,1
"1184","run010","RRR","RBB",1,0,1
"1185","run010","RRR","RGR",1,0,1
"1186","run010","RRR","RRG",2,0,2
"1187","run010","BBB","GRR",0,1,1
"1188","run010","BBG","BGB",0,1,1
"1189","run010","BBG","GRR",0,1,1
"1190","run010","BBG","RBB",0,1,1
"1191","run010","BBG","RBG",0,1,1
"1192","run010","BBG","RRR",0,2,2
"1193","run010","BRB","BBB",0,1,1
"1194","run010","BRB","RRR",0,1,1
"1195","run010","BRR","BBB",0,3,3
"1196","run010","GBB","GBG",0,1,1
"1197","run010","GBB","GGB",0,2,2
"1198","run010","GBB","GRG",0,3,3
"1199","run010","GBG","BBB",0,3,3
"1200","run010","GBG","GGB",0,2,2
"1201","run010","GGB","GGR",0,1,1
"1202","run010","GGB","GRR",0,1,1
"1203","run010","GGB","RBB",0,1,1
"1204","run010","GGB","RBG",0,2,2
"1205","run010","GGG","BRR",0,2,2
"1206","run010","GGG","RBG",0,1,1
"1207","run010","GGG","RBR",0,2,2
"1208","run010","GGG","RRR",0,1,1
"1209","run010","GGR","BBB",0,1,1
"1210","run010","GRG","BRB",0,1,1
"1211","run010","GRG","GBG",0,1,1
"1212","run010","GRG","GGR",0,2,2
"1213","run010","GRG","RBG",0,1,1
"1214","run010","GRR","BGG",0,1,1
"1215","run010","GRR","BRB",0,1,1
"1216","run010","GRR","BRR",0,1,1
"1217","run010","GRR","GGR",0,1,1
"1218","run010","RBR","BBB",0,4,4
"1219","run010","RBR","BGG",0,2,2
"1220","run010","RBR","GGB",0,1,1
"1221","run010","RGG","BRR",0,1,1
"1222","run010","RGR","GGR",0,1,1
"1223","run010","RGR","RRG",0,1,1
"1224","run010","RRG","GGR",0,1,1
"1225","run010","RRR","GGR",0,1,1
"1226","run010","RRR","GRR",0,1,1
"1227","run011","BBB","GGG",1,0,1
"1228","run011","BBB","RRG",1,1,2
"1229","run011","BBG","BBB",1,0,1
"1230","run011","BBG","BRB",1,3,4
"1231","run011","BBG","GBG",2,0,2
"1232","run011","BBG","GGB",2,6,8
"1233","run011","BBG","GGG",4,2,6
"1234","run011","BBG","GRG",1,3,4
"1235","run011","BBG","RRG",1,0,1
"1236","run011","BGG","RBG",1,0,1
"1237","run011","BGG","RRR",1,0,1
"1238","run011","BRR","BGB",1,0,1
"1239","run011","GBB","BBB",12,7,19
"1240","run011","GBB","BRB",1,0,1
"1241","run011","GBB","BRR",1,1,2
"1242","run011","GBB","GGG",7,8,15
"1243","run011","GBB","GGR",1,0,1
"1244","run011","GBB","RBG",3,1,4
"1245","run011","GBB","RBR",1,0,1
"1246","run011","GBB","RGG",1,0,1
"1247","run011","GBB","RGR",2,1,3
"1248","run011","GBB","RRR",1,3,4
"1249","run011","GBG","BRB",1,1,2
"1250","run011","GBG","BRR",1,0,1
"1251","run011","GBG","GGG",4,1,5
"1252","run011","GBG","RBB",1,0,1
"1253","run011","GBG","RGR",1,0,1
"1254","run011","GBG","RRG",1,0,1
"1255","run011","GGB","BBB",3,2,5
"1256","run011","GGB","BBR",1,0,1
"1257","run011","GGB","BRR",1,0,1
"1258","run011","GGB","GBG",1,0,1
"1259","run011","GGB","GGG",13,6,19
"1260","run011","GGB","RGG",1,0,1
"1261","run011","GGB","RRG",1,0,1
"1262","run011","GGB","RRR",1,1,2
"1263","run011","GGG","BBB",8,7,15
"1264","run011","GGG","BGG",1,0,1
"1265","run011","GGG","BRB",1,1,2
"1266","run011","GGG","GGB",5,0,5
"1267","run011","GGG","GGR",1,2,3
"1268","run011","GGG","RBB",1,1,2
"1269","run011","GGG","RGR",1,3,4
"1270","run011","GGG","RRG",1,5,6
"1271","run011","GGR","BRR",1,0,1
"1272","run011","GGR","GRR",1,0,1
"1273","run011","GRG","BBB",3,1,4
"1274","run011","GRG","GGB",2,1,3
"1275","run011","GRG","GGG",3,3,6
"1276","run011","GRG","RGR",1,1,2
"1277","run011","GRG","RRG",2,1,3
"1278","run011","GRR","BGB",1,1,2
"1279","run011","RBG","BBB",2,3,5
"1280","run011","RBG","RBB",1,0,1
"1281","run011","RBR","BGB",2,0,2
"1282","run011","RBR","BRB",1,0,1
"1283","run011","RBR","BRR",1,0,1
"1284","run011","RBR","GRR",4,0,4
"1285","run011","RBR","RGG",2,1,3
"1286","run011","RBR","RGR",1,0,1
"1287","run011","RGG","BBR",1,1,2
"1288","run011","RGR","BBB",2,1,3
"1289","run011","RGR","BBR",1,0,1
"1290","run011","RGR","BGB",2,1,3
"1291","run011","RGR","BGG",2,0,2
"1292","run011","RGR","BRR",1,1,2
"1293","run011","RGR","GGB",2,0,2
"1294","run011","RGR","RGG",1,0,1
"1295","run011","RRG","BBB",2,4,6
"1296","run011","RRG","BGB",1,2,3
"1297","run011","RRG","BRB",2,6,8
"1298","run011","RRG","BRR",1,2,3
"1299","run011","RRG","GGG",2,6,8
"1300","run011","RRG","GRG",1,0,1
"1301","run011","RRG","GRR",3,2,5
"1302","run011","RRG","RBB",1,0,1
"1303","run011","RRR","BBR",1,0,1
"1304","run011","RRR","BGB",2,0,2
"1305","run011","RRR","BGG",1,0,1
"1306","run011","RRR","BRB",1,1,2
"1307","run011","RRR","BRR",1,0,1
"1308","run011","RRR","RBB",1,0,1
"1309","run011","RRR","RGR",1,1,2
"1310","run011","RRR","RRG",2,0,2
"1311","run011","BBB","RRR",0,1,1
"1312","run011","BBG","GRR",0,1,1
"1313","run011","BBG","RBG",0,2,2
"1314","run011","BBG","RRR",0,1,1
"1315","run011","BRB","BBB",0,2,2
"1316","run011","BRB","RGR",0,1,1
"1317","run011","BRR","BBB",0,1,1
"1318","run011","BRR","RBB",0,1,1
"1319","run011","GBB","GGB",0,6,6
"1320","run011","GBB","GRG",0,1,1
"1321","run011","GBB","GRR",0,1,1
"1322","run011","GBG","BBR",0,1,1
"1323","run011","GBG","RGG",0,1,1
"1324","run011","GGB","BGG",0,1,1
"1325","run011","GGB","GBB",0,1,1
"1326","run011","GGB","GGR",0,1,1
"1327","run011","GGB","GRR",0,2,2
"1328","run011","GGB","RBB",0,1,1
"1329","run011","GGB","RBR",0,2,2
"1330","run011","GGG","BRR",0,1,1
"1331","run011","GGG","RBG",0,2,2
"1332","run011","GGG","RBR",0,4,4
"1333","run011","GRG","BRB",0,1,1
"1334","run011","GRG","GGR",0,1,1
"1335","run011","RBB","RGG",0,1,1
"1336","run011","RBG","BBG",0,1,1
"1337","run011","RBG","RGR",0,1,1
"1338","run011","RBR","BBB",0,1,1
"1339","run011","RBR","GGB",0,2,2
"1340","run011","RBR","RBB",0,1,1
"1341","run011","RBR","RRR",0,1,1
"1342","run011","RGG","BBB",0,2,2
"1343","run011","RGG","BRR",0,2,2
"1344","run011","RGR","GGR",0,1,1
"1345","run011","RRG","BGG",0,1,1
"1346","run011","RRG","GGR",0,1,1
"1347","run011","RRG","RGG",0,1,1
"1348","run011","RRR","RGG",0,1,1
"1349","run012","BBB","GGG",1,1,2
"1350","run012","BBB","RRG",1,0,1
"1351","run012","BBG","BBB",1,1,2
"1352","run012","BBG","BRB",1,6,7
"1353","run012","BBG","GBG",2,0,2
"1354","run012","BBG","GGB",2,2,4
"1355","run012","BBG","GGG",4,5,9
"1356","run012","BBG","GRG",1,1,2
"1357","run012","BBG","RRG",1,1,2
"1358","run012","BGG","RBG",1,0,1
"1359","run012","BGG","RRR",1,0,1
"1360","run012","BRR","BGB",1,0,1
"1361","run012","GBB","BBB",12,4,16
"1362","run012","GBB","BRB",1,1,2
"1363","run012","GBB","BRR",1,1,2
"1364","run012","GBB","GGG",7,15,22
"1365","run012","GBB","GGR",1,0,1
"1366","run012","GBB","RBG",3,1,4
"1367","run012","GBB","RBR",1,0,1
"1368","run012","GBB","RGG",1,0,1
"1369","run012","GBB","RGR",2,0,2
"1370","run012","GBB","RRR",1,2,3
"1371","run012","GBG","BRB",1,0,1
"1372","run012","GBG","BRR",1,0,1
"1373","run012","GBG","GGG",4,2,6
"1374","run012","GBG","RBB",1,0,1
"1375","run012","GBG","RGR",1,0,1
"1376","run012","GBG","RRG",1,0,1
"1377","run012","GGB","BBB",3,1,4
"1378","run012","GGB","BBR",1,0,1
"1379","run012","GGB","BRR",1,1,2
"1380","run012","GGB","GBG",1,0,1
"1381","run012","GGB","GGG",13,8,21
"1382","run012","GGB","RGG",1,0,1
"1383","run012","GGB","RRG",1,2,3
"1384","run012","GGB","RRR",1,0,1
"1385","run012","GGG","BBB",8,6,14
"1386","run012","GGG","BGG",1,2,3
"1387","run012","GGG","BRB",1,0,1
"1388","run012","GGG","GGB",5,0,5
"1389","run012","GGG","GGR",1,1,2
"1390","run012","GGG","RBB",1,2,3
"1391","run012","GGG","RGR",1,1,2
"1392","run012","GGG","RRG",1,5,6
"1393","run012","GGR","BRR",1,0,1
"1394","run012","GGR","GRR",1,0,1
"1395","run012","GRG","BBB",3,1,4
"1396","run012","GRG","GGB",2,2,4
"1397","run012","GRG","GGG",3,1,4
"1398","run012","GRG","RGR",1,0,1
"1399","run012","GRG","RRG",2,0,2
"1400","run012","GRR","BGB",1,0,1
"1401","run012","RBG","BBB",2,3,5
"1402","run012","RBG","RBB",1,0,1
"1403","run012","RBR","BGB",2,1,3
"1404","run012","RBR","BRB",1,0,1
"1405","run012","RBR","BRR",1,1,2
"1406","run012","RBR","GRR",4,0,4
"1407","run012","RBR","RGG",2,1,3
"1408","run012","RBR","RGR",1,0,1
"1409","run012","RGG","BBR",1,0,1
"1410","run012","RGR","BBB",2,0,2
"1411","run012","RGR","BBR",1,0,1
"1412","run012","RGR","BGB",2,3,5
"1413","run012","RGR","BGG",2,0,2
"1414","run012","RGR","BRR",1,0,1
"1415","run012","RGR","GGB",2,3,5
"1416","run012","RGR","RGG",1,0,1
"1417","run012","RRG","BBB",2,3,5
"1418","run012","RRG","BGB",1,1,2
"1419","run012","RRG","BRB",2,12,14
"1420","run012","RRG","BRR",1,1,2
"1421","run012","RRG","GGG",2,1,3
"1422","run012","RRG","GRG",1,0,1
"1423","run012","RRG","GRR",3,2,5
"1424","run012","RRG","RBB",1,0,1
"1425","run012","RRR","BBR",1,0,1
"1426","run012","RRR","BGB",2,0,2
"1427","run012","RRR","BGG",1,0,1
"1428","run012","RRR","BRB",1,0,1
"1429","run012","RRR","BRR",1,0,1
"1430","run012","RRR","RBB",1,1,2
"1431","run012","RRR","RGR",1,0,1
"1432","run012","RRR","RRG",2,0,2
"1433","run012","BBB","BRB",0,1,1
"1434","run012","BBB","GRR",0,1,1
"1435","run012","BBB","RBG",0,1,1
"1436","run012","BBG","RRR",0,1,1
"1437","run012","BGG","BBR",0,1,1
"1438","run012","BRB","BBB",0,2,2
"1439","run012","BRB","BRR",0,1,1
"1440","run012","BRR","BBB",0,1,1
"1441","run012","BRR","RBB",0,1,1
"1442","run012","GBB","BGG",0,1,1
"1443","run012","GBB","GGB",0,5,5
"1444","run012","GBB","GRG",0,1,1
"1445","run012","GBB","RRG",0,2,2
"1446","run012","GGB","BGB",0,1,1
"1447","run012","GGB","GGR",0,1,1
"1448","run012","GGB","GRR",0,2,2
"1449","run012","GGB","RBG",0,1,1
"1450","run012","GGB","RBR",0,2,2
"1451","run012","GGG","GRR",0,1,1
"1452","run012","GGG","RBG",0,1,1
"1453","run012","GGG","RBR",0,2,2
"1454","run012","GGR","BBB",0,1,1
"1455","run012","GGR","BGG",0,1,1
"1456","run012","GRG","BBR",0,1,1
"1457","run012","GRG","BGG",0,1,1
"1458","run012","GRG","GGR",0,1,1
"1459","run012","RBB","BBR",0,1,1
"1460","run012","RBR","BBB",0,2,2
"1461","run012","RBR","GGB",0,2,2
"1462","run012","RBR","RBB",0,1,1
"1463","run012","RBR","RRR",0,1,1
"1464","run012","RGG","BBB",0,2,2
"1465","run012","RGG","BGB",0,1,1
"1466","run012","RGG","GRR",0,1,1
"1467","run012","RGR","GGR",0,1,1
"1468","run012","RGR","RRG",0,1,1
"1469","run012","RRG","BBR",0,1,1
"1470","run012","RRR","RBR",0,1,1
"1471","run012","RRR","RGG",0,1,1
"1472","run013","BBB","GGG",1,1,2
"1473","run013","BBB","RRG",1,0,1
"1474","run013","BBG","BBB",1,0,1
"1475","run013","BBG","BRB",1,6,7
"1476","run013","BBG","GBG",2,2,4
"1477","run013","BBG","GGB",2,1,3
"1478","run013","BBG","GGG",4,5,9
"1479","run013","BBG","GRG",1,1,2
"1480","run013","BBG","RRG",1,0,1
"1481","run013","BGG","RBG",1,0,1
"1482","run013","BGG","RRR",1,0,1
"1483","run013","BRR","BGB",1,0,1
"1484","run013","GBB","BBB",12,11,23
"1485","run013","GBB","BRB",1,3,4
"1486","run013","GBB","BRR",1,0,1
"1487","run013","GBB","GGG",7,10,17
"1488","run013","GBB","GGR",1,1,2
"1489","run013","GBB","RBG",3,0,3
"1490","run013","GBB","RBR",1,0,1
"1491","run013","GBB","RGG",1,0,1
"1492","run013","GBB","RGR",2,0,2
"1493","run013","GBB","RRR",1,1,2
"1494","run013","GBG","BRB",1,1,2
"1495","run013","GBG","BRR",1,0,1
"1496","run013","GBG","GGG",4,0,4
"1497","run013","GBG","RBB",1,0,1
"1498","run013","GBG","RGR",1,0,1
"1499","run013","GBG","RRG",1,0,1
"1500","run013","GGB","BBB",3,2,5
"1501","run013","GGB","BBR",1,0,1
"1502","run013","GGB","BRR",1,7,8
"1503","run013","GGB","GBG",1,0,1
"1504","run013","GGB","GGG",13,6,19
"1505","run013","GGB","RGG",1,1,2
"1506","run013","GGB","RRG",1,0,1
"1507","run013","GGB","RRR",1,0,1
"1508","run013","GGG","BBB",8,2,10
"1509","run013","GGG","BGG",1,2,3
"1510","run013","GGG","BRB",1,2,3
"1511","run013","GGG","GGB",5,0,5
"1512","run013","GGG","GGR",1,1,2
"1513","run013","GGG","RBB",1,0,1
"1514","run013","GGG","RGR",1,0,1
"1515","run013","GGG","RRG",1,4,5
"1516","run013","GGR","BRR",1,0,1
"1517","run013","GGR","GRR",1,0,1
"1518","run013","GRG","BBB",3,1,4
"1519","run013","GRG","GGB",2,3,5
"1520","run013","GRG","GGG",3,2,5
"1521","run013","GRG","RGR",1,0,1
"1522","run013","GRG","RRG",2,1,3
"1523","run013","GRR","BGB",1,0,1
"1524","run013","RBG","BBB",2,4,6
"1525","run013","RBG","RBB",1,1,2
"1526","run013","RBR","BGB",2,1,3
"1527","run013","RBR","BRB",1,0,1
"1528","run013","RBR","BRR",1,1,2
"1529","run013","RBR","GRR",4,0,4
"1530","run013","RBR","RGG",2,4,6
"1531","run013","RBR","RGR",1,0,1
"1532","run013","RGG","BBR",1,1,2
"1533","run013","RGR","BBB",2,2,4
"1534","run013","RGR","BBR",1,0,1
"1535","run013","RGR","BGB",2,0,2
"1536","run013","RGR","BGG",2,0,2
"1537","run013","RGR","BRR",1,0,1
"1538","run013","RGR","GGB",2,1,3
"1539","run013","RGR","RGG",1,0,1
"1540","run013","RRG","BBB",2,5,7
"1541","run013","RRG","BGB",1,2,3
"1542","run013","RRG","BRB",2,6,8
"1543","run013","RRG","BRR",1,4,5
"1544","run013","RRG","GGG",2,3,5
"1545","run013","RRG","GRG",1,0,1
"1546","run013","RRG","GRR",3,0,3
"1547","run013","RRG","RBB",1,0,1
"1548","run013","RRR","BBR",1,0,1
"1549","run013","RRR","BGB",2,0,2
"1550","run013","RRR","BGG",1,0,1
"1551","run013","RRR","BRB",1,0,1
"1552","run013","RRR","BRR",1,0,1
"1553","run013","RRR","RBB",1,0,1
"1554","run013","RRR","RGR",1,1,2
"1555","run013","RRR","RRG",2,0,2
"1556","run013","BBB","BRB",0,1,1
"1557","run013","BBG","BGB",0,1,1
"1558","run013","BBG","RRR",0,1,1
"1559","run013","BRB","BBB",0,4,4
"1560","run013","BRB","BRR",0,1,1
"1561","run013","BRB","RBB",0,1,1
"1562","run013","BRR","BBB",0,3,3
"1563","run013","BRR","RBB",0,1,1
"1564","run013","GBB","GGB",0,3,3
"1565","run013","GBB","GRG",0,2,2
"1566","run013","GBG","BBB",0,1,1
"1567","run013","GBG","GGB",0,1,1
"1568","run013","GBG","RGG",0,1,1
"1569","run013","GGB","BRB",0,1,1
"1570","run013","GGB","GGR",0,1,1
"1571","run013","GGG","BGB",0,1,1
"1572","run013","GGG","BRR",0,1,1
"1573","run013","GGG","RBR",0,3,3
"1574","run013","GGG","RRR",0,1,1
"1575","run013","GRG","BBR",0,1,1
"1576","run013","GRG","BRB",0,1,1
"1577","run013","GRG","GGR",0,1,1
"1578","run013","GRR","BGG",0,1,1
"1579","run013","RBB","GRR",0,1,1
"1580","run013","RBG","BBG",0,1,1
"1581","run013","RBR","BBB",0,2,2
"1582","run013","RBR","BGG",0,1,1
"1583","run013","RBR","GGB",0,3,3
"1584","run013","RBR","RRR",0,1,1
"1585","run013","RGG","BRR",0,1,1
"1586","run013","RGG","GGG",0,1,1
"1587","run013","RGG","GGR",0,1,1
"1588","run013","RGG","GRR",0,1,1
"1589","run013","RGR","RBB",0,1,1
"1590","run014","BBB","GGG",1,1,2
"1591","run014","BBB","RRG",1,1,2
"1592","run014","BBG","BBB",1,1,2
"1593","run014","BBG","BRB",1,6,7
"1594","run014","BBG","GBG",2,0,2
"1595","run014","BBG","GGB",2,3,5
"1596","run014","BBG","GGG",4,4,8
"1597","run014","BBG","GRG",1,3,4
"1598","run014","BBG","RRG",1,0,1
"1599","run014","BGG","RBG",1,0,1
"1600","run014","BGG","RRR",1,0,1
"1601","run014","BRR","BGB",1,0,1
"1602","run014","GBB","BBB",12,7,19
"1603","run014","GBB","BRB",1,3,4
"1604","run014","GBB","BRR",1,0,1
"1605","run014","GBB","GGG",7,10,17
"1606","run014","GBB","GGR",1,1,2
"1607","run014","GBB","RBG",3,1,4
"1608","run014","GBB","RBR",1,0,1
"1609","run014","GBB","RGG",1,0,1
"1610","run014","GBB","RGR",2,1,3
"1611","run014","GBB","RRR",1,2,3
"1612","run014","GBG","BRB",1,1,2
"1613","run014","GBG","BRR",1,0,1
"1614","run014","GBG","GGG",4,2,6
"1615","run014","GBG","RBB",1,0,1
"1616","run014","GBG","RGR",1,0,1
"1617","run014","GBG","RRG",1,1,2
"1618","run014","GGB","BBB",3,0,3
"1619","run014","GGB","BBR",1,2,3
"1620","run014","GGB","BRR",1,3,4
"1621","run014","GGB","GBG",1,0,1
"1622","run014","GGB","GGG",13,8,21
"1623","run014","GGB","RGG",1,0,1
"1624","run014","GGB","RRG",1,0,1
"1625","run014","GGB","RRR",1,2,3
"1626","run014","GGG","BBB",8,3,11
"1627","run014","GGG","BGG",1,2,3
"1628","run014","GGG","BRB",1,1,2
"1629","run014","GGG","GGB",5,1,6
"1630","run014","GGG","GGR",1,3,4
"1631","run014","GGG","RBB",1,1,2
"1632","run014","GGG","RGR",1,2,3
"1633","run014","GGG","RRG",1,4,5
"1634","run014","GGR","BRR",1,0,1
"1635","run014","GGR","GRR",1,0,1
"1636","run014","GRG","BBB",3,2,5
"1637","run014","GRG","GGB",2,2,4
"1638","run014","GRG","GGG",3,1,4
"1639","run014","GRG","RGR",1,1,2
"1640","run014","GRG","RRG",2,1,3
"1641","run014","GRR","BGB",1,0,1
"1642","run014","RBG","BBB",2,2,4
"1643","run014","RBG","RBB",1,0,1
"1644","run014","RBR","BGB",2,1,3
"1645","run014","RBR","BRB",1,0,1
"1646","run014","RBR","BRR",1,0,1
"1647","run014","RBR","GRR",4,1,5
"1648","run014","RBR","RGG",2,0,2
"1649","run014","RBR","RGR",1,0,1
"1650","run014","RGG","BBR",1,0,1
"1651","run014","RGR","BBB",2,1,3
"1652","run014","RGR","BBR",1,0,1
"1653","run014","RGR","BGB",2,0,2
"1654","run014","RGR","BGG",2,0,2
"1655","run014","RGR","BRR",1,0,1
"1656","run014","RGR","GGB",2,2,4
"1657","run014","RGR","RGG",1,0,1
"1658","run014","RRG","BBB",2,5,7
"1659","run014","RRG","BGB",1,3,4
"1660","run014","RRG","BRB",2,3,5
"1661","run014","RRG","BRR",1,1,2
"1662","run014","RRG","GGG",2,0,2
"1663","run014","RRG","GRG",1,0,1
"1664","run014","RRG","GRR",3,3,6
"1665","run014","RRG","RBB",1,0,1
"1666","run014","RRR","BBR",1,0,1
"1667","run014","RRR","BGB",2,1,3
"1668","run014","RRR","BGG",1,0,1
"1669","run014","RRR","BRB",1,0,1
"1670","run014","RRR","BRR",1,0,1
"1671","run014","RRR","RBB",1,0,1
"1672","run014","RRR","RGR",1,1,2
"1673","run014","RRR","RRG",2,0,2
"1674","run014","BBG","RBG",0,1,1
"1675","run014","BBG","RRR",0,1,1
"1676","run014","BGB","RRG",0,1,1
"1677","run014","BGG","BBB",0,1,1
"1678","run014","BRB","BBB",0,4,4
"1679","run014","BRB","RBB",0,1,1
"1680","run014","BRR","BBB",0,2,2
"1681","run014","GBB","GGB",0,2,2
"1682","run014","GBB","GRG",0,1,1
"1683","run014","GBB","GRR",0,1,1
"1684","run014","GGB","BGB",0,1,1
"1685","run014","GGB","GGR",0,1,1
"1686","run014","GGB","RGR",0,1,1
"1687","run014","GGG","GRR",0,1,1
"1688","run014","GGG","RBR",0,5,5
"1689","run014","GGR","BBB",0,2,2
"1690","run014","GGR","BBR",0,1,1
"1691","run014","GRG","BRB",0,2,2
"1692","run014","GRG","RBR",0,1,1
"1693","run014","GRR","BGG",0,1,1
"1694","run014","GRR","GGR",0,1,1
"1695","run014","RBB","BBB",0,1,1
"1696","run014","RBG","RGR",0,1,1
"1697","run014","RBR","BBB",0,2,2
"1698","run014","RBR","GGB",0,3,3
"1699","run014","RGG","BBB",0,4,4
"1700","run014","RGG","GGG",0,1,1
"1701","run014","RGG","GRR",0,1,1
"1702","run014","RRG","BBR",0,1,1
"1703","run014","RRG","GGR",0,1,1
"1704","run014","RRR","GRR",0,2,2
"1705","run015","BBB","GGG",1,1,2
"1706","run015","BBB","RRG",1,0,1
"1707","run015","BBG","BBB",1,1,2
"1708","run015","BBG","BRB",1,2,3
"1709","run015","BBG","GBG",2,2,4
"1710","run015","BBG","GGB",2,5,7
"1711","run015","BBG","GGG",4,5,9
"1712","run015","BBG","GRG",1,0,1
"1713","run015","BBG","RRG",1,1,2
"1714","run015","BGG","RBG",1,0,1
"1715","run015","BGG","RRR",1,0,1
"1716","run015","BRR","BGB",1,0,1
"1717","run015","GBB","BBB",12,5,17
"1718","run015","GBB","BRB",1,3,4
"1719","run015","GBB","BRR",1,0,1
"1720","run015","GBB","GGG",7,12,19
"1721","run015","GBB","GGR",1,0,1
"1722","run015","GBB","RBG",3,1,4
"1723","run015","GBB","RBR",1,0,1
"1724","run015","GBB","RGG",1,0,1
"1725","run015","GBB","RGR",2,0,2
"1726","run015","GBB","RRR",1,0,1
"1727","run015","GBG","BRB",1,0,1
"1728","run015","GBG","BRR",1,0,1
"1729","run015","GBG","GGG",4,2,6
"1730","run015","GBG","RBB",1,0,1
"1731","run015","GBG","RGR",1,0,1
"1732","run015","GBG","RRG",1,0,1
"1733","run015","GGB","BBB",3,2,5
"1734","run015","GGB","BBR",1,1,2
"1735","run015","GGB","BRR",1,1,2
"1736","run015","GGB","GBG",1,0,1
"1737","run015","GGB","GGG",13,8,21
"1738","run015","GGB","RGG",1,1,2
"1739","run015","GGB","RRG",1,0,1
"1740","run015","GGB","RRR",1,0,1
"1741","run015","GGG","BBB",8,5,13
"1742","run015","GGG","BGG",1,1,2
"1743","run015","GGG","BRB",1,0,1
"1744","run015","GGG","GGB",5,0,5
"1745","run015","GGG","GGR",1,1,2
"1746","run015","GGG","RBB",1,1,2
"1747","run015","GGG","RGR",1,3,4
"1748","run015","GGG","RRG",1,3,4
"1749","run015","GGR","BRR",1,0,1
"1750","run015","GGR","GRR",1,0,1
"1751","run015","GRG","BBB",3,2,5
"1752","run015","GRG","GGB",2,2,4
"1753","run015","GRG","GGG",3,3,6
"1754","run015","GRG","RGR",1,1,2
"1755","run015","GRG","RRG",2,1,3
"1756","run015","GRR","BGB",1,0,1
"1757","run015","RBG","BBB",2,0,2
"1758","run015","RBG","RBB",1,0,1
"1759","run015","RBR","BGB",2,1,3
"1760","run015","RBR","BRB",1,0,1
"1761","run015","RBR","BRR",1,0,1
"1762","run015","RBR","GRR",4,0,4
"1763","run015","RBR","RGG",2,0,2
"1764","run015","RBR","RGR",1,0,1
"1765","run015","RGG","BBR",1,1,2
"1766","run015","RGR","BBB",2,2,4
"1767","run015","RGR","BBR",1,0,1
"1768","run015","RGR","BGB",2,2,4
"1769","run015","RGR","BGG",2,0,2
"1770","run015","RGR","BRR",1,3,4
"1771","run015","RGR","GGB",2,2,4
"1772","run015","RGR","RGG",1,0,1
"1773","run015","RRG","BBB",2,6,8
"1774","run015","RRG","BGB",1,0,1
"1775","run015","RRG","BRB",2,4,6
"1776","run015","RRG","BRR",1,1,2
"1777","run015","RRG","GGG",2,3,5
"1778","run015","RRG","GRG",1,0,1
"1779","run015","RRG","GRR",3,0,3
"1780","run015","RRG","RBB",1,1,2
"1781","run015","RRR","BBR",1,0,1
"1782","run015","RRR","BGB",2,0,2
"1783","run015","RRR","BGG",1,0,1
"1784","run015","RRR","BRB",1,0,1
"1785","run015","RRR","BRR",1,0,1
"1786","run015","RRR","RBB",1,0,1
"1787","run015","RRR","RGR",1,1,2
"1788","run015","RRR","RRG",2,0,2
"1789","run015","BBG","RBG",0,1,1
"1790","run015","BBG","RRR",0,2,2
"1791","run015","BGB","BBB",0,1,1
"1792","run015","BRB","BBB",0,1,1
"1793","run015","BRB","RBG",0,1,1
"1794","run015","BRR","BBB",0,2,2
"1795","run015","GBB","GBG",0,1,1
"1796","run015","GBB","GGB",0,3,3
"1797","run015","GBB","GRG",0,1,1
"1798","run015","GBG","BBB",0,1,1
"1799","run015","GBG","BBR",0,1,1
"1800","run015","GBG","GGB",0,2,2
"1801","run015","GBG","RGG",0,1,1
"1802","run015","GGB","BRB",0,1,1
"1803","run015","GGB","GGR",0,1,1
"1804","run015","GGB","GRR",0,1,1
"1805","run015","GGB","RBG",0,1,1
"1806","run015","GGB","RBR",0,3,3
"1807","run015","GGG","RBG",0,1,1
"1808","run015","GGG","RBR",0,3,3
"1809","run015","GGG","RRR",0,1,1
"1810","run015","GGR","BBB",0,1,1
"1811","run015","GRR","BBR",0,1,1
"1812","run015","GRR","BGG",0,1,1
"1813","run015","GRR","GGG",0,1,1
"1814","run015","RBB","BRB",0,1,1
"1815","run015","RBB","GRR",0,1,1
"1816","run015","RBG","GBB",0,1,1
"1817","run015","RBR","BBB",0,4,4
"1818","run015","RBR","GGB",0,4,4
"1819","run015","RBR","RBB",0,1,1
"1820","run015","RGG","BBB",0,2,2
"1821","run015","RGG","BGB",0,1,1
"1822","run015","RGG","BRR",0,1,1
"1823","run015","RGG","GGR",0,2,2
"1824","run015","RGG","GRR",0,1,1
"1825","run015","RGR","GGR",0,1,1
"1826","run015","RRG","BBR",0,1,1
"1827","run015","RRG","BGG",0,1,1
"1828","run015","RRR","RBR",0,1,1
"1829","run016","BBB","GGG",1,0,1
"1830","run016","BBB","RRG",1,0,1
"1831","run016","BBG","BBB",1,0,1
"1832","run016","BBG","BRB",1,2,3
"1833","run016","BBG","GBG",2,1,3
"1834","run016","BBG","GGB",2,3,5
"1835","run016","BBG","GGG",4,8,12
"1836","run016","BBG","GRG",1,2,3
"1837","run016","BBG","RRG",1,0,1
"1838","run016","BGG","RBG",1,0,1
"1839","run016","BGG","RRR",1,0,1
"1840","run016","BRR","BGB",1,1,2
"1841","run016","GBB","BBB",12,6,18
"1842","run016","GBB","BRB",1,1,2
"1843","run016","GBB","BRR",1,0,1
"1844","run016","GBB","GGG",7,11,18
"1845","run016","GBB","GGR",1,0,1
"1846","run016","GBB","RBG",3,2,5
"1847","run016","GBB","RBR",1,0,1
"1848","run016","GBB","RGG",1,0,1
"1849","run016","GBB","RGR",2,0,2
"1850","run016","GBB","RRR",1,1,2
"1851","run016","GBG","BRB",1,0,1
"1852","run016","GBG","BRR",1,0,1
"1853","run016","GBG","GGG",4,1,5
"1854","run016","GBG","RBB",1,0,1
"1855","run016","GBG","RGR",1,1,2
"1856","run016","GBG","RRG",1,1,2
"1857","run016","GGB","BBB",3,0,3
"1858","run016","GGB","BBR",1,2,3
"1859","run016","GGB","BRR",1,3,4
"1860","run016","GGB","GBG",1,0,1
"1861","run016","GGB","GGG",13,7,20
"1862","run016","GGB","RGG",1,0,1
"1863","run016","GGB","RRG",1,1,2
"1864","run016","GGB","RRR",1,0,1
"1865","run016","GGG","BBB",8,6,14
"1866","run016","GGG","BGG",1,0,1
"1867","run016","GGG","BRB",1,0,1
"1868","run016","GGG","GGB",5,1,6
"1869","run016","GGG","GGR",1,3,4
"1870","run016","GGG","RBB",1,3,4
"1871","run016","GGG","RGR",1,3,4
"1872","run016","GGG","RRG",1,3,4
"1873","run016","GGR","BRR",1,0,1
"1874","run016","GGR","GRR",1,0,1
"1875","run016","GRG","BBB",3,3,6
"1876","run016","GRG","GGB",2,2,4
"1877","run016","GRG","GGG",3,3,6
"1878","run016","GRG","RGR",1,0,1
"1879","run016","GRG","RRG",2,1,3
"1880","run016","GRR","BGB",1,0,1
"1881","run016","RBG","BBB",2,2,4
"1882","run016","RBG","RBB",1,0,1
"1883","run016","RBR","BGB",2,1,3
"1884","run016","RBR","BRB",1,0,1
"1885","run016","RBR","BRR",1,0,1
"1886","run016","RBR","GRR",4,0,4
"1887","run016","RBR","RGG",2,5,7
"1888","run016","RBR","RGR",1,0,1
"1889","run016","RGG","BBR",1,0,1
"1890","run016","RGR","BBB",2,1,3
"1891","run016","RGR","BBR",1,1,2
"1892","run016","RGR","BGB",2,2,4
"1893","run016","RGR","BGG",2,0,2
"1894","run016","RGR","BRR",1,3,4
"1895","run016","RGR","GGB",2,2,4
"1896","run016","RGR","RGG",1,1,2
"1897","run016","RRG","BBB",2,4,6
"1898","run016","RRG","BGB",1,1,2
"1899","run016","RRG","BRB",2,6,8
"1900","run016","RRG","BRR",1,2,3
"1901","run016","RRG","GGG",2,4,6
"1902","run016","RRG","GRG",1,0,1
"1903","run016","RRG","GRR",3,1,4
"1904","run016","RRG","RBB",1,0,1
"1905","run016","RRR","BBR",1,0,1
"1906","run016","RRR","BGB",2,0,2
"1907","run016","RRR","BGG",1,0,1
"1908","run016","RRR","BRB",1,1,2
"1909","run016","RRR","BRR",1,1,2
"1910","run016","RRR","RBB",1,0,1
"1911","run016","RRR","RGR",1,0,1
"1912","run016","RRR","RRG",2,2,4
"1913","run016","BBG","RRR",0,2,2
"1914","run016","BGB","BBB",0,1,1
"1915","run016","BGG","RGR",0,1,1
"1916","run016","BRB","BBB",0,1,1
"1917","run016","BRB","GGG",0,1,1
"1918","run016","BRB","RGR",0,1,1
"1919","run016","BRR","BBB",0,1,1
"1920","run016","GBB","GBG",0,1,1
"1921","run016","GBB","GGB",0,4,4
"1922","run016","GBB","GRG",0,1,1
"1923","run016","GBB","GRR",0,1,1
"1924","run016","GBG","BBB",0,1,1
"1925","run016","GGB","BGG",0,1,1
"1926","run016","GGB","GGR",0,1,1
"1927","run016","GGB","GRR",0,1,1
"1928","run016","GGB","RBG",0,1,1
"1929","run016","GGB","RBR",0,1,1
"1930","run016","GGG","BRR",0,1,1
"1931","run016","GGG","RBG",0,1,1
"1932","run016","GGG","RBR",0,1,1
"1933","run016","GRG","GGR",0,1,1
"1934","run016","GRR","BRB",0,1,1
"1935","run016","GRR","BRR",0,1,1
"1936","run016","RBG","GBB",0,1,1
"1937","run016","RBR","BBB",0,2,2
"1938","run016","RGG","BBB",0,2,2
"1939","run016","RGG","GRR",0,1,1
"1940","run016","RGR","GGR",0,1,1
"1941","run016","RGR","RRG",0,3,3
"1942","run016","RRR","RBR",0,1,1
"1943","run017","BBB","GGG",1,0,1
"1944","run017","BBB","RRG",1,1,2
"1945","run017","BBG","BBB",1,0,1
"1946","run017","BBG","BRB",1,4,5
"1947","run017","BBG","GBG",2,3,5
"1948","run017","BBG","GGB",2,2,4
"1949","run017","BBG","GGG",4,3,7
"1950","run017","BBG","GRG",1,1,2
"1951","run017","BBG","RRG",1,0,1
"1952","run017","BGG","RBG",1,0,1
"1953","run017","BGG","RRR",1,0,1
"1954","run017","BRR","BGB",1,0,1
"1955","run017","GBB","BBB",12,6,18
"1956","run017","GBB","BRB",1,1,2
"1957","run017","GBB","BRR",1,0,1
"1958","run017","GBB","GGG",7,13,20
"1959","run017","GBB","GGR",1,0,1
"1960","run017","GBB","RBG",3,1,4
"1961","run017","GBB","RBR",1,0,1
"1962","run017","GBB","RGG",1,0,1
"1963","run017","GBB","RGR",2,0,2
"1964","run017","GBB","RRR",1,0,1
"1965","run017","GBG","BRB",1,0,1
"1966","run017","GBG","BRR",1,0,1
"1967","run017","GBG","GGG",4,1,5
"1968","run017","GBG","RBB",1,0,1
"1969","run017","GBG","RGR",1,0,1
"1970","run017","GBG","RRG",1,2,3
"1971","run017","GGB","BBB",3,3,6
"1972","run017","GGB","BBR",1,1,2
"1973","run017","GGB","BRR",1,1,2
"1974","run017","GGB","GBG",1,0,1
"1975","run017","GGB","GGG",13,7,20
"1976","run017","GGB","RGG",1,1,2
"1977","run017","GGB","RRG",1,2,3
"1978","run017","GGB","RRR",1,0,1
"1979","run017","GGG","BBB",8,6,14
"1980","run017","GGG","BGG",1,1,2
"1981","run017","GGG","BRB",1,0,1
"1982","run017","GGG","GGB",5,1,6
"1983","run017","GGG","GGR",1,1,2
"1984","run017","GGG","RBB",1,2,3
"1985","run017","GGG","RGR",1,2,3
"1986","run017","GGG","RRG",1,3,4
"1987","run017","GGR","BRR",1,0,1
"1988","run017","GGR","GRR",1,0,1
"1989","run017","GRG","BBB",3,1,4
"1990","run017","GRG","GGB",2,4,6
"1991","run017","GRG","GGG",3,4,7
"1992","run017","GRG","RGR",1,0,1
"1993","run017","GRG","RRG",2,0,2
"1994","run017","GRR","BGB",1,0,1
"1995","run017","RBG","BBB",2,1,3
"1996","run017","RBG","RBB",1,0,1
"1997","run017","RBR","BGB",2,0,2
"1998","run017","RBR","BRB",1,0,1
"1999","run017","RBR","BRR",1,1,2
"2000","run017","RBR","GRR",4,0,4
"2001","run017","RBR","RGG",2,1,3
"2002","run017","RBR","RGR",1,0,1
"2003","run017","RGG","BBR",1,0,1
"2004","run017","RGR","BBB",2,1,3
"2005","run017","RGR","BBR",1,0,1
"2006","run017","RGR","BGB",2,1,3
"2007","run017","RGR","BGG",2,0,2
"2008","run017","RGR","BRR",1,0,1
"2009","run017","RGR","GGB",2,2,4
"2010","run017","RGR","RGG",1,0,1
"2011","run017","RRG","BBB",2,10,12
"2012","run017","RRG","BGB",1,2,3
"2013","run017","RRG","BRB",2,7,9
"2014","run017","RRG","BRR",1,3,4
"2015","run017","RRG","GGG",2,0,2
"2016","run017","RRG","GRG",1,0,1
"2017","run017","RRG","GRR",3,1,4
"2018","run017","RRG","RBB",1,0,1
"2019","run017","RRR","BBR",1,0,1
"2020","run017","RRR","BGB",2,0,2
"2021","run017","RRR","BGG",1,0,1
"2022","run017","RRR","BRB",1,0,1
"2023","run017","RRR","BRR",1,0,1
"2024","run017","RRR","RBB",1,0,1
"2025","run017","RRR","RGR",1,1,2
"2026","run017","RRR","RRG",2,0,2
"2027","run017","BBG","BGG",0,1,1
"2028","run017","BBG","GBB",0,1,1
"2029","run017","BBG","RBG",0,1,1
"2030","run017","BGG","BBB",0,1,1
"2031","run017","BGG","BBR",0,1,1
"2032","run017","BRB","BBB",0,2,2
"2033","run017","BRB","BRR",0,1,1
"2034","run017","BRB","GGR",0,1,1
"2035","run017","BRR","BBB",0,4,4
"2036","run017","BRR","RBB",0,1,1
"2037","run017","GBB","GGB",0,2,2
"2038","run017","GBB","GRG",0,3,3
"2039","run017","GBB","RBB",0,1,1
"2040","run017","GBG","BBB",0,3,3
"2041","run017","GBG","RBG",0,1,1
"2042","run017","GGB","GBB",0,1,1
"2043","run017","GGB","GGR",0,3,3
"2044","run017","GGB","RBG",0,2,2
"2045","run017","GGB","RBR",0,1,1
"2046","run017","GGG","BGB",0,1,1
"2047","run017","GGG","RBR",0,2,2
"2048","run017","GGG","RGG",0,1,1
"2049","run017","GGR","BGG",0,1,1
"2050","run017","GRG","GBG",0,1,1
"2051","run017","GRG","GGR",0,2,2
"2052","run017","GRR","BRR",0,2,2
"2053","run017","RBG","GBB",0,1,1
"2054","run017","RBG","GRR",0,1,1
"2055","run017","RBR","BBB",0,1,1
"2056","run017","RGG","GRR",0,3,3
"2057","run017","RGR","RBB",0,1,1
"2058","run017","RRG","BGG",0,2,2
"2059","run017","RRR","RBR",0,1,1
"2060","run018","BBB","GGG",1,2,3
"2061","run018","BBB","RRG",1,0,1
"2062","run018","BBG","BBB",1,1,2
"2063","run018","BBG","BRB",1,1,2
"2064","run018","BBG","GBG",2,0,2
"2065","run018","BBG","GGB",2,6,8
"2066","run018","BBG","GGG",4,6,10
"2067","run018","BBG","GRG",1,3,4
"2068","run018","BBG","RRG",1,0,1
"2069","run018","BGG","RBG",1,0,1
"2070","run018","BGG","RRR",1,0,1
"2071","run018","BRR","BGB",1,0,1
"2072","run018","GBB","BBB",12,2,14
"2073","run018","GBB","BRB",1,3,4
"2074","run018","GBB","BRR",1,0,1
"2075","run018","GBB","GGG",7,15,22
"2076","run018","GBB","GGR",1,0,1
"2077","run018","GBB","RBG",3,0,3
"2078","run018","GBB","RBR",1,0,1
"2079","run018","GBB","RGG",1,0,1
"2080","run018","GBB","RGR",2,1,3
"2081","run018","GBB","RRR",1,2,3
"2082","run018","GBG","BRB",1,0,1
"2083","run018","GBG","BRR",1,0,1
"2084","run018","GBG","GGG",4,3,7
"2085","run018","GBG","RBB",1,0,1
"2086","run018","GBG","RGR",1,0,1
"2087","run018","GBG","RRG",1,0,1
"2088","run018","GGB","BBB",3,2,5
"2089","run018","GGB","BBR",1,1,2
"2090","run018","GGB","BRR",1,1,2
"2091","run018","GGB","GBG",1,0,1
"2092","run018","GGB","GGG",13,7,20
"2093","run018","GGB","RGG",1,1,2
"2094","run018","GGB","RRG",1,3,4
"2095","run018","GGB","RRR",1,1,2
"2096","run018","GGG","BBB",8,2,10
"2097","run018","GGG","BGG",1,0,1
"2098","run018","GGG","BRB",1,1,2
"2099","run018","GGG","GGB",5,0,5
"2100","run018","GGG","GGR",1,2,3
"2101","run018","GGG","RBB",1,2,3
"2102","run018","GGG","RGR",1,2,3
"2103","run018","GGG","RRG",1,1,2
"2104","run018","GGR","BRR",1,0,1
"2105","run018","GGR","GRR",1,0,1
"2106","run018","GRG","BBB",3,0,3
"2107","run018","GRG","GGB",2,1,3
"2108","run018","GRG","GGG",3,1,4
"2109","run018","GRG","RGR",1,0,1
"2110","run018","GRG","RRG",2,0,2
"2111","run018","GRR","BGB",1,0,1
"2112","run018","RBG","BBB",2,3,5
"2113","run018","RBG","RBB",1,0,1
"2114","run018","RBR","BGB",2,1,3
"2115","run018","RBR","BRB",1,0,1
"2116","run018","RBR","BRR",1,0,1
"2117","run018","RBR","GRR",4,0,4
"2118","run018","RBR","RGG",2,1,3
"2119","run018","RBR","RGR",1,0,1
"2120","run018","RGG","BBR",1,1,2
"2121","run018","RGR","BBB",2,2,4
"2122","run018","RGR","BBR",1,0,1
"2123","run018","RGR","BGB",2,0,2
"2124","run018","RGR","BGG",2,0,2
"2125","run018","RGR","BRR",1,1,2
"2126","run018","RGR","GGB",2,1,3
"2127","run018","RGR","RGG",1,0,1
"2128","run018","RRG","BBB",2,6,8
"2129","run018","RRG","BGB",1,2,3
"2130","run018","RRG","BRB",2,4,6
"2131","run018","RRG","BRR",1,3,4
"2132","run018","RRG","GGG",2,2,4
"2133","run018","RRG","GRG",1,0,1
"2134","run018","RRG","GRR",3,2,5
"2135","run018","RRG","RBB",1,0,1
"2136","run018","RRR","BBR",1,0,1
"2137","run018","RRR","BGB",2,1,3
"2138","run018","RRR","BGG",1,0,1
"2139","run018","RRR","BRB",1,0,1
"2140","run018","RRR","BRR",1,0,1
"2141","run018","RRR","RBB",1,0,1
"2142","run018","RRR","RGR",1,0,1
"2143","run018","RRR","RRG",2,0,2
"2144","run018","BBB","GRR",0,1,1
"2145","run018","BBB","RRR",0,1,1
"2146","run018","BBG","RBG",0,1,1
"2147","run018","BBG","RRR",0,2,2
"2148","run018","BGB","BBB",0,1,1
"2149","run018","BGG","BBB",0,1,1
"2150","run018","BGG","BBR",0,1,1
"2151","run018","BGG","GRG",0,1,1
"2152","run018","BGG","RGR",0,1,1
"2153","run018","BRB","BRR",0,1,1
"2154","run018","BRR","BBB",0,2,2
"2155","run018","BRR","BRB",0,1,1
"2156","run018","BRR","RBB",0,1,1
"2157","run018","GBB","GGB",0,5,5
"2158","run018","GBB","RBB",0,1,1
"2159","run018","GBG","BBB",0,1,1
"2160","run018","GBG","GGB",0,1,1
"2161","run018","GGB","BGG",0,1,1
"2162","run018","GGB","RBB",0,1,1
"2163","run018","GGB","RBR",0,2,2
"2164","run018","GGG","BRR",0,2,2
"2165","run018","GGG","RBG",0,2,2
"2166","run018","GGG","RBR",0,1,1
"2167","run018","GGG","RGG",0,1,1
"2168","run018","GGR","BBB",0,1,1
"2169","run018","GRG","BRB",0,2,2
"2170","run018","RBB","BBB",0,1,1
"2171","run018","RBR","BBB",0,4,4
"2172","run018","RBR","GGB",0,3,3
"2173","run018","RGG","BBB",0,2,2
"2174","run018","RGG","BGB",0,1,1
"2175","run018","RGG","GGR",0,1,1
"2176","run018","RGR","GGG",0,2,2
"2177","run018","RGR","RBB",0,1,1
"2178","run018","RRG","BBR",0,2,2
"2179","run018","RRG","BGG",0,2,2
"2180","run018","RRG","GGR",0,1,1
"2181","run018","RRG","RGG",0,1,1
"2182","run019","BBB","GGG",1,0,1
"2183","run019","BBB","RRG",1,1,2
"2184","run019","BBG","BBB",1,0,1
"2185","run019","BBG","BRB",1,2,3
"2186","run019","BBG","GBG",2,2,4
"2187","run019","BBG","GGB",2,3,5
"2188","run019","BBG","GGG",4,4,8
"2189","run019","BBG","GRG",1,1,2
"2190","run019","BBG","RRG",1,0,1
"2191","run019","BGG","RBG",1,0,1
"2192","run019","BGG","RRR",1,1,2
"2193","run019","BRR","BGB",1,0,1
"2194","run019","GBB","BBB",12,6,18
"2195","run019","GBB","BRB",1,2,3
"2196","run019","GBB","BRR",1,0,1
"2197","run019","GBB","GGG",7,9,16
"2198","run019","GBB","GGR",1,1,2
"2199","run019","GBB","RBG",3,1,4
"2200","run019","GBB","RBR",1,0,1
"2201","run019","GBB","RGG",1,0,1
"2202","run019","GBB","RGR",2,0,2
"2203","run019","GBB","RRR",1,3,4
"2204","run019","GBG","BRB",1,0,1
"2205","run019","GBG","BRR",1,0,1
"2206","run019","GBG","GGG",4,2,6
"2207","run019","GBG","RBB",1,0,1
"2208","run019","GBG","RGR",1,2,3
"2209","run019","GBG","RRG",1,1,2
"2210","run019","GGB","BBB",3,2,5
"2211","run019","GGB","BBR",1,0,1
"2212","run019","GGB","BRR",1,0,1
"2213","run019","GGB","GBG",1,0,1
"2214","run019","GGB","GGG",13,9,22
"2215","run019","GGB","RGG",1,1,2
"2216","run019","GGB","RRG",1,1,2
"2217","run019","GGB","RRR",1,1,2
"2218","run019","GGG","BBB",8,2,10
"2219","run019","GGG","BGG",1,1,2
"2220","run019","GGG","BRB",1,0,1
"2221","run019","GGG","GGB",5,0,5
"2222","run019","GGG","GGR",1,1,2
"2223","run019","GGG","RBB",1,0,1
"2224","run019","GGG","RGR",1,1,2
"2225","run019","GGG","RRG",1,3,4
"2226","run019","GGR","BRR",1,0,1
"2227","run019","GGR","GRR",1,0,1
"2228","run019","GRG","BBB",3,1,4
"2229","run019","GRG","GGB",2,1,3
"2230","run019","GRG","GGG",3,4,7
"2231","run019","GRG","RGR",1,0,1
"2232","run019","GRG","RRG",2,0,2
"2233","run019","GRR","BGB",1,0,1
"2234","run019","RBG","BBB",2,0,2
"2235","run019","RBG","RBB",1,1,2
"2236","run019","RBR","BGB",2,1,3
"2237","run019","RBR","BRB",1,0,1
"2238","run019","RBR","BRR",1,2,3
"2239","run019","RBR","GRR",4,0,4
"2240","run019","RBR","RGG",2,2,4
"2241","run019","RBR","RGR",1,0,1
"2242","run019","RGG","BBR",1,0,1
"2243","run019","RGR","BBB",2,0,2
"2244","run019","RGR","BBR",1,0,1
"2245","run019","RGR","BGB",2,0,2
"2246","run019","RGR","BGG",2,1,3
"2247","run019","RGR","BRR",1,1,2
"2248","run019","RGR","GGB",2,5,7
"2249","run019","RGR","RGG",1,0,1
"2250","run019","RRG","BBB",2,7,9
"2251","run019","RRG","BGB",1,0,1
"2252","run019","RRG","BRB",2,7,9
"2253","run019","RRG","BRR",1,3,4
"2254","run019","RRG","GGG",2,5,7
"2255","run019","RRG","GRG",1,0,1
"2256","run019","RRG","GRR",3,1,4
"2257","run019","RRG","RBB",1,0,1
"2258","run019","RRR","BBR",1,0,1
"2259","run019","RRR","BGB",2,0,2
"2260","run019","RRR","BGG",1,0,1
"2261","run019","RRR","BRB",1,0,1
"2262","run019","RRR","BRR",1,0,1
"2263","run019","RRR","RBB",1,0,1
"2264","run019","RRR","RGR",1,0,1
"2265","run019","RRR","RRG",2,0,2
"2266","run019","BBB","GRR",0,1,1
"2267","run019","BBG","RBG",0,1,1
"2268","run019","BGG","BBB",0,1,1
"2269","run019","BGG","RGG",0,2,2
"2270","run019","BRB","BBB",0,1,1
"2271","run019","BRB","BRR",0,1,1
"2272","run019","BRB","GGG",0,1,1
"2273","run019","BRR","BBB",0,1,1
"2274","run019","BRR","RBB",0,1,1
"2275","run019","GBB","GBG",0,1,1
"2276","run019","GBB","GGB",0,4,4
"2277","run019","GBB","GRG",0,2,2
"2278","run019","GBG","RGG",0,1,1
"2279","run019","GGB","BGG",0,2,2
"2280","run019","GGB","GBB",0,1,1
"2281","run019","GGB","GRR",0,1,1
"2282","run019","GGB","RGR",0,1,1
"2283","run019","GGG","BRR",0,2,2
"2284","run019","GGG","RBG",0,1,1
"2285","run019","GGG","RBR",0,3,3
"2286","run019","GGG","RGG",0,2,2
"2287","run019","GGR","BBB",0,1,1
"2288","run019","GRG","GBG",0,1,1
"2289","run019","GRR","GGR",0,1,1
"2290","run019","RBG","GRR",0,2,2
"2291","run019","RBR","BBB",0,2,2
"2292","run019","RBR","GGB",0,1,1
"2293","run019","RBR","RRR",0,1,1
"2294","run019","RGG","BBB",0,4,4
"2295","run019","RGG","GGG",0,1,1
"2296","run019","RGG","GRR",0,1,1
"2297","run019","RGR","GGG",0,1,1
"2298","run019","RGR","GGR",0,1,1
"2299","run019","RGR","RBB",0,1,1
"2300","run019","RRG","BBR",0,1,1
"2301","run019","RRG","BGG",0,2,2
"2302","run019","RRG","GGR",0,1,1
"2303","run019","RRR","GRR",0,1,1
"2304","run019","RRR","RGG",0,1,1
"2305","run020","BBB","GGG",1,0,1
"2306","run020","BBB","RRG",1,1,2
"2307","run020","BBG","BBB",1,0,1
"2308","run020","BBG","BRB",1,1,2
"2309","run020","BBG","GBG",2,0,2
"2310","run020","BBG","GGB",2,2,4
"2311","run020","BBG","GGG",4,6,10
"2312","run020","BBG","GRG",1,1,2
"2313","run020","BBG","RRG",1,0,1
"2314","run020","BGG","RBG",1,0,1
"2315","run020","BGG","RRR",1,0,1
"2316","run020","BRR","BGB",1,1,2
"2317","run020","GBB","BBB",12,7,19
"2318","run020","GBB","BRB",1,3,4
"2319","run020","GBB","BRR",1,0,1
"2320","run020","GBB","GGG",7,16,23
"2321","run020","GBB","GGR",1,1,2
"2322","run020","GBB","RBG",3,2,5
"2323","run020","GBB","RBR",1,0,1
"2324","run020","GBB","RGG",1,0,1
"2325","run020","GBB","RGR",2,0,2
"2326","run020","GBB","RRR",1,0,1
"2327","run020","GBG","BRB",1,1,2
"2328","run020","GBG","BRR",1,0,1
"2329","run020","GBG","GGG",4,1,5
"2330","run020","GBG","RBB",1,0,1
"2331","run020","GBG","RGR",1,1,2
"2332","run020","GBG","RRG",1,0,1
"2333","run020","GGB","BBB",3,2,5
"2334","run020","GGB","BBR",1,0,1
"2335","run020","GGB","BRR",1,1,2
"2336","run020","GGB","GBG",1,0,1
"2337","run020","GGB","GGG",13,7,20
"2338","run020","GGB","RGG",1,0,1
"2339","run020","GGB","RRG",1,2,3
"2340","run020","GGB","RRR",1,0,1
"2341","run020","GGG","BBB",8,9,17
"2342","run020","GGG","BGG",1,1,2
"2343","run020","GGG","BRB",1,0,1
"2344","run020","GGG","GGB",5,1,6
"2345","run020","GGG","GGR",1,2,3
"2346","run020","GGG","RBB",1,3,4
"2347","run020","GGG","RGR",1,2,3
"2348","run020","GGG","RRG",1,3,4
"2349","run020","GGR","BRR",1,0,1
"2350","run020","GGR","GRR",1,0,1
"2351","run020","GRG","BBB",3,1,4
"2352","run020","GRG","GGB",2,3,5
"2353","run020","GRG","GGG",3,0,3
"2354","run020","GRG","RGR",1,1,2
"2355","run020","GRG","RRG",2,1,3
"2356","run020","GRR","BGB",1,0,1
"2357","run020","RBG","BBB",2,1,3
"2358","run020","RBG","RBB",1,0,1
"2359","run020","RBR","BGB",2,1,3
"2360","run020","RBR","BRB",1,0,1
"2361","run020","RBR","BRR",1,0,1
"2362","run020","RBR","GRR",4,0,4
"2363","run020","RBR","RGG",2,3,5
"2364","run020","RBR","RGR",1,0,1
"2365","run020","RGG","BBR",1,0,1
"2366","run020","RGR","BBB",2,0,2
"2367","run020","RGR","BBR",1,0,1
"2368","run020","RGR","BGB",2,0,2
"2369","run020","RGR","BGG",2,0,2
"2370","run020","RGR","BRR",1,1,2
"2371","run020","RGR","GGB",2,4,6
"2372","run020","RGR","RGG",1,0,1
"2373","run020","RRG","BBB",2,4,6
"2374","run020","RRG","BGB",1,1,2
"2375","run020","RRG","BRB",2,5,7
"2376","run020","RRG","BRR",1,3,4
"2377","run020","RRG","GGG",2,1,3
"2378","run020","RRG","GRG",1,0,1
"2379","run020","RRG","GRR",3,1,4
"2380","run020","RRG","RBB",1,0,1
"2381","run020","RRR","BBR",1,0,1
"2382","run020","RRR","BGB",2,0,2
"2383","run020","RRR","BGG",1,0,1
"2384","run020","RRR","BRB",1,0,1
"2385","run020","RRR","BRR",1,1,2
"2386","run020","RRR","RBB",1,1,2
"2387","run020","RRR","RGR",1,0,1
"2388","run020","RRR","RRG",2,0,2
"2389","run020","BBB","GRR",0,1,1
"2390","run020","BBB","RBG",0,1,1
"2391","run020","BBG","RRR",0,3,3
"2392","run020","BRB","BBB",0,2,2
"2393","run020","BRB","RBG",0,1,1
"2394","run020","BRR","BBB",0,3,3
"2395","run020","GBB","GBG",0,1,1
"2396","run020","GBB","GGB",0,2,2
"2397","run020","GBB","GRG",0,1,1
"2398","run020","GBG","BBB",0,2,2
"2399","run020","GGB","BRB",0,1,1
"2400","run020","GGB","GGR",0,1,1
"2401","run020","GGB","RBR",0,2,2
"2402","run020","GGB","RGR",0,1,1
"2403","run020","GGG","BRR",0,1,1
"2404","run020","GGG","GRR",0,1,1
"2405","run020","GGG","RBG",0,1,1
"2406","run020","GGG","RBR",0,7,7
"2407","run020","GRG","GRR",0,1,1
"2408","run020","GRR","BGG",0,1,1
"2409","run020","GRR","BRB",0,1,1
"2410","run020","GRR","BRR",0,1,1
"2411","run020","RBR","BBB",0,4,4
"2412","run020","RBR","GGB",0,1,1
"2413","run020","RBR","RBB",0,1,1
"2414","run020","RBR","RRR",0,1,1
"2415","run020","RGG","BRR",0,1,1
"2416","run020","RGG","GRR",0,2,2
"2417","run020","RGR","GGR",0,1,1
"2418","run020","RGR","RBB",0,2,2
"2419","run020","RRR","GRR",0,1,1
"2420","run021","BBB","GGG",1,0,1
"2421","run021","BBB","RRG",1,0,1
"2422","run021","BBG","BBB",1,2,3
"2423","run021","BBG","BRB",1,3,4
"2424","run021","BBG","GBG",2,1,3
"2425","run021","BBG","GGB",2,2,4
"2426","run021","BBG","GGG",4,4,8
"2427","run021","BBG","GRG",1,0,1
"2428","run021","BBG","RRG",1,0,1
"2429","run021","BGG","RBG",1,0,1
"2430","run021","BGG","RRR",1,1,2
"2431","run021","BRR","BGB",1,1,2
"2432","run021","GBB","BBB",12,8,20
"2433","run021","GBB","BRB",1,0,1
"2434","run021","GBB","BRR",1,1,2
"2435","run021","GBB","GGG",7,13,20
"2436","run021","GBB","GGR",1,1,2
"2437","run021","GBB","RBG",3,1,4
"2438","run021","GBB","RBR",1,0,1
"2439","run021","GBB","RGG",1,0,1
"2440","run021","GBB","RGR",2,1,3
"2441","run021","GBB","RRR",1,1,2
"2442","run021","GBG","BRB",1,0,1
"2443","run021","GBG","BRR",1,0,1
"2444","run021","GBG","GGG",4,2,6
"2445","run021","GBG","RBB",1,0,1
"2446","run021","GBG","RGR",1,0,1
"2447","run021","GBG","RRG",1,0,1
"2448","run021","GGB","BBB",3,1,4
"2449","run021","GGB","BBR",1,1,2
"2450","run021","GGB","BRR",1,1,2
"2451","run021","GGB","GBG",1,0,1
"2452","run021","GGB","GGG",13,8,21
"2453","run021","GGB","RGG",1,1,2
"2454","run021","GGB","RRG",1,0,1
"2455","run021","GGB","RRR",1,1,2
"2456","run021","GGG","BBB",8,4,12
"2457","run021","GGG","BGG",1,0,1
"2458","run021","GGG","BRB",1,0,1
"2459","run021","GGG","GGB",5,0,5
"2460","run021","GGG","GGR",1,3,4
"2461","run021","GGG","RBB",1,1,2
"2462","run021","GGG","RGR",1,1,2
"2463","run021","GGG","RRG",1,4,5
"2464","run021","GGR","BRR",1,0,1
"2465","run021","GGR","GRR",1,0,1
"2466","run021","GRG","BBB",3,1,4
"2467","run021","GRG","GGB",2,2,4
"2468","run021","GRG","GGG",3,2,5
"2469","run021","GRG","RGR",1,0,1
"2470","run021","GRG","RRG",2,1,3
"2471","run021","GRR","BGB",1,0,1
"2472","run021","RBG","BBB",2,0,2
"2473","run021","RBG","RBB",1,0,1
"2474","run021","RBR","BGB",2,1,3
"2475","run021","RBR","BRB",1,0,1
"2476","run021","RBR","BRR",1,1,2
"2477","run021","RBR","GRR",4,0,4
"2478","run021","RBR","RGG",2,2,4
"2479","run021","RBR","RGR",1,0,1
"2480","run021","RGG","BBR",1,1,2
"2481","run021","RGR","BBB",2,0,2
"2482","run021","RGR","BBR",1,0,1
"2483","run021","RGR","BGB",2,1,3
"2484","run021","RGR","BGG",2,0,2
"2485","run021","RGR","BRR",1,1,2
"2486","run021","RGR","GGB",2,1,3
"2487","run021","RGR","RGG",1,0,1
"2488","run021","RRG","BBB",2,7,9
"2489","run021","RRG","BGB",1,4,5
"2490","run021","RRG","BRB",2,5,7
"2491","run021","RRG","BRR",1,2,3
"2492","run021","RRG","GGG",2,0,2
"2493","run021","RRG","GRG",1,0,1
"2494","run021","RRG","GRR",3,2,5
"2495","run021","RRG","RBB",1,0,1
"2496","run021","RRR","BBR",1,0,1
"2497","run021","RRR","BGB",2,0,2
"2498","run021","RRR","BGG",1,0,1
"2499","run021","RRR","BRB",1,1,2
"2500","run021","RRR","BRR",1,0,1
"2501","run021","RRR","RBB",1,0,1
"2502","run021","RRR","RGR",1,1,2
"2503","run021","RRR","RRG",2,0,2
"2504","run021","BBB","GRR",0,2,2
"2505","run021","BBG","RBG",0,1,1
"2506","run021","BBG","RBR",0,1,1
"2507","run021","BBG","RRR",0,2,2
"2508","run021","BGB","RRG",0,1,1
"2509","run021","BGG","BBR",0,1,1
"2510","run021","BGG","GRG",0,1,1
"2511","run021","BGG","RGG",0,1,1
"2512","run021","BGG","RGR",0,1,1
"2513","run021","BRB","BBB",0,3,3
"2514","run021","BRB","GGG",0,1,1
"2515","run021","BRR","BBB",0,4,4
"2516","run021","BRR","RBB",0,1,1
"2517","run021","GBB","GBG",0,1,1
"2518","run021","GBB","GGB",0,4,4
"2519","run021","GBB","RBB",0,1,1
"2520","run021","GBG","RGG",0,1,1
"2521","run021","GGB","BRB",0,1,1
"2522","run021","GGB","GBB",0,1,1
"2523","run021","GGB","RBB",0,1,1
"2524","run021","GGG","BGB",0,1,1
"2525","run021","GGG","RBR",0,1,1
"2526","run021","GGG","RGG",0,1,1
"2527","run021","GRG","GGR",0,4,4
"2528","run021","GRG","RBG",0,1,1
"2529","run021","GRR","BGG",0,1,1
"2530","run021","GRR","BRR",0,1,1
"2531","run021","RBB","BBR",0,1,1
"2532","run021","RBG","BRR",0,1,1
"2533","run021","RBG","GRR",0,2,2
"2534","run021","RBR","GGB",0,3,3
"2535","run021","RBR","RBB",0,1,1
"2536","run021","RGG","BBB",0,2,2
"2537","run021","RGG","BRR",0,1,1
"2538","run021","RGG","RBB",0,1,1
"2539","run021","RGR","RBB",0,1,1
"2540","run021","RGR","RRG",0,1,1
"2541","run021","RRG","BBR",0,2,2
"2542","run022","BBB","GGG",1,1,2
"2543","run022","BBB","RRG",1,0,1
"2544","run022","BBG","BBB",1,0,1
"2545","run022","BBG","BRB",1,1,2
"2546","run022","BBG","GBG",2,3,5
"2547","run022","BBG","GGB",2,1,3
"2548","run022","BBG","GGG",4,3,7
"2549","run022","BBG","GRG",1,1,2
"2550","run022","BBG","RRG",1,1,2
"2551","run022","BGG","RBG",1,0,1
"2552","run022","BGG","RRR",1,0,1
"2553","run022","BRR","BGB",1,1,2
"2554","run022","GBB","BBB",12,6,18
"2555","run022","GBB","BRB",1,2,3
"2556","run022","GBB","BRR",1,0,1
"2557","run022","GBB","GGG",7,9,16
"2558","run022","GBB","GGR",1,0,1
"2559","run022","GBB","RBG",3,1,4
"2560","run022","GBB","RBR",1,0,1
"2561","run022","GBB","RGG",1,0,1
"2562","run022","GBB","RGR",2,1,3
"2563","run022","GBB","RRR",1,1,2
"2564","run022","GBG","BRB",1,1,2
"2565","run022","GBG","BRR",1,0,1
"2566","run022","GBG","GGG",4,3,7
"2567","run022","GBG","RBB",1,0,1
"2568","run022","GBG","RGR",1,1,2
"2569","run022","GBG","RRG",1,0,1
"2570","run022","GGB","BBB",3,0,3
"2571","run022","GGB","BBR",1,0,1
"2572","run022","GGB","BRR",1,4,5
"2573","run022","GGB","GBG",1,0,1
"2574","run022","GGB","GGG",13,4,17
"2575","run022","GGB","RGG",1,0,1
"2576","run022","GGB","RRG",1,0,1
"2577","run022","GGB","RRR",1,0,1
"2578","run022","GGG","BBB",8,3,11
"2579","run022","GGG","BGG",1,2,3
"2580","run022","GGG","BRB",1,1,2
"2581","run022","GGG","GGB",5,0,5
"2582","run022","GGG","GGR",1,0,1
"2583","run022","GGG","RBB",1,4,5
"2584","run022","GGG","RGR",1,3,4
"2585","run022","GGG","RRG",1,2,3
"2586","run022","GGR","BRR",1,0,1
"2587","run022","GGR","GRR",1,0,1
"2588","run022","GRG","BBB",3,1,4
"2589","run022","GRG","GGB",2,4,6
"2590","run022","GRG","GGG",3,2,5
"2591","run022","GRG","RGR",1,0,1
"2592","run022","GRG","RRG",2,0,2
"2593","run022","GRR","BGB",1,1,2
"2594","run022","RBG","BBB",2,4,6
"2595","run022","RBG","RBB",1,0,1
"2596","run022","RBR","BGB",2,0,2
"2597","run022","RBR","BRB",1,0,1
"2598","run022","RBR","BRR",1,0,1
"2599","run022","RBR","GRR",4,0,4
"2600","run022","RBR","RGG",2,1,3
"2601","run022","RBR","RGR",1,0,1
"2602","run022","RGG","BBR",1,1,2
"2603","run022","RGR","BBB",2,0,2
"2604","run022","RGR","BBR",1,0,1
"2605","run022","RGR","BGB",2,0,2
"2606","run022","RGR","BGG",2,0,2
"2607","run022","RGR","BRR",1,0,1
"2608","run022","RGR","GGB",2,1,3
"2609","run022","RGR","RGG",1,0,1
"2610","run022","RRG","BBB",2,4,6
"2611","run022","RRG","BGB",1,3,4
"2612","run022","RRG","BRB",2,7,9
"2613","run022","RRG","BRR",1,4,5
"2614","run022","RRG","GGG",2,1,3
"2615","run022","RRG","GRG",1,0,1
"2616","run022","RRG","GRR",3,2,5
"2617","run022","RRG","RBB",1,0,1
"2618","run022","RRR","BBR",1,0,1
"2619","run022","RRR","BGB",2,0,2
"2620","run022","RRR","BGG",1,0,1
"2621","run022","RRR","BRB",1,1,2
"2622","run022","RRR","BRR",1,0,1
"2623","run022","RRR","RBB",1,0,1
"2624","run022","RRR","RGR",1,1,2
"2625","run022","RRR","RRG",2,0,2
"2626","run022","BBG","RRR",0,3,3
"2627","run022","BGB","RRG",0,1,1
"2628","run022","BGG","BBB",0,1,1
"2629","run022","BRB","BBB",0,2,2
"2630","run022","BRB","BRR",0,2,2
"2631","run022","GBB","GBG",0,1,1
"2632","run022","GBB","GGB",0,5,5
"2633","run022","GBB","GRG",0,2,2
"2634","run022","GBG","GGB",0,2,2
"2635","run022","GBG","RGG",0,1,1
"2636","run022","GGB","GGR",0,1,1
"2637","run022","GGB","GRR",0,2,2
"2638","run022","GGG","RBG",0,1,1
"2639","run022","GGG","RBR",0,5,5
"2640","run022","GGG","RRR",0,1,1
"2641","run022","GRG","BBR",0,1,1
"2642","run022","GRG","BGG",0,1,1
"2643","run022","GRG","GBG",0,1,1
"2644","run022","GRG","GGR",0,3,3
"2645","run022","GRG","RBR",0,1,1
"2646","run022","GRR","BGG",0,1,1
"2647","run022","RBG","GRR",0,2,2
"2648","run022","RBG","RGR",0,1,1
"2649","run022","RBR","BBB",0,4,4
"2650","run022","RBR","BGG",0,1,1
"2651","run022","RBR","GGB",0,3,3
"2652","run022","RBR","RBB",0,1,1
"2653","run022","RGG","BBB",0,1,1
"2654","run022","RGG","BRR",0,2,2
"2655","run022","RGG","GRR",0,2,2
"2656","run022","RGR","RBB",0,1,1
"2657","run022","RRG","BBR",0,1,1
"2658","run022","RRG","GGR",0,3,3
"2659","run022","RRG","RGR",0,1,1
"2660","run022","RRR","GRR",0,1,1
"2661","run023","BBB","GGG",1,0,1
"2662","run023","BBB","RRG",1,0,1
"2663","run023","BBG","BBB",1,1,2
"2664","run023","BBG","BRB",1,2,3
"2665","run023","BBG","GBG",2,1,3
"2666","run023","BBG","GGB",2,1,3
"2667","run023","BBG","GGG",4,6,10
"2668","run023","BBG","GRG",1,1,2
"2669","run023","BBG","RRG",1,1,2
"2670","run023","BGG","RBG",1,0,1
"2671","run023","BGG","RRR",1,0,1
"2672","run023","BRR","BGB",1,0,1
"2673","run023","GBB","BBB",12,4,16
"2674","run023","GBB","BRB",1,2,3
"2675","run023","GBB","BRR",1,0,1
"2676","run023","GBB","GGG",7,11,18
"2677","run023","GBB","GGR",1,0,1
"2678","run023","GBB","RBG",3,3,6
"2679","run023","GBB","RBR",1,0,1
"2680","run023","GBB","RGG",1,0,1
"2681","run023","GBB","RGR",2,0,2
"2682","run023","GBB","RRR",1,0,1
"2683","run023","GBG","BRB",1,2,3
"2684","run023","GBG","BRR",1,0,1
"2685","run023","GBG","GGG",4,1,5
"2686","run023","GBG","RBB",1,0,1
"2687","run023","GBG","RGR",1,0,1
"2688","run023","GBG","RRG",1,1,2
"2689","run023","GGB","BBB",3,3,6
"2690","run023","GGB","BBR",1,0,1
"2691","run023","GGB","BRR",1,0,1
"2692","run023","GGB","GBG",1,0,1
"2693","run023","GGB","GGG",13,7,20
"2694","run023","GGB","RGG",1,0,1
"2695","run023","GGB","RRG",1,0,1
"2696","run023","GGB","RRR",1,1,2
"2697","run023","GGG","BBB",8,7,15
"2698","run023","GGG","BGG",1,1,2
"2699","run023","GGG","BRB",1,0,1
"2700","run023","GGG","GGB",5,0,5
"2701","run023","GGG","GGR",1,1,2
"2702","run023","GGG","RBB",1,1,2
"2703","run023","GGG","RGR",1,2,3
"2704","run023","GGG","RRG",1,3,4
"2705","run023","GGR","BRR",1,0,1
"2706","run023","GGR","GRR",1,0,1
"2707","run023","GRG","BBB",3,2,5
"2708","run023","GRG","GGB",2,5,7
"2709","run023","GRG","GGG",3,3,6
"2710","run023","GRG","RGR",1,0,1
"2711","run023","GRG","RRG",2,2,4
"2712","run023","GRR","BGB",1,1,2
"2713","run023","RBG","BBB",2,2,4
"2714","run023","RBG","RBB",1,0,1
"2715","run023","RBR","BGB",2,0,2
"2716","run023","RBR","BRB",1,0,1
"2717","run023","RBR","BRR",1,1,2
"2718","run023","RBR","GRR",4,0,4
"2719","run023","RBR","RGG",2,2,4
"2720","run023","RBR","RGR",1,0,1
"2721","run023","RGG","BBR",1,1,2
"2722","run023","RGR","BBB",2,2,4
"2723","run023","RGR","BBR",1,0,1
"2724","run023","RGR","BGB",2,1,3
"2725","run023","RGR","BGG",2,0,2
"2726","run023","RGR","BRR",1,0,1
"2727","run023","RGR","GGB",2,1,3
"2728","run023","RGR","RGG",1,0,1
"2729","run023","RRG","BBB",2,7,9
"2730","run023","RRG","BGB",1,1,2
"2731","run023","RRG","BRB",2,8,10
"2732","run023","RRG","BRR",1,3,4
"2733","run023","RRG","GGG",2,3,5
"2734","run023","RRG","GRG",1,0,1
"2735","run023","RRG","GRR",3,1,4
"2736","run023","RRG","RBB",1,0,1
"2737","run023","RRR","BBR",1,0,1
"2738","run023","RRR","BGB",2,0,2
"2739","run023","RRR","BGG",1,0,1
"2740","run023","RRR","BRB",1,0,1
"2741","run023","RRR","BRR",1,0,1
"2742","run023","RRR","RBB",1,1,2
"2743","run023","RRR","RGR",1,0,1
"2744","run023","RRR","RRG",2,0,2
"2745","run023","BBB","RBG",0,1,1
"2746","run023","BBG","GBB",0,1,1
"2747","run023","BBG","RBR",0,1,1
"2748","run023","BBG","RRR",0,1,1
"2749","run023","BRB","BBB",0,1,1
"2750","run023","BRB","RGR",0,1,1
"2751","run023","BRR","BBB",0,2,2
"2752","run023","GBB","GGB",0,5,5
"2753","run023","GBB","GRG",0,1,1
"2754","run023","GBB","RRG",0,1,1
"2755","run023","GBG","RGG",0,1,1
"2756","run023","GGB","BGG",0,1,1
"2757","run023","GGB","GBB",0,1,1
"2758","run023","GGB","GRR",0,2,2
"2759","run023","GGB","RBB",0,1,1
"2760","run023","GGB","RBR",0,1,1
"2761","run023","GGG","BRR",0,2,2
"2762","run023","GGG","RBR",0,2,2
"2763","run023","GGG","RGG",0,1,1
"2764","run023","GGR","RBB",0,1,1
"2765","run023","GRG","BBR",0,1,1
"2766","run023","GRG","BGG",0,1,1
"2767","run023","GRG","GGR",0,2,2
"2768","run023","GRR","BRB",0,1,1
"2769","run023","GRR","BRR",0,2,2
"2770","run023","RBG","GRR",0,2,2
"2771","run023","RBR","BBB",0,2,2
"2772","run023","RBR","BBR",0,1,1
"2773","run023","RGG","GGR",0,1,1
"2774","run023","RGG","GRR",0,2,2
"2775","run023","RGR","RBB",0,1,1
"2776","run023","RGR","RRG",0,1,1
"2777","run023","RRG","BBR",0,1,1
"2778","run023","RRG","BGG",0,1,1
"2779","run023","RRR","GRR",0,2,2
"2780","run023","RRR","RGG",0,1,1
"2781","run024","BBB","GGG",1,1,2
"2782","run024","BBB","RRG",1,0,1
"2783","run024","BBG","BBB",1,1,2
"2784","run024","BBG","BRB",1,5,6
"2785","run024","BBG","GBG",2,0,2
"2786","run024","BBG","GGB",2,10,12
"2787","run024","BBG","GGG",4,9,13
"2788","run024","BBG","GRG",1,1,2
"2789","run024","BBG","RRG",1,0,1
"2790","run024","BGG","RBG",1,0,1
"2791","run024","BGG","RRR",1,1,2
"2792","run024","BRR","BGB",1,1,2
"2793","run024","GBB","BBB",12,7,19
"2794","run024","GBB","BRB",1,3,4
"2795","run024","GBB","BRR",1,1,2
"2796","run024","GBB","GGG",7,10,17
"2797","run024","GBB","GGR",1,0,1
"2798","run024","GBB","RBG",3,0,3
"2799","run024","GBB","RBR",1,0,1
"2800","run024","GBB","RGG",1,0,1
"2801","run024","GBB","RGR",2,0,2
"2802","run024","GBB","RRR",1,1,2
"2803","run024","GBG","BRB",1,2,3
"2804","run024","GBG","BRR",1,0,1
"2805","run024","GBG","GGG",4,0,4
"2806","run024","GBG","RBB",1,0,1
"2807","run024","GBG","RGR",1,0,1
"2808","run024","GBG","RRG",1,1,2
"2809","run024","GGB","BBB",3,1,4
"2810","run024","GGB","BBR",1,0,1
"2811","run024","GGB","BRR",1,2,3
"2812","run024","GGB","GBG",1,0,1
"2813","run024","GGB","GGG",13,7,20
"2814","run024","GGB","RGG",1,0,1
"2815","run024","GGB","RRG",1,0,1
"2816","run024","GGB","RRR",1,2,3
"2817","run024","GGG","BBB",8,2,10
"2818","run024","GGG","BGG",1,2,3
"2819","run024","GGG","BRB",1,0,1
"2820","run024","GGG","GGB",5,0,5
"2821","run024","GGG","GGR",1,0,1
"2822","run024","GGG","RBB",1,0,1
"2823","run024","GGG","RGR",1,2,3
"2824","run024","GGG","RRG",1,2,3
"2825","run024","GGR","BRR",1,0,1
"2826","run024","GGR","GRR",1,0,1
"2827","run024","GRG","BBB",3,1,4
"2828","run024","GRG","GGB",2,3,5
"2829","run024","GRG","GGG",3,3,6
"2830","run024","GRG","RGR",1,0,1
"2831","run024","GRG","RRG",2,1,3
"2832","run024","GRR","BGB",1,0,1
"2833","run024","RBG","BBB",2,2,4
"2834","run024","RBG","RBB",1,0,1
"2835","run024","RBR","BGB",2,1,3
"2836","run024","RBR","BRB",1,0,1
"2837","run024","RBR","BRR",1,1,2
"2838","run024","RBR","GRR",4,1,5
"2839","run024","RBR","RGG",2,1,3
"2840","run024","RBR","RGR",1,0,1
"2841","run024","RGG","BBR",1,0,1
"2842","run024","RGR","BBB",2,2,4
"2843","run024","RGR","BBR",1,0,1
"2844","run024","RGR","BGB",2,0,2
"2845","run024","RGR","BGG",2,1,3
"2846","run024","RGR","BRR",1,0,1
"2847","run024","RGR","GGB",2,2,4
"2848","run024","RGR","RGG",1,0,1
"2849","run024","RRG","BBB",2,4,6
"2850","run024","RRG","BGB",1,1,2
"2851","run024","RRG","BRB",2,9,11
"2852","run024","RRG","BRR",1,3,4
"2853","run024","RRG","GGG",2,0,2
"2854","run024","RRG","GRG",1,0,1
"2855","run024","RRG","GRR",3,0,3
"2856","run024","RRG","RBB",1,0,1
"2857","run024","RRR","BBR",1,0,1
"2858","run024","RRR","BGB",2,0,2
"2859","run024","RRR","BGG",1,0,1
"2860","run024","RRR","BRB",1,0,1
"2861","run024","RRR","BRR",1,0,1
"2862","run024","RRR","RBB",1,1,2
"2863","run024","RRR","RGR",1,0,1
"2864","run024","RRR","RRG",2,1,3
"2865","run024","BBB","GRR",0,1,1
"2866","run024","BBG","BGB",0,1,1
"2867","run024","BBG","BGG",0,1,1
"2868","run024","BBG","GBB",0,1,1
"2869","run024","BBG","GRR",0,1,1
"2870","run024","BBG","RRR",0,2,2
"2871","run024","BGB","BBB",0,1,1
"2872","run024","BGG","BBB",0,1,1
"2873","run024","BRB","BBB",0,3,3
"2874","run024","BRB","BRR",0,1,1
"2875","run024","BRR","BBB",0,1,1
"2876","run024","BRR","RBB",0,1,1
"2877","run024","GBB","GBG",0,1,1
"2878","run024","GBB","GGB",0,3,3
"2879","run024","GBB","GRG",0,2,2
"2880","run024","GBB","RBB",0,1,1
"2881","run024","GBG","BBB",0,1,1
"2882","run024","GBG","BBR",0,1,1
"2883","run024","GBG","RBG",0,1,1
"2884","run024","GGB","BGG",0,2,2
"2885","run024","GGB","GGR",0,1,1
"2886","run024","GGB","RBR",0,2,2
"2887","run024","GGG","BRR",0,1,1
"2888","run024","GGG","RRR",0,1,1
"2889","run024","GGR","BBR",0,1,1
"2890","run024","GRG","BRB",0,1,1
"2891","run024","GRG","GBG",0,1,1
"2892","run024","GRG","GGR",0,1,1
"2893","run024","GRR","BGG",0,2,2
"2894","run024","GRR","BRB",0,1,1
"2895","run024","RBG","BRR",0,1,1
"2896","run024","RBR","GGB",0,2,2
"2897","run024","RGG","BRR",0,2,2
"2898","run024","RGR","RBB",0,1,1
"2899","run024","RGR","RRG",0,1,1
"2900","run024","RRG","RGG",0,1,1
"2901","run024","RRR","GRR",0,1,1
"2902","run025","BBB","GGG",1,0,1
"2903","run025","BBB","RRG",1,0,1
"2904","run025","BBG","BBB",1,1,2
"2905","run025","BBG","BRB",1,3,4
"2906","run025","BBG","GBG",2,2,4
"2907","run025","BBG","GGB",2,2,4
"2908","run025","BBG","GGG",4,5,9
"2909","run025","BBG","GRG",1,0,1
"2910","run025","BBG","RRG",1,0,1
"2911","run025","BGG","RBG",1,0,1
"2912","run025","BGG","RRR",1,0,1
"2913","run025","BRR","BGB",1,0,1
"2914","run025","GBB","BBB",12,6,18
"2915","run025","GBB","BRB",1,2,3
"2916","run025","GBB","BRR",1,1,2
"2917","run025","GBB","GGG",7,12,19
"2918","run025","GBB","GGR",1,0,1
"2919","run025","GBB","RBG",3,2,5
"2920","run025","GBB","RBR",1,0,1
"2921","run025","GBB","RGG",1,0,1
"2922","run025","GBB","RGR",2,0,2
"2923","run025","GBB","RRR",1,2,3
"2924","run025","GBG","BRB",1,1,2
"2925","run025","GBG","BRR",1,0,1
"2926","run025","GBG","GGG",4,2,6
"2927","run025","GBG","RBB",1,0,1
"2928","run025","GBG","RGR",1,0,1
"2929","run025","GBG","RRG",1,0,1
"2930","run025","GGB","BBB",3,1,4
"2931","run025","GGB","BBR",1,3,4
"2932","run025","GGB","BRR",1,1,2
"2933","run025","GGB","GBG",1,0,1
"2934","run025","GGB","GGG",13,10,23
"2935","run025","GGB","RGG",1,1,2
"2936","run025","GGB","RRG",1,2,3
"2937","run025","GGB","RRR",1,1,2
"2938","run025","GGG","BBB",8,7,15
"2939","run025","GGG","BGG",1,1,2
"2940","run025","GGG","BRB",1,0,1
"2941","run025","GGG","GGB",5,0,5
"2942","run025","GGG","GGR",1,2,3
"2943","run025","GGG","RBB",1,1,2
"2944","run025","GGG","RGR",1,2,3
"2945","run025","GGG","RRG",1,2,3
"2946","run025","GGR","BRR",1,0,1
"2947","run025","GGR","GRR",1,0,1
"2948","run025","GRG","BBB",3,0,3
"2949","run025","GRG","GGB",2,4,6
"2950","run025","GRG","GGG",3,2,5
"2951","run025","GRG","RGR",1,0,1
"2952","run025","GRG","RRG",2,0,2
"2953","run025","GRR","BGB",1,0,1
"2954","run025","RBG","BBB",2,0,2
"2955","run025","RBG","RBB",1,0,1
"2956","run025","RBR","BGB",2,2,4
"2957","run025","RBR","BRB",1,0,1
"2958","run025","RBR","BRR",1,1,2
"2959","run025","RBR","GRR",4,0,4
"2960","run025","RBR","RGG",2,0,2
"2961","run025","RBR","RGR",1,0,1
"2962","run025","RGG","BBR",1,0,1
"2963","run025","RGR","BBB",2,0,2
"2964","run025","RGR","BBR",1,1,2
"2965","run025","RGR","BGB",2,0,2
"2966","run025","RGR","BGG",2,1,3
"2967","run025","RGR","BRR",1,0,1
"2968","run025","RGR","GGB",2,2,4
"2969","run025","RGR","RGG",1,0,1
"2970","run025","RRG","BBB",2,5,7
"2971","run025","RRG","BGB",1,2,3
"2972","run025","RRG","BRB",2,6,8
"2973","run025","RRG","BRR",1,3,4
"2974","run025","RRG","GGG",2,1,3
"2975","run025","RRG","GRG",1,0,1
"2976","run025","RRG","GRR",3,1,4
"2977","run025","RRG","RBB",1,0,1
"2978","run025","RRR","BBR",1,0,1
"2979","run025","RRR","BGB",2,0,2
"2980","run025","RRR","BGG",1,0,1
"2981","run025","RRR","BRB",1,0,1
"2982","run025","RRR","BRR",1,0,1
"2983","run025","RRR","RBB",1,0,1
"2984","run025","RRR","RGR",1,0,1
"2985","run025","RRR","RRG",2,0,2
"2986","run025","BBB","GRR",0,1,1
"2987","run025","BBG","BGB",0,1,1
"2988","run025","BBG","GBB",0,1,1
"2989","run025","BBG","RBB",0,1,1
"2990","run025","BBG","RBG",0,1,1
"2991","run025","BBG","RRR",0,2,2
"2992","run025","BGG","BBB",0,2,2
"2993","run025","BGG","RGG",0,2,2
"2994","run025","BGG","RGR",0,1,1
"2995","run025","BRB","BBB",0,3,3
"2996","run025","BRB","GGR",0,1,1
"2997","run025","BRB","RBB",0,1,1
"2998","run025","BRB","RBG",0,1,1
"2999","run025","BRR","BBB",0,1,1
"3000","run025","BRR","BGG",0,1,1
"3001","run025","BRR","BRB",0,1,1
"3002","run025","BRR","RBB",0,1,1
"3003","run025","GBB","BGG",0,1,1
"3004","run025","GBB","GGB",0,1,1
"3005","run025","GBG","GGB",0,1,1
"3006","run025","GBG","RBG",0,1,1
"3007","run025","GGB","BGB",0,1,1
"3008","run025","GGB","GGR",0,2,2
"3009","run025","GGB","RBG",0,3,3
"3010","run025","GGG","BGB",0,1,1
"3011","run025","GGG","RBR",0,1,1
"3012","run025","GRG","BRR",0,1,1
"3013","run025","GRR","BBB",0,1,1
"3014","run025","GRR","BRB",0,1,1
"3015","run025","RBG","BBG",0,1,1
"3016","run025","RBG","GRR",0,1,1
"3017","run025","RBG","RGR",0,1,1
"3018","run025","RBR","BBB",0,2,2
"3019","run025","RBR","GGB",0,1,1
"3020","run025","RBR","RRR",0,1,1
"3021","run025","RGG","BBB",0,1,1
"3022","run025","RGR","RBB",0,1,1
"3023","run025","RGR","RRG",0,1,1
"3024","run025","RRG","BBR",0,1,1
"3025","run025","RRG","BGG",0,1,1
"3026","run025","RRG","GGR",0,1,1
"3027","run025","RRG","RGG",0,1,1
"3028","run025","RRR","GRR",0,1,1
"3029","run025","RRR","RBR",0,1,1
"3030","run025","RRR","RGG",0,1,1
"3031","run026","BBB","GGG",1,0,1
"3032","run026","BBB","RRG",1,0,1
"3033","run026","BBG","BBB",1,0,1
"3034","run026","BBG","BRB",1,1,2
"3035","run026","BBG","GBG",2,1,3
"3036","run026","BBG","GGB",2,2,4
"3037","run026","BBG","GGG",4,2,6
"3038","run026","BBG","GRG",1,1,2
"3039","run026","BBG","RRG",1,0,1
"3040","run026","BGG","RBG",1,1,2
"3041","run026","BGG","RRR",1,0,1
"3042","run026","BRR","BGB",1,0,1
"3043","run026","GBB","BBB",12,9,21
"3044","run026","GBB","BRB",1,1,2
"3045","run026","GBB","BRR",1,0,1
"3046","run026","GBB","GGG",7,8,15
"3047","run026","GBB","GGR",1,1,2
"3048","run026","GBB","RBG",3,0,3
"3049","run026","GBB","RBR",1,0,1
"3050","run026","GBB","RGG",1,0,1
"3051","run026","GBB","RGR",2,0,2
"3052","run026","GBB","RRR",1,1,2
"3053","run026","GBG","BRB",1,0,1
"3054","run026","GBG","BRR",1,0,1
"3055","run026","GBG","GGG",4,1,5
"3056","run026","GBG","RBB",1,0,1
"3057","run026","GBG","RGR",1,0,1
"3058","run026","GBG","RRG",1,0,1
"3059","run026","GGB","BBB",3,5,8
"3060","run026","GGB","BBR",1,0,1
"3061","run026","GGB","BRR",1,1,2
"3062","run026","GGB","GBG",1,0,1
"3063","run026","GGB","GGG",13,9,22
"3064","run026","GGB","RGG",1,2,3
"3065","run026","GGB","RRG",1,2,3
"3066","run026","GGB","RRR",1,0,1
"3067","run026","GGG","BBB",8,3,11
"3068","run026","GGG","BGG",1,0,1
"3069","run026","GGG","BRB",1,0,1
"3070","run026","GGG","GGB",5,0,5
"3071","run026","GGG","GGR",1,0,1
"3072","run026","GGG","RBB",1,2,3
"3073","run026","GGG","RGR",1,3,4
"3074","run026","GGG","RRG",1,6,7
"3075","run026","GGR","BRR",1,0,1
"3076","run026","GGR","GRR",1,0,1
"3077","run026","GRG","BBB",3,1,4
"3078","run026","GRG","GGB",2,2,4
"3079","run026","GRG","GGG",3,5,8
"3080","run026","GRG","RGR",1,0,1
"3081","run026","GRG","RRG",2,2,4
"3082","run026","GRR","BGB",1,0,1
"3083","run026","RBG","BBB",2,1,3
"3084","run026","RBG","RBB",1,0,1
"3085","run026","RBR","BGB",2,2,4
"3086","run026","RBR","BRB",1,0,1
"3087","run026","RBR","BRR",1,1,2
"3088","run026","RBR","GRR",4,0,4
"3089","run026","RBR","RGG",2,2,4
"3090","run026","RBR","RGR",1,0,1
"3091","run026","RGG","BBR",1,1,2
"3092","run026","RGR","BBB",2,1,3
"3093","run026","RGR","BBR",1,0,1
"3094","run026","RGR","BGB",2,3,5
"3095","run026","RGR","BGG",2,0,2
"3096","run026","RGR","BRR",1,0,1
"3097","run026","RGR","GGB",2,1,3
"3098","run026","RGR","RGG",1,0,1
"3099","run026","RRG","BBB",2,4,6
"3100","run026","RRG","BGB",1,1,2
"3101","run026","RRG","BRB",2,6,8
"3102","run026","RRG","BRR",1,2,3
"3103","run026","RRG","GGG",2,2,4
"3104","run026","RRG","GRG",1,0,1
"3105","run026","RRG","GRR",3,2,5
"3106","run026","RRG","RBB",1,1,2
"3107","run026","RRR","BBR",1,0,1
"3108","run026","RRR","BGB",2,1,3
"3109","run026","RRR","BGG",1,0,1
"3110","run026","RRR","BRB",1,0,1
"3111","run026","RRR","BRR",1,0,1
"3112","run026","RRR","RBB",1,0,1
"3113","run026","RRR","RGR",1,0,1
"3114","run026","RRR","RRG",2,0,2
"3115","run026","BBB","GRR",0,1,1
"3116","run026","BBB","RRR",0,1,1
"3117","run026","BBG","RBG",0,1,1
"3118","run026","BBG","RRR",0,1,1
"3119","run026","BGG","BBR",0,1,1
"3120","run026","BGG","RGG",0,1,1
"3121","run026","BGG","RGR",0,1,1
"3122","run026","BRB","BBB",0,2,2
"3123","run026","BRB","BBR",0,1,1
"3124","run026","BRB","GGG",0,1,1
"3125","run026","BRR","BBB",0,1,1
"3126","run026","GBB","BGG",0,1,1
"3127","run026","GBB","GBG",0,1,1
"3128","run026","GBB","GGB",0,2,2
"3129","run026","GBG","BBB",0,1,1
"3130","run026","GBG","BBR",0,1,1
"3131","run026","GBG","RGG",0,1,1
"3132","run026","GGB","BGG",0,1,1
"3133","run026","GGB","GGR",0,2,2
"3134","run026","GGB","GRR",0,2,2
"3135","run026","GGB","RBB",0,1,1
"3136","run026","GGB","RBG",0,1,1
"3137","run026","GGB","RBR",0,3,3
"3138","run026","GGB","RGR",0,1,1
"3139","run026","GGG","BRR",0,2,2
"3140","run026","GGG","RBG",0,4,4
"3141","run026","GGG","RBR",0,3,3
"3142","run026","GGR","RBB",0,1,1
"3143","run026","GRG","GGR",0,1,1
"3144","run026","GRR","BGG",0,1,1
"3145","run026","GRR","GGG",0,1,1
"3146","run026","RBG","GRR",0,1,1
"3147","run026","RBR","BBB",0,5,5
"3148","run026","RBR","BGG",0,1,1
"3149","run026","RBR","GGB",0,1,1
"3150","run026","RGG","BBB",0,1,1
"3151","run026","RGG","BRR",0,1,1
"3152","run026","RGG","GRR",0,1,1
"3153","run026","RGR","RRG",0,1,1
"3154","run026","RRG","BBR",0,1,1
"3155","run026","RRG","BGG",0,1,1
"3156","run027","BBB","GGG",1,0,1
"3157","run027","BBB","RRG",1,0,1
"3158","run027","BBG","BBB",1,1,2
"3159","run027","BBG","BRB",1,3,4
"3160","run027","BBG","GBG",2,1,3
"3161","run027","BBG","GGB",2,8,10
"3162","run027","BBG","GGG",4,7,11
"3163","run027","BBG","GRG",1,3,4
"3164","run027","BBG","RRG",1,0,1
"3165","run027","BGG","RBG",1,0,1
"3166","run027","BGG","RRR",1,0,1
"3167","run027","BRR","BGB",1,0,1
"3168","run027","GBB","BBB",12,4,16
"3169","run027","GBB","BRB",1,1,2
"3170","run027","GBB","BRR",1,0,1
"3171","run027","GBB","GGG",7,14,21
"3172","run027","GBB","GGR",1,0,1
"3173","run027","GBB","RBG",3,1,4
"3174","run027","GBB","RBR",1,0,1
"3175","run027","GBB","RGG",1,0,1
"3176","run027","GBB","RGR",2,0,2
"3177","run027","GBB","RRR",1,2,3
"3178","run027","GBG","BRB",1,0,1
"3179","run027","GBG","BRR",1,0,1
"3180","run027","GBG","GGG",4,2,6
"3181","run027","GBG","RBB",1,0,1
"3182","run027","GBG","RGR",1,1,2
"3183","run027","GBG","RRG",1,1,2
"3184","run027","GGB","BBB",3,0,3
"3185","run027","GGB","BBR",1,0,1
"3186","run027","GGB","BRR",1,1,2
"3187","run027","GGB","GBG",1,0,1
"3188","run027","GGB","GGG",13,7,20
"3189","run027","GGB","RGG",1,1,2
"3190","run027","GGB","RRG",1,2,3
"3191","run027","GGB","RRR",1,1,2
"3192","run027","GGG","BBB",8,10,18
"3193","run027","GGG","BGG",1,1,2
"3194","run027","GGG","BRB",1,0,1
"3195","run027","GGG","GGB",5,0,5
"3196","run027","GGG","GGR",1,1,2
"3197","run027","GGG","RBB",1,0,1
"3198","run027","GGG","RGR",1,0,1
"3199","run027","GGG","RRG",1,5,6
"3200","run027","GGR","BRR",1,0,1
"3201","run027","GGR","GRR",1,0,1
"3202","run027","GRG","BBB",3,1,4
"3203","run027","GRG","GGB",2,1,3
"3204","run027","GRG","GGG",3,2,5
"3205","run027","GRG","RGR",1,0,1
"3206","run027","GRG","RRG",2,0,2
"3207","run027","GRR","BGB",1,0,1
"3208","run027","RBG","BBB",2,1,3
"3209","run027","RBG","RBB",1,0,1
"3210","run027","RBR","BGB",2,1,3
"3211","run027","RBR","BRB",1,0,1
"3212","run027","RBR","BRR",1,0,1
"3213","run027","RBR","GRR",4,2,6
"3214","run027","RBR","RGG",2,2,4
"3215","run027","RBR","RGR",1,0,1
"3216","run027","RGG","BBR",1,0,1
"3217","run027","RGR","BBB",2,0,2
"3218","run027","RGR","BBR",1,0,1
"3219","run027","RGR","BGB",2,1,3
"3220","run027","RGR","BGG",2,1,3
"3221","run027","RGR","BRR",1,1,2
"3222","run027","RGR","GGB",2,4,6
"3223","run027","RGR","RGG",1,0,1
"3224","run027","RRG","BBB",2,1,3
"3225","run027","RRG","BGB",1,2,3
"3226","run027","RRG","BRB",2,7,9
"3227","run027","RRG","BRR",1,0,1
"3228","run027","RRG","GGG",2,4,6
"3229","run027","RRG","GRG",1,0,1
"3230","run027","RRG","GRR",3,1,4
"3231","run027","RRG","RBB",1,0,1
"3232","run027","RRR","BBR",1,0,1
"3233","run027","RRR","BGB",2,0,2
"3234","run027","RRR","BGG",1,0,1
"3235","run027","RRR","BRB",1,0,1
"3236","run027","RRR","BRR",1,0,1
"3237","run027","RRR","RBB",1,0,1
"3238","run027","RRR","RGR",1,0,1
"3239","run027","RRR","RRG",2,0,2
"3240","run027","BBG","GBB",0,1,1
"3241","run027","BBG","GRR",0,1,1
"3242","run027","BGG","GRG",0,1,1
"3243","run027","BGG","RGG",0,1,1
"3244","run027","BRB","BBB",0,1,1
"3245","run027","BRB","GGG",0,1,1
"3246","run027","BRB","RBB",0,1,1
"3247","run027","BRR","RBB",0,1,1
"3248","run027","GBB","GGB",0,1,1
"3249","run027","GBB","GRG",0,1,1
"3250","run027","GBB","GRR",0,1,1
"3251","run027","GBG","GGB",0,2,2
"3252","run027","GBG","RGG",0,1,1
"3253","run027","GGB","BGB",0,1,1
"3254","run027","GGB","GBB",0,1,1
"3255","run027","GGB","GGR",0,1,1
"3256","run027","GGB","RBB",0,1,1
"3257","run027","GGB","RGR",0,1,1
"3258","run027","GGG","BRR",0,2,2
"3259","run027","GGG","RBG",0,2,2
"3260","run027","GGG","RBR",0,7,7
"3261","run027","GGG","RRR",0,1,1
"3262","run027","GRG","BRR",0,1,1
"3263","run027","GRG","GGR",0,2,2
"3264","run027","GRR","BBR",0,1,1
"3265","run027","RBB","BBB",0,1,1
"3266","run027","RBB","BRB",0,1,1
"3267","run027","RBG","GRR",0,2,2
"3268","run027","RBG","RBR",0,1,1
"3269","run027","RBR","BBB",0,1,1
"3270","run027","RBR","BGG",0,1,1
"3271","run027","RBR","GGB",0,2,2
"3272","run027","RGG","BBB",0,1,1
"3273","run027","RGG","BGB",0,1,1
"3274","run027","RGG","GRR",0,1,1
"3275","run027","RGR","RBB",0,1,1
"3276","run027","RRG","GGR",0,1,1
"3277","run027","RRG","RGR",0,1,1
"3278","run028","BBB","GGG",1,0,1
"3279","run028","BBB","RRG",1,0,1
"3280","run028","BBG","BBB",1,1,2
"3281","run028","BBG","BRB",1,1,2
"3282","run028","BBG","GBG",2,1,3
"3283","run028","BBG","GGB",2,3,5
"3284","run028","BBG","GGG",4,3,7
"3285","run028","BBG","GRG",1,5,6
"3286","run028","BBG","RRG",1,0,1
"3287","run028","BGG","RBG",1,0,1
"3288","run028","BGG","RRR",1,0,1
"3289","run028","BRR","BGB",1,0,1
"3290","run028","GBB","BBB",12,9,21
"3291","run028","GBB","BRB",1,1,2
"3292","run028","GBB","BRR",1,1,2
"3293","run028","GBB","GGG",7,14,21
"3294","run028","GBB","GGR",1,0,1
"3295","run028","GBB","RBG",3,0,3
"3296","run028","GBB","RBR",1,0,1
"3297","run028","GBB","RGG",1,0,1
"3298","run028","GBB","RGR",2,1,3
"3299","run028","GBB","RRR",1,1,2
"3300","run028","GBG","BRB",1,0,1
"3301","run028","GBG","BRR",1,0,1
"3302","run028","GBG","GGG",4,1,5
"3303","run028","GBG","RBB",1,0,1
"3304","run028","GBG","RGR",1,0,1
"3305","run028","GBG","RRG",1,1,2
"3306","run028","GGB","BBB",3,1,4
"3307","run028","GGB","BBR",1,0,1
"3308","run028","GGB","BRR",1,2,3
"3309","run028","GGB","GBG",1,0,1
"3310","run028","GGB","GGG",13,5,18
"3311","run028","GGB","RGG",1,1,2
"3312","run028","GGB","RRG",1,1,2
"3313","run028","GGB","RRR",1,1,2
"3314","run028","GGG","BBB",8,8,16
"3315","run028","GGG","BGG",1,1,2
"3316","run028","GGG","BRB",1,0,1
"3317","run028","GGG","GGB",5,1,6
"3318","run028","GGG","GGR",1,1,2
"3319","run028","GGG","RBB",1,1,2
"3320","run028","GGG","RGR",1,2,3
"3321","run028","GGG","RRG",1,2,3
"3322","run028","GGR","BRR",1,0,1
"3323","run028","GGR","GRR",1,0,1
"3324","run028","GRG","BBB",3,2,5
"3325","run028","GRG","GGB",2,1,3
"3326","run028","GRG","GGG",3,1,4
"3327","run028","GRG","RGR",1,1,2
"3328","run028","GRG","RRG",2,1,3
"3329","run028","GRR","BGB",1,0,1
"3330","run028","RBG","BBB",2,1,3
"3331","run028","RBG","RBB",1,0,1
"3332","run028","RBR","BGB",2,1,3
"3333","run028","RBR","BRB",1,0,1
"3334","run028","RBR","BRR",1,0,1
"3335","run028","RBR","GRR",4,0,4
"3336","run028","RBR","RGG",2,1,3
"3337","run028","RBR","RGR",1,0,1
"3338","run028","RGG","BBR",1,0,1
"3339","run028","RGR","BBB",2,0,2
"3340","run028","RGR","BBR",1,0,1
"3341","run028","RGR","BGB",2,0,2
"3342","run028","RGR","BGG",2,0,2
"3343","run028","RGR","BRR",1,1,2
"3344","run028","RGR","GGB",2,3,5
"3345","run028","RGR","RGG",1,0,1
"3346","run028","RRG","BBB",2,9,11
"3347","run028","RRG","BGB",1,0,1
"3348","run028","RRG","BRB",2,5,7
"3349","run028","RRG","BRR",1,1,2
"3350","run028","RRG","GGG",2,4,6
"3351","run028","RRG","GRG",1,0,1
"3352","run028","RRG","GRR",3,0,3
"3353","run028","RRG","RBB",1,0,1
"3354","run028","RRR","BBR",1,0,1
"3355","run028","RRR","BGB",2,0,2
"3356","run028","RRR","BGG",1,0,1
"3357","run028","RRR","BRB",1,0,1
"3358","run028","RRR","BRR",1,0,1
"3359","run028","RRR","RBB",1,1,2
"3360","run028","RRR","RGR",1,0,1
"3361","run028","RRR","RRG",2,0,2
"3362","run028","BBB","BRB",0,1,1
"3363","run028","BBB","GRR",0,1,1
"3364","run028","BBG","RBG",0,1,1
"3365","run028","BBG","RGR",0,1,1
"3366","run028","BGB","RRG",0,1,1
"3367","run028","BGG","BBB",0,1,1
"3368","run028","BRB","BBB",0,3,3
"3369","run028","BRB","RBB",0,1,1
"3370","run028","BRB","RBG",0,1,1
"3371","run028","BRB","RRR",0,1,1
"3372","run028","BRR","BBB",0,2,2
"3373","run028","BRR","BGG",0,1,1
"3374","run028","GBB","GBG",0,1,1
"3375","run028","GBB","GGB",0,5,5
"3376","run028","GBB","RRG",0,1,1
"3377","run028","GBG","BBB",0,1,1
"3378","run028","GBG","BBR",0,1,1
"3379","run028","GBG","GGB",0,2,2
"3380","run028","GGB","BGG",0,1,1
"3381","run028","GGB","GGR",0,2,2
"3382","run028","GGB","GRR",0,2,2
"3383","run028","GGB","RBR",0,2,2
"3384","run028","GGG","BRR",0,1,1
"3385","run028","GGG","RBR",0,1,1
"3386","run028","GRG","BGG",0,1,1
"3387","run028","GRG","GGR",0,2,2
"3388","run028","RBG","BRR",0,1,1
"3389","run028","RBG","GRR",0,1,1
"3390","run028","RBR","BBB",0,1,1
"3391","run028","RBR","GGB",0,2,2
"3392","run028","RBR","RBB",0,1,1
"3393","run028","RGG","BBB",0,2,2
"3394","run028","RGG","BRR",0,1,1
"3395","run028","RGG","GRR",0,1,1
"3396","run028","RGR","GGG",0,1,1
"3397","run028","RGR","GGR",0,2,2
"3398","run028","RGR","RBB",0,1,1
"3399","run028","RRG","BGG",0,1,1
"3400","run028","RRG","GGR",0,1,1
"3401","run028","RRG","RGG",0,1,1
"3402","run028","RRR","GRR",0,2,2
"3403","run029","BBB","GGG",1,1,2
"3404","run029","BBB","RRG",1,1,2
"3405","run029","BBG","BBB",1,0,1
"3406","run029","BBG","BRB",1,3,4
"3407","run029","BBG","GBG",2,0,2
"3408","run029","BBG","GGB",2,4,6
"3409","run029","BBG","GGG",4,7,11
"3410","run029","BBG","GRG",1,2,3
"3411","run029","BBG","RRG",1,0,1
"3412","run029","BGG","RBG",1,0,1
"3413","run029","BGG","RRR",1,1,2
"3414","run029","BRR","BGB",1,1,2
"3415","run029","GBB","BBB",12,6,18
"3416","run029","GBB","BRB",1,4,5
"3417","run029","GBB","BRR",1,0,1
"3418","run029","GBB","GGG",7,5,12
"3419","run029","GBB","GGR",1,0,1
"3420","run029","GBB","RBG",3,2,5
"3421","run029","GBB","RBR",1,0,1
"3422","run029","GBB","RGG",1,0,1
"3423","run029","GBB","RGR",2,0,2
"3424","run029","GBB","RRR",1,1,2
"3425","run029","GBG","BRB",1,0,1
"3426","run029","GBG","BRR",1,0,1
"3427","run029","GBG","GGG",4,1,5
"3428","run029","GBG","RBB",1,0,1
"3429","run029","GBG","RGR",1,1,2
"3430","run029","GBG","RRG",1,2,3
"3431","run029","GGB","BBB",3,3,6
"3432","run029","GGB","BBR",1,0,1
"3433","run029","GGB","BRR",1,1,2
"3434","run029","GGB","GBG",1,0,1
"3435","run029","GGB","GGG",13,11,24
"3436","run029","GGB","RGG",1,1,2
"3437","run029","GGB","RRG",1,0,1
"3438","run029","GGB","RRR",1,1,2
"3439","run029","GGG","BBB",8,5,13
"3440","run029","GGG","BGG",1,1,2
"3441","run029","GGG","BRB",1,1,2
"3442","run029","GGG","GGB",5,0,5
"3443","run029","GGG","GGR",1,0,1
"3444","run029","GGG","RBB",1,1,2
"3445","run029","GGG","RGR",1,1,2
"3446","run029","GGG","RRG",1,2,3
"3447","run029","GGR","BRR",1,0,1
"3448","run029","GGR","GRR",1,0,1
"3449","run029","GRG","BBB",3,2,5
"3450","run029","GRG","GGB",2,1,3
"3451","run029","GRG","GGG",3,2,5
"3452","run029","GRG","RGR",1,0,1
"3453","run029","GRG","RRG",2,0,2
"3454","run029","GRR","BGB",1,0,1
"3455","run029","RBG","BBB",2,0,2
"3456","run029","RBG","RBB",1,0,1
"3457","run029","RBR","BGB",2,1,3
"3458","run029","RBR","BRB",1,0,1
"3459","run029","RBR","BRR",1,1,2
"3460","run029","RBR","GRR",4,2,6
"3461","run029","RBR","RGG",2,0,2
"3462","run029","RBR","RGR",1,0,1
"3463","run029","RGG","BBR",1,0,1
"3464","run029","RGR","BBB",2,0,2
"3465","run029","RGR","BBR",1,0,1
"3466","run029","RGR","BGB",2,2,4
"3467","run029","RGR","BGG",2,0,2
"3468","run029","RGR","BRR",1,0,1
"3469","run029","RGR","GGB",2,0,2
"3470","run029","RGR","RGG",1,0,1
"3471","run029","RRG","BBB",2,2,4
"3472","run029","RRG","BGB",1,0,1
"3473","run029","RRG","BRB",2,9,11
"3474","run029","RRG","BRR",1,2,3
"3475","run029","RRG","GGG",2,4,6
"3476","run029","RRG","GRG",1,0,1
"3477","run029","RRG","GRR",3,1,4
"3478","run029","RRG","RBB",1,0,1
"3479","run029","RRR","BBR",1,0,1
"3480","run029","RRR","BGB",2,0,2
"3481","run029","RRR","BGG",1,0,1
"3482","run029","RRR","BRB",1,0,1
"3483","run029","RRR","BRR",1,0,1
"3484","run029","RRR","RBB",1,1,2
"3485","run029","RRR","RGR",1,0,1
"3486","run029","RRR","RRG",2,1,3
"3487","run029","BBB","RRR",0,1,1
"3488","run029","BBG","RBR",0,1,1
"3489","run029","BGB","BBB",0,1,1
"3490","run029","BGG","BBR",0,1,1
"3491","run029","BGG","GRG",0,1,1
"3492","run029","BRB","BBB",0,1,1
"3493","run029","BRR","BBB",0,2,2
"3494","run029","BRR","RBB",0,1,1
"3495","run029","GBB","BGG",0,1,1
"3496","run029","GBB","GBG",0,1,1
"3497","run029","GBB","GGB",0,2,2
"3498","run029","GBB","GRG",0,3,3
"3499","run029","GBB","RRG",0,1,1
"3500","run029","GBG","GGB",0,1,1
"3501","run029","GBG","RGG",0,1,1
"3502","run029","GGB","BGG",0,1,1
"3503","run029","GGB","RBB",0,3,3
"3504","run029","GGB","RGR",0,1,1
"3505","run029","GGG","BGB",0,1,1
"3506","run029","GGG","BRR",0,1,1
"3507","run029","GGG","RBR",0,4,4
"3508","run029","GGG","RRR",0,2,2
"3509","run029","GGR","RBB",0,1,1
"3510","run029","GRG","BRB",0,2,2
"3511","run029","GRR","BGG",0,1,1
"3512","run029","GRR","BRB",0,1,1
"3513","run029","RBB","BBB",0,1,1
"3514","run029","RBB","BRB",0,1,1
"3515","run029","RBG","GRR",0,1,1
"3516","run029","RBR","BBB",0,4,4
"3517","run029","RBR","GGB",0,2,2
"3518","run029","RGG","BBB",0,1,1
"3519","run029","RGG","BRR",0,2,2
"3520","run029","RGG","GGR",0,1,1
"3521","run029","RGG","GRR",0,1,1
"3522","run029","RGR","GGR",0,1,1
"3523","run029","RGR","RBB",0,1,1
"3524","run029","RRG","BGG",0,1,1
"3525","run029","RRG","GGR",0,1,1
"3526","run029","RRG","RGG",0,1,1
"3527","run029","RRR","GGR",0,1,1
"3528","run029","RRR","GRR",0,1,1
"3529","run029","RRR","RBR",0,1,1
"3530","run030","BBB","GGG",1,0,1
"3531","run030","BBB","RRG",1,1,2
"3532","run030","BBG","BBB",1,1,2
"3533","run030","BBG","BRB",1,2,3
"3534","run030","BBG","GBG",2,1,3
"3535","run030","BBG","GGB",2,5,7
"3536","run030","BBG","GGG",4,2,6
"3537","run030","BBG","GRG",1,0,1
"3538","run030","BBG","RRG",1,0,1
"3539","run030","BGG","RBG",1,0,1
"3540","run030","BGG","RRR",1,0,1
"3541","run030","BRR","BGB",1,1,2
"3542","run030","GBB","BBB",12,6,18
"3543","run030","GBB","BRB",1,1,2
"3544","run030","GBB","BRR",1,2,3
"3545","run030","GBB","GGG",7,10,17
"3546","run030","GBB","GGR",1,0,1
"3547","run030","GBB","RBG",3,1,4
"3548","run030","GBB","RBR",1,0,1
"3549","run030","GBB","RGG",1,0,1
"3550","run030","GBB","RGR",2,1,3
"3551","run030","GBB","RRR",1,2,3
"3552","run030","GBG","BRB",1,0,1
"3553","run030","GBG","BRR",1,0,1
"3554","run030","GBG","GGG",4,1,5
"3555","run030","GBG","RBB",1,0,1
"3556","run030","GBG","RGR",1,0,1
"3557","run030","GBG","RRG",1,1,2
"3558","run030","GGB","BBB",3,1,4
"3559","run030","GGB","BBR",1,0,1
"3560","run030","GGB","BRR",1,3,4
"3561","run030","GGB","GBG",1,0,1
"3562","run030","GGB","GGG",13,9,22
"3563","run030","GGB","RGG",1,0,1
"3564","run030","GGB","RRG",1,0,1
"3565","run030","GGB","RRR",1,0,1
"3566","run030","GGG","BBB",8,4,12
"3567","run030","GGG","BGG",1,0,1
"3568","run030","GGG","BRB",1,0,1
"3569","run030","GGG","GGB",5,0,5
"3570","run030","GGG","GGR",1,2,3
"3571","run030","GGG","RBB",1,2,3
"3572","run030","GGG","RGR",1,2,3
"3573","run030","GGG","RRG",1,5,6
"3574","run030","GGR","BRR",1,0,1
"3575","run030","GGR","GRR",1,0,1
"3576","run030","GRG","BBB",3,0,3
"3577","run030","GRG","GGB",2,4,6
"3578","run030","GRG","GGG",3,1,4
"3579","run030","GRG","RGR",1,0,1
"3580","run030","GRG","RRG",2,0,2
"3581","run030","GRR","BGB",1,1,2
"3582","run030","RBG","BBB",2,0,2
"3583","run030","RBG","RBB",1,0,1
"3584","run030","RBR","BGB",2,1,3
"3585","run030","RBR","BRB",1,0,1
"3586","run030","RBR","BRR",1,1,2
"3587","run030","RBR","GRR",4,1,5
"3588","run030","RBR","RGG",2,1,3
"3589","run030","RBR","RGR",1,0,1
"3590","run030","RGG","BBR",1,0,1
"3591","run030","RGR","BBB",2,0,2
"3592","run030","RGR","BBR",1,0,1
"3593","run030","RGR","BGB",2,2,4
"3594","run030","RGR","BGG",2,1,3
"3595","run030","RGR","BRR",1,0,1
"3596","run030","RGR","GGB",2,0,2
"3597","run030","RGR","RGG",1,0,1
"3598","run030","RRG","BBB",2,4,6
"3599","run030","RRG","BGB",1,1,2
"3600","run030","RRG","BRB",2,3,5
"3601","run030","RRG","BRR",1,2,3
"3602","run030","RRG","GGG",2,2,4
"3603","run030","RRG","GRG",1,0,1
"3604","run030","RRG","GRR",3,2,5
"3605","run030","RRG","RBB",1,0,1
"3606","run030","RRR","BBR",1,0,1
"3607","run030","RRR","BGB",2,0,2
"3608","run030","RRR","BGG",1,0,1
"3609","run030","RRR","BRB",1,0,1
"3610","run030","RRR","BRR",1,0,1
"3611","run030","RRR","RBB",1,0,1
"3612","run030","RRR","RGR",1,0,1
"3613","run030","RRR","RRG",2,0,2
"3614","run030","BBB","BRB",0,1,1
"3615","run030","BBG","RBB",0,1,1
"3616","run030","BBG","RBG",0,2,2
"3617","run030","BBG","RRR",0,1,1
"3618","run030","BGB","BBB",0,1,1
"3619","run030","BGG","BBB",0,1,1
"3620","run030","BGG","BBR",0,1,1
"3621","run030","BRB","BBB",0,4,4
"3622","run030","BRR","BBB",0,3,3
"3623","run030","GBB","GGB",0,4,4
"3624","run030","GBB","GRG",0,1,1
"3625","run030","GBB","GRR",0,1,1
"3626","run030","GBB","RRG",0,1,1
"3627","run030","GBG","BBB",0,2,2
"3628","run030","GBG","GGB",0,1,1
"3629","run030","GGB","BGG",0,1,1
"3630","run030","GGB","GGR",0,1,1
"3631","run030","GGB","RBG",0,1,1
"3632","run030","GGB","RBR",0,2,2
"3633","run030","GGB","RGR",0,1,1
"3634","run030","GGG","BRR",0,1,1
"3635","run030","GGG","RBG",0,2,2
"3636","run030","GGG","RBR",0,3,3
"3637","run030","GGG","RGG",0,2,2
"3638","run030","GGR","BBB",0,1,1
"3639","run030","GGR","BBR",0,1,1
"3640","run030","GRG","BRR",0,1,1
"3641","run030","GRR","BRR",0,1,1
"3642","run030","RBG","BBG",0,1,1
"3643","run030","RBG","GRR",0,1,1
"3644","run030","RBR","BBB",0,4,4
"3645","run030","RBR","BGG",0,1,1
"3646","run030","RBR","GGB",0,4,4
"3647","run030","RBR","RRR",0,1,1
"3648","run030","RGG","BBB",0,2,2
"3649","run030","RGG","GRR",0,2,2
"3650","run030","RGR","GGG",0,1,1
"3651","run030","RGR","RBB",0,1,1
"3652","run030","RRG","BBR",0,3,3
"3653","run030","RRG","GGR",0,2,2
"3654","run030","RRG","RGR",0,1,1
"3655","run031","BBB","GGG",1,0,1
"3656","run031","BBB","RRG",1,2,3
"3657","run031","BBG","BBB",1,0,1
"3658","run031","BBG","BRB",1,2,3
"3659","run031","BBG","GBG",2,0,2
"3660","run031","BBG","GGB",2,6,8
"3661","run031","BBG","GGG",4,7,11
"3662","run031","BBG","GRG",1,1,2
"3663","run031","BBG","RRG",1,0,1
"3664","run031","BGG","RBG",1,0,1
"3665","run031","BGG","RRR",1,0,1
"3666","run031","BRR","BGB",1,0,1
"3667","run031","GBB","BBB",12,4,16
"3668","run031","GBB","BRB",1,1,2
"3669","run031","GBB","BRR",1,1,2
"3670","run031","GBB","GGG",7,14,21
"3671","run031","GBB","GGR",1,1,2
"3672","run031","GBB","RBG",3,1,4
"3673","run031","GBB","RBR",1,0,1
"3674","run031","GBB","RGG",1,0,1
"3675","run031","GBB","RGR",2,0,2
"3676","run031","GBB","RRR",1,4,5
"3677","run031","GBG","BRB",1,1,2
"3678","run031","GBG","BRR",1,0,1
"3679","run031","GBG","GGG",4,2,6
"3680","run031","GBG","RBB",1,0,1
"3681","run031","GBG","RGR",1,1,2
"3682","run031","GBG","RRG",1,0,1
"3683","run031","GGB","BBB",3,3,6
"3684","run031","GGB","BBR",1,1,2
"3685","run031","GGB","BRR",1,2,3
"3686","run031","GGB","GBG",1,0,1
"3687","run031","GGB","GGG",13,5,18
"3688","run031","GGB","RGG",1,1,2
"3689","run031","GGB","RRG",1,1,2
"3690","run031","GGB","RRR",1,1,2
"3691","run031","GGG","BBB",8,1,9
"3692","run031","GGG","BGG",1,2,3
"3693","run031","GGG","BRB",1,1,2
"3694","run031","GGG","GGB",5,0,5
"3695","run031","GGG","GGR",1,2,3
"3696","run031","GGG","RBB",1,1,2
"3697","run031","GGG","RGR",1,4,5
"3698","run031","GGG","RRG",1,6,7
"3699","run031","GGR","BRR",1,0,1
"3700","run031","GGR","GRR",1,0,1
"3701","run031","GRG","BBB",3,0,3
"3702","run031","GRG","GGB",2,7,9
"3703","run031","GRG","GGG",3,2,5
"3704","run031","GRG","RGR",1,0,1
"3705","run031","GRG","RRG",2,1,3
"3706","run031","GRR","BGB",1,0,1
"3707","run031","RBG","BBB",2,0,2
"3708","run031","RBG","RBB",1,1,2
"3709","run031","RBR","BGB",2,0,2
"3710","run031","RBR","BRB",1,0,1
"3711","run031","RBR","BRR",1,0,1
"3712","run031","RBR","GRR",4,0,4
"3713","run031","RBR","RGG",2,1,3
"3714","run031","RBR","RGR",1,0,1
"3715","run031","RGG","BBR",1,0,1
"3716","run031","RGR","BBB",2,0,2
"3717","run031","RGR","BBR",1,1,2
"3718","run031","RGR","BGB",2,2,4
"3719","run031","RGR","BGG",2,0,2
"3720","run031","RGR","BRR",1,1,2
"3721","run031","RGR","GGB",2,3,5
"3722","run031","RGR","RGG",1,1,2
"3723","run031","RRG","BBB",2,5,7
"3724","run031","RRG","BGB",1,3,4
"3725","run031","RRG","BRB",2,4,6
"3726","run031","RRG","BRR",1,1,2
"3727","run031","RRG","GGG",2,2,4
"3728","run031","RRG","GRG",1,0,1
"3729","run031","RRG","GRR",3,4,7
"3730","run031","RRG","RBB",1,0,1
"3731","run031","RRR","BBR",1,0,1
"3732","run031","RRR","BGB",2,0,2
"3733","run031","RRR","BGG",1,0,1
"3734","run031","RRR","BRB",1,0,1
"3735","run031","RRR","BRR",1,0,1
"3736","run031","RRR","RBB",1,0,1
"3737","run031","RRR","RGR",1,0,1
"3738","run031","RRR","RRG",2,0,2
"3739","run031","BBG","RBR",0,1,1
"3740","run031","BGB","BBB",0,1,1
"3741","run031","BGG","RGG",0,1,1
"3742","run031","BRB","BBB",0,2,2
"3743","run031","BRB","BBR",0,1,1
"3744","run031","BRB","BRR",0,2,2
"3745","run031","BRR","BBB",0,1,1
"3746","run031","GBB","GGB",0,1,1
"3747","run031","GBB","GRG",0,1,1
"3748","run031","GBB","RBB",0,1,1
"3749","run031","GBG","BBB",0,1,1
"3750","run031","GBG","RGG",0,1,1
"3751","run031","GGB","BRB",0,1,1
"3752","run031","GGB","RBG",0,1,1
"3753","run031","GGG","BRR",0,1,1
"3754","run031","GGG","GRR",0,1,1
"3755","run031","GGG","RBR",0,3,3
"3756","run031","GGG","RGG",0,1,1
"3757","run031","GGG","RRR",0,2,2
"3758","run031","GGR","BBB",0,1,1
"3759","run031","GRG","BRB",0,1,1
"3760","run031","GRG","GGR",0,1,1
"3761","run031","RBB","BBB",0,1,1
"3762","run031","RBB","BBR",0,1,1
"3763","run031","RBR","BBR",0,1,1
"3764","run031","RBR","BGG",0,1,1
"3765","run031","RBR","GGB",0,1,1
"3766","run031","RBR","RBB",0,1,1
"3767","run031","RBR","RRR",0,1,1
"3768","run031","RGG","BRR",0,1,1
"3769","run031","RGG","GGG",0,1,1
"3770","run031","RRG","BBR",0,2,2
"3771","run031","RRG","BGG",0,1,1
"3772","run031","RRG","GGR",0,1,1
"3773","run031","RRG","RGR",0,1,1
"3774","run031","RRR","GRR",0,1,1
"3775","run032","BBB","GGG",1,0,1
"3776","run032","BBB","RRG",1,1,2
"3777","run032","BBG","BBB",1,1,2
"3778","run032","BBG","BRB",1,0,1
"3779","run032","BBG","GBG",2,1,3
"3780","run032","BBG","GGB",2,3,5
"3781","run032","BBG","GGG",4,7,11
"3782","run032","BBG","GRG",1,2,3
"3783","run032","BBG","RRG",1,0,1
"3784","run032","BGG","RBG",1,0,1
"3785","run032","BGG","RRR",1,0,1
"3786","run032","BRR","BGB",1,0,1
"3787","run032","GBB","BBB",12,1,13
"3788","run032","GBB","BRB",1,2,3
"3789","run032","GBB","BRR",1,1,2
"3790","run032","GBB","GGG",7,12,19
"3791","run032","GBB","GGR",1,0,1
"3792","run032","GBB","RBG",3,1,4
"3793","run032","GBB","RBR",1,0,1
"3794","run032","GBB","RGG",1,0,1
"3795","run032","GBB","RGR",2,0,2
"3796","run032","GBB","RRR",1,0,1
"3797","run032","GBG","BRB",1,0,1
"3798","run032","GBG","BRR",1,0,1
"3799","run032","GBG","GGG",4,3,7
"3800","run032","GBG","RBB",1,0,1
"3801","run032","GBG","RGR",1,0,1
"3802","run032","GBG","RRG",1,0,1
"3803","run032","GGB","BBB",3,1,4
"3804","run032","GGB","BBR",1,0,1
"3805","run032","GGB","BRR",1,1,2
"3806","run032","GGB","GBG",1,0,1
"3807","run032","GGB","GGG",13,6,19
"3808","run032","GGB","RGG",1,1,2
"3809","run032","GGB","RRG",1,2,3
"3810","run032","GGB","RRR",1,0,1
"3811","run032","GGG","BBB",8,6,14
"3812","run032","GGG","BGG",1,1,2
"3813","run032","GGG","BRB",1,2,3
"3814","run032","GGG","GGB",5,0,5
"3815","run032","GGG","GGR",1,2,3
"3816","run032","GGG","RBB",1,4,5
"3817","run032","GGG","RGR",1,1,2
"3818","run032","GGG","RRG",1,4,5
"3819","run032","GGR","BRR",1,0,1
"3820","run032","GGR","GRR",1,0,1
"3821","run032","GRG","BBB",3,0,3
"3822","run032","GRG","GGB",2,5,7
"3823","run032","GRG","GGG",3,3,6
"3824","run032","GRG","RGR",1,0,1
"3825","run032","GRG","RRG",2,2,4
"3826","run032","GRR","BGB",1,1,2
"3827","run032","RBG","BBB",2,3,5
"3828","run032","RBG","RBB",1,0,1
"3829","run032","RBR","BGB",2,1,3
"3830","run032","RBR","BRB",1,0,1
"3831","run032","RBR","BRR",1,2,3
"3832","run032","RBR","GRR",4,1,5
"3833","run032","RBR","RGG",2,0,2
"3834","run032","RBR","RGR",1,0,1
"3835","run032","RGG","BBR",1,0,1
"3836","run032","RGR","BBB",2,0,2
"3837","run032","RGR","BBR",1,0,1
"3838","run032","RGR","BGB",2,0,2
"3839","run032","RGR","BGG",2,0,2
"3840","run032","RGR","BRR",1,0,1
"3841","run032","RGR","GGB",2,2,4
"3842","run032","RGR","RGG",1,1,2
"3843","run032","RRG","BBB",2,2,4
"3844","run032","RRG","BGB",1,3,4
"3845","run032","RRG","BRB",2,8,10
"3846","run032","RRG","BRR",1,3,4
"3847","run032","RRG","GGG",2,1,3
"3848","run032","RRG","GRG",1,0,1
"3849","run032","RRG","GRR",3,2,5
"3850","run032","RRG","RBB",1,0,1
"3851","run032","RRR","BBR",1,0,1
"3852","run032","RRR","BGB",2,0,2
"3853","run032","RRR","BGG",1,0,1
"3854","run032","RRR","BRB",1,0,1
"3855","run032","RRR","BRR",1,0,1
"3856","run032","RRR","RBB",1,0,1
"3857","run032","RRR","RGR",1,0,1
"3858","run032","RRR","RRG",2,0,2
"3859","run032","BBB","GRR",0,1,1
"3860","run032","BBB","RBG",0,1,1
"3861","run032","BBG","BGG",0,1,1
"3862","run032","BBG","RRR",0,1,1
"3863","run032","BGG","GRG",0,1,1
"3864","run032","BRB","BBB",0,3,3
"3865","run032","BRB","RBB",0,1,1
"3866","run032","BRR","BRB",0,1,1
"3867","run032","BRR","RBB",0,1,1
"3868","run032","GBB","BGG",0,1,1
"3869","run032","GBB","GGB",0,4,4
"3870","run032","GBB","GRG",0,2,2
"3871","run032","GBB","RRG",0,1,1
"3872","run032","GBG","GGB",0,1,1
"3873","run032","GBG","RBG",0,1,1
"3874","run032","GGB","BGG",0,1,1
"3875","run032","GGB","BRB",0,1,1
"3876","run032","GGB","GGR",0,1,1
"3877","run032","GGB","GRR",0,1,1
"3878","run032","GGB","RBB",0,1,1
"3879","run032","GGB","RBG",0,1,1
"3880","run032","GGG","BGB",0,2,2
"3881","run032","GGG","RBG",0,1,1
"3882","run032","GGG","RBR",0,3,3
"3883","run032","GGR","BBR",0,1,1
"3884","run032","GRG","GGR",0,1,1
"3885","run032","GRG","GRR",0,1,1
"3886","run032","GRG","RBG",0,1,1
"3887","run032","RBB","GRR",0,1,1
"3888","run032","RBR","BBB",0,1,1
"3889","run032","RBR","GGB",0,3,3
"3890","run032","RBR","RBB",0,1,1
"3891","run032","RBR","RRR",0,1,1
"3892","run032","RGG","BBB",0,2,2
"3893","run032","RGG","BRR",0,1,1
"3894","run032","RGG","GRR",0,2,2
"3895","run032","RGR","RRG",0,1,1
"3896","run032","RRG","BBR",0,1,1
"3897","run032","RRG","GGR",0,1,1
"3898","run032","RRG","RGG",0,1,1
"3899","run032","RRG","RGR",0,1,1
"3900","run033","BBB","GGG",1,1,2
"3901","run033","BBB","RRG",1,0,1
"3902","run033","BBG","BBB",1,0,1
"3903","run033","BBG","BRB",1,2,3
"3904","run033","BBG","GBG",2,0,2
"3905","run033","BBG","GGB",2,2,4
"3906","run033","BBG","GGG",4,1,5
"3907","run033","BBG","GRG",1,1,2
"3908","run033","BBG","RRG",1,0,1
"3909","run033","BGG","RBG",1,0,1
"3910","run033","BGG","RRR",1,0,1
"3911","run033","BRR","BGB",1,0,1
"3912","run033","GBB","BBB",12,9,21
"3913","run033","GBB","BRB",1,0,1
"3914","run033","GBB","BRR",1,0,1
"3915","run033","GBB","GGG",7,14,21
"3916","run033","GBB","GGR",1,0,1
"3917","run033","GBB","RBG",3,3,6
"3918","run033","GBB","RBR",1,0,1
"3919","run033","GBB","RGG",1,0,1
"3920","run033","GBB","RGR",2,0,2
"3921","run033","GBB","RRR",1,2,3
"3922","run033","GBG","BRB",1,3,4
"3923","run033","GBG","BRR",1,0,1
"3924","run033","GBG","GGG",4,0,4
"3925","run033","GBG","RBB",1,0,1
"3926","run033","GBG","RGR",1,1,2
"3927","run033","GBG","RRG",1,1,2
"3928","run033","GGB","BBB",3,3,6
"3929","run033","GGB","BBR",1,1,2
"3930","run033","GGB","BRR",1,3,4
"3931","run033","GGB","GBG",1,0,1
"3932","run033","GGB","GGG",13,7,20
"3933","run033","GGB","RGG",1,0,1
"3934","run033","GGB","RRG",1,1,2
"3935","run033","GGB","RRR",1,0,1
"3936","run033","GGG","BBB",8,5,13
"3937","run033","GGG","BGG",1,2,3
"3938","run033","GGG","BRB",1,1,2
"3939","run033","GGG","GGB",5,0,5
"3940","run033","GGG","GGR",1,1,2
"3941","run033","GGG","RBB",1,1,2
"3942","run033","GGG","RGR",1,2,3
"3943","run033","GGG","RRG",1,6,7
"3944","run033","GGR","BRR",1,0,1
"3945","run033","GGR","GRR",1,0,1
"3946","run033","GRG","BBB",3,2,5
"3947","run033","GRG","GGB",2,0,2
"3948","run033","GRG","GGG",3,1,4
"3949","run033","GRG","RGR",1,0,1
"3950","run033","GRG","RRG",2,1,3
"3951","run033","GRR","BGB",1,0,1
"3952","run033","RBG","BBB",2,1,3
"3953","run033","RBG","RBB",1,0,1
"3954","run033","RBR","BGB",2,0,2
"3955","run033","RBR","BRB",1,0,1
"3956","run033","RBR","BRR",1,0,1
"3957","run033","RBR","GRR",4,0,4
"3958","run033","RBR","RGG",2,2,4
"3959","run033","RBR","RGR",1,0,1
"3960","run033","RGG","BBR",1,0,1
"3961","run033","RGR","BBB",2,1,3
"3962","run033","RGR","BBR",1,0,1
"3963","run033","RGR","BGB",2,0,2
"3964","run033","RGR","BGG",2,1,3
"3965","run033","RGR","BRR",1,2,3
"3966","run033","RGR","GGB",2,2,4
"3967","run033","RGR","RGG",1,0,1
"3968","run033","RRG","BBB",2,4,6
"3969","run033","RRG","BGB",1,2,3
"3970","run033","RRG","BRB",2,8,10
"3971","run033","RRG","BRR",1,3,4
"3972","run033","RRG","GGG",2,4,6
"3973","run033","RRG","GRG",1,0,1
"3974","run033","RRG","GRR",3,0,3
"3975","run033","RRG","RBB",1,0,1
"3976","run033","RRR","BBR",1,0,1
"3977","run033","RRR","BGB",2,0,2
"3978","run033","RRR","BGG",1,0,1
"3979","run033","RRR","BRB",1,0,1
"3980","run033","RRR","BRR",1,0,1
"3981","run033","RRR","RBB",1,0,1
"3982","run033","RRR","RGR",1,0,1
"3983","run033","RRR","RRG",2,0,2
"3984","run033","BBB","BRB",0,1,1
"3985","run033","BBB","GRR",0,2,2
"3986","run033","BBG","BGG",0,1,1
"3987","run033","BBG","GRR",0,1,1
"3988","run033","BBG","RBG",0,1,1
"3989","run033","BBG","RGR",0,1,1
"3990","run033","BBG","RRR",0,3,3
"3991","run033","BGG","RGG",0,1,1
"3992","run033","BRB","BBB",0,1,1
"3993","run033","BRB","BRR",0,2,2
"3994","run033","BRB","RRR",0,1,1
"3995","run033","BRR","BBB",0,1,1
"3996","run033","BRR","BRB",0,1,1
"3997","run033","GBB","GGB",0,4,4
"3998","run033","GBB","GRG",0,1,1
"3999","run033","GBB","RRG",0,1,1
"4000","run033","GBG","BBB",0,1,1
"4001","run033","GBG","GGB",0,2,2
"4002","run033","GGB","BGG",0,1,1
"4003","run033","GGB","GGR",0,1,1
"4004","run033","GGB","RBB",0,1,1
"4005","run033","GGB","RBR",0,3,3
"4006","run033","GGG","BRR",0,2,2
"4007","run033","GGG","GRR",0,1,1
"4008","run033","GGG","RBR",0,2,2
"4009","run033","GGG","RRR",0,1,1
"4010","run033","GGR","BGG",0,1,1
"4011","run033","GRG","BBR",0,1,1
"4012","run033","GRG","GBG",0,1,1
"4013","run033","GRG","GGR",0,2,2
"4014","run033","GRR","BGG",0,1,1
"4015","run033","RBR","BGG",0,1,1
"4016","run033","RBR","GGB",0,2,2
"4017","run033","RGG","BBB",0,1,1
"4018","run033","RGR","GGG",0,1,1
"4019","run033","RGR","RRG",0,1,1
"4020","run033","RRG","BBR",0,1,1
"4021","run033","RRG","GGR",0,1,1
"4022","run033","RRR","GRR",0,1,1
"4023","run034","BBB","GGG",1,1,2
"4024","run034","BBB","RRG",1,1,2
"4025","run034","BBG","BBB",1,1,2
"4026","run034","BBG","BRB",1,0,1
"4027","run034","BBG","GBG",2,1,3
"4028","run034","BBG","GGB",2,4,6
"4029","run034","BBG","GGG",4,6,10
"4030","run034","BBG","GRG",1,3,4
"4031","run034","BBG","RRG",1,0,1
"4032","run034","BGG","RBG",1,0,1
"4033","run034","BGG","RRR",1,0,1
"4034","run034","BRR","BGB",1,0,1
"4035","run034","GBB","BBB",12,8,20
"4036","run034","GBB","BRB",1,0,1
"4037","run034","GBB","BRR",1,0,1
"4038","run034","GBB","GGG",7,20,27
"4039","run034","GBB","GGR",1,0,1
"4040","run034","GBB","RBG",3,3,6
"4041","run034","GBB","RBR",1,0,1
"4042","run034","GBB","RGG",1,0,1
"4043","run034","GBB","RGR",2,0,2
"4044","run034","GBB","RRR",1,0,1
"4045","run034","GBG","BRB",1,0,1
"4046","run034","GBG","BRR",1,0,1
"4047","run034","GBG","GGG",4,1,5
"4048","run034","GBG","RBB",1,0,1
"4049","run034","GBG","RGR",1,0,1
"4050","run034","GBG","RRG",1,0,1
"4051","run034","GGB","BBB",3,1,4
"4052","run034","GGB","BBR",1,1,2
"4053","run034","GGB","BRR",1,4,5
"4054","run034","GGB","GBG",1,0,1
"4055","run034","GGB","GGG",13,5,18
"4056","run034","GGB","RGG",1,1,2
"4057","run034","GGB","RRG",1,0,1
"4058","run034","GGB","RRR",1,0,1
"4059","run034","GGG","BBB",8,5,13
"4060","run034","GGG","BGG",1,1,2
"4061","run034","GGG","BRB",1,0,1
"4062","run034","GGG","GGB",5,0,5
"4063","run034","GGG","GGR",1,3,4
"4064","run034","GGG","RBB",1,2,3
"4065","run034","GGG","RGR",1,1,2
"4066","run034","GGG","RRG",1,3,4
"4067","run034","GGR","BRR",1,0,1
"4068","run034","GGR","GRR",1,0,1
"4069","run034","GRG","BBB",3,1,4
"4070","run034","GRG","GGB",2,1,3
"4071","run034","GRG","GGG",3,1,4
"4072","run034","GRG","RGR",1,0,1
"4073","run034","GRG","RRG",2,0,2
"4074","run034","GRR","BGB",1,0,1
"4075","run034","RBG","BBB",2,3,5
"4076","run034","RBG","RBB",1,1,2
"4077","run034","RBR","BGB",2,0,2
"4078","run034","RBR","BRB",1,0,1
"4079","run034","RBR","BRR",1,1,2
"4080","run034","RBR","GRR",4,0,4
"4081","run034","RBR","RGG",2,3,5
"4082","run034","RBR","RGR",1,0,1
"4083","run034","RGG","BBR",1,0,1
"4084","run034","RGR","BBB",2,2,4
"4085","run034","RGR","BBR",1,0,1
"4086","run034","RGR","BGB",2,0,2
"4087","run034","RGR","BGG",2,1,3
"4088","run034","RGR","BRR",1,1,2
"4089","run034","RGR","GGB",2,3,5
"4090","run034","RGR","RGG",1,0,1
"4091","run034","RRG","BBB",2,5,7
"4092","run034","RRG","BGB",1,3,4
"4093","run034","RRG","BRB",2,4,6
"4094","run034","RRG","BRR",1,3,4
"4095","run034","RRG","GGG",2,0,2
"4096","run034","RRG","GRG",1,0,1
"4097","run034","RRG","GRR",3,2,5
"4098","run034","RRG","RBB",1,0,1
"4099","run034","RRR","BBR",1,0,1
"4100","run034","RRR","BGB",2,0,2
"4101","run034","RRR","BGG",1,0,1
"4102","run034","RRR","BRB",1,0,1
"4103","run034","RRR","BRR",1,0,1
"4104","run034","RRR","RBB",1,1,2
"4105","run034","RRR","RGR",1,0,1
"4106","run034","RRR","RRG",2,2,4
"4107","run034","BBB","RRR",0,1,1
"4108","run034","BBG","RBG",0,1,1
"4109","run034","BGG","BBB",0,1,1
"4110","run034","BGG","GRG",0,1,1
"4111","run034","BGG","RGG",0,1,1
"4112","run034","BRB","BBB",0,5,5
"4113","run034","BRB","BRR",0,1,1
"4114","run034","BRB","RGR",0,1,1
"4115","run034","BRR","BBB",0,2,2
"4116","run034","GBB","GGB",0,4,4
"4117","run034","GBB","RRG",0,2,2
"4118","run034","GBG","BBB",0,1,1
"4119","run034","GBG","GGB",0,1,1
"4120","run034","GGB","BGB",0,1,1
"4121","run034","GGB","GGR",0,1,1
"4122","run034","GGB","RBB",0,1,1
"4123","run034","GGG","RBG",0,2,2
"4124","run034","GGG","RBR",0,1,1
"4125","run034","GGG","RRR",0,1,1
"4126","run034","GGR","BBB",0,1,1
"4127","run034","GRG","GGR",0,1,1
"4128","run034","GRG","RBR",0,1,1
"4129","run034","GRR","BRB",0,1,1
"4130","run034","GRR","GGR",0,1,1
"4131","run034","RBB","BRB",0,1,1
"4132","run034","RBB","RGG",0,1,1
"4133","run034","RBG","RGR",0,1,1
"4134","run034","RBR","GGB",0,2,2
"4135","run034","RBR","RBB",0,1,1
"4136","run034","RBR","RRR",0,1,1
"4137","run034","RGG","BBB",0,1,1
"4138","run034","RGG","BGB",0,1,1
"4139","run034","RRG","GGR",0,1,1
"4140","run034","RRR","GGR",0,1,1
"4141","run034","RRR","RBR",0,1,1
"4142","run035","BBB","GGG",1,2,3
"4143","run035","BBB","RRG",1,0,1
"4144","run035","BBG","BBB",1,0,1
"4145","run035","BBG","BRB",1,3,4
"4146","run035","BBG","GBG",2,1,3
"4147","run035","BBG","GGB",2,2,4
"4148","run035","BBG","GGG",4,9,13
"4149","run035","BBG","GRG",1,1,2
"4150","run035","BBG","RRG",1,0,1
"4151","run035","BGG","RBG",1,0,1
"4152","run035","BGG","RRR",1,0,1
"4153","run035","BRR","BGB",1,0,1
"4154","run035","GBB","BBB",12,4,16
"4155","run035","GBB","BRB",1,0,1
"4156","run035","GBB","BRR",1,1,2
"4157","run035","GBB","GGG",7,13,20
"4158","run035","GBB","GGR",1,0,1
"4159","run035","GBB","RBG",3,1,4
"4160","run035","GBB","RBR",1,0,1
"4161","run035","GBB","RGG",1,0,1
"4162","run035","GBB","RGR",2,1,3
"4163","run035","GBB","RRR",1,3,4
"4164","run035","GBG","BRB",1,0,1
"4165","run035","GBG","BRR",1,0,1
"4166","run035","GBG","GGG",4,3,7
"4167","run035","GBG","RBB",1,0,1
"4168","run035","GBG","RGR",1,0,1
"4169","run035","GBG","RRG",1,0,1
"4170","run035","GGB","BBB",3,2,5
"4171","run035","GGB","BBR",1,3,4
"4172","run035","GGB","BRR",1,1,2
"4173","run035","GGB","GBG",1,0,1
"4174","run035","GGB","GGG",13,7,20
"4175","run035","GGB","RGG",1,0,1
"4176","run035","GGB","RRG",1,0,1
"4177","run035","GGB","RRR",1,1,2
"4178","run035","GGG","BBB",8,8,16
"4179","run035","GGG","BGG",1,0,1
"4180","run035","GGG","BRB",1,0,1
"4181","run035","GGG","GGB",5,1,6
"4182","run035","GGG","GGR",1,3,4
"4183","run035","GGG","RBB",1,2,3
"4184","run035","GGG","RGR",1,3,4
"4185","run035","GGG","RRG",1,4,5
"4186","run035","GGR","BRR",1,0,1
"4187","run035","GGR","GRR",1,0,1
"4188","run035","GRG","BBB",3,2,5
"4189","run035","GRG","GGB",2,2,4
"4190","run035","GRG","GGG",3,2,5
"4191","run035","GRG","RGR",1,0,1
"4192","run035","GRG","RRG",2,0,2
"4193","run035","GRR","BGB",1,0,1
"4194","run035","RBG","BBB",2,0,2
"4195","run035","RBG","RBB",1,0,1
"4196","run035","RBR","BGB",2,0,2
"4197","run035","RBR","BRB",1,0,1
"4198","run035","RBR","BRR",1,1,2
"4199","run035","RBR","GRR",4,2,6
"4200","run035","RBR","RGG",2,0,2
"4201","run035","RBR","RGR",1,0,1
"4202","run035","RGG","BBR",1,0,1
"4203","run035","RGR","BBB",2,2,4
"4204","run035","RGR","BBR",1,0,1
"4205","run035","RGR","BGB",2,3,5
"4206","run035","RGR","BGG",2,1,3
"4207","run035","RGR","BRR",1,0,1
"4208","run035","RGR","GGB",2,2,4
"4209","run035","RGR","RGG",1,0,1
"4210","run035","RRG","BBB",2,6,8
"4211","run035","RRG","BGB",1,0,1
"4212","run035","RRG","BRB",2,7,9
"4213","run035","RRG","BRR",1,1,2
"4214","run035","RRG","GGG",2,2,4
"4215","run035","RRG","GRG",1,0,1
"4216","run035","RRG","GRR",3,1,4
"4217","run035","RRG","RBB",1,0,1
"4218","run035","RRR","BBR",1,0,1
"4219","run035","RRR","BGB",2,1,3
"4220","run035","RRR","BGG",1,0,1
"4221","run035","RRR","BRB",1,0,1
"4222","run035","RRR","BRR",1,0,1
"4223","run035","RRR","RBB",1,1,2
"4224","run035","RRR","RGR",1,1,2
"4225","run035","RRR","RRG",2,0,2
"4226","run035","BBB","GRR",0,1,1
"4227","run035","BBB","RRR",0,2,2
"4228","run035","BGB","BBB",0,1,1
"4229","run035","BGG","RGG",0,1,1
"4230","run035","BRB","RBG",0,1,1
"4231","run035","BRR","BBB",0,3,3
"4232","run035","GBB","BGG",0,1,1
"4233","run035","GBB","GBG",0,1,1
"4234","run035","GBB","GGB",0,1,1
"4235","run035","GBB","GRG",0,1,1
"4236","run035","GBB","RBB",0,1,1
"4237","run035","GGB","GGR",0,1,1
"4238","run035","GGB","GRR",0,1,1
"4239","run035","GGB","RBB",0,1,1
"4240","run035","GGB","RBG",0,1,1
"4241","run035","GGB","RBR",0,1,1
"4242","run035","GGG","BRR",0,2,2
"4243","run035","GGG","GRR",0,1,1
"4244","run035","GGG","RBG",0,1,1
"4245","run035","GGG","RBR",0,3,3
"4246","run035","GGG","RGG",0,1,1
"4247","run035","GRG","BGG",0,1,1
"4248","run035","GRG","GGR",0,1,1
"4249","run035","GRR","BGG",0,1,1
"4250","run035","GRR","GGR",0,1,1
"4251","run035","RBG","BRR",0,1,1
"4252","run035","RBR","BBB",0,1,1
"4253","run035","RBR","GGB",0,3,3
"4254","run035","RBR","RBB",0,1,1
"4255","run035","RBR","RRR",0,1,1
"4256","run035","RGG","BBB",0,1,1
"4257","run035","RGG","GRR",0,1,1
"4258","run035","RGR","GGR",0,1,1
"4259","run035","RGR","RBB",0,1,1
"4260","run035","RGR","RRG",0,1,1
"4261","run035","RRG","GGR",0,1,1
"4262","run036","BBB","GGG",1,0,1
"4263","run036","BBB","RRG",1,1,2
"4264","run036","BBG","BBB",1,1,2
"4265","run036","BBG","BRB",1,6,7
"4266","run036","BBG","GBG",2,2,4
"4267","run036","BBG","GGB",2,5,7
"4268","run036","BBG","GGG",4,7,11
"4269","run036","BBG","GRG",1,1,2
"4270","run036","BBG","RRG",1,1,2
"4271","run036","BGG","RBG",1,0,1
"4272","run036","BGG","RRR",1,0,1
"4273","run036","BRR","BGB",1,0,1
"4274","run036","GBB","BBB",12,6,18
"4275","run036","GBB","BRB",1,1,2
"4276","run036","GBB","BRR",1,0,1
"4277","run036","GBB","GGG",7,5,12
"4278","run036","GBB","GGR",1,1,2
"4279","run036","GBB","RBG",3,1,4
"4280","run036","GBB","RBR",1,0,1
"4281","run036","GBB","RGG",1,0,1
"4282","run036","GBB","RGR",2,0,2
"4283","run036","GBB","RRR",1,1,2
"4284","run036","GBG","BRB",1,1,2
"4285","run036","GBG","BRR",1,0,1
"4286","run036","GBG","GGG",4,2,6
"4287","run036","GBG","RBB",1,0,1
"4288","run036","GBG","RGR",1,0,1
"4289","run036","GBG","RRG",1,1,2
"4290","run036","GGB","BBB",3,0,3
"4291","run036","GGB","BBR",1,0,1
"4292","run036","GGB","BRR",1,3,4
"4293","run036","GGB","GBG",1,0,1
"4294","run036","GGB","GGG",13,11,24
"4295","run036","GGB","RGG",1,0,1
"4296","run036","GGB","RRG",1,0,1
"4297","run036","GGB","RRR",1,2,3
"4298","run036","GGG","BBB",8,8,16
"4299","run036","GGG","BGG",1,0,1
"4300","run036","GGG","BRB",1,1,2
"4301","run036","GGG","GGB",5,0,5
"4302","run036","GGG","GGR",1,3,4
"4303","run036","GGG","RBB",1,0,1
"4304","run036","GGG","RGR",1,0,1
"4305","run036","GGG","RRG",1,3,4
"4306","run036","GGR","BRR",1,0,1
"4307","run036","GGR","GRR",1,0,1
"4308","run036","GRG","BBB",3,1,4
"4309","run036","GRG","GGB",2,4,6
"4310","run036","GRG","GGG",3,2,5
"4311","run036","GRG","RGR",1,0,1
"4312","run036","GRG","RRG",2,1,3
"4313","run036","GRR","BGB",1,0,1
"4314","run036","RBG","BBB",2,3,5
"4315","run036","RBG","RBB",1,0,1
"4316","run036","RBR","BGB",2,0,2
"4317","run036","RBR","BRB",1,0,1
"4318","run036","RBR","BRR",1,0,1
"4319","run036","RBR","GRR",4,1,5
"4320","run036","RBR","RGG",2,2,4
"4321","run036","RBR","RGR",1,0,1
"4322","run036","RGG","BBR",1,0,1
"4323","run036","RGR","BBB",2,0,2
"4324","run036","RGR","BBR",1,0,1
"4325","run036","RGR","BGB",2,0,2
"4326","run036","RGR","BGG",2,1,3
"4327","run036","RGR","BRR",1,1,2
"4328","run036","RGR","GGB",2,0,2
"4329","run036","RGR","RGG",1,0,1
"4330","run036","RRG","BBB",2,3,5
"4331","run036","RRG","BGB",1,0,1
"4332","run036","RRG","BRB",2,4,6
"4333","run036","RRG","BRR",1,1,2
"4334","run036","RRG","GGG",2,3,5
"4335","run036","RRG","GRG",1,0,1
"4336","run036","RRG","GRR",3,1,4
"4337","run036","RRG","RBB",1,0,1
"4338","run036","RRR","BBR",1,0,1
"4339","run036","RRR","BGB",2,0,2
"4340","run036","RRR","BGG",1,0,1
"4341","run036","RRR","BRB",1,0,1
"4342","run036","RRR","BRR",1,0,1
"4343","run036","RRR","RBB",1,0,1
"4344","run036","RRR","RGR",1,0,1
"4345","run036","RRR","RRG",2,0,2
"4346","run036","BBB","RBG",0,1,1
"4347","run036","BBG","RRR",0,1,1
"4348","run036","BGG","BBR",0,1,1
"4349","run036","BRB","BBB",0,3,3
"4350","run036","BRB","BRR",0,1,1
"4351","run036","BRB","GGR",0,1,1
"4352","run036","BRB","RBB",0,1,1
"4353","run036","BRB","RBG",0,1,1
"4354","run036","BRR","BBB",0,5,5
"4355","run036","BRR","RBB",0,1,1
"4356","run036","GBB","GBG",0,2,2
"4357","run036","GBB","GRG",0,1,1
"4358","run036","GBB","RBB",0,1,1
"4359","run036","GBG","RGG",0,1,1
"4360","run036","GGB","GGR",0,1,1
"4361","run036","GGB","GRR",0,1,1
"4362","run036","GGB","RBR",0,1,1
"4363","run036","GGG","RBG",0,3,3
"4364","run036","GGG","RBR",0,4,4
"4365","run036","GRG","BBR",0,1,1
"4366","run036","GRG","BRB",0,1,1
"4367","run036","GRG","GGR",0,1,1
"4368","run036","RBB","BBB",0,1,1
"4369","run036","RBG","GRR",0,2,2
"4370","run036","RBR","BBB",0,2,2
"4371","run036","RBR","BGG",0,1,1
"4372","run036","RBR","GGB",0,2,2
"4373","run036","RBR","RBB",0,2,2
"4374","run036","RGG","BBB",0,1,1
"4375","run036","RGG","GGR",0,2,2
"4376","run036","RGG","GRR",0,1,1
"4377","run036","RGR","GGR",0,2,2
"4378","run036","RGR","RBB",0,3,3
"4379","run036","RRG","BGG",0,1,1
"4380","run036","RRG","GGR",0,1,1
"4381","run036","RRG","RGR",0,1,1
"4382","run036","RRR","GRR",0,1,1
"4383","run036","RRR","RGG",0,1,1
"4384","run037","BBB","GGG",1,0,1
"4385","run037","BBB","RRG",1,1,2
"4386","run037","BBG","BBB",1,0,1
"4387","run037","BBG","BRB",1,1,2
"4388","run037","BBG","GBG",2,2,4
"4389","run037","BBG","GGB",2,4,6
"4390","run037","BBG","GGG",4,5,9
"4391","run037","BBG","GRG",1,0,1
"4392","run037","BBG","RRG",1,0,1
"4393","run037","BGG","RBG",1,0,1
"4394","run037","BGG","RRR",1,0,1
"4395","run037","BRR","BGB",1,0,1
"4396","run037","GBB","BBB",12,11,23
"4397","run037","GBB","BRB",1,1,2
"4398","run037","GBB","BRR",1,1,2
"4399","run037","GBB","GGG",7,10,17
"4400","run037","GBB","GGR",1,1,2
"4401","run037","GBB","RBG",3,3,6
"4402","run037","GBB","RBR",1,0,1
"4403","run037","GBB","RGG",1,0,1
"4404","run037","GBB","RGR",2,0,2
"4405","run037","GBB","RRR",1,2,3
"4406","run037","GBG","BRB",1,1,2
"4407","run037","GBG","BRR",1,0,1
"4408","run037","GBG","GGG",4,3,7
"4409","run037","GBG","RBB",1,0,1
"4410","run037","GBG","RGR",1,0,1
"4411","run037","GBG","RRG",1,0,1
"4412","run037","GGB","BBB",3,2,5
"4413","run037","GGB","BBR",1,0,1
"4414","run037","GGB","BRR",1,1,2
"4415","run037","GGB","GBG",1,0,1
"4416","run037","GGB","GGG",13,4,17
"4417","run037","GGB","RGG",1,0,1
"4418","run037","GGB","RRG",1,1,2
"4419","run037","GGB","RRR",1,1,2
"4420","run037","GGG","BBB",8,5,13
"4421","run037","GGG","BGG",1,0,1
"4422","run037","GGG","BRB",1,0,1
"4423","run037","GGG","GGB",5,0,5
"4424","run037","GGG","GGR",1,1,2
"4425","run037","GGG","RBB",1,0,1
"4426","run037","GGG","RGR",1,2,3
"4427","run037","GGG","RRG",1,5,6
"4428","run037","GGR","BRR",1,0,1
"4429","run037","GGR","GRR",1,0,1
"4430","run037","GRG","BBB",3,2,5
"4431","run037","GRG","GGB",2,5,7
"4432","run037","GRG","GGG",3,3,6
"4433","run037","GRG","RGR",1,0,1
"4434","run037","GRG","RRG",2,0,2
"4435","run037","GRR","BGB",1,0,1
"4436","run037","RBG","BBB",2,0,2
"4437","run037","RBG","RBB",1,0,1
"4438","run037","RBR","BGB",2,0,2
"4439","run037","RBR","BRB",1,0,1
"4440","run037","RBR","BRR",1,1,2
"4441","run037","RBR","GRR",4,1,5
"4442","run037","RBR","RGG",2,0,2
"4443","run037","RBR","RGR",1,0,1
"4444","run037","RGG","BBR",1,0,1
"4445","run037","RGR","BBB",2,1,3
"4446","run037","RGR","BBR",1,0,1
"4447","run037","RGR","BGB",2,2,4
"4448","run037","RGR","BGG",2,1,3
"4449","run037","RGR","BRR",1,2,3
"4450","run037","RGR","GGB",2,2,4
"4451","run037","RGR","RGG",1,0,1
"4452","run037","RRG","BBB",2,4,6
"4453","run037","RRG","BGB",1,2,3
"4454","run037","RRG","BRB",2,5,7
"4455","run037","RRG","BRR",1,3,4
"4456","run037","RRG","GGG",2,3,5
"4457","run037","RRG","GRG",1,0,1
"4458","run037","RRG","GRR",3,1,4
"4459","run037","RRG","RBB",1,1,2
"4460","run037","RRR","BBR",1,0,1
"4461","run037","RRR","BGB",2,0,2
"4462","run037","RRR","BGG",1,0,1
"4463","run037","RRR","BRB",1,1,2
"4464","run037","RRR","BRR",1,1,2
"4465","run037","RRR","RBB",1,1,2
"4466","run037","RRR","RGR",1,0,1
"4467","run037","RRR","RRG",2,0,2
"4468","run037","BBB","GRR",0,1,1
"4469","run037","BBG","BGG",0,1,1
"4470","run037","BBG","RRR",0,2,2
"4471","run037","BGG","BBB",0,2,2
"4472","run037","BGG","GRG",0,1,1
"4473","run037","BGG","RGG",0,1,1
"4474","run037","BRB","BBB",0,2,2
"4475","run037","BRR","BBB",0,3,3
"4476","run037","BRR","BRB",0,1,1
"4477","run037","GBB","BGG",0,1,1
"4478","run037","GBB","GBG",0,2,2
"4479","run037","GBB","GGB",0,3,3
"4480","run037","GBB","GRG",0,1,1
"4481","run037","GBB","RBB",0,1,1
"4482","run037","GGB","GRR",0,1,1
"4483","run037","GGB","RBB",0,1,1
"4484","run037","GGB","RBG",0,1,1
"4485","run037","GGB","RGR",0,2,2
"4486","run037","GGG","BGB",0,1,1
"4487","run037","GGG","BRR",0,2,2
"4488","run037","GGG","RBR",0,3,3
"4489","run037","GGG","RGG",0,1,1
"4490","run037","GGR","RBB",0,1,1
"4491","run037","GRG","BGG",0,1,1
"4492","run037","GRG","BRR",0,1,1
"4493","run037","GRG","GGR",0,2,2
"4494","run037","GRG","GRR",0,1,1
"4495","run037","RBR","BBB",0,3,3
"4496","run037","RGG","BBB",0,2,2
"4497","run037","RGG","BRR",0,2,2
"4498","run037","RGG","GGG",0,1,1
"4499","run037","RGR","RBB",0,1,1
"4500","run037","RRR","RBR",0,1,1
"4501","run038","BBB","GGG",1,0,1
"4502","run038","BBB","RRG",1,0,1
"4503","run038","BBG","BBB",1,1,2
"4504","run038","BBG","BRB",1,2,3
"4505","run038","BBG","GBG",2,1,3
"4506","run038","BBG","GGB",2,3,5
"4507","run038","BBG","GGG",4,8,12
"4508","run038","BBG","GRG",1,1,2
"4509","run038","BBG","RRG",1,0,1
"4510","run038","BGG","RBG",1,0,1
"4511","run038","BGG","RRR",1,1,2
"4512","run038","BRR","BGB",1,0,1
"4513","run038","GBB","BBB",12,8,20
"4514","run038","GBB","BRB",1,1,2
"4515","run038","GBB","BRR",1,0,1
"4516","run038","GBB","GGG",7,12,19
"4517","run038","GBB","GGR",1,0,1
"4518","run038","GBB","RBG",3,1,4
"4519","run038","GBB","RBR",1,0,1
"4520","run038","GBB","RGG",1,0,1
"4521","run038","GBB","RGR",2,0,2
"4522","run038","GBB","RRR",1,0,1
"4523","run038","GBG","BRB",1,1,2
"4524","run038","GBG","BRR",1,0,1
"4525","run038","GBG","GGG",4,2,6
"4526","run038","GBG","RBB",1,0,1
"4527","run038","GBG","RGR",1,0,1
"4528","run038","GBG","RRG",1,0,1
"4529","run038","GGB","BBB",3,1,4
"4530","run038","GGB","BBR",1,0,1
"4531","run038","GGB","BRR",1,3,4
"4532","run038","GGB","GBG",1,0,1
"4533","run038","GGB","GGG",13,7,20
"4534","run038","GGB","RGG",1,0,1
"4535","run038","GGB","RRG",1,1,2
"4536","run038","GGB","RRR",1,1,2
"4537","run038","GGG","BBB",8,7,15
"4538","run038","GGG","BGG",1,2,3
"4539","run038","GGG","BRB",1,1,2
"4540","run038","GGG","GGB",5,0,5
"4541","run038","GGG","GGR",1,0,1
"4542","run038","GGG","RBB",1,2,3
"4543","run038","GGG","RGR",1,2,3
"4544","run038","GGG","RRG",1,3,4
"4545","run038","GGR","BRR",1,0,1
"4546","run038","GGR","GRR",1,0,1
"4547","run038","GRG","BBB",3,2,5
"4548","run038","GRG","GGB",2,1,3
"4549","run038","GRG","GGG",3,3,6
"4550","run038","GRG","RGR",1,0,1
"4551","run038","GRG","RRG",2,0,2
"4552","run038","GRR","BGB",1,0,1
"4553","run038","RBG","BBB",2,0,2
"4554","run038","RBG","RBB",1,0,1
"4555","run038","RBR","BGB",2,1,3
"4556","run038","RBR","BRB",1,0,1
"4557","run038","RBR","BRR",1,0,1
"4558","run038","RBR","GRR",4,0,4
"4559","run038","RBR","RGG",2,2,4
"4560","run038","RBR","RGR",1,0,1
"4561","run038","RGG","BBR",1,0,1
"4562","run038","RGR","BBB",2,1,3
"4563","run038","RGR","BBR",1,0,1
"4564","run038","RGR","BGB",2,0,2
"4565","run038","RGR","BGG",2,1,3
"4566","run038","RGR","BRR",1,1,2
"4567","run038","RGR","GGB",2,0,2
"4568","run038","RGR","RGG",1,0,1
"4569","run038","RRG","BBB",2,6,8
"4570","run038","RRG","BGB",1,3,4
"4571","run038","RRG","BRB",2,7,9
"4572","run038","RRG","BRR",1,3,4
"4573","run038","RRG","GGG",2,3,5
"4574","run038","RRG","GRG",1,0,1
"4575","run038","RRG","GRR",3,1,4
"4576","run038","RRG","RBB",1,0,1
"4577","run038","RRR","BBR",1,0,1
"4578","run038","RRR","BGB",2,0,2
"4579","run038","RRR","BGG",1,0,1
"4580","run038","RRR","BRB",1,0,1
"4581","run038","RRR","BRR",1,0,1
"4582","run038","RRR","RBB",1,0,1
"4583","run038","RRR","RGR",1,0,1
"4584","run038","RRR","RRG",2,1,3
"4585","run038","BBB","RBG",0,1,1
"4586","run038","BBG","RGR",0,1,1
"4587","run038","BBG","RRR",0,2,2
"4588","run038","BGG","BBR",0,1,1
"4589","run038","BGG","GRG",0,1,1
"4590","run038","BRR","BBB",0,3,3
"4591","run038","BRR","BGG",0,1,1
"4592","run038","GBB","GGB",0,1,1
"4593","run038","GBB","GRG",0,1,1
"4594","run038","GBG","BBB",0,1,1
"4595","run038","GBG","BBR",0,1,1
"4596","run038","GBG","GGB",0,1,1
"4597","run038","GGB","GGR",0,3,3
"4598","run038","GGB","RBB",0,2,2
"4599","run038","GGB","RBG",0,1,1
"4600","run038","GGB","RBR",0,3,3
"4601","run038","GGG","BRR",0,1,1
"4602","run038","GGG","RBG",0,1,1
"4603","run038","GGG","RBR",0,2,2
"4604","run038","GGG","RGG",0,1,1
"4605","run038","GGG","RRR",0,1,1
"4606","run038","GRG","BGG",0,1,1
"4607","run038","GRG","BRR",0,1,1
"4608","run038","GRG","GGR",0,1,1
"4609","run038","GRR","BGG",0,1,1
"4610","run038","GRR","BRB",0,1,1
"4611","run038","RBB","RGG",0,1,1
"4612","run038","RBR","BBB",0,3,3
"4613","run038","RBR","GGB",0,2,2
"4614","run038","RBR","RBB",0,1,1
"4615","run038","RGG","BBB",0,3,3
"4616","run038","RGG","BRR",0,1,1
"4617","run038","RGG","GGR",0,1,1
"4618","run038","RGG","GRR",0,2,2
"4619","run038","RGR","GGR",0,1,1
"4620","run038","RRR","GRR",0,1,1
"4621","run038","RRR","RBR",0,1,1
"4622","run039","BBB","GGG",1,0,1
"4623","run039","BBB","RRG",1,3,4
"4624","run039","BBG","BBB",1,0,1
"4625","run039","BBG","BRB",1,0,1
"4626","run039","BBG","GBG",2,3,5
"4627","run039","BBG","GGB",2,2,4
"4628","run039","BBG","GGG",4,7,11
"4629","run039","BBG","GRG",1,2,3
"4630","run039","BBG","RRG",1,1,2
"4631","run039","BGG","RBG",1,0,1
"4632","run039","BGG","RRR",1,0,1
"4633","run039","BRR","BGB",1,0,1
"4634","run039","GBB","BBB",12,5,17
"4635","run039","GBB","BRB",1,0,1
"4636","run039","GBB","BRR",1,0,1
"4637","run039","GBB","GGG",7,12,19
"4638","run039","GBB","GGR",1,0,1
"4639","run039","GBB","RBG",3,2,5
"4640","run039","GBB","RBR",1,0,1
"4641","run039","GBB","RGG",1,0,1
"4642","run039","GBB","RGR",2,0,2
"4643","run039","GBB","RRR",1,1,2
"4644","run039","GBG","BRB",1,0,1
"4645","run039","GBG","BRR",1,0,1
"4646","run039","GBG","GGG",4,4,8
"4647","run039","GBG","RBB",1,0,1
"4648","run039","GBG","RGR",1,1,2
"4649","run039","GBG","RRG",1,0,1
"4650","run039","GGB","BBB",3,4,7
"4651","run039","GGB","BBR",1,1,2
"4652","run039","GGB","BRR",1,2,3
"4653","run039","GGB","GBG",1,0,1
"4654","run039","GGB","GGG",13,10,23
"4655","run039","GGB","RGG",1,0,1
"4656","run039","GGB","RRG",1,1,2
"4657","run039","GGB","RRR",1,2,3
"4658","run039","GGG","BBB",8,6,14
"4659","run039","GGG","BGG",1,3,4
"4660","run039","GGG","BRB",1,0,1
"4661","run039","GGG","GGB",5,0,5
"4662","run039","GGG","GGR",1,2,3
"4663","run039","GGG","RBB",1,0,1
"4664","run039","GGG","RGR",1,0,1
"4665","run039","GGG","RRG",1,1,2
"4666","run039","GGR","BRR",1,0,1
"4667","run039","GGR","GRR",1,0,1
"4668","run039","GRG","BBB",3,2,5
"4669","run039","GRG","GGB",2,4,6
"4670","run039","GRG","GGG",3,2,5
"4671","run039","GRG","RGR",1,0,1
"4672","run039","GRG","RRG",2,0,2
"4673","run039","GRR","BGB",1,1,2
"4674","run039","RBG","BBB",2,1,3
"4675","run039","RBG","RBB",1,1,2
"4676","run039","RBR","BGB",2,2,4
"4677","run039","RBR","BRB",1,0,1
"4678","run039","RBR","BRR",1,0,1
"4679","run039","RBR","GRR",4,0,4
"4680","run039","RBR","RGG",2,2,4
"4681","run039","RBR","RGR",1,0,1
"4682","run039","RGG","BBR",1,1,2
"4683","run039","RGR","BBB",2,0,2
"4684","run039","RGR","BBR",1,0,1
"4685","run039","RGR","BGB",2,1,3
"4686","run039","RGR","BGG",2,1,3
"4687","run039","RGR","BRR",1,0,1
"4688","run039","RGR","GGB",2,2,4
"4689","run039","RGR","RGG",1,0,1
"4690","run039","RRG","BBB",2,3,5
"4691","run039","RRG","BGB",1,1,2
"4692","run039","RRG","BRB",2,8,10
"4693","run039","RRG","BRR",1,2,3
"4694","run039","RRG","GGG",2,2,4
"4695","run039","RRG","GRG",1,0,1
"4696","run039","RRG","GRR",3,0,3
"4697","run039","RRG","RBB",1,0,1
"4698","run039","RRR","BBR",1,0,1
"4699","run039","RRR","BGB",2,0,2
"4700","run039","RRR","BGG",1,0,1
"4701","run039","RRR","BRB",1,0,1
"4702","run039","RRR","BRR",1,0,1
"4703","run039","RRR","RBB",1,0,1
"4704","run039","RRR","RGR",1,0,1
"4705","run039","RRR","RRG",2,0,2
"4706","run039","BBB","GRR",0,1,1
"4707","run039","BBB","RBG",0,1,1
"4708","run039","BBG","RBG",0,1,1
"4709","run039","BBG","RRR",0,1,1
"4710","run039","BGG","GRG",0,1,1
"4711","run039","BGG","RGG",0,1,1
"4712","run039","BRB","BBB",0,2,2
"4713","run039","BRB","BBR",0,1,1
"4714","run039","BRR","BBB",0,2,2
"4715","run039","BRR","BRB",0,1,1
"4716","run039","GBB","GBG",0,1,1
"4717","run039","GBB","GGB",0,1,1
"4718","run039","GBB","RRG",0,1,1
"4719","run039","GBG","GGB",0,1,1
"4720","run039","GGB","BGG",0,1,1
"4721","run039","GGB","RBR",0,2,2
"4722","run039","GGG","BGB",0,1,1
"4723","run039","GGG","BRR",0,2,2
"4724","run039","GGG","RBG",0,2,2
"4725","run039","GGG","RBR",0,1,1
"4726","run039","GGG","RGG",0,1,1
"4727","run039","GGG","RRR",0,1,1
"4728","run039","GRG","RBR",0,1,1
"4729","run039","GRR","BBR",0,1,1
"4730","run039","GRR","BGG",0,1,1
"4731","run039","RBG","GBB",0,1,1
"4732","run039","RBG","GRR",0,1,1
"4733","run039","RBR","BBB",0,2,2
"4734","run039","RBR","GGB",0,3,3
"4735","run039","RBR","RBB",0,1,1
"4736","run039","RGG","BRR",0,2,2
"4737","run039","RGG","GGR",0,1,1
"4738","run039","RGG","GRR",0,1,1
"4739","run039","RGR","RBB",0,2,2
"4740","run039","RGR","RRG",0,1,1
"4741","run039","RRG","RGR",0,1,1
"4742","run039","RRR","GRR",0,2,2
"4743","run039","RRR","RGG",0,1,1
"4744","run040","BBB","GGG",1,1,2
"4745","run040","BBB","RRG",1,0,1
"4746","run040","BBG","BBB",1,1,2
"4747","run040","BBG","BRB",1,1,2
"4748","run040","BBG","GBG",2,0,2
"4749","run040","BBG","GGB",2,4,6
"4750","run040","BBG","GGG",4,5,9
"4751","run040","BBG","GRG",1,2,3
"4752","run040","BBG","RRG",1,0,1
"4753","run040","BGG","RBG",1,0,1
"4754","run040","BGG","RRR",1,0,1
"4755","run040","BRR","BGB",1,1,2
"4756","run040","GBB","BBB",12,3,15
"4757","run040","GBB","BRB",1,2,3
"4758","run040","GBB","BRR",1,0,1
"4759","run040","GBB","GGG",7,7,14
"4760","run040","GBB","GGR",1,0,1
"4761","run040","GBB","RBG",3,0,3
"4762","run040","GBB","RBR",1,0,1
"4763","run040","GBB","RGG",1,0,1
"4764","run040","GBB","RGR",2,0,2
"4765","run040","GBB","RRR",1,1,2
"4766","run040","GBG","BRB",1,1,2
"4767","run040","GBG","BRR",1,0,1
"4768","run040","GBG","GGG",4,2,6
"4769","run040","GBG","RBB",1,0,1
"4770","run040","GBG","RGR",1,1,2
"4771","run040","GBG","RRG",1,0,1
"4772","run040","GGB","BBB",3,1,4
"4773","run040","GGB","BBR",1,0,1
"4774","run040","GGB","BRR",1,2,3
"4775","run040","GGB","GBG",1,0,1
"4776","run040","GGB","GGG",13,9,22
"4777","run040","GGB","RGG",1,0,1
"4778","run040","GGB","RRG",1,1,2
"4779","run040","GGB","RRR",1,2,3
"4780","run040","GGG","BBB",8,3,11
"4781","run040","GGG","BGG",1,1,2
"4782","run040","GGG","BRB",1,1,2
"4783","run040","GGG","GGB",5,0,5
"4784","run040","GGG","GGR",1,2,3
"4785","run040","GGG","RBB",1,1,2
"4786","run040","GGG","RGR",1,3,4
"4787","run040","GGG","RRG",1,3,4
"4788","run040","GGR","BRR",1,0,1
"4789","run040","GGR","GRR",1,0,1
"4790","run040","GRG","BBB",3,2,5
"4791","run040","GRG","GGB",2,4,6
"4792","run040","GRG","GGG",3,2,5
"4793","run040","GRG","RGR",1,1,2
"4794","run040","GRG","RRG",2,0,2
"4795","run040","GRR","BGB",1,0,1
"4796","run040","RBG","BBB",2,0,2
"4797","run040","RBG","RBB",1,0,1
"4798","run040","RBR","BGB",2,2,4
"4799","run040","RBR","BRB",1,0,1
"4800","run040","RBR","BRR",1,1,2
"4801","run040","RBR","GRR",4,0,4
"4802","run040","RBR","RGG",2,2,4
"4803","run040","RBR","RGR",1,0,1
"4804","run040","RGG","BBR",1,0,1
"4805","run040","RGR","BBB",2,0,2
"4806","run040","RGR","BBR",1,0,1
"4807","run040","RGR","BGB",2,2,4
"4808","run040","RGR","BGG",2,0,2
"4809","run040","RGR","BRR",1,0,1
"4810","run040","RGR","GGB",2,3,5
"4811","run040","RGR","RGG",1,0,1
"4812","run040","RRG","BBB",2,8,10
"4813","run040","RRG","BGB",1,1,2
"4814","run040","RRG","BRB",2,6,8
"4815","run040","RRG","BRR",1,5,6
"4816","run040","RRG","GGG",2,0,2
"4817","run040","RRG","GRG",1,0,1
"4818","run040","RRG","GRR",3,1,4
"4819","run040","RRG","RBB",1,0,1
"4820","run040","RRR","BBR",1,0,1
"4821","run040","RRR","BGB",2,0,2
"4822","run040","RRR","BGG",1,0,1
"4823","run040","RRR","BRB",1,0,1
"4824","run040","RRR","BRR",1,0,1
"4825","run040","RRR","RBB",1,1,2
"4826","run040","RRR","RGR",1,0,1
"4827","run040","RRR","RRG",2,0,2
"4828","run040","BBG","RRR",0,1,1
"4829","run040","BGB","BBB",0,1,1
"4830","run040","BGG","BBB",0,2,2
"4831","run040","BGG","RGR",0,1,1
"4832","run040","BRB","BBB",0,2,2
"4833","run040","BRB","GGG",0,1,1
"4834","run040","BRB","RGR",0,1,1
"4835","run040","BRR","BBB",0,4,4
"4836","run040","BRR","BGG",0,1,1
"4837","run040","BRR","RBB",0,1,1
"4838","run040","GBB","GGB",0,2,2
"4839","run040","GBB","GRG",0,1,1
"4840","run040","GBG","BBB",0,2,2
"4841","run040","GBG","BBR",0,1,1
"4842","run040","GBG","GGB",0,2,2
"4843","run040","GGB","BGG",0,3,3
"4844","run040","GGB","GBB",0,1,1
"4845","run040","GGB","GRR",0,1,1
"4846","run040","GGB","RBG",0,2,2
"4847","run040","GGG","BRR",0,3,3
"4848","run040","GGG","RBG",0,2,2
"4849","run040","GGG","RBR",0,2,2
"4850","run040","GGG","RRR",0,2,2
"4851","run040","GGR","BBR",0,1,1
"4852","run040","GRG","GGR",0,1,1
"4853","run040","GRG","GRR",0,1,1
"4854","run040","RBR","BBB",0,3,3
"4855","run040","RBR","BGG",0,1,1
"4856","run040","RBR","GGB",0,2,2
"4857","run040","RGG","BBB",0,1,1
"4858","run040","RGG","BRR",0,1,1
"4859","run040","RGG","GRR",0,3,3
"4860","run040","RGR","GGG",0,1,1
"4861","run040","RRG","GGR",0,1,1
"4862","run040","RRR","GRR",0,2,2
"4863","run040","RRR","RBR",0,1,1
"4864","run041","BBB","GGG",1,0,1
"4865","run041","BBB","RRG",1,1,2
"4866","run041","BBG","BBB",1,0,1
"4867","run041","BBG","BRB",1,1,2
"4868","run041","BBG","GBG",2,1,3
"4869","run041","BBG","GGB",2,3,5
"4870","run041","BBG","GGG",4,7,11
"4871","run041","BBG","GRG",1,1,2
"4872","run041","BBG","RRG",1,1,2
"4873","run041","BGG","RBG",1,0,1
"4874","run041","BGG","RRR",1,0,1
"4875","run041","BRR","BGB",1,0,1
"4876","run041","GBB","BBB",12,6,18
"4877","run041","GBB","BRB",1,1,2
"4878","run041","GBB","BRR",1,0,1
"4879","run041","GBB","GGG",7,12,19
"4880","run041","GBB","GGR",1,0,1
"4881","run041","GBB","RBG",3,1,4
"4882","run041","GBB","RBR",1,0,1
"4883","run041","GBB","RGG",1,0,1
"4884","run041","GBB","RGR",2,0,2
"4885","run041","GBB","RRR",1,2,3
"4886","run041","GBG","BRB",1,0,1
"4887","run041","GBG","BRR",1,0,1
"4888","run041","GBG","GGG",4,2,6
"4889","run041","GBG","RBB",1,0,1
"4890","run041","GBG","RGR",1,0,1
"4891","run041","GBG","RRG",1,0,1
"4892","run041","GGB","BBB",3,6,9
"4893","run041","GGB","BBR",1,0,1
"4894","run041","GGB","BRR",1,2,3
"4895","run041","GGB","GBG",1,0,1
"4896","run041","GGB","GGG",13,8,21
"4897","run041","GGB","RGG",1,1,2
"4898","run041","GGB","RRG",1,0,1
"4899","run041","GGB","RRR",1,0,1
"4900","run041","GGG","BBB",8,6,14
"4901","run041","GGG","BGG",1,1,2
"4902","run041","GGG","BRB",1,0,1
"4903","run041","GGG","GGB",5,0,5
"4904","run041","GGG","GGR",1,2,3
"4905","run041","GGG","RBB",1,0,1
"4906","run041","GGG","RGR",1,2,3
"4907","run041","GGG","RRG",1,2,3
"4908","run041","GGR","BRR",1,0,1
"4909","run041","GGR","GRR",1,0,1
"4910","run041","GRG","BBB",3,1,4
"4911","run041","GRG","GGB",2,1,3
"4912","run041","GRG","GGG",3,3,6
"4913","run041","GRG","RGR",1,0,1
"4914","run041","GRG","RRG",2,0,2
"4915","run041","GRR","BGB",1,0,1
"4916","run041","RBG","BBB",2,1,3
"4917","run041","RBG","RBB",1,0,1
"4918","run041","RBR","BGB",2,0,2
"4919","run041","RBR","BRB",1,0,1
"4920","run041","RBR","BRR",1,0,1
"4921","run041","RBR","GRR",4,0,4
"4922","run041","RBR","RGG",2,1,3
"4923","run041","RBR","RGR",1,0,1
"4924","run041","RGG","BBR",1,0,1
"4925","run041","RGR","BBB",2,1,3
"4926","run041","RGR","BBR",1,0,1
"4927","run041","RGR","BGB",2,1,3
"4928","run041","RGR","BGG",2,1,3
"4929","run041","RGR","BRR",1,2,3
"4930","run041","RGR","GGB",2,2,4
"4931","run041","RGR","RGG",1,0,1
"4932","run041","RRG","BBB",2,5,7
"4933","run041","RRG","BGB",1,0,1
"4934","run041","RRG","BRB",2,9,11
"4935","run041","RRG","BRR",1,2,3
"4936","run041","RRG","GGG",2,4,6
"4937","run041","RRG","GRG",1,0,1
"4938","run041","RRG","GRR",3,2,5
"4939","run041","RRG","RBB",1,0,1
"4940","run041","RRR","BBR",1,0,1
"4941","run041","RRR","BGB",2,1,3
"4942","run041","RRR","BGG",1,0,1
"4943","run041","RRR","BRB",1,0,1
"4944","run041","RRR","BRR",1,1,2
"4945","run041","RRR","RBB",1,1,2
"4946","run041","RRR","RGR",1,2,3
"4947","run041","RRR","RRG",2,0,2
"4948","run041","BBB","BRB",0,1,1
"4949","run041","BBB","RBG",0,1,1
"4950","run041","BBG","BGG",0,1,1
"4951","run041","BBG","RGR",0,1,1
"4952","run041","BBG","RRR",0,1,1
"4953","run041","BRB","BBB",0,1,1
"4954","run041","BRB","BRR",0,1,1
"4955","run041","BRB","GGR",0,1,1
"4956","run041","BRB","RBB",0,1,1
"4957","run041","BRB","RBG",0,1,1
"4958","run041","BRR","BBB",0,4,4
"4959","run041","GBB","GBG",0,1,1
"4960","run041","GBB","GGB",0,4,4
"4961","run041","GBB","GRG",0,1,1
"4962","run041","GBG","BBB",0,1,1
"4963","run041","GGB","GRR",0,1,1
"4964","run041","GGB","RBB",0,3,3
"4965","run041","GGB","RBG",0,1,1
"4966","run041","GGG","BRR",0,1,1
"4967","run041","GGG","RBR",0,3,3
"4968","run041","GGG","RGG",0,1,1
"4969","run041","GGG","RRR",0,1,1
"4970","run041","GRG","RBR",0,1,1
"4971","run041","GRR","BBB",0,1,1
"4972","run041","GRR","BGG",0,2,2
"4973","run041","RBB","GRR",0,1,1
"4974","run041","RBG","GBB",0,1,1
"4975","run041","RBG","RGR",0,1,1
"4976","run041","RBR","BBB",0,1,1
"4977","run041","RBR","GGB",0,1,1
"4978","run041","RGG","GGR",0,1,1
"4979","run041","RGG","GRR",0,3,3
"4980","run041","RGR","GGG",0,1,1
"4981","run041","RGR","RBB",0,1,1
"4982","run041","RRG","BBR",0,1,1
"4983","run041","RRG","BGG",0,1,1
"4984","run041","RRR","GRR",0,1,1
"4985","run042","BBB","GGG",1,0,1
"4986","run042","BBB","RRG",1,1,2
"4987","run042","BBG","BBB",1,1,2
"4988","run042","BBG","BRB",1,3,4
"4989","run042","BBG","GBG",2,2,4
"4990","run042","BBG","GGB",2,4,6
"4991","run042","BBG","GGG",4,2,6
"4992","run042","BBG","GRG",1,0,1
"4993","run042","BBG","RRG",1,0,1
"4994","run042","BGG","RBG",1,0,1
"4995","run042","BGG","RRR",1,0,1
"4996","run042","BRR","BGB",1,0,1
"4997","run042","GBB","BBB",12,8,20
"4998","run042","GBB","BRB",1,0,1
"4999","run042","GBB","BRR",1,0,1
"5000","run042","GBB","GGG",7,11,18
"5001","run042","GBB","GGR",1,0,1
"5002","run042","GBB","RBG",3,3,6
"5003","run042","GBB","RBR",1,0,1
"5004","run042","GBB","RGG",1,0,1
"5005","run042","GBB","RGR",2,0,2
"5006","run042","GBB","RRR",1,1,2
"5007","run042","GBG","BRB",1,1,2
"5008","run042","GBG","BRR",1,0,1
"5009","run042","GBG","GGG",4,1,5
"5010","run042","GBG","RBB",1,0,1
"5011","run042","GBG","RGR",1,0,1
"5012","run042","GBG","RRG",1,1,2
"5013","run042","GGB","BBB",3,1,4
"5014","run042","GGB","BBR",1,0,1
"5015","run042","GGB","BRR",1,1,2
"5016","run042","GGB","GBG",1,0,1
"5017","run042","GGB","GGG",13,4,17
"5018","run042","GGB","RGG",1,1,2
"5019","run042","GGB","RRG",1,1,2
"5020","run042","GGB","RRR",1,1,2
"5021","run042","GGG","BBB",8,4,12
"5022","run042","GGG","BGG",1,1,2
"5023","run042","GGG","BRB",1,0,1
"5024","run042","GGG","GGB",5,1,6
"5025","run042","GGG","GGR",1,0,1
"5026","run042","GGG","RBB",1,1,2
"5027","run042","GGG","RGR",1,1,2
"5028","run042","GGG","RRG",1,2,3
"5029","run042","GGR","BRR",1,0,1
"5030","run042","GGR","GRR",1,0,1
"5031","run042","GRG","BBB",3,0,3
"5032","run042","GRG","GGB",2,1,3
"5033","run042","GRG","GGG",3,3,6
"5034","run042","GRG","RGR",1,1,2
"5035","run042","GRG","RRG",2,1,3
"5036","run042","GRR","BGB",1,0,1
"5037","run042","RBG","BBB",2,1,3
"5038","run042","RBG","RBB",1,0,1
"5039","run042","RBR","BGB",2,1,3
"5040","run042","RBR","BRB",1,0,1
"5041","run042","RBR","BRR",1,0,1
"5042","run042","RBR","GRR",4,0,4
"5043","run042","RBR","RGG",2,2,4
"5044","run042","RBR","RGR",1,0,1
"5045","run042","RGG","BBR",1,0,1
"5046","run042","RGR","BBB",2,2,4
"5047","run042","RGR","BBR",1,0,1
"5048","run042","RGR","BGB",2,0,2
"5049","run042","RGR","BGG",2,0,2
"5050","run042","RGR","BRR",1,0,1
"5051","run042","RGR","GGB",2,1,3
"5052","run042","RGR","RGG",1,0,1
"5053","run042","RRG","BBB",2,7,9
"5054","run042","RRG","BGB",1,1,2
"5055","run042","RRG","BRB",2,9,11
"5056","run042","RRG","BRR",1,5,6
"5057","run042","RRG","GGG",2,2,4
"5058","run042","RRG","GRG",1,0,1
"5059","run042","RRG","GRR",3,1,4
"5060","run042","RRG","RBB",1,0,1
"5061","run042","RRR","BBR",1,0,1
"5062","run042","RRR","BGB",2,1,3
"5063","run042","RRR","BGG",1,0,1
"5064","run042","RRR","BRB",1,0,1
"5065","run042","RRR","BRR",1,1,2
"5066","run042","RRR","RBB",1,0,1
"5067","run042","RRR","RGR",1,0,1
"5068","run042","RRR","RRG",2,0,2
"5069","run042","BBB","GRR",0,1,1
"5070","run042","BBG","GBB",0,1,1
"5071","run042","BBG","RBB",0,1,1
"5072","run042","BBG","RRR",0,2,2
"5073","run042","BGG","BBB",0,1,1
"5074","run042","BGG","RGG",0,2,2
"5075","run042","BRB","BBB",0,2,2
"5076","run042","BRB","BRR",0,1,1
"5077","run042","BRR","BRB",0,1,1
"5078","run042","GBB","GGB",0,2,2
"5079","run042","GBB","GRG",0,2,2
"5080","run042","GBB","RRG",0,1,1
"5081","run042","GBG","RBG",0,1,1
"5082","run042","GGB","BGB",0,1,1
"5083","run042","GGB","GGR",0,4,4
"5084","run042","GGB","RBG",0,2,2
"5085","run042","GGB","RBR",0,1,1
"5086","run042","GGG","BGB",0,1,1
"5087","run042","GGG","BRR",0,2,2
"5088","run042","GGG","GRR",0,1,1
"5089","run042","GGG","RBG",0,1,1
"5090","run042","GGG","RBR",0,4,4
"5091","run042","GGG","RRR",0,1,1
"5092","run042","GGR","BGG",0,1,1
"5093","run042","GGR","RBB",0,1,1
"5094","run042","GRG","BRB",0,1,1
"5095","run042","GRG","GBG",0,1,1
"5096","run042","GRG","RBG",0,1,1
"5097","run042","GRG","RBR",0,1,1
"5098","run042","GRR","BRR",0,1,1
"5099","run042","GRR","GGR",0,1,1
"5100","run042","RBB","GRR",0,1,1
"5101","run042","RBG","RGR",0,1,1
"5102","run042","RBR","BBB",0,3,3
"5103","run042","RBR","BBR",0,1,1
"5104","run042","RBR","GGB",0,1,1
"5105","run042","RBR","RBB",0,1,1
"5106","run042","RGG","BBB",0,1,1
"5107","run042","RGG","BRR",0,1,1
"5108","run042","RGG","GGR",0,1,1
"5109","run042","RGG","GRR",0,1,1
"5110","run042","RGG","RBB",0,1,1
"5111","run042","RGR","GGR",0,1,1
"5112","run042","RGR","RRG",0,1,1
"5113","run042","RRG","BBR",0,1,1
"5114","run042","RRG","BGG",0,1,1
"5115","run042","RRR","GRR",0,1,1
"5116","run043","BBB","GGG",1,0,1
"5117","run043","BBB","RRG",1,0,1
"5118","run043","BBG","BBB",1,0,1
"5119","run043","BBG","BRB",1,1,2
"5120","run043","BBG","GBG",2,0,2
"5121","run043","BBG","GGB",2,2,4
"5122","run043","BBG","GGG",4,8,12
"5123","run043","BBG","GRG",1,1,2
"5124","run043","BBG","RRG",1,1,2
"5125","run043","BGG","RBG",1,0,1
"5126","run043","BGG","RRR",1,0,1
"5127","run043","BRR","BGB",1,0,1
"5128","run043","GBB","BBB",12,10,22
"5129","run043","GBB","BRB",1,1,2
"5130","run043","GBB","BRR",1,2,3
"5131","run043","GBB","GGG",7,11,18
"5132","run043","GBB","GGR",1,1,2
"5133","run043","GBB","RBG",3,1,4
"5134","run043","GBB","RBR",1,0,1
"5135","run043","GBB","RGG",1,0,1
"5136","run043","GBB","RGR",2,0,2
"5137","run043","GBB","RRR",1,2,3
"5138","run043","GBG","BRB",1,1,2
"5139","run043","GBG","BRR",1,0,1
"5140","run043","GBG","GGG",4,1,5
"5141","run043","GBG","RBB",1,0,1
"5142","run043","GBG","RGR",1,1,2
"5143","run043","GBG","RRG",1,0,1
"5144","run043","GGB","BBB",3,3,6
"5145","run043","GGB","BBR",1,0,1
"5146","run043","GGB","BRR",1,1,2
"5147","run043","GGB","GBG",1,0,1
"5148","run043","GGB","GGG",13,11,24
"5149","run043","GGB","RGG",1,2,3
"5150","run043","GGB","RRG",1,0,1
"5151","run043","GGB","RRR",1,1,2
"5152","run043","GGG","BBB",8,1,9
"5153","run043","GGG","BGG",1,0,1
"5154","run043","GGG","BRB",1,0,1
"5155","run043","GGG","GGB",5,0,5
"5156","run043","GGG","GGR",1,1,2
"5157","run043","GGG","RBB",1,1,2
"5158","run043","GGG","RGR",1,1,2
"5159","run043","GGG","RRG",1,4,5
"5160","run043","GGR","BRR",1,0,1
"5161","run043","GGR","GRR",1,0,1
"5162","run043","GRG","BBB",3,3,6
"5163","run043","GRG","GGB",2,4,6
"5164","run043","GRG","GGG",3,1,4
"5165","run043","GRG","RGR",1,1,2
"5166","run043","GRG","RRG",2,1,3
"5167","run043","GRR","BGB",1,0,1
"5168","run043","RBG","BBB",2,0,2
"5169","run043","RBG","RBB",1,0,1
"5170","run043","RBR","BGB",2,0,2
"5171","run043","RBR","BRB",1,0,1
"5172","run043","RBR","BRR",1,1,2
"5173","run043","RBR","GRR",4,1,5
"5174","run043","RBR","RGG",2,2,4
"5175","run043","RBR","RGR",1,0,1
"5176","run043","RGG","BBR",1,0,1
"5177","run043","RGR","BBB",2,0,2
"5178","run043","RGR","BBR",1,0,1
"5179","run043","RGR","BGB",2,1,3
"5180","run043","RGR","BGG",2,0,2
"5181","run043","RGR","BRR",1,1,2
"5182","run043","RGR","GGB",2,4,6
"5183","run043","RGR","RGG",1,0,1
"5184","run043","RRG","BBB",2,3,5
"5185","run043","RRG","BGB",1,2,3
"5186","run043","RRG","BRB",2,10,12
"5187","run043","RRG","BRR",1,2,3
"5188","run043","RRG","GGG",2,2,4
"5189","run043","RRG","GRG",1,0,1
"5190","run043","RRG","GRR",3,2,5
"5191","run043","RRG","RBB",1,1,2
"5192","run043","RRR","BBR",1,0,1
"5193","run043","RRR","BGB",2,0,2
"5194","run043","RRR","BGG",1,0,1
"5195","run043","RRR","BRB",1,0,1
"5196","run043","RRR","BRR",1,0,1
"5197","run043","RRR","RBB",1,1,2
"5198","run043","RRR","RGR",1,1,2
"5199","run043","RRR","RRG",2,1,3
"5200","run043","BBB","BRB",0,1,1
"5201","run043","BBB","RBG",0,1,1
"5202","run043","BBG","GBB",0,1,1
"5203","run043","BBG","RBB",0,1,1
"5204","run043","BBG","RRR",0,1,1
"5205","run043","BRB","BBB",0,1,1
"5206","run043","BRB","BRR",0,1,1
"5207","run043","BRR","BBB",0,4,4
"5208","run043","GBB","GBG",0,1,1
"5209","run043","GBB","GGB",0,1,1
"5210","run043","GBB","GRG",0,1,1
"5211","run043","GBB","RBB",0,1,1
"5212","run043","GBG","BBB",0,1,1
"5213","run043","GGB","BGB",0,1,1
"5214","run043","GGB","BGG",0,1,1
"5215","run043","GGB","GGR",0,1,1
"5216","run043","GGB","GRR",0,1,1
"5217","run043","GGB","RBR",0,1,1
"5218","run043","GGG","RBG",0,1,1
"5219","run043","GGG","RBR",0,2,2
"5220","run043","GGG","RRR",0,1,1
"5221","run043","GGR","BBR",0,1,1
"5222","run043","GRG","GGR",0,1,1
"5223","run043","GRG","GRR",0,1,1
"5224","run043","RBB","BBR",0,1,1
"5225","run043","RBB","RGG",0,1,1
"5226","run043","RBG","GRR",0,1,1
"5227","run043","RBR","BBB",0,2,2
"5228","run043","RBR","GGB",0,2,2
"5229","run043","RGG","BRR",0,2,2
"5230","run043","RGG","GGG",0,1,1
"5231","run043","RGG","GGR",0,1,1
"5232","run043","RGR","GGG",0,1,1
"5233","run043","RGR","GGR",0,1,1
"5234","run043","RGR","RRG",0,2,2
"5235","run043","RRG","BGG",0,1,1
"5236","run043","RRR","RGG",0,1,1
"5237","run044","BBB","GGG",1,2,3
"5238","run044","BBB","RRG",1,0,1
"5239","run044","BBG","BBB",1,0,1
"5240","run044","BBG","BRB",1,1,2
"5241","run044","BBG","GBG",2,1,3
"5242","run044","BBG","GGB",2,3,5
"5243","run044","BBG","GGG",4,3,7
"5244","run044","BBG","GRG",1,0,1
"5245","run044","BBG","RRG",1,0,1
"5246","run044","BGG","RBG",1,0,1
"5247","run044","BGG","RRR",1,0,1
"5248","run044","BRR","BGB",1,0,1
"5249","run044","GBB","BBB",12,5,17
"5250","run044","GBB","BRB",1,1,2
"5251","run044","GBB","BRR",1,1,2
"5252","run044","GBB","GGG",7,15,22
"5253","run044","GBB","GGR",1,0,1
"5254","run044","GBB","RBG",3,1,4
"5255","run044","GBB","RBR",1,0,1
"5256","run044","GBB","RGG",1,0,1
"5257","run044","GBB","RGR",2,0,2
"5258","run044","GBB","RRR",1,4,5
"5259","run044","GBG","BRB",1,0,1
"5260","run044","GBG","BRR",1,0,1
"5261","run044","GBG","GGG",4,1,5
"5262","run044","GBG","RBB",1,0,1
"5263","run044","GBG","RGR",1,2,3
"5264","run044","GBG","RRG",1,0,1
"5265","run044","GGB","BBB",3,2,5
"5266","run044","GGB","BBR",1,1,2
"5267","run044","GGB","BRR",1,3,4
"5268","run044","GGB","GBG",1,0,1
"5269","run044","GGB","GGG",13,8,21
"5270","run044","GGB","RGG",1,0,1
"5271","run044","GGB","RRG",1,1,2
"5272","run044","GGB","RRR",1,2,3
"5273","run044","GGG","BBB",8,4,12
"5274","run044","GGG","BGG",1,1,2
"5275","run044","GGG","BRB",1,0,1
"5276","run044","GGG","GGB",5,0,5
"5277","run044","GGG","GGR",1,1,2
"5278","run044","GGG","RBB",1,0,1
"5279","run044","GGG","RGR",1,3,4
"5280","run044","GGG","RRG",1,2,3
"5281","run044","GGR","BRR",1,0,1
"5282","run044","GGR","GRR",1,0,1
"5283","run044","GRG","BBB",3,1,4
"5284","run044","GRG","GGB",2,3,5
"5285","run044","GRG","GGG",3,2,5
"5286","run044","GRG","RGR",1,0,1
"5287","run044","GRG","RRG",2,0,2
"5288","run044","GRR","BGB",1,1,2
"5289","run044","RBG","BBB",2,2,4
"5290","run044","RBG","RBB",1,0,1
"5291","run044","RBR","BGB",2,0,2
"5292","run044","RBR","BRB",1,0,1
"5293","run044","RBR","BRR",1,1,2
"5294","run044","RBR","GRR",4,1,5
"5295","run044","RBR","RGG",2,1,3
"5296","run044","RBR","RGR",1,0,1
"5297","run044","RGG","BBR",1,0,1
"5298","run044","RGR","BBB",2,1,3
"5299","run044","RGR","BBR",1,0,1
"5300","run044","RGR","BGB",2,1,3
"5301","run044","RGR","BGG",2,0,2
"5302","run044","RGR","BRR",1,0,1
"5303","run044","RGR","GGB",2,2,4
"5304","run044","RGR","RGG",1,0,1
"5305","run044","RRG","BBB",2,4,6
"5306","run044","RRG","BGB",1,2,3
"5307","run044","RRG","BRB",2,5,7
"5308","run044","RRG","BRR",1,1,2
"5309","run044","RRG","GGG",2,7,9
"5310","run044","RRG","GRG",1,0,1
"5311","run044","RRG","GRR",3,0,3
"5312","run044","RRG","RBB",1,0,1
"5313","run044","RRR","BBR",1,0,1
"5314","run044","RRR","BGB",2,1,3
"5315","run044","RRR","BGG",1,0,1
"5316","run044","RRR","BRB",1,0,1
"5317","run044","RRR","BRR",1,1,2
"5318","run044","RRR","RBB",1,1,2
"5319","run044","RRR","RGR",1,0,1
"5320","run044","RRR","RRG",2,0,2
"5321","run044","BBB","RRR",0,1,1
"5322","run044","BBG","BGB",0,1,1
"5323","run044","BBG","BGG",0,1,1
"5324","run044","BBG","RRR",0,2,2
"5325","run044","BRB","BBB",0,3,3
"5326","run044","BRB","BRR",0,1,1
"5327","run044","BRB","RRR",0,1,1
"5328","run044","GBB","BGG",0,1,1
"5329","run044","GBB","GGB",0,1,1
"5330","run044","GBB","GRG",0,1,1
"5331","run044","GBB","RBB",0,1,1
"5332","run044","GBG","BBB",0,1,1
"5333","run044","GGB","BGG",0,1,1
"5334","run044","GGB","GRR",0,1,1
"5335","run044","GGB","RBG",0,1,1
"5336","run044","GGG","RBG",0,2,2
"5337","run044","GGG","RBR",0,7,7
"5338","run044","GGG","RGG",0,1,1
"5339","run044","GGG","RRR",0,1,1
"5340","run044","GGR","BBR",0,1,1
"5341","run044","GRG","BBR",0,1,1
"5342","run044","GRG","GBG",0,1,1
"5343","run044","GRG","GGR",0,2,2
"5344","run044","GRR","BBB",0,1,1
"5345","run044","GRR","BBR",0,1,1
"5346","run044","RBG","RBR",0,1,1
"5347","run044","RBG","RGR",0,1,1
"5348","run044","RBR","BBB",0,2,2
"5349","run044","RBR","BBR",0,1,1
"5350","run044","RBR","BGG",0,1,1
"5351","run044","RBR","GGB",0,1,1
"5352","run044","RGG","BBB",0,2,2
"5353","run044","RGG","BRR",0,1,1
"5354","run044","RGG","GRR",0,3,3
"5355","run044","RGR","GGR",0,1,1
"5356","run044","RRG","GGR",0,2,2
"5357","run044","RRR","GGR",0,1,1
"5358","run044","RRR","GRR",0,1,1
"5359","run045","BBB","GGG",1,0,1
"5360","run045","BBB","RRG",1,0,1
"5361","run045","BBG","BBB",1,1,2
"5362","run045","BBG","BRB",1,4,5
"5363","run045","BBG","GBG",2,3,5
"5364","run045","BBG","GGB",2,4,6
"5365","run045","BBG","GGG",4,8,12
"5366","run045","BBG","GRG",1,0,1
"5367","run045","BBG","RRG",1,0,1
"5368","run045","BGG","RBG",1,0,1
"5369","run045","BGG","RRR",1,0,1
"5370","run045","BRR","BGB",1,0,1
"5371","run045","GBB","BBB",12,5,17
"5372","run045","GBB","BRB",1,3,4
"5373","run045","GBB","BRR",1,0,1
"5374","run045","GBB","GGG",7,10,17
"5375","run045","GBB","GGR",1,2,3
"5376","run045","GBB","RBG",3,1,4
"5377","run045","GBB","RBR",1,0,1
"5378","run045","GBB","RGG",1,0,1
"5379","run045","GBB","RGR",2,1,3
"5380","run045","GBB","RRR",1,1,2
"5381","run045","GBG","BRB",1,1,2
"5382","run045","GBG","BRR",1,0,1
"5383","run045","GBG","GGG",4,3,7
"5384","run045","GBG","RBB",1,0,1
"5385","run045","GBG","RGR",1,0,1
"5386","run045","GBG","RRG",1,0,1
"5387","run045","GGB","BBB",3,1,4
"5388","run045","GGB","BBR",1,1,2
"5389","run045","GGB","BRR",1,3,4
"5390","run045","GGB","GBG",1,0,1
"5391","run045","GGB","GGG",13,6,19
"5392","run045","GGB","RGG",1,1,2
"5393","run045","GGB","RRG",1,0,1
"5394","run045","GGB","RRR",1,1,2
"5395","run045","GGG","BBB",8,3,11
"5396","run045","GGG","BGG",1,0,1
"5397","run045","GGG","BRB",1,1,2
"5398","run045","GGG","GGB",5,0,5
"5399","run045","GGG","GGR",1,2,3
"5400","run045","GGG","RBB",1,1,2
"5401","run045","GGG","RGR",1,2,3
"5402","run045","GGG","RRG",1,4,5
"5403","run045","GGR","BRR",1,0,1
"5404","run045","GGR","GRR",1,0,1
"5405","run045","GRG","BBB",3,3,6
"5406","run045","GRG","GGB",2,5,7
"5407","run045","GRG","GGG",3,1,4
"5408","run045","GRG","RGR",1,0,1
"5409","run045","GRG","RRG",2,0,2
"5410","run045","GRR","BGB",1,0,1
"5411","run045","RBG","BBB",2,1,3
"5412","run045","RBG","RBB",1,1,2
"5413","run045","RBR","BGB",2,0,2
"5414","run045","RBR","BRB",1,0,1
"5415","run045","RBR","BRR",1,1,2
"5416","run045","RBR","GRR",4,0,4
"5417","run045","RBR","RGG",2,1,3
"5418","run045","RBR","RGR",1,0,1
"5419","run045","RGG","BBR",1,0,1
"5420","run045","RGR","BBB",2,1,3
"5421","run045","RGR","BBR",1,0,1
"5422","run045","RGR","BGB",2,3,5
"5423","run045","RGR","BGG",2,0,2
"5424","run045","RGR","BRR",1,0,1
"5425","run045","RGR","GGB",2,1,3
"5426","run045","RGR","RGG",1,0,1
"5427","run045","RRG","BBB",2,6,8
"5428","run045","RRG","BGB",1,2,3
"5429","run045","RRG","BRB",2,6,8
"5430","run045","RRG","BRR",1,4,5
"5431","run045","RRG","GGG",2,4,6
"5432","run045","RRG","GRG",1,0,1
"5433","run045","RRG","GRR",3,1,4
"5434","run045","RRG","RBB",1,0,1
"5435","run045","RRR","BBR",1,0,1
"5436","run045","RRR","BGB",2,0,2
"5437","run045","RRR","BGG",1,0,1
"5438","run045","RRR","BRB",1,0,1
"5439","run045","RRR","BRR",1,0,1
"5440","run045","RRR","RBB",1,0,1
"5441","run045","RRR","RGR",1,0,1
"5442","run045","RRR","RRG",2,0,2
"5443","run045","BBB","GRR",0,1,1
"5444","run045","BBG","RRR",0,1,1
"5445","run045","BGB","BBB",0,1,1
"5446","run045","BRB","BBB",0,2,2
"5447","run045","BRB","RBB",0,1,1
"5448","run045","BRR","BBB",0,3,3
"5449","run045","GBB","GBG",0,1,1
"5450","run045","GBB","GGB",0,4,4
"5451","run045","GBG","BBB",0,1,1
"5452","run045","GBG","RGG",0,1,1
"5453","run045","GGB","BRB",0,1,1
"5454","run045","GGB","GBB",0,1,1
"5455","run045","GGB","RBB",0,1,1
"5456","run045","GGB","RBG",0,2,2
"5457","run045","GGG","BRR",0,1,1
"5458","run045","GGG","GRR",0,1,1
"5459","run045","GGG","RBG",0,1,1
"5460","run045","GGG","RBR",0,2,2
"5461","run045","GGR","RBB",0,1,1
"5462","run045","GRG","BBR",0,1,1
"5463","run045","GRG","BGG",0,1,1
"5464","run045","GRG","GBG",0,1,1
"5465","run045","GRG","GGR",0,1,1
"5466","run045","RBG","GRR",0,1,1
"5467","run045","RBR","BBB",0,2,2
"5468","run045","RBR","BGG",0,1,1
"5469","run045","RGG","BBB",0,3,3
"5470","run045","RGG","BRR",0,1,1
"5471","run045","RGG","GRR",0,2,2
"5472","run045","RGR","RRG",0,2,2
"5473","run045","RRG","BBR",0,1,1
"5474","run045","RRG","BGG",0,1,1
"5475","run045","RRG","RGR",0,1,1
"5476","run046","BBB","GGG",1,0,1
"5477","run046","BBB","RRG",1,0,1
"5478","run046","BBG","BBB",1,0,1
"5479","run046","BBG","BRB",1,3,4
"5480","run046","BBG","GBG",2,1,3
"5481","run046","BBG","GGB",2,6,8
"5482","run046","BBG","GGG",4,3,7
"5483","run046","BBG","GRG",1,1,2
"5484","run046","BBG","RRG",1,0,1
"5485","run046","BGG","RBG",1,0,1
"5486","run046","BGG","RRR",1,1,2
"5487","run046","BRR","BGB",1,0,1
"5488","run046","GBB","BBB",12,6,18
"5489","run046","GBB","BRB",1,0,1
"5490","run046","GBB","BRR",1,0,1
"5491","run046","GBB","GGG",7,12,19
"5492","run046","GBB","GGR",1,0,1
"5493","run046","GBB","RBG",3,2,5
"5494","run046","GBB","RBR",1,0,1
"5495","run046","GBB","RGG",1,0,1
"5496","run046","GBB","RGR",2,0,2
"5497","run046","GBB","RRR",1,1,2
"5498","run046","GBG","BRB",1,0,1
"5499","run046","GBG","BRR",1,0,1
"5500","run046","GBG","GGG",4,0,4
"5501","run046","GBG","RBB",1,0,1
"5502","run046","GBG","RGR",1,0,1
"5503","run046","GBG","RRG",1,1,2
"5504","run046","GGB","BBB",3,4,7
"5505","run046","GGB","BBR",1,1,2
"5506","run046","GGB","BRR",1,2,3
"5507","run046","GGB","GBG",1,0,1
"5508","run046","GGB","GGG",13,6,19
"5509","run046","GGB","RGG",1,1,2
"5510","run046","GGB","RRG",1,4,5
"5511","run046","GGB","RRR",1,1,2
"5512","run046","GGG","BBB",8,6,14
"5513","run046","GGG","BGG",1,1,2
"5514","run046","GGG","BRB",1,0,1
"5515","run046","GGG","GGB",5,0,5
"5516","run046","GGG","GGR",1,1,2
"5517","run046","GGG","RBB",1,1,2
"5518","run046","GGG","RGR",1,1,2
"5519","run046","GGG","RRG",1,6,7
"5520","run046","GGR","BRR",1,0,1
"5521","run046","GGR","GRR",1,0,1
"5522","run046","GRG","BBB",3,1,4
"5523","run046","GRG","GGB",2,3,5
"5524","run046","GRG","GGG",3,2,5
"5525","run046","GRG","RGR",1,1,2
"5526","run046","GRG","RRG",2,1,3
"5527","run046","GRR","BGB",1,1,2
"5528","run046","RBG","BBB",2,1,3
"5529","run046","RBG","RBB",1,0,1
"5530","run046","RBR","BGB",2,0,2
"5531","run046","RBR","BRB",1,0,1
"5532","run046","RBR","BRR",1,0,1
"5533","run046","RBR","GRR",4,0,4
"5534","run046","RBR","RGG",2,1,3
"5535","run046","RBR","RGR",1,0,1
"5536","run046","RGG","BBR",1,1,2
"5537","run046","RGR","BBB",2,1,3
"5538","run046","RGR","BBR",1,0,1
"5539","run046","RGR","BGB",2,0,2
"5540","run046","RGR","BGG",2,0,2
"5541","run046","RGR","BRR",1,1,2
"5542","run046","RGR","GGB",2,0,2
"5543","run046","RGR","RGG",1,0,1
"5544","run046","RRG","BBB",2,5,7
"5545","run046","RRG","BGB",1,1,2
"5546","run046","RRG","BRB",2,9,11
"5547","run046","RRG","BRR",1,3,4
"5548","run046","RRG","GGG",2,1,3
"5549","run046","RRG","GRG",1,0,1
"5550","run046","RRG","GRR",3,2,5
"5551","run046","RRG","RBB",1,0,1
"5552","run046","RRR","BBR",1,0,1
"5553","run046","RRR","BGB",2,0,2
"5554","run046","RRR","BGG",1,0,1
"5555","run046","RRR","BRB",1,0,1
"5556","run046","RRR","BRR",1,0,1
"5557","run046","RRR","RBB",1,0,1
"5558","run046","RRR","RGR",1,0,1
"5559","run046","RRR","RRG",2,0,2
"5560","run046","BBG","BGG",0,1,1
"5561","run046","BBG","RBG",0,1,1
"5562","run046","BBG","RRR",0,2,2
"5563","run046","BRB","BBR",0,1,1
"5564","run046","BRB","RBB",0,1,1
"5565","run046","BRB","RGR",0,1,1
"5566","run046","BRR","BBB",0,2,2
"5567","run046","BRR","RBB",0,1,1
"5568","run046","GBB","GBG",0,1,1
"5569","run046","GBB","GGB",0,2,2
"5570","run046","GBB","RRG",0,1,1
"5571","run046","GBG","BBR",0,1,1
"5572","run046","GBG","GGB",0,1,1
"5573","run046","GGB","GGR",0,1,1
"5574","run046","GGB","GRR",0,1,1
"5575","run046","GGB","RBB",0,2,2
"5576","run046","GGB","RBG",0,1,1
"5577","run046","GGB","RBR",0,1,1
"5578","run046","GGB","RGR",0,1,1
"5579","run046","GGG","BRR",0,2,2
"5580","run046","GGG","RBG",0,1,1
"5581","run046","GGG","RBR",0,4,4
"5582","run046","GGR","BBB",0,1,1
"5583","run046","GRG","GGR",0,1,1
"5584","run046","GRG","RBR",0,1,1
"5585","run046","GRR","BGG",0,1,1
"5586","run046","RBB","GRR",0,1,1
"5587","run046","RBR","BBB",0,1,1
"5588","run046","RBR","GGB",0,4,4
"5589","run046","RBR","RBB",0,2,2
"5590","run046","RGG","RBB",0,1,1
"5591","run046","RGR","GGG",0,1,1
"5592","run046","RGR","RBB",0,2,2
"5593","run046","RGR","RRG",0,1,1
"5594","run046","RRG","BBR",0,1,1
"5595","run046","RRG","GGR",0,3,3
"5596","run046","RRR","GRR",0,1,1
"5597","run046","RRR","RGG",0,1,1
"5598","run047","BBB","GGG",1,1,2
"5599","run047","BBB","RRG",1,0,1
"5600","run047","BBG","BBB",1,1,2
"5601","run047","BBG","BRB",1,4,5
"5602","run047","BBG","GBG",2,0,2
"5603","run047","BBG","GGB",2,6,8
"5604","run047","BBG","GGG",4,5,9
"5605","run047","BBG","GRG",1,0,1
"5606","run047","BBG","RRG",1,0,1
"5607","run047","BGG","RBG",1,0,1
"5608","run047","BGG","RRR",1,0,1
"5609","run047","BRR","BGB",1,0,1
"5610","run047","GBB","BBB",12,5,17
"5611","run047","GBB","BRB",1,1,2
"5612","run047","GBB","BRR",1,1,2
"5613","run047","GBB","GGG",7,17,24
"5614","run047","GBB","GGR",1,1,2
"5615","run047","GBB","RBG",3,1,4
"5616","run047","GBB","RBR",1,0,1
"5617","run047","GBB","RGG",1,0,1
"5618","run047","GBB","RGR",2,0,2
"5619","run047","GBB","RRR",1,2,3
"5620","run047","GBG","BRB",1,1,2
"5621","run047","GBG","BRR",1,0,1
"5622","run047","GBG","GGG",4,0,4
"5623","run047","GBG","RBB",1,0,1
"5624","run047","GBG","RGR",1,0,1
"5625","run047","GBG","RRG",1,1,2
"5626","run047","GGB","BBB",3,2,5
"5627","run047","GGB","BBR",1,0,1
"5628","run047","GGB","BRR",1,2,3
"5629","run047","GGB","GBG",1,0,1
"5630","run047","GGB","GGG",13,6,19
"5631","run047","GGB","RGG",1,0,1
"5632","run047","GGB","RRG",1,0,1
"5633","run047","GGB","RRR",1,2,3
"5634","run047","GGG","BBB",8,2,10
"5635","run047","GGG","BGG",1,2,3
"5636","run047","GGG","BRB",1,1,2
"5637","run047","GGG","GGB",5,0,5
"5638","run047","GGG","GGR",1,0,1
"5639","run047","GGG","RBB",1,0,1
"5640","run047","GGG","RGR",1,4,5
"5641","run047","GGG","RRG",1,4,5
"5642","run047","GGR","BRR",1,0,1
"5643","run047","GGR","GRR",1,0,1
"5644","run047","GRG","BBB",3,2,5
"5645","run047","GRG","GGB",2,3,5
"5646","run047","GRG","GGG",3,1,4
"5647","run047","GRG","RGR",1,1,2
"5648","run047","GRG","RRG",2,0,2
"5649","run047","GRR","BGB",1,1,2
"5650","run047","RBG","BBB",2,1,3
"5651","run047","RBG","RBB",1,0,1
"5652","run047","RBR","BGB",2,0,2
"5653","run047","RBR","BRB",1,0,1
"5654","run047","RBR","BRR",1,1,2
"5655","run047","RBR","GRR",4,0,4
"5656","run047","RBR","RGG",2,1,3
"5657","run047","RBR","RGR",1,0,1
"5658","run047","RGG","BBR",1,1,2
"5659","run047","RGR","BBB",2,0,2
"5660","run047","RGR","BBR",1,0,1
"5661","run047","RGR","BGB",2,1,3
"5662","run047","RGR","BGG",2,0,2
"5663","run047","RGR","BRR",1,2,3
"5664","run047","RGR","GGB",2,1,3
"5665","run047","RGR","RGG",1,1,2
"5666","run047","RRG","BBB",2,6,8
"5667","run047","RRG","BGB",1,4,5
"5668","run047","RRG","BRB",2,7,9
"5669","run047","RRG","BRR",1,0,1
"5670","run047","RRG","GGG",2,5,7
"5671","run047","RRG","GRG",1,0,1
"5672","run047","RRG","GRR",3,2,5
"5673","run047","RRG","RBB",1,0,1
"5674","run047","RRR","BBR",1,0,1
"5675","run047","RRR","BGB",2,0,2
"5676","run047","RRR","BGG",1,0,1
"5677","run047","RRR","BRB",1,0,1
"5678","run047","RRR","BRR",1,0,1
"5679","run047","RRR","RBB",1,0,1
"5680","run047","RRR","RGR",1,1,2
"5681","run047","RRR","RRG",2,0,2
"5682","run047","BBB","GRR",0,1,1
"5683","run047","BBG","BGG",0,1,1
"5684","run047","BBG","RBR",0,1,1
"5685","run047","BBG","RRR",0,1,1
"5686","run047","BGB","RRG",0,1,1
"5687","run047","BGG","BBB",0,1,1
"5688","run047","BRR","BBB",0,2,2
"5689","run047","GBB","GBG",0,1,1
"5690","run047","GBB","GGB",0,2,2
"5691","run047","GBB","GRG",0,1,1
"5692","run047","GBB","RBB",0,1,1
"5693","run047","GBB","RRG",0,1,1
"5694","run047","GBG","BBR",0,1,1
"5695","run047","GBG","GGB",0,1,1
"5696","run047","GBG","RGG",0,1,1
"5697","run047","GGB","BGB",0,1,1
"5698","run047","GGB","BGG",0,1,1
"5699","run047","GGB","RGR",0,2,2
"5700","run047","GGG","BRR",0,1,1
"5701","run047","GGG","RBR",0,3,3
"5702","run047","GGR","RBB",0,1,1
"5703","run047","GRG","BRB",0,1,1
"5704","run047","GRG","BRR",0,1,1
"5705","run047","GRG","GBG",0,1,1
"5706","run047","GRR","BBB",0,1,1
"5707","run047","RBG","BRR",0,1,1
"5708","run047","RBR","BBB",0,3,3
"5709","run047","RBR","GGB",0,5,5
"5710","run047","RBR","RBB",0,1,1
"5711","run047","RGG","BBB",0,1,1
"5712","run047","RGG","BRR",0,1,1
"5713","run047","RGG","GRR",0,1,1
"5714","run047","RGR","RBB",0,1,1
"5715","run047","RRG","GGR",0,1,1
"5716","run047","RRR","RGG",0,1,1
"5717","run048","BBB","GGG",1,1,2
"5718","run048","BBB","RRG",1,0,1
"5719","run048","BBG","BBB",1,2,3
"5720","run048","BBG","BRB",1,2,3
"5721","run048","BBG","GBG",2,1,3
"5722","run048","BBG","GGB",2,5,7
"5723","run048","BBG","GGG",4,1,5
"5724","run048","BBG","GRG",1,0,1
"5725","run048","BBG","RRG",1,0,1
"5726","run048","BGG","RBG",1,0,1
"5727","run048","BGG","RRR",1,0,1
"5728","run048","BRR","BGB",1,0,1
"5729","run048","GBB","BBB",12,5,17
"5730","run048","GBB","BRB",1,1,2
"5731","run048","GBB","BRR",1,0,1
"5732","run048","GBB","GGG",7,11,18
"5733","run048","GBB","GGR",1,0,1
"5734","run048","GBB","RBG",3,2,5
"5735","run048","GBB","RBR",1,0,1
"5736","run048","GBB","RGG",1,0,1
"5737","run048","GBB","RGR",2,0,2
"5738","run048","GBB","RRR",1,2,3
"5739","run048","GBG","BRB",1,1,2
"5740","run048","GBG","BRR",1,0,1
"5741","run048","GBG","GGG",4,3,7
"5742","run048","GBG","RBB",1,0,1
"5743","run048","GBG","RGR",1,1,2
"5744","run048","GBG","RRG",1,1,2
"5745","run048","GGB","BBB",3,5,8
"5746","run048","GGB","BBR",1,1,2
"5747","run048","GGB","BRR",1,3,4
"5748","run048","GGB","GBG",1,0,1
"5749","run048","GGB","GGG",13,10,23
"5750","run048","GGB","RGG",1,0,1
"5751","run048","GGB","RRG",1,1,2
"5752","run048","GGB","RRR",1,0,1
"5753","run048","GGG","BBB",8,5,13
"5754","run048","GGG","BGG",1,3,4
"5755","run048","GGG","BRB",1,2,3
"5756","run048","GGG","GGB",5,1,6
"5757","run048","GGG","GGR",1,0,1
"5758","run048","GGG","RBB",1,1,2
"5759","run048","GGG","RGR",1,2,3
"5760","run048","GGG","RRG",1,3,4
"5761","run048","GGR","BRR",1,0,1
"5762","run048","GGR","GRR",1,0,1
"5763","run048","GRG","BBB",3,0,3
"5764","run048","GRG","GGB",2,1,3
"5765","run048","GRG","GGG",3,2,5
"5766","run048","GRG","RGR",1,0,1
"5767","run048","GRG","RRG",2,0,2
"5768","run048","GRR","BGB",1,0,1
"5769","run048","RBG","BBB",2,0,2
"5770","run048","RBG","RBB",1,0,1
"5771","run048","RBR","BGB",2,0,2
"5772","run048","RBR","BRB",1,0,1
"5773","run048","RBR","BRR",1,0,1
"5774","run048","RBR","GRR",4,0,4
"5775","run048","RBR","RGG",2,1,3
"5776","run048","RBR","RGR",1,0,1
"5777","run048","RGG","BBR",1,0,1
"5778","run048","RGR","BBB",2,0,2
"5779","run048","RGR","BBR",1,0,1
"5780","run048","RGR","BGB",2,1,3
"5781","run048","RGR","BGG",2,0,2
"5782","run048","RGR","BRR",1,0,1
"5783","run048","RGR","GGB",2,2,4
"5784","run048","RGR","RGG",1,0,1
"5785","run048","RRG","BBB",2,4,6
"5786","run048","RRG","BGB",1,2,3
"5787","run048","RRG","BRB",2,8,10
"5788","run048","RRG","BRR",1,2,3
"5789","run048","RRG","GGG",2,2,4
"5790","run048","RRG","GRG",1,0,1
"5791","run048","RRG","GRR",3,0,3
"5792","run048","RRG","RBB",1,0,1
"5793","run048","RRR","BBR",1,0,1
"5794","run048","RRR","BGB",2,0,2
"5795","run048","RRR","BGG",1,0,1
"5796","run048","RRR","BRB",1,0,1
"5797","run048","RRR","BRR",1,1,2
"5798","run048","RRR","RBB",1,1,2
"5799","run048","RRR","RGR",1,1,2
"5800","run048","RRR","RRG",2,0,2
"5801","run048","BBB","BRB",0,1,1
"5802","run048","BBB","RRR",0,1,1
"5803","run048","BBG","BGG",0,1,1
"5804","run048","BBG","GBB",0,1,1
"5805","run048","BBG","RRR",0,2,2
"5806","run048","BRB","BBB",0,1,1
"5807","run048","BRB","BRR",0,1,1
"5808","run048","BRB","GGR",0,1,1
"5809","run048","BRB","RBB",0,1,1
"5810","run048","GBB","GGB",0,3,3
"5811","run048","GBB","GRR",0,1,1
"5812","run048","GBB","RRG",0,1,1
"5813","run048","GGB","BGB",0,1,1
"5814","run048","GGB","BGG",0,1,1
"5815","run048","GGB","GGR",0,3,3
"5816","run048","GGB","RBB",0,2,2
"5817","run048","GGB","RBG",0,2,2
"5818","run048","GGB","RBR",0,2,2
"5819","run048","GGB","RGR",0,1,1
"5820","run048","GGG","BRR",0,1,1
"5821","run048","GGG","GRR",0,1,1
"5822","run048","GGG","RBR",0,3,3
"5823","run048","GGG","RGG",0,1,1
"5824","run048","GRG","BRR",0,1,1
"5825","run048","GRG","GGR",0,1,1
"5826","run048","RBB","GRR",0,1,1
"5827","run048","RBG","BBG",0,1,1
"5828","run048","RBG","GBB",0,1,1
"5829","run048","RBR","BBB",0,2,2
"5830","run048","RBR","BBR",0,1,1
"5831","run048","RBR","GGB",0,2,2
"5832","run048","RBR","RBB",0,1,1
"5833","run048","RBR","RRR",0,1,1
"5834","run048","RGG","BBB",0,3,3
"5835","run048","RGG","BGB",0,1,1
"5836","run048","RGG","GGR",0,1,1
"5837","run048","RGR","RBB",0,2,2
"5838","run048","RGR","RRG",0,1,1
"5839","run048","RRG","BGG",0,2,2
"5840","run048","RRG","GGR",0,1,1
"5841","run049","BBB","GGG",1,1,2
"5842","run049","BBB","RRG",1,1,2
"5843","run049","BBG","BBB",1,0,1
"5844","run049","BBG","BRB",1,2,3
"5845","run049","BBG","GBG",2,1,3
"5846","run049","BBG","GGB",2,4,6
"5847","run049","BBG","GGG",4,6,10
"5848","run049","BBG","GRG",1,2,3
"5849","run049","BBG","RRG",1,2,3
"5850","run049","BGG","RBG",1,0,1
"5851","run049","BGG","RRR",1,0,1
"5852","run049","BRR","BGB",1,0,1
"5853","run049","GBB","BBB",12,9,21
"5854","run049","GBB","BRB",1,1,2
"5855","run049","GBB","BRR",1,0,1
"5856","run049","GBB","GGG",7,13,20
"5857","run049","GBB","GGR",1,1,2
"5858","run049","GBB","RBG",3,2,5
"5859","run049","GBB","RBR",1,0,1
"5860","run049","GBB","RGG",1,0,1
"5861","run049","GBB","RGR",2,0,2
"5862","run049","GBB","RRR",1,0,1
"5863","run049","GBG","BRB",1,0,1
"5864","run049","GBG","BRR",1,0,1
"5865","run049","GBG","GGG",4,1,5
"5866","run049","GBG","RBB",1,0,1
"5867","run049","GBG","RGR",1,2,3
"5868","run049","GBG","RRG",1,1,2
"5869","run049","GGB","BBB",3,3,6
"5870","run049","GGB","BBR",1,0,1
"5871","run049","GGB","BRR",1,1,2
"5872","run049","GGB","GBG",1,0,1
"5873","run049","GGB","GGG",13,4,17
"5874","run049","GGB","RGG",1,0,1
"5875","run049","GGB","RRG",1,0,1
"5876","run049","GGB","RRR",1,1,2
"5877","run049","GGG","BBB",8,3,11
"5878","run049","GGG","BGG",1,1,2
"5879","run049","GGG","BRB",1,0,1
"5880","run049","GGG","GGB",5,0,5
"5881","run049","GGG","GGR",1,2,3
"5882","run049","GGG","RBB",1,0,1
"5883","run049","GGG","RGR",1,1,2
"5884","run049","GGG","RRG",1,4,5
"5885","run049","GGR","BRR",1,0,1
"5886","run049","GGR","GRR",1,0,1
"5887","run049","GRG","BBB",3,1,4
"5888","run049","GRG","GGB",2,7,9
"5889","run049","GRG","GGG",3,1,4
"5890","run049","GRG","RGR",1,0,1
"5891","run049","GRG","RRG",2,0,2
"5892","run049","GRR","BGB",1,0,1
"5893","run049","RBG","BBB",2,0,2
"5894","run049","RBG","RBB",1,0,1
"5895","run049","RBR","BGB",2,1,3
"5896","run049","RBR","BRB",1,0,1
"5897","run049","RBR","BRR",1,1,2
"5898","run049","RBR","GRR",4,1,5
"5899","run049","RBR","RGG",2,0,2
"5900","run049","RBR","RGR",1,0,1
"5901","run049","RGG","BBR",1,1,2
"5902","run049","RGR","BBB",2,2,4
"5903","run049","RGR","BBR",1,1,2
"5904","run049","RGR","BGB",2,0,2
"5905","run049","RGR","BGG",2,0,2
"5906","run049","RGR","BRR",1,0,1
"5907","run049","RGR","GGB",2,1,3
"5908","run049","RGR","RGG",1,1,2
"5909","run049","RRG","BBB",2,6,8
"5910","run049","RRG","BGB",1,1,2
"5911","run049","RRG","BRB",2,4,6
"5912","run049","RRG","BRR",1,2,3
"5913","run049","RRG","GGG",2,2,4
"5914","run049","RRG","GRG",1,0,1
"5915","run049","RRG","GRR",3,0,3
"5916","run049","RRG","RBB",1,0,1
"5917","run049","RRR","BBR",1,0,1
"5918","run049","RRR","BGB",2,0,2
"5919","run049","RRR","BGG",1,0,1
"5920","run049","RRR","BRB",1,0,1
"5921","run049","RRR","BRR",1,0,1
"5922","run049","RRR","RBB",1,1,2
"5923","run049","RRR","RGR",1,1,2
"5924","run049","RRR","RRG",2,0,2
"5925","run049","BBB","RBG",0,1,1
"5926","run049","BBB","RRR",0,1,1
"5927","run049","BBG","BGB",0,1,1
"5928","run049","BBG","RBG",0,1,1
"5929","run049","BBG","RRR",0,3,3
"5930","run049","BGB","BBB",0,1,1
"5931","run049","BGG","RGR",0,1,1
"5932","run049","BRB","BBB",0,3,3
"5933","run049","BRB","BRR",0,1,1
"5934","run049","BRR","BBB",0,2,2
"5935","run049","BRR","BRB",0,1,1
"5936","run049","GBB","GGB",0,6,6
"5937","run049","GBB","RRG",0,1,1
"5938","run049","GBG","BBB",0,1,1
"5939","run049","GBG","GGB",0,1,1
"5940","run049","GBG","RBG",0,1,1
"5941","run049","GGB","BGG",0,1,1
"5942","run049","GGB","BRB",0,1,1
"5943","run049","GGB","GBB",0,1,1
"5944","run049","GGB","GRR",0,1,1
"5945","run049","GGB","RBB",0,1,1
"5946","run049","GGG","BGB",0,1,1
"5947","run049","GGG","BRR",0,3,3
"5948","run049","GGG","RBG",0,1,1
"5949","run049","GGG","RBR",0,3,3
"5950","run049","GGR","BBB",0,1,1
"5951","run049","GGR","BBR",0,1,1
"5952","run049","GRG","GGR",0,1,1
"5953","run049","RBR","BBB",0,2,2
"5954","run049","RBR","GGB",0,1,1
"5955","run049","RBR","RBB",0,1,1
"5956","run049","RGG","BBB",0,2,2
"5957","run049","RGG","BRR",0,1,1
"5958","run049","RGG","GGR",0,1,1
"5959","run049","RGR","GGR",0,1,1
"5960","run049","RGR","RRG",0,1,1
"5961","run049","RRG","BBR",0,1,1
"5962","run049","RRG","GGR",0,2,2
"5963","run049","RRR","RBR",0,1,1
"5964","run050","BBB","GGG",1,0,1
"5965","run050","BBB","RRG",1,0,1
"5966","run050","BBG","BBB",1,0,1
"5967","run050","BBG","BRB",1,3,4
"5968","run050","BBG","GBG",2,2,4
"5969","run050","BBG","GGB",2,4,6
"5970","run050","BBG","GGG",4,5,9
"5971","run050","BBG","GRG",1,1,2
"5972","run050","BBG","RRG",1,0,1
"5973","run050","BGG","RBG",1,0,1
"5974","run050","BGG","RRR",1,0,1
"5975","run050","BRR","BGB",1,0,1
"5976","run050","GBB","BBB",12,6,18
"5977","run050","GBB","BRB",1,0,1
"5978","run050","GBB","BRR",1,1,2
"5979","run050","GBB","GGG",7,16,23
"5980","run050","GBB","GGR",1,1,2
"5981","run050","GBB","RBG",3,3,6
"5982","run050","GBB","RBR",1,0,1
"5983","run050","GBB","RGG",1,0,1
"5984","run050","GBB","RGR",2,0,2
"5985","run050","GBB","RRR",1,2,3
"5986","run050","GBG","BRB",1,0,1
"5987","run050","GBG","BRR",1,0,1
"5988","run050","GBG","GGG",4,1,5
"5989","run050","GBG","RBB",1,0,1
"5990","run050","GBG","RGR",1,1,2
"5991","run050","GBG","RRG",1,0,1
"5992","run050","GGB","BBB",3,2,5
"5993","run050","GGB","BBR",1,0,1
"5994","run050","GGB","BRR",1,2,3
"5995","run050","GGB","GBG",1,0,1
"5996","run050","GGB","GGG",13,6,19
"5997","run050","GGB","RGG",1,1,2
"5998","run050","GGB","RRG",1,0,1
"5999","run050","GGB","RRR",1,1,2
"6000","run050","GGG","BBB",8,6,14
"6001","run050","GGG","BGG",1,1,2
"6002","run050","GGG","BRB",1,1,2
"6003","run050","GGG","GGB",5,1,6
"6004","run050","GGG","GGR",1,0,1
"6005","run050","GGG","RBB",1,3,4
"6006","run050","GGG","RGR",1,3,4
"6007","run050","GGG","RRG",1,6,7
"6008","run050","GGR","BRR",1,0,1
"6009","run050","GGR","GRR",1,0,1
"6010","run050","GRG","BBB",3,0,3
"6011","run050","GRG","GGB",2,1,3
"6012","run050","GRG","GGG",3,1,4
"6013","run050","GRG","RGR",1,0,1
"6014","run050","GRG","RRG",2,0,2
"6015","run050","GRR","BGB",1,0,1
"6016","run050","RBG","BBB",2,2,4
"6017","run050","RBG","RBB",1,0,1
"6018","run050","RBR","BGB",2,0,2
"6019","run050","RBR","BRB",1,0,1
"6020","run050","RBR","BRR",1,1,2
"6021","run050","RBR","GRR",4,0,4
"6022","run050","RBR","RGG",2,2,4
"6023","run050","RBR","RGR",1,0,1
"6024","run050","RGG","BBR",1,1,2
"6025","run050","RGR","BBB",2,0,2
"6026","run050","RGR","BBR",1,0,1
"6027","run050","RGR","BGB",2,1,3
"6028","run050","RGR","BGG",2,0,2
"6029","run050","RGR","BRR",1,1,2
"6030","run050","RGR","GGB",2,0,2
"6031","run050","RGR","RGG",1,0,1
"6032","run050","RRG","BBB",2,9,11
"6033","run050","RRG","BGB",1,2,3
"6034","run050","RRG","BRB",2,4,6
"6035","run050","RRG","BRR",1,2,3
"6036","run050","RRG","GGG",2,4,6
"6037","run050","RRG","GRG",1,0,1
"6038","run050","RRG","GRR",3,1,4
"6039","run050","RRG","RBB",1,0,1
"6040","run050","RRR","BBR",1,0,1
"6041","run050","RRR","BGB",2,0,2
"6042","run050","RRR","BGG",1,0,1
"6043","run050","RRR","BRB",1,0,1
"6044","run050","RRR","BRR",1,0,1
"6045","run050","RRR","RBB",1,0,1
"6046","run050","RRR","RGR",1,0,1
"6047","run050","RRR","RRG",2,0,2
"6048","run050","BBB","BRB",0,1,1
"6049","run050","BBG","BGB",0,1,1
"6050","run050","BBG","RRR",0,2,2
"6051","run050","BGB","BBB",0,1,1
"6052","run050","BRB","BRR",0,1,1
"6053","run050","BRB","GGG",0,1,1
"6054","run050","BRB","RBB",0,1,1
"6055","run050","BRR","BBB",0,2,2
"6056","run050","GBB","GGB",0,2,2
"6057","run050","GBB","GRG",0,1,1
"6058","run050","GGB","BGB",0,2,2
"6059","run050","GGB","BGG",0,1,1
"6060","run050","GGB","GBB",0,1,1
"6061","run050","GGB","GGR",0,1,1
"6062","run050","GGB","GRR",0,1,1
"6063","run050","GGB","RBB",0,1,1
"6064","run050","GGB","RBR",0,1,1
"6065","run050","GGG","GRR",0,1,1
"6066","run050","GGG","RBG",0,1,1
"6067","run050","GGG","RBR",0,4,4
"6068","run050","GRG","BBR",0,1,1
"6069","run050","GRG","GGR",0,1,1
"6070","run050","GRG","GRR",0,1,1
"6071","run050","GRG","RBR",0,1,1
"6072","run050","GRR","BBR",0,1,1
"6073","run050","GRR","BGG",0,1,1
"6074","run050","RBG","GBB",0,1,1
"6075","run050","RBR","BBB",0,1,1
"6076","run050","RBR","GGB",0,1,1
"6077","run050","RBR","RBB",0,2,2
"6078","run050","RGG","GGR",0,1,1
"6079","run050","RGG","GRR",0,2,2
"6080","run050","RGR","GGG",0,1,1
"6081","run050","RGR","GGR",0,1,1
"6082","run050","RGR","RRG",0,2,2
"6083","run050","RRG","BBR",0,2,2
"6084","run050","RRG","GGR",0,1,1
"6085","run050","RRG","RGG",0,1,1
"6086","run051","BBB","GGG",1,0,1
"6087","run051","BBB","RRG",1,1,2
"6088","run051","BBG","BBB",1,0,1
"6089","run051","BBG","BRB",1,4,5
"6090","run051","BBG","GBG",2,0,2
"6091","run051","BBG","GGB",2,6,8
"6092","run051","BBG","GGG",4,5,9
"6093","run051","BBG","GRG",1,2,3
"6094","run051","BBG","RRG",1,1,2
"6095","run051","BGG","RBG",1,0,1
"6096","run051","BGG","RRR",1,0,1
"6097","run051","BRR","BGB",1,0,1
"6098","run051","GBB","BBB",12,6,18
"6099","run051","GBB","BRB",1,3,4
"6100","run051","GBB","BRR",1,0,1
"6101","run051","GBB","GGG",7,11,18
"6102","run051","GBB","GGR",1,0,1
"6103","run051","GBB","RBG",3,4,7
"6104","run051","GBB","RBR",1,0,1
"6105","run051","GBB","RGG",1,0,1
"6106","run051","GBB","RGR",2,1,3
"6107","run051","GBB","RRR",1,1,2
"6108","run051","GBG","BRB",1,2,3
"6109","run051","GBG","BRR",1,0,1
"6110","run051","GBG","GGG",4,2,6
"6111","run051","GBG","RBB",1,0,1
"6112","run051","GBG","RGR",1,0,1
"6113","run051","GBG","RRG",1,3,4
"6114","run051","GGB","BBB",3,3,6
"6115","run051","GGB","BBR",1,0,1
"6116","run051","GGB","BRR",1,3,4
"6117","run051","GGB","GBG",1,0,1
"6118","run051","GGB","GGG",13,10,23
"6119","run051","GGB","RGG",1,1,2
"6120","run051","GGB","RRG",1,0,1
"6121","run051","GGB","RRR",1,0,1
"6122","run051","GGG","BBB",8,3,11
"6123","run051","GGG","BGG",1,0,1
"6124","run051","GGG","BRB",1,0,1
"6125","run051","GGG","GGB",5,0,5
"6126","run051","GGG","GGR",1,2,3
"6127","run051","GGG","RBB",1,1,2
"6128","run051","GGG","RGR",1,2,3
"6129","run051","GGG","RRG",1,0,1
"6130","run051","GGR","BRR",1,0,1
"6131","run051","GGR","GRR",1,0,1
"6132","run051","GRG","BBB",3,0,3
"6133","run051","GRG","GGB",2,2,4
"6134","run051","GRG","GGG",3,1,4
"6135","run051","GRG","RGR",1,1,2
"6136","run051","GRG","RRG",2,0,2
"6137","run051","GRR","BGB",1,0,1
"6138","run051","RBG","BBB",2,1,3
"6139","run051","RBG","RBB",1,0,1
"6140","run051","RBR","BGB",2,0,2
"6141","run051","RBR","BRB",1,0,1
"6142","run051","RBR","BRR",1,0,1
"6143","run051","RBR","GRR",4,0,4
"6144","run051","RBR","RGG",2,0,2
"6145","run051","RBR","RGR",1,0,1
"6146","run051","RGG","BBR",1,1,2
"6147","run051","RGR","BBB",2,1,3
"6148","run051","RGR","BBR",1,0,1
"6149","run051","RGR","BGB",2,0,2
"6150","run051","RGR","BGG",2,1,3
"6151","run051","RGR","BRR",1,0,1
"6152","run051","RGR","GGB",2,3,5
"6153","run051","RGR","RGG",1,0,1
"6154","run051","RRG","BBB",2,3,5
"6155","run051","RRG","BGB",1,4,5
"6156","run051","RRG","BRB",2,6,8
"6157","run051","RRG","BRR",1,2,3
"6158","run051","RRG","GGG",2,1,3
"6159","run051","RRG","GRG",1,0,1
"6160","run051","RRG","GRR",3,0,3
"6161","run051","RRG","RBB",1,0,1
"6162","run051","RRR","BBR",1,0,1
"6163","run051","RRR","BGB",2,0,2
"6164","run051","RRR","BGG",1,0,1
"6165","run051","RRR","BRB",1,1,2
"6166","run051","RRR","BRR",1,0,1
"6167","run051","RRR","RBB",1,1,2
"6168","run051","RRR","RGR",1,0,1
"6169","run051","RRR","RRG",2,1,3
"6170","run051","BBG","RRR",0,1,1
"6171","run051","BGG","BBB",0,1,1
"6172","run051","BGG","BBR",0,1,1
"6173","run051","BGG","GRG",0,1,1
"6174","run051","BGG","RGR",0,1,1
"6175","run051","BRB","BBB",0,1,1
"6176","run051","BRB","BRR",0,1,1
"6177","run051","BRR","BBB",0,1,1
"6178","run051","GBB","GGB",0,4,4
"6179","run051","GBB","RBB",0,1,1
"6180","run051","GBG","BBB",0,1,1
"6181","run051","GBG","GGB",0,1,1
"6182","run051","GGB","BGB",0,1,1
"6183","run051","GGB","BGG",0,2,2
"6184","run051","GGB","GGR",0,3,3
"6185","run051","GGB","RBR",0,2,2
"6186","run051","GGB","RGR",0,1,1
"6187","run051","GGG","BRR",0,2,2
"6188","run051","GGG","RBG",0,2,2
"6189","run051","GGG","RBR",0,4,4
"6190","run051","GGG","RGG",0,1,1
"6191","run051","GGR","BBR",0,1,1
"6192","run051","GRG","GGR",0,1,1
"6193","run051","GRR","BBB",0,1,1
"6194","run051","GRR","BBR",0,1,1
"6195","run051","GRR","GGG",0,1,1
"6196","run051","RBG","RGR",0,1,1
"6197","run051","RBR","BBB",0,1,1
"6198","run051","RBR","GGB",0,1,1
"6199","run051","RBR","RRR",0,1,1
"6200","run051","RGG","BBB",0,2,2
"6201","run051","RGG","BGB",0,1,1
"6202","run051","RGG","BRR",0,1,1
"6203","run051","RGG","GGG",0,1,1
"6204","run051","RGG","GRR",0,1,1
"6205","run051","RGR","GGG",0,1,1
"6206","run051","RGR","RBB",0,2,2
"6207","run051","RRG","BBR",0,1,1
"6208","run051","RRG","RGR",0,1,1
"6209","run052","BBB","GGG",1,0,1
"6210","run052","BBB","RRG",1,1,2
"6211","run052","BBG","BBB",1,1,2
"6212","run052","BBG","BRB",1,1,2
"6213","run052","BBG","GBG",2,0,2
"6214","run052","BBG","GGB",2,3,5
"6215","run052","BBG","GGG",4,9,13
"6216","run052","BBG","GRG",1,3,4
"6217","run052","BBG","RRG",1,0,1
"6218","run052","BGG","RBG",1,0,1
"6219","run052","BGG","RRR",1,0,1
"6220","run052","BRR","BGB",1,0,1
"6221","run052","GBB","BBB",12,12,24
"6222","run052","GBB","BRB",1,3,4
"6223","run052","GBB","BRR",1,0,1
"6224","run052","GBB","GGG",7,16,23
"6225","run052","GBB","GGR",1,1,2
"6226","run052","GBB","RBG",3,2,5
"6227","run052","GBB","RBR",1,0,1
"6228","run052","GBB","RGG",1,0,1
"6229","run052","GBB","RGR",2,0,2
"6230","run052","GBB","RRR",1,1,2
"6231","run052","GBG","BRB",1,0,1
"6232","run052","GBG","BRR",1,0,1
"6233","run052","GBG","GGG",4,2,6
"6234","run052","GBG","RBB",1,0,1
"6235","run052","GBG","RGR",1,0,1
"6236","run052","GBG","RRG",1,2,3
"6237","run052","GGB","BBB",3,2,5
"6238","run052","GGB","BBR",1,1,2
"6239","run052","GGB","BRR",1,2,3
"6240","run052","GGB","GBG",1,0,1
"6241","run052","GGB","GGG",13,5,18
"6242","run052","GGB","RGG",1,1,2
"6243","run052","GGB","RRG",1,1,2
"6244","run052","GGB","RRR",1,2,3
"6245","run052","GGG","BBB",8,4,12
"6246","run052","GGG","BGG",1,3,4
"6247","run052","GGG","BRB",1,0,1
"6248","run052","GGG","GGB",5,0,5
"6249","run052","GGG","GGR",1,0,1
"6250","run052","GGG","RBB",1,0,1
"6251","run052","GGG","RGR",1,3,4
"6252","run052","GGG","RRG",1,4,5
"6253","run052","GGR","BRR",1,0,1
"6254","run052","GGR","GRR",1,0,1
"6255","run052","GRG","BBB",3,1,4
"6256","run052","GRG","GGB",2,1,3
"6257","run052","GRG","GGG",3,2,5
"6258","run052","GRG","RGR",1,1,2
"6259","run052","GRG","RRG",2,1,3
"6260","run052","GRR","BGB",1,0,1
"6261","run052","RBG","BBB",2,1,3
"6262","run052","RBG","RBB",1,0,1
"6263","run052","RBR","BGB",2,2,4
"6264","run052","RBR","BRB",1,0,1
"6265","run052","RBR","BRR",1,0,1
"6266","run052","RBR","GRR",4,0,4
"6267","run052","RBR","RGG",2,1,3
"6268","run052","RBR","RGR",1,0,1
"6269","run052","RGG","BBR",1,0,1
"6270","run052","RGR","BBB",2,1,3
"6271","run052","RGR","BBR",1,0,1
"6272","run052","RGR","BGB",2,2,4
"6273","run052","RGR","BGG",2,0,2
"6274","run052","RGR","BRR",1,0,1
"6275","run052","RGR","GGB",2,0,2
"6276","run052","RGR","RGG",1,0,1
"6277","run052","RRG","BBB",2,5,7
"6278","run052","RRG","BGB",1,1,2
"6279","run052","RRG","BRB",2,7,9
"6280","run052","RRG","BRR",1,1,2
"6281","run052","RRG","GGG",2,1,3
"6282","run052","RRG","GRG",1,0,1
"6283","run052","RRG","GRR",3,1,4
"6284","run052","RRG","RBB",1,1,2
"6285","run052","RRR","BBR",1,0,1
"6286","run052","RRR","BGB",2,0,2
"6287","run052","RRR","BGG",1,0,1
"6288","run052","RRR","BRB",1,0,1
"6289","run052","RRR","BRR",1,0,1
"6290","run052","RRR","RBB",1,1,2
"6291","run052","RRR","RGR",1,0,1
"6292","run052","RRR","RRG",2,1,3
"6293","run052","BBB","RRR",0,1,1
"6294","run052","BBG","RRR",0,2,2
"6295","run052","BGG","RGG",0,1,1
"6296","run052","BRB","BBB",0,1,1
"6297","run052","BRB","BRR",0,3,3
"6298","run052","BRR","BBB",0,1,1
"6299","run052","BRR","BRB",0,1,1
"6300","run052","GBB","GGB",0,5,5
"6301","run052","GBB","GRG",0,1,1
"6302","run052","GGB","BGB",0,3,3
"6303","run052","GGB","BGG",0,1,1
"6304","run052","GGB","GGR",0,1,1
"6305","run052","GGB","GRR",0,1,1
"6306","run052","GGB","RBG",0,1,1
"6307","run052","GGB","RBR",0,1,1
"6308","run052","GGG","BGB",0,1,1
"6309","run052","GGG","BRR",0,1,1
"6310","run052","GGG","RBR",0,1,1
"6311","run052","GGG","RGG",0,1,1
"6312","run052","GRG","BRB",0,1,1
"6313","run052","GRG","GGR",0,1,1
"6314","run052","GRG","RBG",0,1,1
"6315","run052","RBR","BBB",0,1,1
"6316","run052","RBR","BGG",0,1,1
"6317","run052","RBR","GGB",0,1,1
"6318","run052","RBR","RBB",0,1,1
"6319","run052","RGG","GRR",0,1,1
"6320","run052","RGR","GGR",0,2,2
"6321","run052","RRG","GGR",0,2,2
"6322","run052","RRG","RGR",0,1,1
"6323","run052","RRR","GRR",0,1,1
"6324","run052","RRR","RGG",0,1,1
"6325","run053","BBB","GGG",1,0,1
"6326","run053","BBB","RRG",1,1,2
"6327","run053","BBG","BBB",1,0,1
"6328","run053","BBG","BRB",1,5,6
"6329","run053","BBG","GBG",2,1,3
"6330","run053","BBG","GGB",2,4,6
"6331","run053","BBG","GGG",4,5,9
"6332","run053","BBG","GRG",1,1,2
"6333","run053","BBG","RRG",1,0,1
"6334","run053","BGG","RBG",1,0,1
"6335","run053","BGG","RRR",1,0,1
"6336","run053","BRR","BGB",1,1,2
"6337","run053","GBB","BBB",12,7,19
"6338","run053","GBB","BRB",1,1,2
"6339","run053","GBB","BRR",1,1,2
"6340","run053","GBB","GGG",7,11,18
"6341","run053","GBB","GGR",1,0,1
"6342","run053","GBB","RBG",3,1,4
"6343","run053","GBB","RBR",1,0,1
"6344","run053","GBB","RGG",1,0,1
"6345","run053","GBB","RGR",2,0,2
"6346","run053","GBB","RRR",1,3,4
"6347","run053","GBG","BRB",1,0,1
"6348","run053","GBG","BRR",1,0,1
"6349","run053","GBG","GGG",4,1,5
"6350","run053","GBG","RBB",1,0,1
"6351","run053","GBG","RGR",1,0,1
"6352","run053","GBG","RRG",1,2,3
"6353","run053","GGB","BBB",3,3,6
"6354","run053","GGB","BBR",1,0,1
"6355","run053","GGB","BRR",1,2,3
"6356","run053","GGB","GBG",1,0,1
"6357","run053","GGB","GGG",13,9,22
"6358","run053","GGB","RGG",1,1,2
"6359","run053","GGB","RRG",1,0,1
"6360","run053","GGB","RRR",1,1,2
"6361","run053","GGG","BBB",8,3,11
"6362","run053","GGG","BGG",1,1,2
"6363","run053","GGG","BRB",1,1,2
"6364","run053","GGG","GGB",5,0,5
"6365","run053","GGG","GGR",1,2,3
"6366","run053","GGG","RBB",1,2,3
"6367","run053","GGG","RGR",1,1,2
"6368","run053","GGG","RRG",1,2,3
"6369","run053","GGR","BRR",1,0,1
"6370","run053","GGR","GRR",1,0,1
"6371","run053","GRG","BBB",3,1,4
"6372","run053","GRG","GGB",2,2,4
"6373","run053","GRG","GGG",3,1,4
"6374","run053","GRG","RGR",1,0,1
"6375","run053","GRG","RRG",2,0,2
"6376","run053","GRR","BGB",1,1,2
"6377","run053","RBG","BBB",2,0,2
"6378","run053","RBG","RBB",1,0,1
"6379","run053","RBR","BGB",2,1,3
"6380","run053","RBR","BRB",1,0,1
"6381","run053","RBR","BRR",1,0,1
"6382","run053","RBR","GRR",4,0,4
"6383","run053","RBR","RGG",2,0,2
"6384","run053","RBR","RGR",1,0,1
"6385","run053","RGG","BBR",1,1,2
"6386","run053","RGR","BBB",2,1,3
"6387","run053","RGR","BBR",1,0,1
"6388","run053","RGR","BGB",2,2,4
"6389","run053","RGR","BGG",2,0,2
"6390","run053","RGR","BRR",1,1,2
"6391","run053","RGR","GGB",2,3,5
"6392","run053","RGR","RGG",1,0,1
"6393","run053","RRG","BBB",2,6,8
"6394","run053","RRG","BGB",1,1,2
"6395","run053","RRG","BRB",2,6,8
"6396","run053","RRG","BRR",1,1,2
"6397","run053","RRG","GGG",2,1,3
"6398","run053","RRG","GRG",1,0,1
"6399","run053","RRG","GRR",3,5,8
"6400","run053","RRG","RBB",1,0,1
"6401","run053","RRR","BBR",1,0,1
"6402","run053","RRR","BGB",2,0,2
"6403","run053","RRR","BGG",1,0,1
"6404","run053","RRR","BRB",1,0,1
"6405","run053","RRR","BRR",1,1,2
"6406","run053","RRR","RBB",1,0,1
"6407","run053","RRR","RGR",1,0,1
"6408","run053","RRR","RRG",2,1,3
"6409","run053","BBB","RRR",0,1,1
"6410","run053","BBG","BGB",0,1,1
"6411","run053","BBG","RRR",0,2,2
"6412","run053","BGB","RRG",0,1,1
"6413","run053","BRB","BBB",0,4,4
"6414","run053","BRB","BBR",0,1,1
"6415","run053","BRB","BRR",0,2,2
"6416","run053","BRB","RBG",0,1,1
"6417","run053","BRB","RRR",0,1,1
"6418","run053","BRR","BBB",0,1,1
"6419","run053","BRR","RBB",0,1,1
"6420","run053","GBB","GGB",0,2,2
"6421","run053","GBB","GRG",0,1,1
"6422","run053","GBB","GRR",0,1,1
"6423","run053","GBG","GGB",0,1,1
"6424","run053","GGB","BRB",0,1,1
"6425","run053","GGB","GGR",0,2,2
"6426","run053","GGB","RBB",0,1,1
"6427","run053","GGB","RBG",0,2,2
"6428","run053","GGB","RGR",0,1,1
"6429","run053","GGG","RBG",0,2,2
"6430","run053","GGG","RBR",0,2,2
"6431","run053","GGR","BBB",0,1,1
"6432","run053","GRG","BBR",0,1,1
"6433","run053","GRG","BGG",0,1,1
"6434","run053","GRR","BRR",0,1,1
"6435","run053","RBB","BRB",0,1,1
"6436","run053","RBB","GRR",0,1,1
"6437","run053","RBB","RGG",0,1,1
"6438","run053","RBR","BBB",0,2,2
"6439","run053","RGG","BBB",0,3,3
"6440","run053","RGG","GGR",0,1,1
"6441","run053","RGG","GRR",0,3,3
"6442","run053","RRG","BBR",0,1,1
"6443","run053","RRG","GGR",0,1,1
"6444","run053","RRR","GRR",0,1,1
"6445","run054","BBB","GGG",1,0,1
"6446","run054","BBB","RRG",1,0,1
"6447","run054","BBG","BBB",1,2,3
"6448","run054","BBG","BRB",1,3,4
"6449","run054","BBG","GBG",2,0,2
"6450","run054","BBG","GGB",2,9,11
"6451","run054","BBG","GGG",4,3,7
"6452","run054","BBG","GRG",1,0,1
"6453","run054","BBG","RRG",1,0,1
"6454","run054","BGG","RBG",1,0,1
"6455","run054","BGG","RRR",1,1,2
"6456","run054","BRR","BGB",1,0,1
"6457","run054","GBB","BBB",12,6,18
"6458","run054","GBB","BRB",1,2,3
"6459","run054","GBB","BRR",1,1,2
"6460","run054","GBB","GGG",7,9,16
"6461","run054","GBB","GGR",1,2,3
"6462","run054","GBB","RBG",3,1,4
"6463","run054","GBB","RBR",1,0,1
"6464","run054","GBB","RGG",1,0,1
"6465","run054","GBB","RGR",2,0,2
"6466","run054","GBB","RRR",1,2,3
"6467","run054","GBG","BRB",1,2,3
"6468","run054","GBG","BRR",1,0,1
"6469","run054","GBG","GGG",4,0,4
"6470","run054","GBG","RBB",1,0,1
"6471","run054","GBG","RGR",1,0,1
"6472","run054","GBG","RRG",1,0,1
"6473","run054","GGB","BBB",3,3,6
"6474","run054","GGB","BBR",1,0,1
"6475","run054","GGB","BRR",1,0,1
"6476","run054","GGB","GBG",1,0,1
"6477","run054","GGB","GGG",13,11,24
"6478","run054","GGB","RGG",1,0,1
"6479","run054","GGB","RRG",1,0,1
"6480","run054","GGB","RRR",1,1,2
"6481","run054","GGG","BBB",8,11,19
"6482","run054","GGG","BGG",1,0,1
"6483","run054","GGG","BRB",1,0,1
"6484","run054","GGG","GGB",5,0,5
"6485","run054","GGG","GGR",1,2,3
"6486","run054","GGG","RBB",1,1,2
"6487","run054","GGG","RGR",1,2,3
"6488","run054","GGG","RRG",1,3,4
"6489","run054","GGR","BRR",1,0,1
"6490","run054","GGR","GRR",1,0,1
"6491","run054","GRG","BBB",3,2,5
"6492","run054","GRG","GGB",2,3,5
"6493","run054","GRG","GGG",3,1,4
"6494","run054","GRG","RGR",1,0,1
"6495","run054","GRG","RRG",2,2,4
"6496","run054","GRR","BGB",1,1,2
"6497","run054","RBG","BBB",2,0,2
"6498","run054","RBG","RBB",1,0,1
"6499","run054","RBR","BGB",2,1,3
"6500","run054","RBR","BRB",1,0,1
"6501","run054","RBR","BRR",1,3,4
"6502","run054","RBR","GRR",4,1,5
"6503","run054","RBR","RGG",2,4,6
"6504","run054","RBR","RGR",1,0,1
"6505","run054","RGG","BBR",1,0,1
"6506","run054","RGR","BBB",2,2,4
"6507","run054","RGR","BBR",1,0,1
"6508","run054","RGR","BGB",2,1,3
"6509","run054","RGR","BGG",2,0,2
"6510","run054","RGR","BRR",1,1,2
"6511","run054","RGR","GGB",2,1,3
"6512","run054","RGR","RGG",1,0,1
"6513","run054","RRG","BBB",2,5,7
"6514","run054","RRG","BGB",1,2,3
"6515","run054","RRG","BRB",2,1,3
"6516","run054","RRG","BRR",1,1,2
"6517","run054","RRG","GGG",2,1,3
"6518","run054","RRG","GRG",1,0,1
"6519","run054","RRG","GRR",3,1,4
"6520","run054","RRG","RBB",1,0,1
"6521","run054","RRR","BBR",1,0,1
"6522","run054","RRR","BGB",2,0,2
"6523","run054","RRR","BGG",1,0,1
"6524","run054","RRR","BRB",1,0,1
"6525","run054","RRR","BRR",1,0,1
"6526","run054","RRR","RBB",1,0,1
"6527","run054","RRR","RGR",1,0,1
"6528","run054","RRR","RRG",2,0,2
"6529","run054","BBB","GRR",0,1,1
"6530","run054","BBG","RBB",0,1,1
"6531","run054","BBG","RBG",0,1,1
"6532","run054","BBG","RBR",0,1,1
"6533","run054","BBG","RRR",0,1,1
"6534","run054","BRB","BBB",0,2,2
"6535","run054","BRB","RRR",0,1,1
"6536","run054","BRR","BGG",0,1,1
"6537","run054","GBB","BGG",0,1,1
"6538","run054","GBB","GBG",0,1,1
"6539","run054","GBB","GGB",0,5,5
"6540","run054","GBB","RRG",0,2,2
"6541","run054","GBG","BBB",0,1,1
"6542","run054","GBG","BBR",0,1,1
"6543","run054","GBG","RBG",0,1,1
"6544","run054","GGB","GGR",0,1,1
"6545","run054","GGB","RBB",0,1,1
"6546","run054","GGB","RBG",0,1,1
"6547","run054","GGB","RBR",0,1,1
"6548","run054","GGB","RGR",0,1,1
"6549","run054","GGG","BRR",0,1,1
"6550","run054","GGG","GRR",0,1,1
"6551","run054","GGG","RBR",0,3,3
"6552","run054","GRG","GGR",0,2,2
"6553","run054","RBG","RGR",0,1,1
"6554","run054","RBR","BBB",0,2,2
"6555","run054","RBR","GGB",0,1,1
"6556","run054","RGG","BBB",0,2,2
"6557","run054","RGG","GGG",0,1,1
"6558","run054","RGG","GGR",0,1,1
"6559","run054","RGG","GRR",0,1,1
"6560","run054","RGR","GGG",0,1,1
"6561","run054","RGR","RBB",0,1,1
"6562","run054","RRG","BBR",0,1,1
"6563","run054","RRG","GGR",0,1,1
"6564","run054","RRR","GRR",0,1,1
"6565","run054","RRR","RBR",0,1,1
"6566","run054","RRR","RGG",0,1,1
"6567","run055","BBB","GGG",1,0,1
"6568","run055","BBB","RRG",1,0,1
"6569","run055","BBG","BBB",1,1,2
"6570","run055","BBG","BRB",1,0,1
"6571","run055","BBG","GBG",2,0,2
"6572","run055","BBG","GGB",2,6,8
"6573","run055","BBG","GGG",4,6,10
"6574","run055","BBG","GRG",1,1,2
"6575","run055","BBG","RRG",1,0,1
"6576","run055","BGG","RBG",1,0,1
"6577","run055","BGG","RRR",1,1,2
"6578","run055","BRR","BGB",1,0,1
"6579","run055","GBB","BBB",12,4,16
"6580","run055","GBB","BRB",1,1,2
"6581","run055","GBB","BRR",1,0,1
"6582","run055","GBB","GGG",7,14,21
"6583","run055","GBB","GGR",1,0,1
"6584","run055","GBB","RBG",3,1,4
"6585","run055","GBB","RBR",1,0,1
"6586","run055","GBB","RGG",1,0,1
"6587","run055","GBB","RGR",2,0,2
"6588","run055","GBB","RRR",1,2,3
"6589","run055","GBG","BRB",1,0,1
"6590","run055","GBG","BRR",1,0,1
"6591","run055","GBG","GGG",4,0,4
"6592","run055","GBG","RBB",1,0,1
"6593","run055","GBG","RGR",1,1,2
"6594","run055","GBG","RRG",1,0,1
"6595","run055","GGB","BBB",3,3,6
"6596","run055","GGB","BBR",1,0,1
"6597","run055","GGB","BRR",1,1,2
"6598","run055","GGB","GBG",1,0,1
"6599","run055","GGB","GGG",13,8,21
"6600","run055","GGB","RGG",1,0,1
"6601","run055","GGB","RRG",1,1,2
"6602","run055","GGB","RRR",1,0,1
"6603","run055","GGG","BBB",8,7,15
"6604","run055","GGG","BGG",1,2,3
"6605","run055","GGG","BRB",1,1,2
"6606","run055","GGG","GGB",5,0,5
"6607","run055","GGG","GGR",1,2,3
"6608","run055","GGG","RBB",1,2,3
"6609","run055","GGG","RGR",1,1,2
"6610","run055","GGG","RRG",1,3,4
"6611","run055","GGR","BRR",1,0,1
"6612","run055","GGR","GRR",1,0,1
"6613","run055","GRG","BBB",3,2,5
"6614","run055","GRG","GGB",2,2,4
"6615","run055","GRG","GGG",3,2,5
"6616","run055","GRG","RGR",1,0,1
"6617","run055","GRG","RRG",2,2,4
"6618","run055","GRR","BGB",1,0,1
"6619","run055","RBG","BBB",2,0,2
"6620","run055","RBG","RBB",1,0,1
"6621","run055","RBR","BGB",2,1,3
"6622","run055","RBR","BRB",1,0,1
"6623","run055","RBR","BRR",1,0,1
"6624","run055","RBR","GRR",4,1,5
"6625","run055","RBR","RGG",2,2,4
"6626","run055","RBR","RGR",1,0,1
"6627","run055","RGG","BBR",1,0,1
"6628","run055","RGR","BBB",2,1,3
"6629","run055","RGR","BBR",1,0,1
"6630","run055","RGR","BGB",2,1,3
"6631","run055","RGR","BGG",2,0,2
"6632","run055","RGR","BRR",1,0,1
"6633","run055","RGR","GGB",2,4,6
"6634","run055","RGR","RGG",1,0,1
"6635","run055","RRG","BBB",2,7,9
"6636","run055","RRG","BGB",1,1,2
"6637","run055","RRG","BRB",2,3,5
"6638","run055","RRG","BRR",1,3,4
"6639","run055","RRG","GGG",2,3,5
"6640","run055","RRG","GRG",1,0,1
"6641","run055","RRG","GRR",3,1,4
"6642","run055","RRG","RBB",1,0,1
"6643","run055","RRR","BBR",1,0,1
"6644","run055","RRR","BGB",2,1,3
"6645","run055","RRR","BGG",1,0,1
"6646","run055","RRR","BRB",1,0,1
"6647","run055","RRR","BRR",1,0,1
"6648","run055","RRR","RBB",1,1,2
"6649","run055","RRR","RGR",1,0,1
"6650","run055","RRR","RRG",2,0,2
"6651","run055","BBG","RRR",0,1,1
"6652","run055","BGB","RRG",0,1,1
"6653","run055","BGG","BBB",0,1,1
"6654","run055","BGG","RGG",0,1,1
"6655","run055","BRB","BBB",0,3,3
"6656","run055","BRB","BBR",0,1,1
"6657","run055","BRB","RGR",0,1,1
"6658","run055","BRR","BBB",0,4,4
"6659","run055","BRR","BRB",0,1,1
"6660","run055","BRR","RBB",0,1,1
"6661","run055","GBB","GBG",0,2,2
"6662","run055","GBB","GRG",0,2,2
"6663","run055","GBG","BBB",0,2,2
"6664","run055","GBG","GGB",0,1,1
"6665","run055","GGB","GGR",0,4,4
"6666","run055","GGB","GRR",0,1,1
"6667","run055","GGB","RBG",0,2,2
"6668","run055","GGB","RBR",0,1,1
"6669","run055","GGG","RBG",0,1,1
"6670","run055","GGG","RBR",0,5,5
"6671","run055","GGG","RGG",0,2,2
"6672","run055","GGG","RRR",0,1,1
"6673","run055","GRG","GGR",0,1,1
"6674","run055","RBB","GRR",0,1,1
"6675","run055","RBB","RGG",0,1,1
"6676","run055","RBG","BRR",0,1,1
"6677","run055","RBG","GRR",0,1,1
"6678","run055","RBG","RBR",0,1,1
"6679","run055","RBR","BBB",0,1,1
"6680","run055","RBR","GGB",0,2,2
"6681","run055","RGG","BBB",0,1,1
"6682","run055","RGG","BRR",0,1,1
"6683","run055","RGG","GRR",0,1,1
"6684","run055","RGR","RRG",0,1,1
"6685","run055","RRR","GRR",0,1,1
"6686","run056","BBB","GGG",1,0,1
"6687","run056","BBB","RRG",1,0,1
"6688","run056","BBG","BBB",1,0,1
"6689","run056","BBG","BRB",1,4,5
"6690","run056","BBG","GBG",2,2,4
"6691","run056","BBG","GGB",2,5,7
"6692","run056","BBG","GGG",4,10,14
"6693","run056","BBG","GRG",1,3,4
"6694","run056","BBG","RRG",1,0,1
"6695","run056","BGG","RBG",1,0,1
"6696","run056","BGG","RRR",1,0,1
"6697","run056","BRR","BGB",1,0,1
"6698","run056","GBB","BBB",12,5,17
"6699","run056","GBB","BRB",1,2,3
"6700","run056","GBB","BRR",1,0,1
"6701","run056","GBB","GGG",7,12,19
"6702","run056","GBB","GGR",1,0,1
"6703","run056","GBB","RBG",3,2,5
"6704","run056","GBB","RBR",1,0,1
"6705","run056","GBB","RGG",1,0,1
"6706","run056","GBB","RGR",2,0,2
"6707","run056","GBB","RRR",1,2,3
"6708","run056","GBG","BRB",1,0,1
"6709","run056","GBG","BRR",1,0,1
"6710","run056","GBG","GGG",4,2,6
"6711","run056","GBG","RBB",1,0,1
"6712","run056","GBG","RGR",1,0,1
"6713","run056","GBG","RRG",1,0,1
"6714","run056","GGB","BBB",3,2,5
"6715","run056","GGB","BBR",1,0,1
"6716","run056","GGB","BRR",1,1,2
"6717","run056","GGB","GBG",1,0,1
"6718","run056","GGB","GGG",13,7,20
"6719","run056","GGB","RGG",1,2,3
"6720","run056","GGB","RRG",1,0,1
"6721","run056","GGB","RRR",1,0,1
"6722","run056","GGG","BBB",8,8,16
"6723","run056","GGG","BGG",1,0,1
"6724","run056","GGG","BRB",1,0,1
"6725","run056","GGG","GGB",5,0,5
"6726","run056","GGG","GGR",1,1,2
"6727","run056","GGG","RBB",1,1,2
"6728","run056","GGG","RGR",1,4,5
"6729","run056","GGG","RRG",1,2,3
"6730","run056","GGR","BRR",1,0,1
"6731","run056","GGR","GRR",1,0,1
"6732","run056","GRG","BBB",3,0,3
"6733","run056","GRG","GGB",2,1,3
"6734","run056","GRG","GGG",3,2,5
"6735","run056","GRG","RGR",1,0,1
"6736","run056","GRG","RRG",2,1,3
"6737","run056","GRR","BGB",1,0,1
"6738","run056","RBG","BBB",2,0,2
"6739","run056","RBG","RBB",1,0,1
"6740","run056","RBR","BGB",2,3,5
"6741","run056","RBR","BRB",1,0,1
"6742","run056","RBR","BRR",1,0,1
"6743","run056","RBR","GRR",4,2,6
"6744","run056","RBR","RGG",2,3,5
"6745","run056","RBR","RGR",1,0,1
"6746","run056","RGG","BBR",1,0,1
"6747","run056","RGR","BBB",2,0,2
"6748","run056","RGR","BBR",1,1,2
"6749","run056","RGR","BGB",2,1,3
"6750","run056","RGR","BGG",2,0,2
"6751","run056","RGR","BRR",1,1,2
"6752","run056","RGR","GGB",2,4,6
"6753","run056","RGR","RGG",1,1,2
"6754","run056","RRG","BBB",2,1,3
"6755","run056","RRG","BGB",1,2,3
"6756","run056","RRG","BRB",2,4,6
"6757","run056","RRG","BRR",1,1,2
"6758","run056","RRG","GGG",2,1,3
"6759","run056","RRG","GRG",1,0,1
"6760","run056","RRG","GRR",3,0,3
"6761","run056","RRG","RBB",1,0,1
"6762","run056","RRR","BBR",1,0,1
"6763","run056","RRR","BGB",2,1,3
"6764","run056","RRR","BGG",1,0,1
"6765","run056","RRR","BRB",1,0,1
"6766","run056","RRR","BRR",1,0,1
"6767","run056","RRR","RBB",1,0,1
"6768","run056","RRR","RGR",1,0,1
"6769","run056","RRR","RRG",2,0,2
"6770","run056","BBB","GRR",0,1,1
"6771","run056","BBG","BGB",0,1,1
"6772","run056","BBG","BGG",0,1,1
"6773","run056","BBG","RBG",0,1,1
"6774","run056","BBG","RGR",0,1,1
"6775","run056","BBG","RRR",0,1,1
"6776","run056","BGG","GRG",0,1,1
"6777","run056","BRB","BBB",0,1,1
"6778","run056","BRB","BBR",0,1,1
"6779","run056","BRB","GGG",0,1,1
"6780","run056","BRB","RBG",0,1,1
"6781","run056","BRR","BBB",0,3,3
"6782","run056","BRR","BRB",0,1,1
"6783","run056","GBB","GGB",0,3,3
"6784","run056","GBB","GRG",0,1,1
"6785","run056","GBB","RRG",0,1,1
"6786","run056","GBG","BBB",0,2,2
"6787","run056","GGB","BGG",0,1,1
"6788","run056","GGB","GGR",0,2,2
"6789","run056","GGB","GRR",0,1,1
"6790","run056","GGB","RBB",0,1,1
"6791","run056","GGB","RBR",0,1,1
"6792","run056","GGB","RGR",0,1,1
"6793","run056","GGG","BGB",0,1,1
"6794","run056","GGG","BRR",0,1,1
"6795","run056","GGG","GRR",0,1,1
"6796","run056","GGG","RBG",0,1,1
"6797","run056","GGG","RBR",0,4,4
"6798","run056","GGR","RBB",0,1,1
"6799","run056","GRG","BBR",0,1,1
"6800","run056","GRG","GGR",0,2,2
"6801","run056","GRR","BRR",0,1,1
"6802","run056","RBR","BBB",0,3,3
"6803","run056","RBR","BGG",0,2,2
"6804","run056","RBR","GGB",0,2,2
"6805","run056","RGG","BBB",0,1,1
"6806","run056","RGG","BRR",0,1,1
"6807","run056","RGG","GRR",0,1,1
"6808","run056","RRR","GRR",0,1,1
"6809","run057","BBB","GGG",1,0,1
"6810","run057","BBB","RRG",1,0,1
"6811","run057","BBG","BBB",1,1,2
"6812","run057","BBG","BRB",1,1,2
"6813","run057","BBG","GBG",2,0,2
"6814","run057","BBG","GGB",2,8,10
"6815","run057","BBG","GGG",4,9,13
"6816","run057","BBG","GRG",1,2,3
"6817","run057","BBG","RRG",1,0,1
"6818","run057","BGG","RBG",1,0,1
"6819","run057","BGG","RRR",1,0,1
"6820","run057","BRR","BGB",1,0,1
"6821","run057","GBB","BBB",12,2,14
"6822","run057","GBB","BRB",1,2,3
"6823","run057","GBB","BRR",1,1,2
"6824","run057","GBB","GGG",7,17,24
"6825","run057","GBB","GGR",1,1,2
"6826","run057","GBB","RBG",3,1,4
"6827","run057","GBB","RBR",1,0,1
"6828","run057","GBB","RGG",1,0,1
"6829","run057","GBB","RGR",2,0,2
"6830","run057","GBB","RRR",1,0,1
"6831","run057","GBG","BRB",1,1,2
"6832","run057","GBG","BRR",1,0,1
"6833","run057","GBG","GGG",4,4,8
"6834","run057","GBG","RBB",1,0,1
"6835","run057","GBG","RGR",1,0,1
"6836","run057","GBG","RRG",1,0,1
"6837","run057","GGB","BBB",3,0,3
"6838","run057","GGB","BBR",1,0,1
"6839","run057","GGB","BRR",1,0,1
"6840","run057","GGB","GBG",1,0,1
"6841","run057","GGB","GGG",13,10,23
"6842","run057","GGB","RGG",1,0,1
"6843","run057","GGB","RRG",1,0,1
"6844","run057","GGB","RRR",1,2,3
"6845","run057","GGG","BBB",8,5,13
"6846","run057","GGG","BGG",1,1,2
"6847","run057","GGG","BRB",1,0,1
"6848","run057","GGG","GGB",5,1,6
"6849","run057","GGG","GGR",1,1,2
"6850","run057","GGG","RBB",1,2,3
"6851","run057","GGG","RGR",1,2,3
"6852","run057","GGG","RRG",1,1,2
"6853","run057","GGR","BRR",1,0,1
"6854","run057","GGR","GRR",1,0,1
"6855","run057","GRG","BBB",3,1,4
"6856","run057","GRG","GGB",2,1,3
"6857","run057","GRG","GGG",3,2,5
"6858","run057","GRG","RGR",1,0,1
"6859","run057","GRG","RRG",2,2,4
"6860","run057","GRR","BGB",1,0,1
"6861","run057","RBG","BBB",2,3,5
"6862","run057","RBG","RBB",1,0,1
"6863","run057","RBR","BGB",2,1,3
"6864","run057","RBR","BRB",1,0,1
"6865","run057","RBR","BRR",1,1,2
"6866","run057","RBR","GRR",4,1,5
"6867","run057","RBR","RGG",2,0,2
"6868","run057","RBR","RGR",1,0,1
"6869","run057","RGG","BBR",1,0,1
"6870","run057","RGR","BBB",2,3,5
"6871","run057","RGR","BBR",1,0,1
"6872","run057","RGR","BGB",2,0,2
"6873","run057","RGR","BGG",2,0,2
"6874","run057","RGR","BRR",1,0,1
"6875","run057","RGR","GGB",2,2,4
"6876","run057","RGR","RGG",1,0,1
"6877","run057","RRG","BBB",2,3,5
"6878","run057","RRG","BGB",1,1,2
"6879","run057","RRG","BRB",2,6,8
"6880","run057","RRG","BRR",1,3,4
"6881","run057","RRG","GGG",2,2,4
"6882","run057","RRG","GRG",1,0,1
"6883","run057","RRG","GRR",3,1,4
"6884","run057","RRG","RBB",1,0,1
"6885","run057","RRR","BBR",1,0,1
"6886","run057","RRR","BGB",2,0,2
"6887","run057","RRR","BGG",1,0,1
"6888","run057","RRR","BRB",1,0,1
"6889","run057","RRR","BRR",1,0,1
"6890","run057","RRR","RBB",1,0,1
"6891","run057","RRR","RGR",1,0,1
"6892","run057","RRR","RRG",2,0,2
"6893","run057","BBB","GRR",0,1,1
"6894","run057","BBB","RRR",0,1,1
"6895","run057","BBG","RBG",0,1,1
"6896","run057","BBG","RRR",0,2,2
"6897","run057","BGB","BBB",0,1,1
"6898","run057","BGG","BBB",0,1,1
"6899","run057","BRB","BBB",0,2,2
"6900","run057","BRB","BRR",0,1,1
"6901","run057","BRR","BBB",0,2,2
"6902","run057","GBB","GGB",0,2,2
"6903","run057","GBB","RRG",0,2,2
"6904","run057","GBG","BBB",0,2,2
"6905","run057","GBG","GGB",0,2,2
"6906","run057","GGB","BGB",0,1,1
"6907","run057","GGB","BRB",0,1,1
"6908","run057","GGB","GGR",0,1,1
"6909","run057","GGB","GRR",0,1,1
"6910","run057","GGB","RBB",0,2,2
"6911","run057","GGB","RBR",0,2,2
"6912","run057","GGB","RGR",0,1,1
"6913","run057","GGG","BRR",0,1,1
"6914","run057","GGG","RBR",0,3,3
"6915","run057","GRG","GGR",0,2,2
"6916","run057","RBB","BBR",0,1,1
"6917","run057","RBB","RGG",0,1,1
"6918","run057","RBG","RBR",0,1,1
"6919","run057","RBR","BBB",0,2,2
"6920","run057","RBR","GGB",0,1,1
"6921","run057","RBR","RRR",0,1,1
"6922","run057","RGG","GRR",0,4,4
"6923","run057","RGR","GGR",0,1,1
"6924","run057","RGR","RBB",0,1,1
"6925","run057","RRG","BBR",0,1,1
"6926","run057","RRG","GGR",0,1,1
"6927","run057","RRG","RGG",0,1,1
"6928","run057","RRR","RGG",0,1,1
"6929","run058","BBB","GGG",1,0,1
"6930","run058","BBB","RRG",1,1,2
"6931","run058","BBG","BBB",1,0,1
"6932","run058","BBG","BRB",1,4,5
"6933","run058","BBG","GBG",2,0,2
"6934","run058","BBG","GGB",2,3,5
"6935","run058","BBG","GGG",4,10,14
"6936","run058","BBG","GRG",1,1,2
"6937","run058","BBG","RRG",1,0,1
"6938","run058","BGG","RBG",1,0,1
"6939","run058","BGG","RRR",1,0,1
"6940","run058","BRR","BGB",1,0,1
"6941","run058","GBB","BBB",12,6,18
"6942","run058","GBB","BRB",1,2,3
"6943","run058","GBB","BRR",1,0,1
"6944","run058","GBB","GGG",7,11,18
"6945","run058","GBB","GGR",1,0,1
"6946","run058","GBB","RBG",3,1,4
"6947","run058","GBB","RBR",1,0,1
"6948","run058","GBB","RGG",1,0,1
"6949","run058","GBB","RGR",2,1,3
"6950","run058","GBB","RRR",1,0,1
"6951","run058","GBG","BRB",1,0,1
"6952","run058","GBG","BRR",1,0,1
"6953","run058","GBG","GGG",4,0,4
"6954","run058","GBG","RBB",1,0,1
"6955","run058","GBG","RGR",1,0,1
"6956","run058","GBG","RRG",1,0,1
"6957","run058","GGB","BBB",3,4,7
"6958","run058","GGB","BBR",1,1,2
"6959","run058","GGB","BRR",1,2,3
"6960","run058","GGB","GBG",1,0,1
"6961","run058","GGB","GGG",13,11,24
"6962","run058","GGB","RGG",1,1,2
"6963","run058","GGB","RRG",1,0,1
"6964","run058","GGB","RRR",1,0,1
"6965","run058","GGG","BBB",8,4,12
"6966","run058","GGG","BGG",1,1,2
"6967","run058","GGG","BRB",1,0,1
"6968","run058","GGG","GGB",5,0,5
"6969","run058","GGG","GGR",1,0,1
"6970","run058","GGG","RBB",1,2,3
"6971","run058","GGG","RGR",1,3,4
"6972","run058","GGG","RRG",1,3,4
"6973","run058","GGR","BRR",1,0,1
"6974","run058","GGR","GRR",1,0,1
"6975","run058","GRG","BBB",3,1,4
"6976","run058","GRG","GGB",2,2,4
"6977","run058","GRG","GGG",3,2,5
"6978","run058","GRG","RGR",1,1,2
"6979","run058","GRG","RRG",2,1,3
"6980","run058","GRR","BGB",1,0,1
"6981","run058","RBG","BBB",2,2,4
"6982","run058","RBG","RBB",1,0,1
"6983","run058","RBR","BGB",2,0,2
"6984","run058","RBR","BRB",1,0,1
"6985","run058","RBR","BRR",1,2,3
"6986","run058","RBR","GRR",4,1,5
"6987","run058","RBR","RGG",2,1,3
"6988","run058","RBR","RGR",1,0,1
"6989","run058","RGG","BBR",1,0,1
"6990","run058","RGR","BBB",2,1,3
"6991","run058","RGR","BBR",1,0,1
"6992","run058","RGR","BGB",2,2,4
"6993","run058","RGR","BGG",2,0,2
"6994","run058","RGR","BRR",1,2,3
"6995","run058","RGR","GGB",2,4,6
"6996","run058","RGR","RGG",1,0,1
"6997","run058","RRG","BBB",2,4,6
"6998","run058","RRG","BGB",1,0,1
"6999","run058","RRG","BRB",2,3,5
"7000","run058","RRG","BRR",1,3,4
"7001","run058","RRG","GGG",2,2,4
"7002","run058","RRG","GRG",1,0,1
"7003","run058","RRG","GRR",3,2,5
"7004","run058","RRG","RBB",1,0,1
"7005","run058","RRR","BBR",1,0,1
"7006","run058","RRR","BGB",2,0,2
"7007","run058","RRR","BGG",1,0,1
"7008","run058","RRR","BRB",1,1,2
"7009","run058","RRR","BRR",1,0,1
"7010","run058","RRR","RBB",1,0,1
"7011","run058","RRR","RGR",1,0,1
"7012","run058","RRR","RRG",2,0,2
"7013","run058","BBB","BRB",0,1,1
"7014","run058","BBG","RBG",0,1,1
"7015","run058","BBG","RBR",0,1,1
"7016","run058","BBG","RGR",0,1,1
"7017","run058","BBG","RRR",0,2,2
"7018","run058","BRB","BBB",0,3,3
"7019","run058","BRR","BRB",0,1,1
"7020","run058","GBB","GBG",0,1,1
"7021","run058","GBB","GGB",0,6,6
"7022","run058","GBB","GRG",0,1,1
"7023","run058","GGB","BGB",0,1,1
"7024","run058","GGB","BGG",0,1,1
"7025","run058","GGB","GGR",0,1,1
"7026","run058","GGB","RBB",0,1,1
"7027","run058","GGB","RBG",0,1,1
"7028","run058","GGB","RBR",0,1,1
"7029","run058","GGB","RGR",0,1,1
"7030","run058","GGG","GRR",0,1,1
"7031","run058","GGG","RBG",0,1,1
"7032","run058","GGG","RBR",0,1,1
"7033","run058","GGG","RRR",0,1,1
"7034","run058","GGR","BGG",0,1,1
"7035","run058","GGR","RBB",0,1,1
"7036","run058","GRG","BGG",0,1,1
"7037","run058","GRG","GGR",0,1,1
"7038","run058","GRR","BRR",0,1,1
"7039","run058","RBG","GRR",0,2,2
"7040","run058","RBR","BBB",0,1,1
"7041","run058","RBR","GGB",0,3,3
"7042","run058","RBR","RBB",0,1,1
"7043","run058","RGG","BRR",0,2,2
"7044","run058","RGG","GRR",0,1,1
"7045","run058","RGR","GGG",0,1,1
"7046","run058","RGR","GGR",0,1,1
"7047","run058","RGR","RRG",0,2,2
"7048","run058","RRG","BGG",0,1,1
"7049","run058","RRG","RGR",0,1,1
"7050","run058","RRR","RBR",0,1,1
"7051","run059","BBB","GGG",1,1,2
"7052","run059","BBB","RRG",1,0,1
"7053","run059","BBG","BBB",1,0,1
"7054","run059","BBG","BRB",1,2,3
"7055","run059","BBG","GBG",2,1,3
"7056","run059","BBG","GGB",2,4,6
"7057","run059","BBG","GGG",4,9,13
"7058","run059","BBG","GRG",1,1,2
"7059","run059","BBG","RRG",1,1,2
"7060","run059","BGG","RBG",1,0,1
"7061","run059","BGG","RRR",1,1,2
"7062","run059","BRR","BGB",1,0,1
"7063","run059","GBB","BBB",12,6,18
"7064","run059","GBB","BRB",1,2,3
"7065","run059","GBB","BRR",1,0,1
"7066","run059","GBB","GGG",7,12,19
"7067","run059","GBB","GGR",1,1,2
"7068","run059","GBB","RBG",3,0,3
"7069","run059","GBB","RBR",1,0,1
"7070","run059","GBB","RGG",1,0,1
"7071","run059","GBB","RGR",2,0,2
"7072","run059","GBB","RRR",1,2,3
"7073","run059","GBG","BRB",1,0,1
"7074","run059","GBG","BRR",1,0,1
"7075","run059","GBG","GGG",4,1,5
"7076","run059","GBG","RBB",1,0,1
"7077","run059","GBG","RGR",1,1,2
"7078","run059","GBG","RRG",1,1,2
"7079","run059","GGB","BBB",3,2,5
"7080","run059","GGB","BBR",1,0,1
"7081","run059","GGB","BRR",1,3,4
"7082","run059","GGB","GBG",1,0,1
"7083","run059","GGB","GGG",13,4,17
"7084","run059","GGB","RGG",1,1,2
"7085","run059","GGB","RRG",1,1,2
"7086","run059","GGB","RRR",1,1,2
"7087","run059","GGG","BBB",8,3,11
"7088","run059","GGG","BGG",1,0,1
"7089","run059","GGG","BRB",1,0,1
"7090","run059","GGG","GGB",5,0,5
"7091","run059","GGG","GGR",1,2,3
"7092","run059","GGG","RBB",1,4,5
"7093","run059","GGG","RGR",1,1,2
"7094","run059","GGG","RRG",1,5,6
"7095","run059","GGR","BRR",1,0,1
"7096","run059","GGR","GRR",1,0,1
"7097","run059","GRG","BBB",3,0,3
"7098","run059","GRG","GGB",2,3,5
"7099","run059","GRG","GGG",3,4,7
"7100","run059","GRG","RGR",1,0,1
"7101","run059","GRG","RRG",2,1,3
"7102","run059","GRR","BGB",1,1,2
"7103","run059","RBG","BBB",2,3,5
"7104","run059","RBG","RBB",1,0,1
"7105","run059","RBR","BGB",2,1,3
"7106","run059","RBR","BRB",1,0,1
"7107","run059","RBR","BRR",1,3,4
"7108","run059","RBR","GRR",4,0,4
"7109","run059","RBR","RGG",2,4,6
"7110","run059","RBR","RGR",1,0,1
"7111","run059","RGG","BBR",1,0,1
"7112","run059","RGR","BBB",2,0,2
"7113","run059","RGR","BBR",1,0,1
"7114","run059","RGR","BGB",2,1,3
"7115","run059","RGR","BGG",2,0,2
"7116","run059","RGR","BRR",1,0,1
"7117","run059","RGR","GGB",2,0,2
"7118","run059","RGR","RGG",1,0,1
"7119","run059","RRG","BBB",2,6,8
"7120","run059","RRG","BGB",1,0,1
"7121","run059","RRG","BRB",2,2,4
"7122","run059","RRG","BRR",1,4,5
"7123","run059","RRG","GGG",2,1,3
"7124","run059","RRG","GRG",1,0,1
"7125","run059","RRG","GRR",3,2,5
"7126","run059","RRG","RBB",1,1,2
"7127","run059","RRR","BBR",1,0,1
"7128","run059","RRR","BGB",2,0,2
"7129","run059","RRR","BGG",1,0,1
"7130","run059","RRR","BRB",1,0,1
"7131","run059","RRR","BRR",1,0,1
"7132","run059","RRR","RBB",1,1,2
"7133","run059","RRR","RGR",1,0,1
"7134","run059","RRR","RRG",2,0,2
"7135","run059","BBB","BRB",0,1,1
"7136","run059","BBB","GRR",0,1,1
"7137","run059","BBG","GRR",0,1,1
"7138","run059","BBG","RBG",0,1,1
"7139","run059","BBG","RGR",0,1,1
"7140","run059","BBG","RRR",0,1,1
"7141","run059","BGG","BBB",0,2,2
"7142","run059","BGG","RGG",0,2,2
"7143","run059","BRB","BBB",0,2,2
"7144","run059","BRB","BRR",0,1,1
"7145","run059","BRB","GGG",0,1,1
"7146","run059","BRR","BBB",0,2,2
"7147","run059","GBB","BGG",0,1,1
"7148","run059","GBB","GBG",0,1,1
"7149","run059","GBB","GGB",0,1,1
"7150","run059","GBG","RGG",0,1,1
"7151","run059","GGB","GGR",0,3,3
"7152","run059","GGG","BRR",0,2,2
"7153","run059","GGG","RBG",0,1,1
"7154","run059","GGG","RBR",0,3,3
"7155","run059","GGG","RGG",0,1,1
"7156","run059","GGR","BBR",0,1,1
"7157","run059","GGR","RBB",0,1,1
"7158","run059","GRG","RBR",0,1,1
"7159","run059","GRR","BBR",0,1,1
"7160","run059","RBB","BBR",0,1,1
"7161","run059","RBR","BBB",0,2,2
"7162","run059","RBR","GGB",0,2,2
"7163","run059","RBR","RBB",0,1,1
"7164","run059","RGG","BGB",0,1,1
"7165","run059","RGG","BRR",0,1,1
"7166","run059","RGG","GRR",0,2,2
"7167","run059","RGR","GGG",0,1,1
"7168","run059","RGR","RBB",0,1,1
"7169","run059","RRG","BBR",0,1,1
"7170","run059","RRG","GGR",0,2,2
"7171","run060","BBB","GGG",1,1,2
"7172","run060","BBB","RRG",1,0,1
"7173","run060","BBG","BBB",1,1,2
"7174","run060","BBG","BRB",1,3,4
"7175","run060","BBG","GBG",2,0,2
"7176","run060","BBG","GGB",2,3,5
"7177","run060","BBG","GGG",4,7,11
"7178","run060","BBG","GRG",1,2,3
"7179","run060","BBG","RRG",1,0,1
"7180","run060","BGG","RBG",1,0,1
"7181","run060","BGG","RRR",1,0,1
"7182","run060","BRR","BGB",1,0,1
"7183","run060","GBB","BBB",12,4,16
"7184","run060","GBB","BRB",1,2,3
"7185","run060","GBB","BRR",1,0,1
"7186","run060","GBB","GGG",7,15,22
"7187","run060","GBB","GGR",1,0,1
"7188","run060","GBB","RBG",3,0,3
"7189","run060","GBB","RBR",1,0,1
"7190","run060","GBB","RGG",1,0,1
"7191","run060","GBB","RGR",2,0,2
"7192","run060","GBB","RRR",1,2,3
"7193","run060","GBG","BRB",1,2,3
"7194","run060","GBG","BRR",1,0,1
"7195","run060","GBG","GGG",4,0,4
"7196","run060","GBG","RBB",1,0,1
"7197","run060","GBG","RGR",1,1,2
"7198","run060","GBG","RRG",1,0,1
"7199","run060","GGB","BBB",3,4,7
"7200","run060","GGB","BBR",1,0,1
"7201","run060","GGB","BRR",1,2,3
"7202","run060","GGB","GBG",1,0,1
"7203","run060","GGB","GGG",13,3,16
"7204","run060","GGB","RGG",1,1,2
"7205","run060","GGB","RRG",1,0,1
"7206","run060","GGB","RRR",1,0,1
"7207","run060","GGG","BBB",8,8,16
"7208","run060","GGG","BGG",1,1,2
"7209","run060","GGG","BRB",1,1,2
"7210","run060","GGG","GGB",5,0,5
"7211","run060","GGG","GGR",1,2,3
"7212","run060","GGG","RBB",1,1,2
"7213","run060","GGG","RGR",1,4,5
"7214","run060","GGG","RRG",1,5,6
"7215","run060","GGR","BRR",1,0,1
"7216","run060","GGR","GRR",1,0,1
"7217","run060","GRG","BBB",3,3,6
"7218","run060","GRG","GGB",2,3,5
"7219","run060","GRG","GGG",3,1,4
"7220","run060","GRG","RGR",1,0,1
"7221","run060","GRG","RRG",2,1,3
"7222","run060","GRR","BGB",1,0,1
"7223","run060","RBG","BBB",2,0,2
"7224","run060","RBG","RBB",1,0,1
"7225","run060","RBR","BGB",2,1,3
"7226","run060","RBR","BRB",1,0,1
"7227","run060","RBR","BRR",1,1,2
"7228","run060","RBR","GRR",4,1,5
"7229","run060","RBR","RGG",2,2,4
"7230","run060","RBR","RGR",1,0,1
"7231","run060","RGG","BBR",1,0,1
"7232","run060","RGR","BBB",2,0,2
"7233","run060","RGR","BBR",1,0,1
"7234","run060","RGR","BGB",2,0,2
"7235","run060","RGR","BGG",2,0,2
"7236","run060","RGR","BRR",1,2,3
"7237","run060","RGR","GGB",2,2,4
"7238","run060","RGR","RGG",1,0,1
"7239","run060","RRG","BBB",2,5,7
"7240","run060","RRG","BGB",1,5,6
"7241","run060","RRG","BRB",2,7,9
"7242","run060","RRG","BRR",1,0,1
"7243","run060","RRG","GGG",2,2,4
"7244","run060","RRG","GRG",1,0,1
"7245","run060","RRG","GRR",3,1,4
"7246","run060","RRG","RBB",1,0,1
"7247","run060","RRR","BBR",1,0,1
"7248","run060","RRR","BGB",2,0,2
"7249","run060","RRR","BGG",1,0,1
"7250","run060","RRR","BRB",1,0,1
"7251","run060","RRR","BRR",1,0,1
"7252","run060","RRR","RBB",1,0,1
"7253","run060","RRR","RGR",1,0,1
"7254","run060","RRR","RRG",2,0,2
"7255","run060","BBB","RRR",0,1,1
"7256","run060","BBG","BGB",0,1,1
"7257","run060","BRB","BBB",0,4,4
"7258","run060","BRB","BRR",0,1,1
"7259","run060","BRB","GGG",0,1,1
"7260","run060","BRB","RGR",0,1,1
"7261","run060","BRR","BBB",0,1,1
"7262","run060","BRR","BGG",0,1,1
"7263","run060","GBB","GBG",0,1,1
"7264","run060","GBB","GGB",0,3,3
"7265","run060","GGB","BGG",0,1,1
"7266","run060","GGB","GRR",0,1,1
"7267","run060","GGB","RBB",0,1,1
"7268","run060","GGG","BRR",0,2,2
"7269","run060","GGG","RBR",0,2,2
"7270","run060","GGG","RRR",0,1,1
"7271","run060","GGR","BBR",0,1,1
"7272","run060","GRG","BRB",0,1,1
"7273","run060","GRG","GGR",0,1,1
"7274","run060","RBG","BRR",0,1,1
"7275","run060","RBG","RBR",0,1,1
"7276","run060","RBR","BBB",0,3,3
"7277","run060","RBR","GGB",0,1,1
"7278","run060","RBR","RBB",0,1,1
"7279","run060","RGG","BBB",0,2,2
"7280","run060","RGG","BRR",0,1,1
"7281","run060","RGG","GRR",0,3,3
"7282","run060","RGR","GGG",0,1,1
"7283","run060","RGR","GGR",0,1,1
"7284","run060","RRG","BBR",0,3,3
"7285","run060","RRG","GGR",0,2,2
"7286","run060","RRR","GGR",0,1,1
"7287","run060","RRR","RBR",0,1,1
"7288","run061","BBB","GGG",1,0,1
"7289","run061","BBB","RRG",1,1,2
"7290","run061","BBG","BBB",1,2,3
"7291","run061","BBG","BRB",1,5,6
"7292","run061","BBG","GBG",2,1,3
"7293","run061","BBG","GGB",2,5,7
"7294","run061","BBG","GGG",4,5,9
"7295","run061","BBG","GRG",1,0,1
"7296","run061","BBG","RRG",1,1,2
"7297","run061","BGG","RBG",1,1,2
"7298","run061","BGG","RRR",1,1,2
"7299","run061","BRR","BGB",1,0,1
"7300","run061","GBB","BBB",12,3,15
"7301","run061","GBB","BRB",1,2,3
"7302","run061","GBB","BRR",1,1,2
"7303","run061","GBB","GGG",7,9,16
"7304","run061","GBB","GGR",1,1,2
"7305","run061","GBB","RBG",3,1,4
"7306","run061","GBB","RBR",1,0,1
"7307","run061","GBB","RGG",1,0,1
"7308","run061","GBB","RGR",2,0,2
"7309","run061","GBB","RRR",1,3,4
"7310","run061","GBG","BRB",1,0,1
"7311","run061","GBG","BRR",1,0,1
"7312","run061","GBG","GGG",4,2,6
"7313","run061","GBG","RBB",1,0,1
"7314","run061","GBG","RGR",1,0,1
"7315","run061","GBG","RRG",1,0,1
"7316","run061","GGB","BBB",3,1,4
"7317","run061","GGB","BBR",1,0,1
"7318","run061","GGB","BRR",1,2,3
"7319","run061","GGB","GBG",1,0,1
"7320","run061","GGB","GGG",13,11,24
"7321","run061","GGB","RGG",1,2,3
"7322","run061","GGB","RRG",1,0,1
"7323","run061","GGB","RRR",1,0,1
"7324","run061","GGG","BBB",8,7,15
"7325","run061","GGG","BGG",1,0,1
"7326","run061","GGG","BRB",1,0,1
"7327","run061","GGG","GGB",5,0,5
"7328","run061","GGG","GGR",1,3,4
"7329","run061","GGG","RBB",1,1,2
"7330","run061","GGG","RGR",1,1,2
"7331","run061","GGG","RRG",1,1,2
"7332","run061","GGR","BRR",1,0,1
"7333","run061","GGR","GRR",1,0,1
"7334","run061","GRG","BBB",3,3,6
"7335","run061","GRG","GGB",2,3,5
"7336","run061","GRG","GGG",3,1,4
"7337","run061","GRG","RGR",1,1,2
"7338","run061","GRG","RRG",2,1,3
"7339","run061","GRR","BGB",1,1,2
"7340","run061","RBG","BBB",2,1,3
"7341","run061","RBG","RBB",1,0,1
"7342","run061","RBR","BGB",2,2,4
"7343","run061","RBR","BRB",1,0,1
"7344","run061","RBR","BRR",1,0,1
"7345","run061","RBR","GRR",4,0,4
"7346","run061","RBR","RGG",2,1,3
"7347","run061","RBR","RGR",1,0,1
"7348","run061","RGG","BBR",1,1,2
"7349","run061","RGR","BBB",2,1,3
"7350","run061","RGR","BBR",1,0,1
"7351","run061","RGR","BGB",2,0,2
"7352","run061","RGR","BGG",2,0,2
"7353","run061","RGR","BRR",1,0,1
"7354","run061","RGR","GGB",2,1,3
"7355","run061","RGR","RGG",1,0,1
"7356","run061","RRG","BBB",2,7,9
"7357","run061","RRG","BGB",1,2,3
"7358","run061","RRG","BRB",2,6,8
"7359","run061","RRG","BRR",1,4,5
"7360","run061","RRG","GGG",2,3,5
"7361","run061","RRG","GRG",1,0,1
"7362","run061","RRG","GRR",3,2,5
"7363","run061","RRG","RBB",1,0,1
"7364","run061","RRR","BBR",1,0,1
"7365","run061","RRR","BGB",2,0,2
"7366","run061","RRR","BGG",1,0,1
"7367","run061","RRR","BRB",1,0,1
"7368","run061","RRR","BRR",1,0,1
"7369","run061","RRR","RBB",1,1,2
"7370","run061","RRR","RGR",1,0,1
"7371","run061","RRR","RRG",2,1,3
"7372","run061","BBB","RBG",0,1,1
"7373","run061","BBG","RBB",0,1,1
"7374","run061","GBB","GGB",0,5,5
"7375","run061","GBB","GRG",0,1,1
"7376","run061","GBG","BBB",0,1,1
"7377","run061","GBG","RBG",0,1,1
"7378","run061","GGB","BGG",0,1,1
"7379","run061","GGB","GGR",0,2,2
"7380","run061","GGB","RBB",0,1,1
"7381","run061","GGB","RBG",0,2,2
"7382","run061","GGB","RBR",0,2,2
"7383","run061","GGG","BGB",0,1,1
"7384","run061","GGG","RBG",0,1,1
"7385","run061","GGG","RBR",0,1,1
"7386","run061","GGR","BGG",0,1,1
"7387","run061","GRG","GGR",0,2,2
"7388","run061","GRG","GRR",0,1,1
"7389","run061","GRG","RBR",0,1,1
"7390","run061","GRR","BGG",0,1,1
"7391","run061","GRR","BRB",0,1,1
"7392","run061","GRR","GGG",0,1,1
"7393","run061","RBG","RGR",0,1,1
"7394","run061","RBR","BBB",0,1,1
"7395","run061","RBR","GGB",0,1,1
"7396","run061","RBR","RRR",0,1,1
"7397","run061","RGG","BGB",0,1,1
"7398","run061","RGG","GGR",0,1,1
"7399","run061","RGG","GRR",0,3,3
"7400","run061","RGR","GGG",0,1,1
"7401","run061","RGR","RBB",0,1,1
"7402","run061","RRG","BBR",0,1,1
"7403","run061","RRG","GGR",0,2,2
"7404","run061","RRG","RGG",0,1,1
"7405","run062","BBB","GGG",1,0,1
"7406","run062","BBB","RRG",1,0,1
"7407","run062","BBG","BBB",1,1,2
"7408","run062","BBG","BRB",1,3,4
"7409","run062","BBG","GBG",2,3,5
"7410","run062","BBG","GGB",2,2,4
"7411","run062","BBG","GGG",4,10,14
"7412","run062","BBG","GRG",1,1,2
"7413","run062","BBG","RRG",1,0,1
"7414","run062","BGG","RBG",1,0,1
"7415","run062","BGG","RRR",1,0,1
"7416","run062","BRR","BGB",1,0,1
"7417","run062","GBB","BBB",12,7,19
"7418","run062","GBB","BRB",1,0,1
"7419","run062","GBB","BRR",1,1,2
"7420","run062","GBB","GGG",7,12,19
"7421","run062","GBB","GGR",1,2,3
"7422","run062","GBB","RBG",3,4,7
"7423","run062","GBB","RBR",1,0,1
"7424","run062","GBB","RGG",1,0,1
"7425","run062","GBB","RGR",2,0,2
"7426","run062","GBB","RRR",1,2,3
"7427","run062","GBG","BRB",1,0,1
"7428","run062","GBG","BRR",1,0,1
"7429","run062","GBG","GGG",4,2,6
"7430","run062","GBG","RBB",1,0,1
"7431","run062","GBG","RGR",1,0,1
"7432","run062","GBG","RRG",1,0,1
"7433","run062","GGB","BBB",3,4,7
"7434","run062","GGB","BBR",1,1,2
"7435","run062","GGB","BRR",1,2,3
"7436","run062","GGB","GBG",1,0,1
"7437","run062","GGB","GGG",13,7,20
"7438","run062","GGB","RGG",1,2,3
"7439","run062","GGB","RRG",1,1,2
"7440","run062","GGB","RRR",1,0,1
"7441","run062","GGG","BBB",8,2,10
"7442","run062","GGG","BGG",1,0,1
"7443","run062","GGG","BRB",1,1,2
"7444","run062","GGG","GGB",5,0,5
"7445","run062","GGG","GGR",1,3,4
"7446","run062","GGG","RBB",1,0,1
"7447","run062","GGG","RGR",1,5,6
"7448","run062","GGG","RRG",1,2,3
"7449","run062","GGR","BRR",1,0,1
"7450","run062","GGR","GRR",1,0,1
"7451","run062","GRG","BBB",3,2,5
"7452","run062","GRG","GGB",2,0,2
"7453","run062","GRG","GGG",3,1,4
"7454","run062","GRG","RGR",1,0,1
"7455","run062","GRG","RRG",2,0,2
"7456","run062","GRR","BGB",1,0,1
"7457","run062","RBG","BBB",2,1,3
"7458","run062","RBG","RBB",1,0,1
"7459","run062","RBR","BGB",2,1,3
"7460","run062","RBR","BRB",1,0,1
"7461","run062","RBR","BRR",1,2,3
"7462","run062","RBR","GRR",4,2,6
"7463","run062","RBR","RGG",2,0,2
"7464","run062","RBR","RGR",1,0,1
"7465","run062","RGG","BBR",1,0,1
"7466","run062","RGR","BBB",2,0,2
"7467","run062","RGR","BBR",1,0,1
"7468","run062","RGR","BGB",2,1,3
"7469","run062","RGR","BGG",2,0,2
"7470","run062","RGR","BRR",1,1,2
"7471","run062","RGR","GGB",2,2,4
"7472","run062","RGR","RGG",1,1,2
"7473","run062","RRG","BBB",2,7,9
"7474","run062","RRG","BGB",1,0,1
"7475","run062","RRG","BRB",2,3,5
"7476","run062","RRG","BRR",1,2,3
"7477","run062","RRG","GGG",2,3,5
"7478","run062","RRG","GRG",1,0,1
"7479","run062","RRG","GRR",3,2,5
"7480","run062","RRG","RBB",1,0,1
"7481","run062","RRR","BBR",1,0,1
"7482","run062","RRR","BGB",2,0,2
"7483","run062","RRR","BGG",1,0,1
"7484","run062","RRR","BRB",1,0,1
"7485","run062","RRR","BRR",1,1,2
"7486","run062","RRR","RBB",1,1,2
"7487","run062","RRR","RGR",1,1,2
"7488","run062","RRR","RRG",2,0,2
"7489","run062","BBB","RRR",0,1,1
"7490","run062","BBG","RRR",0,2,2
"7491","run062","BGB","RRG",0,1,1
"7492","run062","BGG","BBB",0,1,1
"7493","run062","BGG","RGR",0,1,1
"7494","run062","BRB","BBB",0,2,2
"7495","run062","BRR","BBB",0,1,1
"7496","run062","GBB","GGB",0,4,4
"7497","run062","GBG","BBB",0,1,1
"7498","run062","GBG","BBR",0,1,1
"7499","run062","GBG","GGB",0,1,1
"7500","run062","GBG","RGG",0,1,1
"7501","run062","GGB","BGB",0,1,1
"7502","run062","GGB","BRB",0,1,1
"7503","run062","GGB","GBB",0,1,1
"7504","run062","GGB","GGR",0,1,1
"7505","run062","GGB","RBB",0,1,1
"7506","run062","GGB","RBR",0,1,1
"7507","run062","GGG","BGB",0,1,1
"7508","run062","GGG","BRR",0,1,1
"7509","run062","GGG","RBG",0,1,1
"7510","run062","GGG","RBR",0,1,1
"7511","run062","GGG","RRR",0,1,1
"7512","run062","GGR","BBB",0,2,2
"7513","run062","GRG","BRB",0,1,1
"7514","run062","GRR","GGR",0,1,1
"7515","run062","RBG","BBG",0,1,1
"7516","run062","RBG","BRR",0,1,1
"7517","run062","RBG","GRR",0,1,1
"7518","run062","RBG","RGR",0,1,1
"7519","run062","RBR","BBB",0,3,3
"7520","run062","RBR","GGB",0,1,1
"7521","run062","RGG","BBB",0,1,1
"7522","run062","RGG","GGR",0,1,1
"7523","run062","RGR","GGG",0,1,1
"7524","run062","RRG","GGR",0,1,1
"7525","run062","RRR","GGR",0,1,1
"7526","run062","RRR","GRR",0,1,1
"7527","run063","BBB","GGG",1,1,2
"7528","run063","BBB","RRG",1,0,1
"7529","run063","BBG","BBB",1,0,1
"7530","run063","BBG","BRB",1,2,3
"7531","run063","BBG","GBG",2,3,5
"7532","run063","BBG","GGB",2,3,5
"7533","run063","BBG","GGG",4,5,9
"7534","run063","BBG","GRG",1,2,3
"7535","run063","BBG","RRG",1,0,1
"7536","run063","BGG","RBG",1,0,1
"7537","run063","BGG","RRR",1,0,1
"7538","run063","BRR","BGB",1,1,2
"7539","run063","GBB","BBB",12,5,17
"7540","run063","GBB","BRB",1,0,1
"7541","run063","GBB","BRR",1,2,3
"7542","run063","GBB","GGG",7,10,17
"7543","run063","GBB","GGR",1,0,1
"7544","run063","GBB","RBG",3,1,4
"7545","run063","GBB","RBR",1,0,1
"7546","run063","GBB","RGG",1,0,1
"7547","run063","GBB","RGR",2,0,2
"7548","run063","GBB","RRR",1,0,1
"7549","run063","GBG","BRB",1,0,1
"7550","run063","GBG","BRR",1,0,1
"7551","run063","GBG","GGG",4,1,5
"7552","run063","GBG","RBB",1,0,1
"7553","run063","GBG","RGR",1,0,1
"7554","run063","GBG","RRG",1,0,1
"7555","run063","GGB","BBB",3,2,5
"7556","run063","GGB","BBR",1,1,2
"7557","run063","GGB","BRR",1,1,2
"7558","run063","GGB","GBG",1,0,1
"7559","run063","GGB","GGG",13,11,24
"7560","run063","GGB","RGG",1,1,2
"7561","run063","GGB","RRG",1,2,3
"7562","run063","GGB","RRR",1,3,4
"7563","run063","GGG","BBB",8,5,13
"7564","run063","GGG","BGG",1,2,3
"7565","run063","GGG","BRB",1,0,1
"7566","run063","GGG","GGB",5,0,5
"7567","run063","GGG","GGR",1,2,3
"7568","run063","GGG","RBB",1,0,1
"7569","run063","GGG","RGR",1,2,3
"7570","run063","GGG","RRG",1,2,3
"7571","run063","GGR","BRR",1,0,1
"7572","run063","GGR","GRR",1,0,1
"7573","run063","GRG","BBB",3,0,3
"7574","run063","GRG","GGB",2,5,7
"7575","run063","GRG","GGG",3,2,5
"7576","run063","GRG","RGR",1,0,1
"7577","run063","GRG","RRG",2,1,3
"7578","run063","GRR","BGB",1,0,1
"7579","run063","RBG","BBB",2,0,2
"7580","run063","RBG","RBB",1,0,1
"7581","run063","RBR","BGB",2,0,2
"7582","run063","RBR","BRB",1,0,1
"7583","run063","RBR","BRR",1,0,1
"7584","run063","RBR","GRR",4,0,4
"7585","run063","RBR","RGG",2,0,2
"7586","run063","RBR","RGR",1,0,1
"7587","run063","RGG","BBR",1,0,1
"7588","run063","RGR","BBB",2,3,5
"7589","run063","RGR","BBR",1,0,1
"7590","run063","RGR","BGB",2,1,3
"7591","run063","RGR","BGG",2,0,2
"7592","run063","RGR","BRR",1,1,2
"7593","run063","RGR","GGB",2,1,3
"7594","run063","RGR","RGG",1,0,1
"7595","run063","RRG","BBB",2,6,8
"7596","run063","RRG","BGB",1,2,3
"7597","run063","RRG","BRB",2,7,9
"7598","run063","RRG","BRR",1,1,2
"7599","run063","RRG","GGG",2,2,4
"7600","run063","RRG","GRG",1,0,1
"7601","run063","RRG","GRR",3,0,3
"7602","run063","RRG","RBB",1,1,2
"7603","run063","RRR","BBR",1,0,1
"7604","run063","RRR","BGB",2,0,2
"7605","run063","RRR","BGG",1,0,1
"7606","run063","RRR","BRB",1,0,1
"7607","run063","RRR","BRR",1,0,1
"7608","run063","RRR","RBB",1,1,2
"7609","run063","RRR","RGR",1,1,2
"7610","run063","RRR","RRG",2,0,2
"7611","run063","BBG","RBG",0,1,1
"7612","run063","BBG","RRR",0,1,1
"7613","run063","BGG","BBB",0,1,1
"7614","run063","BGG","BBR",0,1,1
"7615","run063","BGG","RGG",0,1,1
"7616","run063","BRB","BBB",0,3,3
"7617","run063","BRB","BBR",0,1,1
"7618","run063","BRB","BRR",0,1,1
"7619","run063","BRB","GGR",0,1,1
"7620","run063","BRR","BBB",0,1,1
"7621","run063","GBB","GBG",0,1,1
"7622","run063","GBB","GGB",0,5,5
"7623","run063","GBB","GRG",0,1,1
"7624","run063","GBG","BBB",0,1,1
"7625","run063","GGB","BGB",0,2,2
"7626","run063","GGB","GRR",0,2,2
"7627","run063","GGB","RBB",0,1,1
"7628","run063","GGB","RBG",0,2,2
"7629","run063","GGB","RBR",0,2,2
"7630","run063","GGG","BRR",0,2,2
"7631","run063","GGG","RBR",0,2,2
"7632","run063","GGG","RGG",0,1,1
"7633","run063","GGR","BGG",0,1,1
"7634","run063","GGR","RBB",0,1,1
"7635","run063","GRG","BGG",0,1,1
"7636","run063","GRG","GGR",0,1,1
"7637","run063","GRG","RBG",0,1,1
"7638","run063","RBB","BBB",0,1,1
"7639","run063","RBB","GRR",0,1,1
"7640","run063","RBR","BBB",0,1,1
"7641","run063","RBR","BGG",0,1,1
"7642","run063","RBR","GGB",0,1,1
"7643","run063","RBR","RBB",0,1,1
"7644","run063","RBR","RRR",0,1,1
"7645","run063","RGG","BRR",0,1,1
"7646","run063","RGG","GGG",0,1,1
"7647","run063","RGG","GRR",0,1,1
"7648","run063","RGR","GGR",0,1,1
"7649","run063","RGR","RBB",0,1,1
"7650","run063","RGR","RRG",0,1,1
"7651","run063","RRG","GGR",0,1,1
"7652","run063","RRR","GRR",0,1,1
"7653","run063","RRR","RGG",0,1,1
"7654","run064","BBB","GGG",1,0,1
"7655","run064","BBB","RRG",1,1,2
"7656","run064","BBG","BBB",1,1,2
"7657","run064","BBG","BRB",1,1,2
"7658","run064","BBG","GBG",2,0,2
"7659","run064","BBG","GGB",2,2,4
"7660","run064","BBG","GGG",4,7,11
"7661","run064","BBG","GRG",1,0,1
"7662","run064","BBG","RRG",1,0,1
"7663","run064","BGG","RBG",1,0,1
"7664","run064","BGG","RRR",1,0,1
"7665","run064","BRR","BGB",1,0,1
"7666","run064","GBB","BBB",12,9,21
"7667","run064","GBB","BRB",1,2,3
"7668","run064","GBB","BRR",1,1,2
"7669","run064","GBB","GGG",7,9,16
"7670","run064","GBB","GGR",1,0,1
"7671","run064","GBB","RBG",3,3,6
"7672","run064","GBB","RBR",1,0,1
"7673","run064","GBB","RGG",1,0,1
"7674","run064","GBB","RGR",2,0,2
"7675","run064","GBB","RRR",1,1,2
"7676","run064","GBG","BRB",1,0,1
"7677","run064","GBG","BRR",1,0,1
"7678","run064","GBG","GGG",4,3,7
"7679","run064","GBG","RBB",1,0,1
"7680","run064","GBG","RGR",1,0,1
"7681","run064","GBG","RRG",1,0,1
"7682","run064","GGB","BBB",3,0,3
"7683","run064","GGB","BBR",1,0,1
"7684","run064","GGB","BRR",1,4,5
"7685","run064","GGB","GBG",1,0,1
"7686","run064","GGB","GGG",13,4,17
"7687","run064","GGB","RGG",1,1,2
"7688","run064","GGB","RRG",1,1,2
"7689","run064","GGB","RRR",1,0,1
"7690","run064","GGG","BBB",8,2,10
"7691","run064","GGG","BGG",1,3,4
"7692","run064","GGG","BRB",1,0,1
"7693","run064","GGG","GGB",5,0,5
"7694","run064","GGG","GGR",1,1,2
"7695","run064","GGG","RBB",1,2,3
"7696","run064","GGG","RGR",1,2,3
"7697","run064","GGG","RRG",1,4,5
"7698","run064","GGR","BRR",1,0,1
"7699","run064","GGR","GRR",1,0,1
"7700","run064","GRG","BBB",3,1,4
"7701","run064","GRG","GGB",2,2,4
"7702","run064","GRG","GGG",3,2,5
"7703","run064","GRG","RGR",1,1,2
"7704","run064","GRG","RRG",2,1,3
"7705","run064","GRR","BGB",1,0,1
"7706","run064","RBG","BBB",2,1,3
"7707","run064","RBG","RBB",1,0,1
"7708","run064","RBR","BGB",2,0,2
"7709","run064","RBR","BRB",1,0,1
"7710","run064","RBR","BRR",1,0,1
"7711","run064","RBR","GRR",4,1,5
"7712","run064","RBR","RGG",2,0,2
"7713","run064","RBR","RGR",1,0,1
"7714","run064","RGG","BBR",1,0,1
"7715","run064","RGR","BBB",2,0,2
"7716","run064","RGR","BBR",1,0,1
"7717","run064","RGR","BGB",2,0,2
"7718","run064","RGR","BGG",2,0,2
"7719","run064","RGR","BRR",1,0,1
"7720","run064","RGR","GGB",2,2,4
"7721","run064","RGR","RGG",1,0,1
"7722","run064","RRG","BBB",2,8,10
"7723","run064","RRG","BGB",1,3,4
"7724","run064","RRG","BRB",2,8,10
"7725","run064","RRG","BRR",1,4,5
"7726","run064","RRG","GGG",2,3,5
"7727","run064","RRG","GRG",1,0,1
"7728","run064","RRG","GRR",3,0,3
"7729","run064","RRG","RBB",1,1,2
"7730","run064","RRR","BBR",1,0,1
"7731","run064","RRR","BGB",2,0,2
"7732","run064","RRR","BGG",1,0,1
"7733","run064","RRR","BRB",1,0,1
"7734","run064","RRR","BRR",1,0,1
"7735","run064","RRR","RBB",1,1,2
"7736","run064","RRR","RGR",1,2,3
"7737","run064","RRR","RRG",2,0,2
"7738","run064","BBB","BRB",0,1,1
"7739","run064","BBG","RBG",0,2,2
"7740","run064","BBG","RBR",0,1,1
"7741","run064","BGG","RGG",0,1,1
"7742","run064","BRB","BBB",0,1,1
"7743","run064","BRB","BRR",0,1,1
"7744","run064","BRB","GGG",0,1,1
"7745","run064","BRB","RBG",0,1,1
"7746","run064","BRR","BBB",0,1,1
"7747","run064","GBB","BGG",0,1,1
"7748","run064","GBB","GGB",0,2,2
"7749","run064","GBB","RRG",0,1,1
"7750","run064","GBG","BBB",0,1,1
"7751","run064","GBG","RGG",0,1,1
"7752","run064","GGB","BGG",0,3,3
"7753","run064","GGB","BRB",0,1,1
"7754","run064","GGB","GRR",0,1,1
"7755","run064","GGB","RBB",0,1,1
"7756","run064","GGB","RBG",0,2,2
"7757","run064","GGB","RGR",0,1,1
"7758","run064","GGG","BRR",0,1,1
"7759","run064","GGG","RBR",0,3,3
"7760","run064","GGR","BBB",0,1,1
"7761","run064","GGR","BBR",0,1,1
"7762","run064","GGR","BGG",0,1,1
"7763","run064","GRG","BBR",0,1,1
"7764","run064","GRG","RBR",0,1,1
"7765","run064","GRR","BGG",0,2,2
"7766","run064","GRR","BRB",0,1,1
"7767","run064","RBB","BRB",0,1,1
"7768","run064","RBG","GRR",0,1,1
"7769","run064","RBR","BBB",0,4,4
"7770","run064","RBR","GGB",0,2,2
"7771","run064","RGG","BBB",0,1,1
"7772","run064","RGG","RBB",0,1,1
"7773","run064","RGR","GGG",0,1,1
"7774","run064","RGR","GGR",0,1,1
"7775","run064","RGR","RBB",0,1,1
"7776","run064","RGR","RRG",0,3,3
"7777","run064","RRG","BBR",0,1,1
"7778","run064","RRR","GGR",0,1,1
"7779","run065","BBB","GGG",1,0,1
"7780","run065","BBB","RRG",1,0,1
"7781","run065","BBG","BBB",1,1,2
"7782","run065","BBG","BRB",1,4,5
"7783","run065","BBG","GBG",2,2,4
"7784","run065","BBG","GGB",2,5,7
"7785","run065","BBG","GGG",4,6,10
"7786","run065","BBG","GRG",1,1,2
"7787","run065","BBG","RRG",1,0,1
"7788","run065","BGG","RBG",1,0,1
"7789","run065","BGG","RRR",1,0,1
"7790","run065","BRR","BGB",1,0,1
"7791","run065","GBB","BBB",12,5,17
"7792","run065","GBB","BRB",1,2,3
"7793","run065","GBB","BRR",1,1,2
"7794","run065","GBB","GGG",7,7,14
"7795","run065","GBB","GGR",1,1,2
"7796","run065","GBB","RBG",3,0,3
"7797","run065","GBB","RBR",1,0,1
"7798","run065","GBB","RGG",1,0,1
"7799","run065","GBB","RGR",2,0,2
"7800","run065","GBB","RRR",1,0,1
"7801","run065","GBG","BRB",1,1,2
"7802","run065","GBG","BRR",1,0,1
"7803","run065","GBG","GGG",4,1,5
"7804","run065","GBG","RBB",1,0,1
"7805","run065","GBG","RGR",1,0,1
"7806","run065","GBG","RRG",1,1,2
"7807","run065","GGB","BBB",3,3,6
"7808","run065","GGB","BBR",1,1,2
"7809","run065","GGB","BRR",1,4,5
"7810","run065","GGB","GBG",1,0,1
"7811","run065","GGB","GGG",13,6,19
"7812","run065","GGB","RGG",1,0,1
"7813","run065","GGB","RRG",1,1,2
"7814","run065","GGB","RRR",1,1,2
"7815","run065","GGG","BBB",8,2,10
"7816","run065","GGG","BGG",1,1,2
"7817","run065","GGG","BRB",1,0,1
"7818","run065","GGG","GGB",5,1,6
"7819","run065","GGG","GGR",1,3,4
"7820","run065","GGG","RBB",1,0,1
"7821","run065","GGG","RGR",1,4,5
"7822","run065","GGG","RRG",1,6,7
"7823","run065","GGR","BRR",1,0,1
"7824","run065","GGR","GRR",1,0,1
"7825","run065","GRG","BBB",3,1,4
"7826","run065","GRG","GGB",2,3,5
"7827","run065","GRG","GGG",3,1,4
"7828","run065","GRG","RGR",1,0,1
"7829","run065","GRG","RRG",2,0,2
"7830","run065","GRR","BGB",1,0,1
"7831","run065","RBG","BBB",2,0,2
"7832","run065","RBG","RBB",1,0,1
"7833","run065","RBR","BGB",2,0,2
"7834","run065","RBR","BRB",1,0,1
"7835","run065","RBR","BRR",1,0,1
"7836","run065","RBR","GRR",4,0,4
"7837","run065","RBR","RGG",2,3,5
"7838","run065","RBR","RGR",1,0,1
"7839","run065","RGG","BBR",1,1,2
"7840","run065","RGR","BBB",2,2,4
"7841","run065","RGR","BBR",1,0,1
"7842","run065","RGR","BGB",2,0,2
"7843","run065","RGR","BGG",2,0,2
"7844","run065","RGR","BRR",1,1,2
"7845","run065","RGR","GGB",2,1,3
"7846","run065","RGR","RGG",1,0,1
"7847","run065","RRG","BBB",2,4,6
"7848","run065","RRG","BGB",1,2,3
"7849","run065","RRG","BRB",2,7,9
"7850","run065","RRG","BRR",1,2,3
"7851","run065","RRG","GGG",2,1,3
"7852","run065","RRG","GRG",1,0,1
"7853","run065","RRG","GRR",3,3,6
"7854","run065","RRG","RBB",1,0,1
"7855","run065","RRR","BBR",1,0,1
"7856","run065","RRR","BGB",2,0,2
"7857","run065","RRR","BGG",1,0,1
"7858","run065","RRR","BRB",1,0,1
"7859","run065","RRR","BRR",1,1,2
"7860","run065","RRR","RBB",1,0,1
"7861","run065","RRR","RGR",1,0,1
"7862","run065","RRR","RRG",2,1,3
"7863","run065","BBB","GRR",0,1,1
"7864","run065","BBG","RBG",0,2,2
"7865","run065","BGB","BBB",0,1,1
"7866","run065","BGG","RGR",0,1,1
"7867","run065","BRB","BBB",0,2,2
"7868","run065","BRR","BBB",0,4,4
"7869","run065","GBB","GBG",0,2,2
"7870","run065","GBB","GGB",0,5,5
"7871","run065","GBB","GRR",0,1,1
"7872","run065","GBB","RRG",0,1,1
"7873","run065","GBG","BBB",0,1,1
"7874","run065","GBG","GGB",0,2,2
"7875","run065","GBG","RBG",0,1,1
"7876","run065","GGB","BGG",0,1,1
"7877","run065","GGB","GGR",0,2,2
"7878","run065","GGB","RBG",0,1,1
"7879","run065","GGB","RGR",0,1,1
"7880","run065","GGG","BRR",0,2,2
"7881","run065","GGG","RBG",0,1,1
"7882","run065","GGG","RBR",0,4,4
"7883","run065","GGG","RRR",0,1,1
"7884","run065","GGR","BBB",0,1,1
"7885","run065","GGR","RBB",0,1,1
"7886","run065","GRG","GGR",0,1,1
"7887","run065","GRR","BRR",0,1,1
"7888","run065","RBG","GRR",0,1,1
"7889","run065","RBR","BBB",0,2,2
"7890","run065","RBR","GGB",0,2,2
"7891","run065","RBR","RBB",0,1,1
"7892","run065","RGG","BGB",0,1,1
"7893","run065","RGG","GGR",0,1,1
"7894","run065","RGG","GRR",0,3,3
"7895","run065","RGR","RRG",0,1,1
"7896","run065","RRG","BBR",0,1,1
"7897","run065","RRG","BGG",0,1,1
"7898","run066","BBB","GGG",1,0,1
"7899","run066","BBB","RRG",1,2,3
"7900","run066","BBG","BBB",1,0,1
"7901","run066","BBG","BRB",1,3,4
"7902","run066","BBG","GBG",2,2,4
"7903","run066","BBG","GGB",2,5,7
"7904","run066","BBG","GGG",4,6,10
"7905","run066","BBG","GRG",1,1,2
"7906","run066","BBG","RRG",1,0,1
"7907","run066","BGG","RBG",1,0,1
"7908","run066","BGG","RRR",1,0,1
"7909","run066","BRR","BGB",1,0,1
"7910","run066","GBB","BBB",12,4,16
"7911","run066","GBB","BRB",1,1,2
"7912","run066","GBB","BRR",1,0,1
"7913","run066","GBB","GGG",7,14,21
"7914","run066","GBB","GGR",1,0,1
"7915","run066","GBB","RBG",3,0,3
"7916","run066","GBB","RBR",1,0,1
"7917","run066","GBB","RGG",1,0,1
"7918","run066","GBB","RGR",2,0,2
"7919","run066","GBB","RRR",1,1,2
"7920","run066","GBG","BRB",1,0,1
"7921","run066","GBG","BRR",1,0,1
"7922","run066","GBG","GGG",4,1,5
"7923","run066","GBG","RBB",1,0,1
"7924","run066","GBG","RGR",1,1,2
"7925","run066","GBG","RRG",1,0,1
"7926","run066","GGB","BBB",3,4,7
"7927","run066","GGB","BBR",1,0,1
"7928","run066","GGB","BRR",1,5,6
"7929","run066","GGB","GBG",1,0,1
"7930","run066","GGB","GGG",13,9,22
"7931","run066","GGB","RGG",1,0,1
"7932","run066","GGB","RRG",1,1,2
"7933","run066","GGB","RRR",1,0,1
"7934","run066","GGG","BBB",8,5,13
"7935","run066","GGG","BGG",1,0,1
"7936","run066","GGG","BRB",1,1,2
"7937","run066","GGG","GGB",5,0,5
"7938","run066","GGG","GGR",1,0,1
"7939","run066","GGG","RBB",1,2,3
"7940","run066","GGG","RGR",1,1,2
"7941","run066","GGG","RRG",1,5,6
"7942","run066","GGR","BRR",1,0,1
"7943","run066","GGR","GRR",1,0,1
"7944","run066","GRG","BBB",3,1,4
"7945","run066","GRG","GGB",2,0,2
"7946","run066","GRG","GGG",3,2,5
"7947","run066","GRG","RGR",1,0,1
"7948","run066","GRG","RRG",2,0,2
"7949","run066","GRR","BGB",1,0,1
"7950","run066","RBG","BBB",2,1,3
"7951","run066","RBG","RBB",1,1,2
"7952","run066","RBR","BGB",2,0,2
"7953","run066","RBR","BRB",1,0,1
"7954","run066","RBR","BRR",1,1,2
"7955","run066","RBR","GRR",4,1,5
"7956","run066","RBR","RGG",2,4,6
"7957","run066","RBR","RGR",1,0,1
"7958","run066","RGG","BBR",1,0,1
"7959","run066","RGR","BBB",2,1,3
"7960","run066","RGR","BBR",1,0,1
"7961","run066","RGR","BGB",2,1,3
"7962","run066","RGR","BGG",2,0,2
"7963","run066","RGR","BRR",1,2,3
"7964","run066","RGR","GGB",2,1,3
"7965","run066","RGR","RGG",1,0,1
"7966","run066","RRG","BBB",2,6,8
"7967","run066","RRG","BGB",1,1,2
"7968","run066","RRG","BRB",2,5,7
"7969","run066","RRG","BRR",1,0,1
"7970","run066","RRG","GGG",2,6,8
"7971","run066","RRG","GRG",1,0,1
"7972","run066","RRG","GRR",3,0,3
"7973","run066","RRG","RBB",1,0,1
"7974","run066","RRR","BBR",1,0,1
"7975","run066","RRR","BGB",2,0,2
"7976","run066","RRR","BGG",1,0,1
"7977","run066","RRR","BRB",1,0,1
"7978","run066","RRR","BRR",1,0,1
"7979","run066","RRR","RBB",1,0,1
"7980","run066","RRR","RGR",1,0,1
"7981","run066","RRR","RRG",2,0,2
"7982","run066","BBG","GBB",0,1,1
"7983","run066","BBG","RBG",0,2,2
"7984","run066","BBG","RRR",0,1,1
"7985","run066","BGG","BBB",0,1,1
"7986","run066","BRB","BBB",0,2,2
"7987","run066","BRB","GGR",0,1,1
"7988","run066","BRR","BBB",0,1,1
"7989","run066","BRR","RBB",0,1,1
"7990","run066","GBB","BGG",0,1,1
"7991","run066","GBB","GGB",0,4,4
"7992","run066","GBB","GRG",0,1,1
"7993","run066","GBB","RBB",0,1,1
"7994","run066","GBG","BBB",0,1,1
"7995","run066","GGB","BGB",0,1,1
"7996","run066","GGB","GGR",0,2,2
"7997","run066","GGB","GRR",0,1,1
"7998","run066","GGB","RBG",0,1,1
"7999","run066","GGB","RBR",0,1,1
"8000","run066","GGB","RGR",0,1,1
"8001","run066","GGG","BGB",0,1,1
"8002","run066","GGG","RBG",0,3,3
"8003","run066","GGG","RBR",0,4,4
"8004","run066","GGG","RRR",0,1,1
"8005","run066","GRG","BGG",0,1,1
"8006","run066","GRG","GGR",0,1,1
"8007","run066","GRR","BGG",0,1,1
"8008","run066","RBB","RGG",0,1,1
"8009","run066","RBG","RGR",0,1,1
"8010","run066","RBR","BBB",0,2,2
"8011","run066","RBR","BGG",0,1,1
"8012","run066","RBR","GGB",0,2,2
"8013","run066","RBR","RBB",0,1,1
"8014","run066","RBR","RRR",0,1,1
"8015","run066","RGG","BBB",0,2,2
"8016","run066","RGG","BGB",0,1,1
"8017","run066","RGG","GGR",0,1,1
"8018","run066","RGR","GGR",0,1,1
"8019","run066","RRG","GGR",0,1,1
"8020","run067","BBB","GGG",1,0,1
"8021","run067","BBB","RRG",1,0,1
"8022","run067","BBG","BBB",1,1,2
"8023","run067","BBG","BRB",1,5,6
"8024","run067","BBG","GBG",2,1,3
"8025","run067","BBG","GGB",2,5,7
"8026","run067","BBG","GGG",4,9,13
"8027","run067","BBG","GRG",1,1,2
"8028","run067","BBG","RRG",1,0,1
"8029","run067","BGG","RBG",1,1,2
"8030","run067","BGG","RRR",1,0,1
"8031","run067","BRR","BGB",1,0,1
"8032","run067","GBB","BBB",12,1,13
"8033","run067","GBB","BRB",1,1,2
"8034","run067","GBB","BRR",1,0,1
"8035","run067","GBB","GGG",7,17,24
"8036","run067","GBB","GGR",1,0,1
"8037","run067","GBB","RBG",3,1,4
"8038","run067","GBB","RBR",1,0,1
"8039","run067","GBB","RGG",1,0,1
"8040","run067","GBB","RGR",2,0,2
"8041","run067","GBB","RRR",1,2,3
"8042","run067","GBG","BRB",1,0,1
"8043","run067","GBG","BRR",1,0,1
"8044","run067","GBG","GGG",4,0,4
"8045","run067","GBG","RBB",1,0,1
"8046","run067","GBG","RGR",1,0,1
"8047","run067","GBG","RRG",1,0,1
"8048","run067","GGB","BBB",3,3,6
"8049","run067","GGB","BBR",1,0,1
"8050","run067","GGB","BRR",1,2,3
"8051","run067","GGB","GBG",1,0,1
"8052","run067","GGB","GGG",13,10,23
"8053","run067","GGB","RGG",1,1,2
"8054","run067","GGB","RRG",1,0,1
"8055","run067","GGB","RRR",1,1,2
"8056","run067","GGG","BBB",8,9,17
"8057","run067","GGG","BGG",1,2,3
"8058","run067","GGG","BRB",1,1,2
"8059","run067","GGG","GGB",5,0,5
"8060","run067","GGG","GGR",1,1,2
"8061","run067","GGG","RBB",1,4,5
"8062","run067","GGG","RGR",1,1,2
"8063","run067","GGG","RRG",1,2,3
"8064","run067","GGR","BRR",1,0,1
"8065","run067","GGR","GRR",1,0,1
"8066","run067","GRG","BBB",3,2,5
"8067","run067","GRG","GGB",2,0,2
"8068","run067","GRG","GGG",3,1,4
"8069","run067","GRG","RGR",1,0,1
"8070","run067","GRG","RRG",2,0,2
"8071","run067","GRR","BGB",1,0,1
"8072","run067","RBG","BBB",2,1,3
"8073","run067","RBG","RBB",1,1,2
"8074","run067","RBR","BGB",2,0,2
"8075","run067","RBR","BRB",1,0,1
"8076","run067","RBR","BRR",1,0,1
"8077","run067","RBR","GRR",4,0,4
"8078","run067","RBR","RGG",2,2,4
"8079","run067","RBR","RGR",1,0,1
"8080","run067","RGG","BBR",1,0,1
"8081","run067","RGR","BBB",2,1,3
"8082","run067","RGR","BBR",1,0,1
"8083","run067","RGR","BGB",2,1,3
"8084","run067","RGR","BGG",2,0,2
"8085","run067","RGR","BRR",1,1,2
"8086","run067","RGR","GGB",2,2,4
"8087","run067","RGR","RGG",1,0,1
"8088","run067","RRG","BBB",2,2,4
"8089","run067","RRG","BGB",1,2,3
"8090","run067","RRG","BRB",2,3,5
"8091","run067","RRG","BRR",1,2,3
"8092","run067","RRG","GGG",2,3,5
"8093","run067","RRG","GRG",1,0,1
"8094","run067","RRG","GRR",3,1,4
"8095","run067","RRG","RBB",1,1,2
"8096","run067","RRR","BBR",1,0,1
"8097","run067","RRR","BGB",2,0,2
"8098","run067","RRR","BGG",1,0,1
"8099","run067","RRR","BRB",1,0,1
"8100","run067","RRR","BRR",1,0,1
"8101","run067","RRR","RBB",1,1,2
"8102","run067","RRR","RGR",1,0,1
"8103","run067","RRR","RRG",2,0,2
"8104","run067","BBB","RRR",0,1,1
"8105","run067","BBG","BGG",0,1,1
"8106","run067","BBG","RBG",0,1,1
"8107","run067","BBG","RRR",0,1,1
"8108","run067","BGG","BBB",0,1,1
"8109","run067","BGG","BBR",0,1,1
"8110","run067","BGG","RGG",0,1,1
"8111","run067","BRB","BBB",0,2,2
"8112","run067","BRB","RBG",0,1,1
"8113","run067","BRB","RGR",0,1,1
"8114","run067","BRR","BBB",0,2,2
"8115","run067","BRR","RBB",0,1,1
"8116","run067","GBB","GBG",0,2,2
"8117","run067","GBB","GRG",0,1,1
"8118","run067","GBG","BBB",0,1,1
"8119","run067","GBG","RGG",0,1,1
"8120","run067","GGB","BGG",0,1,1
"8121","run067","GGB","GGR",0,2,2
"8122","run067","GGG","BRR",0,4,4
"8123","run067","GGG","GRR",0,1,1
"8124","run067","GGG","RBR",0,1,1
"8125","run067","GGG","RRR",0,1,1
"8126","run067","GRR","BBR",0,1,1
"8127","run067","GRR","BGG",0,1,1
"8128","run067","GRR","BRR",0,1,1
"8129","run067","GRR","GGR",0,1,1
"8130","run067","RBR","BBB",0,3,3
"8131","run067","RBR","GGB",0,1,1
"8132","run067","RGG","BBB",0,2,2
"8133","run067","RGG","BGB",0,1,1
"8134","run067","RGG","BRR",0,1,1
"8135","run067","RGG","GRR",0,1,1
"8136","run067","RGG","RBB",0,1,1
"8137","run067","RGR","GGG",0,1,1
"8138","run067","RGR","GGR",0,1,1
"8139","run067","RGR","RBB",0,1,1
"8140","run067","RGR","RRG",0,1,1
"8141","run067","RRG","BGG",0,1,1
"8142","run067","RRR","GRR",0,1,1
"8143","run067","RRR","RBR",0,2,2
"8144","run068","BBB","GGG",1,1,2
"8145","run068","BBB","RRG",1,1,2
"8146","run068","BBG","BBB",1,0,1
"8147","run068","BBG","BRB",1,3,4
"8148","run068","BBG","GBG",2,1,3
"8149","run068","BBG","GGB",2,1,3
"8150","run068","BBG","GGG",4,6,10
"8151","run068","BBG","GRG",1,0,1
"8152","run068","BBG","RRG",1,1,2
"8153","run068","BGG","RBG",1,0,1
"8154","run068","BGG","RRR",1,0,1
"8155","run068","BRR","BGB",1,0,1
"8156","run068","GBB","BBB",12,6,18
"8157","run068","GBB","BRB",1,1,2
"8158","run068","GBB","BRR",1,0,1
"8159","run068","GBB","GGG",7,11,18
"8160","run068","GBB","GGR",1,0,1
"8161","run068","GBB","RBG",3,4,7
"8162","run068","GBB","RBR",1,0,1
"8163","run068","GBB","RGG",1,0,1
"8164","run068","GBB","RGR",2,0,2
"8165","run068","GBB","RRR",1,2,3
"8166","run068","GBG","BRB",1,0,1
"8167","run068","GBG","BRR",1,0,1
"8168","run068","GBG","GGG",4,3,7
"8169","run068","GBG","RBB",1,0,1
"8170","run068","GBG","RGR",1,1,2
"8171","run068","GBG","RRG",1,0,1
"8172","run068","GGB","BBB",3,1,4
"8173","run068","GGB","BBR",1,0,1
"8174","run068","GGB","BRR",1,1,2
"8175","run068","GGB","GBG",1,0,1
"8176","run068","GGB","GGG",13,5,18
"8177","run068","GGB","RGG",1,1,2
"8178","run068","GGB","RRG",1,0,1
"8179","run068","GGB","RRR",1,1,2
"8180","run068","GGG","BBB",8,12,20
"8181","run068","GGG","BGG",1,0,1
"8182","run068","GGG","BRB",1,1,2
"8183","run068","GGG","GGB",5,0,5
"8184","run068","GGG","GGR",1,1,2
"8185","run068","GGG","RBB",1,2,3
"8186","run068","GGG","RGR",1,3,4
"8187","run068","GGG","RRG",1,6,7
"8188","run068","GGR","BRR",1,0,1
"8189","run068","GGR","GRR",1,0,1
"8190","run068","GRG","BBB",3,0,3
"8191","run068","GRG","GGB",2,0,2
"8192","run068","GRG","GGG",3,1,4
"8193","run068","GRG","RGR",1,0,1
"8194","run068","GRG","RRG",2,0,2
"8195","run068","GRR","BGB",1,0,1
"8196","run068","RBG","BBB",2,4,6
"8197","run068","RBG","RBB",1,0,1
"8198","run068","RBR","BGB",2,1,3
"8199","run068","RBR","BRB",1,0,1
"8200","run068","RBR","BRR",1,1,2
"8201","run068","RBR","GRR",4,0,4
"8202","run068","RBR","RGG",2,2,4
"8203","run068","RBR","RGR",1,0,1
"8204","run068","RGG","BBR",1,0,1
"8205","run068","RGR","BBB",2,0,2
"8206","run068","RGR","BBR",1,0,1
"8207","run068","RGR","BGB",2,1,3
"8208","run068","RGR","BGG",2,0,2
"8209","run068","RGR","BRR",1,1,2
"8210","run068","RGR","GGB",2,1,3
"8211","run068","RGR","RGG",1,0,1
"8212","run068","RRG","BBB",2,6,8
"8213","run068","RRG","BGB",1,1,2
"8214","run068","RRG","BRB",2,3,5
"8215","run068","RRG","BRR",1,3,4
"8216","run068","RRG","GGG",2,1,3
"8217","run068","RRG","GRG",1,0,1
"8218","run068","RRG","GRR",3,1,4
"8219","run068","RRG","RBB",1,0,1
"8220","run068","RRR","BBR",1,0,1
"8221","run068","RRR","BGB",2,0,2
"8222","run068","RRR","BGG",1,0,1
"8223","run068","RRR","BRB",1,1,2
"8224","run068","RRR","BRR",1,0,1
"8225","run068","RRR","RBB",1,0,1
"8226","run068","RRR","RGR",1,0,1
"8227","run068","RRR","RRG",2,0,2
"8228","run068","BBB","BRB",0,1,1
"8229","run068","BBB","RRR",0,1,1
"8230","run068","BBG","BGB",0,1,1
"8231","run068","BBG","BGG",0,1,1
"8232","run068","BBG","GRR",0,1,1
"8233","run068","BBG","RRR",0,4,4
"8234","run068","BGG","BBB",0,1,1
"8235","run068","BRB","BBB",0,1,1
"8236","run068","BRR","BBB",0,1,1
"8237","run068","BRR","BGG",0,1,1
"8238","run068","GBB","GGB",0,2,2
"8239","run068","GBB","GRG",0,1,1
"8240","run068","GBG","GGB",0,1,1
"8241","run068","GGB","BGB",0,1,1
"8242","run068","GGB","GGR",0,1,1
"8243","run068","GGB","GRR",0,1,1
"8244","run068","GGB","RBB",0,1,1
"8245","run068","GGB","RBG",0,2,2
"8246","run068","GGB","RBR",0,2,2
"8247","run068","GGB","RGR",0,1,1
"8248","run068","GGG","GRR",0,1,1
"8249","run068","GGG","RBG",0,2,2
"8250","run068","GGG","RBR",0,1,1
"8251","run068","GGG","RGG",0,2,2
"8252","run068","GGG","RRR",0,1,1
"8253","run068","GRG","BBR",0,1,1
"8254","run068","GRG","BRB",0,1,1
"8255","run068","GRG","GGR",0,1,1
"8256","run068","GRR","BBB",0,1,1
"8257","run068","GRR","BGG",0,1,1
"8258","run068","RBR","BBB",0,3,3
"8259","run068","RBR","GGB",0,1,1
"8260","run068","RBR","RBB",0,1,1
"8261","run068","RGG","BBB",0,1,1
"8262","run068","RGG","GGR",0,1,1
"8263","run068","RGG","GRR",0,2,2
"8264","run068","RGR","GGG",0,1,1
"8265","run068","RGR","GGR",0,1,1
"8266","run068","RGR","RBB",0,1,1
"8267","run068","RRG","BBR",0,1,1
"8268","run068","RRG","BGG",0,1,1
"8269","run068","RRG","GGR",0,2,2
"8270","run068","RRG","RGG",0,1,1
"8271","run068","RRG","RGR",0,1,1
"8272","run069","BBB","GGG",1,0,1
"8273","run069","BBB","RRG",1,2,3
"8274","run069","BBG","BBB",1,0,1
"8275","run069","BBG","BRB",1,3,4
"8276","run069","BBG","GBG",2,2,4
"8277","run069","BBG","GGB",2,4,6
"8278","run069","BBG","GGG",4,5,9
"8279","run069","BBG","GRG",1,1,2
"8280","run069","BBG","RRG",1,0,1
"8281","run069","BGG","RBG",1,0,1
"8282","run069","BGG","RRR",1,0,1
"8283","run069","BRR","BGB",1,0,1
"8284","run069","GBB","BBB",12,8,20
"8285","run069","GBB","BRB",1,3,4
"8286","run069","GBB","BRR",1,1,2
"8287","run069","GBB","GGG",7,15,22
"8288","run069","GBB","GGR",1,1,2
"8289","run069","GBB","RBG",3,1,4
"8290","run069","GBB","RBR",1,0,1
"8291","run069","GBB","RGG",1,0,1
"8292","run069","GBB","RGR",2,0,2
"8293","run069","GBB","RRR",1,1,2
"8294","run069","GBG","BRB",1,0,1
"8295","run069","GBG","BRR",1,0,1
"8296","run069","GBG","GGG",4,1,5
"8297","run069","GBG","RBB",1,0,1
"8298","run069","GBG","RGR",1,0,1
"8299","run069","GBG","RRG",1,1,2
"8300","run069","GGB","BBB",3,1,4
"8301","run069","GGB","BBR",1,1,2
"8302","run069","GGB","BRR",1,3,4
"8303","run069","GGB","GBG",1,0,1
"8304","run069","GGB","GGG",13,6,19
"8305","run069","GGB","RGG",1,1,2
"8306","run069","GGB","RRG",1,0,1
"8307","run069","GGB","RRR",1,2,3
"8308","run069","GGG","BBB",8,4,12
"8309","run069","GGG","BGG",1,2,3
"8310","run069","GGG","BRB",1,0,1
"8311","run069","GGG","GGB",5,0,5
"8312","run069","GGG","GGR",1,0,1
"8313","run069","GGG","RBB",1,2,3
"8314","run069","GGG","RGR",1,1,2
"8315","run069","GGG","RRG",1,6,7
"8316","run069","GGR","BRR",1,0,1
"8317","run069","GGR","GRR",1,0,1
"8318","run069","GRG","BBB",3,2,5
"8319","run069","GRG","GGB",2,3,5
"8320","run069","GRG","GGG",3,1,4
"8321","run069","GRG","RGR",1,0,1
"8322","run069","GRG","RRG",2,2,4
"8323","run069","GRR","BGB",1,1,2
"8324","run069","RBG","BBB",2,1,3
"8325","run069","RBG","RBB",1,0,1
"8326","run069","RBR","BGB",2,0,2
"8327","run069","RBR","BRB",1,0,1
"8328","run069","RBR","BRR",1,2,3
"8329","run069","RBR","GRR",4,1,5
"8330","run069","RBR","RGG",2,0,2
"8331","run069","RBR","RGR",1,0,1
"8332","run069","RGG","BBR",1,0,1
"8333","run069","RGR","BBB",2,1,3
"8334","run069","RGR","BBR",1,1,2
"8335","run069","RGR","BGB",2,0,2
"8336","run069","RGR","BGG",2,0,2
"8337","run069","RGR","BRR",1,1,2
"8338","run069","RGR","GGB",2,2,4
"8339","run069","RGR","RGG",1,1,2
"8340","run069","RRG","BBB",2,3,5
"8341","run069","RRG","BGB",1,1,2
"8342","run069","RRG","BRB",2,6,8
"8343","run069","RRG","BRR",1,3,4
"8344","run069","RRG","GGG",2,1,3
"8345","run069","RRG","GRG",1,0,1
"8346","run069","RRG","GRR",3,0,3
"8347","run069","RRG","RBB",1,0,1
"8348","run069","RRR","BBR",1,0,1
"8349","run069","RRR","BGB",2,1,3
"8350","run069","RRR","BGG",1,0,1
"8351","run069","RRR","BRB",1,0,1
"8352","run069","RRR","BRR",1,0,1
"8353","run069","RRR","RBB",1,1,2
"8354","run069","RRR","RGR",1,0,1
"8355","run069","RRR","RRG",2,0,2
"8356","run069","BBG","BGB",0,1,1
"8357","run069","BBG","RRR",0,2,2
"8358","run069","BGG","BBB",0,1,1
"8359","run069","BGG","RGR",0,1,1
"8360","run069","BRB","BBB",0,1,1
"8361","run069","BRB","BRR",0,1,1
"8362","run069","BRB","RRR",0,1,1
"8363","run069","BRR","BBB",0,1,1
"8364","run069","GBB","BGG",0,1,1
"8365","run069","GBB","GGB",0,1,1
"8366","run069","GBB","RBB",0,1,1
"8367","run069","GBG","GGB",0,2,2
"8368","run069","GGB","BGG",0,2,2
"8369","run069","GGB","GGR",0,1,1
"8370","run069","GGB","RBB",0,1,1
"8371","run069","GGB","RBG",0,1,1
"8372","run069","GGB","RBR",0,2,2
"8373","run069","GGG","BRR",0,1,1
"8374","run069","GGG","RBG",0,1,1
"8375","run069","GGG","RBR",0,2,2
"8376","run069","GGG","RGG",0,1,1
"8377","run069","GRG","BRB",0,1,1
"8378","run069","GRG","GGR",0,1,1
"8379","run069","GRR","BRR",0,1,1
"8380","run069","RBG","GRR",0,1,1
"8381","run069","RBG","RGR",0,1,1
"8382","run069","RBR","BBB",0,2,2
"8383","run069","RBR","BBR",0,1,1
"8384","run069","RBR","GGB",0,1,1
"8385","run069","RGG","BBB",0,2,2
"8386","run069","RGG","BGB",0,1,1
"8387","run069","RGG","BRR",0,1,1
"8388","run069","RGG","GGR",0,1,1
"8389","run069","RGR","GGR",0,1,1
"8390","run069","RGR","RBB",0,1,1
"8391","run069","RRG","BBR",0,1,1
"8392","run069","RRG","BGG",0,1,1
"8393","run069","RRR","GRR",0,1,1
"8394","run069","RRR","RBR",0,2,2
"8395","run070","BBB","GGG",1,0,1
"8396","run070","BBB","RRG",1,0,1
"8397","run070","BBG","BBB",1,1,2
"8398","run070","BBG","BRB",1,3,4
"8399","run070","BBG","GBG",2,2,4
"8400","run070","BBG","GGB",2,4,6
"8401","run070","BBG","GGG",4,7,11
"8402","run070","BBG","GRG",1,2,3
"8403","run070","BBG","RRG",1,1,2
"8404","run070","BGG","RBG",1,0,1
"8405","run070","BGG","RRR",1,0,1
"8406","run070","BRR","BGB",1,0,1
"8407","run070","GBB","BBB",12,7,19
"8408","run070","GBB","BRB",1,0,1
"8409","run070","GBB","BRR",1,0,1
"8410","run070","GBB","GGG",7,11,18
"8411","run070","GBB","GGR",1,1,2
"8412","run070","GBB","RBG",3,1,4
"8413","run070","GBB","RBR",1,0,1
"8414","run070","GBB","RGG",1,0,1
"8415","run070","GBB","RGR",2,0,2
"8416","run070","GBB","RRR",1,0,1
"8417","run070","GBG","BRB",1,0,1
"8418","run070","GBG","BRR",1,0,1
"8419","run070","GBG","GGG",4,0,4
"8420","run070","GBG","RBB",1,0,1
"8421","run070","GBG","RGR",1,1,2
"8422","run070","GBG","RRG",1,0,1
"8423","run070","GGB","BBB",3,5,8
"8424","run070","GGB","BBR",1,1,2
"8425","run070","GGB","BRR",1,4,5
"8426","run070","GGB","GBG",1,0,1
"8427","run070","GGB","GGG",13,7,20
"8428","run070","GGB","RGG",1,0,1
"8429","run070","GGB","RRG",1,2,3
"8430","run070","GGB","RRR",1,1,2
"8431","run070","GGG","BBB",8,3,11
"8432","run070","GGG","BGG",1,0,1
"8433","run070","GGG","BRB",1,0,1
"8434","run070","GGG","GGB",5,0,5
"8435","run070","GGG","GGR",1,0,1
"8436","run070","GGG","RBB",1,1,2
"8437","run070","GGG","RGR",1,3,4
"8438","run070","GGG","RRG",1,1,2
"8439","run070","GGR","BRR",1,0,1
"8440","run070","GGR","GRR",1,0,1
"8441","run070","GRG","BBB",3,3,6
"8442","run070","GRG","GGB",2,0,2
"8443","run070","GRG","GGG",3,3,6
"8444","run070","GRG","RGR",1,0,1
"8445","run070","GRG","RRG",2,0,2
"8446","run070","GRR","BGB",1,0,1
"8447","run070","RBG","BBB",2,1,3
"8448","run070","RBG","RBB",1,0,1
"8449","run070","RBR","BGB",2,1,3
"8450","run070","RBR","BRB",1,0,1
"8451","run070","RBR","BRR",1,0,1
"8452","run070","RBR","GRR",4,1,5
"8453","run070","RBR","RGG",2,0,2
"8454","run070","RBR","RGR",1,0,1
"8455","run070","RGG","BBR",1,0,1
"8456","run070","RGR","BBB",2,1,3
"8457","run070","RGR","BBR",1,0,1
"8458","run070","RGR","BGB",2,1,3
"8459","run070","RGR","BGG",2,0,2
"8460","run070","RGR","BRR",1,3,4
"8461","run070","RGR","GGB",2,1,3
"8462","run070","RGR","RGG",1,0,1
"8463","run070","RRG","BBB",2,7,9
"8464","run070","RRG","BGB",1,2,3
"8465","run070","RRG","BRB",2,4,6
"8466","run070","RRG","BRR",1,1,2
"8467","run070","RRG","GGG",2,1,3
"8468","run070","RRG","GRG",1,0,1
"8469","run070","RRG","GRR",3,2,5
"8470","run070","RRG","RBB",1,1,2
"8471","run070","RRR","BBR",1,0,1
"8472","run070","RRR","BGB",2,0,2
"8473","run070","RRR","BGG",1,0,1
"8474","run070","RRR","BRB",1,0,1
"8475","run070","RRR","BRR",1,0,1
"8476","run070","RRR","RBB",1,0,1
"8477","run070","RRR","RGR",1,0,1
"8478","run070","RRR","RRG",2,0,2
"8479","run070","BBB","GRR",0,1,1
"8480","run070","BBG","BGB",0,1,1
"8481","run070","BBG","BGG",0,1,1
"8482","run070","BBG","GBB",0,1,1
"8483","run070","BBG","RBB",0,1,1
"8484","run070","BBG","RBG",0,1,1
"8485","run070","BBG","RBR",0,1,1
"8486","run070","BBG","RRR",0,2,2
"8487","run070","BGG","BBB",0,1,1
"8488","run070","BGG","BBR",0,1,1
"8489","run070","BGG","RGG",0,1,1
"8490","run070","BGG","RGR",0,1,1
"8491","run070","BRB","BBB",0,3,3
"8492","run070","BRB","BRR",0,1,1
"8493","run070","BRB","RBG",0,1,1
"8494","run070","GBB","GGB",0,1,1
"8495","run070","GBB","GRR",0,1,1
"8496","run070","GBB","RRG",0,2,2
"8497","run070","GBG","BBB",0,2,2
"8498","run070","GBG","GGB",0,1,1
"8499","run070","GGB","BGG",0,1,1
"8500","run070","GGB","RBB",0,1,1
"8501","run070","GGB","RBR",0,2,2
"8502","run070","GGG","BGB",0,1,1
"8503","run070","GGG","RBR",0,5,5
"8504","run070","GGG","RGG",0,2,2
"8505","run070","GGR","BBB",0,1,1
"8506","run070","GGR","BBR",0,1,1
"8507","run070","GRG","BRR",0,1,1
"8508","run070","GRG","GGR",0,1,1
"8509","run070","GRG","RBG",0,1,1
"8510","run070","GRR","BGG",0,1,1
"8511","run070","GRR","BRR",0,1,1
"8512","run070","RBB","BBR",0,1,1
"8513","run070","RBR","BBB",0,1,1
"8514","run070","RBR","BBR",0,1,1
"8515","run070","RBR","BGG",0,1,1
"8516","run070","RBR","GGB",0,2,2
"8517","run070","RGG","BBB",0,1,1
"8518","run070","RGG","BRR",0,1,1
"8519","run070","RGG","GGG",0,1,1
"8520","run070","RGG","GRR",0,1,1
"8521","run070","RGR","GGG",0,1,1
"8522","run070","RGR","RBB",0,1,1
"8523","run070","RRG","BBR",0,1,1
"8524","run070","RRG","GGR",0,1,1
"8525","run071","BBB","GGG",1,0,1
"8526","run071","BBB","RRG",1,0,1
"8527","run071","BBG","BBB",1,1,2
"8528","run071","BBG","BRB",1,3,4
"8529","run071","BBG","GBG",2,2,4
"8530","run071","BBG","GGB",2,5,7
"8531","run071","BBG","GGG",4,2,6
"8532","run071","BBG","GRG",1,5,6
"8533","run071","BBG","RRG",1,0,1
"8534","run071","BGG","RBG",1,0,1
"8535","run071","BGG","RRR",1,0,1
"8536","run071","BRR","BGB",1,0,1
"8537","run071","GBB","BBB",12,6,18
"8538","run071","GBB","BRB",1,0,1
"8539","run071","GBB","BRR",1,1,2
"8540","run071","GBB","GGG",7,12,19
"8541","run071","GBB","GGR",1,0,1
"8542","run071","GBB","RBG",3,0,3
"8543","run071","GBB","RBR",1,0,1
"8544","run071","GBB","RGG",1,0,1
"8545","run071","GBB","RGR",2,0,2
"8546","run071","GBB","RRR",1,1,2
"8547","run071","GBG","BRB",1,0,1
"8548","run071","GBG","BRR",1,0,1
"8549","run071","GBG","GGG",4,3,7
"8550","run071","GBG","RBB",1,0,1
"8551","run071","GBG","RGR",1,1,2
"8552","run071","GBG","RRG",1,1,2
"8553","run071","GGB","BBB",3,2,5
"8554","run071","GGB","BBR",1,0,1
"8555","run071","GGB","BRR",1,1,2
"8556","run071","GGB","GBG",1,0,1
"8557","run071","GGB","GGG",13,9,22
"8558","run071","GGB","RGG",1,1,2
"8559","run071","GGB","RRG",1,1,2
"8560","run071","GGB","RRR",1,0,1
"8561","run071","GGG","BBB",8,3,11
"8562","run071","GGG","BGG",1,2,3
"8563","run071","GGG","BRB",1,2,3
"8564","run071","GGG","GGB",5,0,5
"8565","run071","GGG","GGR",1,2,3
"8566","run071","GGG","RBB",1,2,3
"8567","run071","GGG","RGR",1,1,2
"8568","run071","GGG","RRG",1,6,7
"8569","run071","GGR","BRR",1,0,1
"8570","run071","GGR","GRR",1,0,1
"8571","run071","GRG","BBB",3,0,3
"8572","run071","GRG","GGB",2,4,6
"8573","run071","GRG","GGG",3,0,3
"8574","run071","GRG","RGR",1,0,1
"8575","run071","GRG","RRG",2,1,3
"8576","run071","GRR","BGB",1,0,1
"8577","run071","RBG","BBB",2,1,3
"8578","run071","RBG","RBB",1,0,1
"8579","run071","RBR","BGB",2,1,3
"8580","run071","RBR","BRB",1,0,1
"8581","run071","RBR","BRR",1,0,1
"8582","run071","RBR","GRR",4,1,5
"8583","run071","RBR","RGG",2,1,3
"8584","run071","RBR","RGR",1,0,1
"8585","run071","RGG","BBR",1,0,1
"8586","run071","RGR","BBB",2,0,2
"8587","run071","RGR","BBR",1,0,1
"8588","run071","RGR","BGB",2,0,2
"8589","run071","RGR","BGG",2,0,2
"8590","run071","RGR","BRR",1,0,1
"8591","run071","RGR","GGB",2,2,4
"8592","run071","RGR","RGG",1,0,1
"8593","run071","RRG","BBB",2,5,7
"8594","run071","RRG","BGB",1,3,4
"8595","run071","RRG","BRB",2,9,11
"8596","run071","RRG","BRR",1,1,2
"8597","run071","RRG","GGG",2,4,6
"8598","run071","RRG","GRG",1,0,1
"8599","run071","RRG","GRR",3,1,4
"8600","run071","RRG","RBB",1,0,1
"8601","run071","RRR","BBR",1,0,1
"8602","run071","RRR","BGB",2,0,2
"8603","run071","RRR","BGG",1,0,1
"8604","run071","RRR","BRB",1,0,1
"8605","run071","RRR","BRR",1,0,1
"8606","run071","RRR","RBB",1,1,2
"8607","run071","RRR","RGR",1,0,1
"8608","run071","RRR","RRG",2,0,2
"8609","run071","BBG","RBG",0,2,2
"8610","run071","BBG","RRR",0,1,1
"8611","run071","BRB","BBB",0,3,3
"8612","run071","BRB","BRR",0,3,3
"8613","run071","BRB","RRR",0,1,1
"8614","run071","BRR","BRB",0,1,1
"8615","run071","GBB","GBG",0,2,2
"8616","run071","GBB","GGB",0,5,5
"8617","run071","GBB","GRR",0,1,1
"8618","run071","GBB","RRG",0,1,1
"8619","run071","GBG","BBB",0,1,1
"8620","run071","GGB","BGB",0,2,2
"8621","run071","GGB","BGG",0,1,1
"8622","run071","GGB","GGR",0,1,1
"8623","run071","GGB","RBB",0,1,1
"8624","run071","GGB","RBG",0,1,1
"8625","run071","GGB","RBR",0,1,1
"8626","run071","GGB","RGR",0,1,1
"8627","run071","GGG","BGB",0,1,1
"8628","run071","GGG","RBG",0,2,2
"8629","run071","GGG","RBR",0,1,1
"8630","run071","GGG","RGG",0,2,2
"8631","run071","GGR","BBB",0,1,1
"8632","run071","RBB","RGG",0,1,1
"8633","run071","RBG","BRR",0,1,1
"8634","run071","RBR","BBB",0,1,1
"8635","run071","RBR","BGG",0,1,1
"8636","run071","RBR","GGB",0,3,3
"8637","run071","RGG","BRR",0,1,1
"8638","run071","RGG","GRR",0,1,1
"8639","run071","RGR","RRG",0,2,2
"8640","run071","RRG","BBR",0,1,1
"8641","run071","RRG","GGR",0,1,1
"8642","run071","RRR","GRR",0,1,1
"8643","run072","BBB","GGG",1,0,1
"8644","run072","BBB","RRG",1,1,2
"8645","run072","BBG","BBB",1,0,1
"8646","run072","BBG","BRB",1,3,4
"8647","run072","BBG","GBG",2,1,3
"8648","run072","BBG","GGB",2,9,11
"8649","run072","BBG","GGG",4,5,9
"8650","run072","BBG","GRG",1,2,3
"8651","run072","BBG","RRG",1,0,1
"8652","run072","BGG","RBG",1,0,1
"8653","run072","BGG","RRR",1,0,1
"8654","run072","BRR","BGB",1,0,1
"8655","run072","GBB","BBB",12,5,17
"8656","run072","GBB","BRB",1,1,2
"8657","run072","GBB","BRR",1,0,1
"8658","run072","GBB","GGG",7,17,24
"8659","run072","GBB","GGR",1,0,1
"8660","run072","GBB","RBG",3,0,3
"8661","run072","GBB","RBR",1,0,1
"8662","run072","GBB","RGG",1,0,1
"8663","run072","GBB","RGR",2,0,2
"8664","run072","GBB","RRR",1,3,4
"8665","run072","GBG","BRB",1,0,1
"8666","run072","GBG","BRR",1,0,1
"8667","run072","GBG","GGG",4,3,7
"8668","run072","GBG","RBB",1,0,1
"8669","run072","GBG","RGR",1,0,1
"8670","run072","GBG","RRG",1,1,2
"8671","run072","GGB","BBB",3,2,5
"8672","run072","GGB","BBR",1,0,1
"8673","run072","GGB","BRR",1,0,1
"8674","run072","GGB","GBG",1,0,1
"8675","run072","GGB","GGG",13,11,24
"8676","run072","GGB","RGG",1,1,2
"8677","run072","GGB","RRG",1,0,1
"8678","run072","GGB","RRR",1,2,3
"8679","run072","GGG","BBB",8,0,8
"8680","run072","GGG","BGG",1,0,1
"8681","run072","GGG","BRB",1,1,2
"8682","run072","GGG","GGB",5,0,5
"8683","run072","GGG","GGR",1,2,3
"8684","run072","GGG","RBB",1,3,4
"8685","run072","GGG","RGR",1,1,2
"8686","run072","GGG","RRG",1,2,3
"8687","run072","GGR","BRR",1,0,1
"8688","run072","GGR","GRR",1,0,1
"8689","run072","GRG","BBB",3,2,5
"8690","run072","GRG","GGB",2,3,5
"8691","run072","GRG","GGG",3,1,4
"8692","run072","GRG","RGR",1,1,2
"8693","run072","GRG","RRG",2,0,2
"8694","run072","GRR","BGB",1,0,1
"8695","run072","RBG","BBB",2,0,2
"8696","run072","RBG","RBB",1,1,2
"8697","run072","RBR","BGB",2,0,2
"8698","run072","RBR","BRB",1,0,1
"8699","run072","RBR","BRR",1,2,3
"8700","run072","RBR","GRR",4,1,5
"8701","run072","RBR","RGG",2,1,3
"8702","run072","RBR","RGR",1,0,1
"8703","run072","RGG","BBR",1,0,1
"8704","run072","RGR","BBB",2,1,3
"8705","run072","RGR","BBR",1,0,1
"8706","run072","RGR","BGB",2,1,3
"8707","run072","RGR","BGG",2,0,2
"8708","run072","RGR","BRR",1,1,2
"8709","run072","RGR","GGB",2,1,3
"8710","run072","RGR","RGG",1,0,1
"8711","run072","RRG","BBB",2,6,8
"8712","run072","RRG","BGB",1,3,4
"8713","run072","RRG","BRB",2,4,6
"8714","run072","RRG","BRR",1,3,4
"8715","run072","RRG","GGG",2,1,3
"8716","run072","RRG","GRG",1,0,1
"8717","run072","RRG","GRR",3,2,5
"8718","run072","RRG","RBB",1,0,1
"8719","run072","RRR","BBR",1,0,1
"8720","run072","RRR","BGB",2,0,2
"8721","run072","RRR","BGG",1,0,1
"8722","run072","RRR","BRB",1,0,1
"8723","run072","RRR","BRR",1,0,1
"8724","run072","RRR","RBB",1,0,1
"8725","run072","RRR","RGR",1,0,1
"8726","run072","RRR","RRG",2,0,2
"8727","run072","BBG","RRR",0,1,1
"8728","run072","BGG","RGG",0,1,1
"8729","run072","BGG","RGR",0,1,1
"8730","run072","BRB","BBB",0,3,3
"8731","run072","BRB","BRR",0,1,1
"8732","run072","BRB","GGG",0,1,1
"8733","run072","BRR","BBB",0,2,2
"8734","run072","GBB","GGB",0,4,4
"8735","run072","GBB","GRG",0,2,2
"8736","run072","GBG","BBR",0,1,1
"8737","run072","GBG","GGB",0,1,1
"8738","run072","GGB","BGB",0,1,1
"8739","run072","GGB","GGR",0,1,1
"8740","run072","GGB","RBG",0,1,1
"8741","run072","GGB","RBR",0,1,1
"8742","run072","GGG","BRR",0,1,1
"8743","run072","GGG","RBR",0,4,4
"8744","run072","GGG","RRR",0,1,1
"8745","run072","GGR","BBB",0,1,1
"8746","run072","GGR","BBR",0,1,1
"8747","run072","GRG","BGG",0,1,1
"8748","run072","GRG","BRR",0,1,1
"8749","run072","GRG","GBG",0,1,1
"8750","run072","GRR","BRB",0,1,1
"8751","run072","GRR","BRR",0,1,1
"8752","run072","GRR","GGG",0,1,1
"8753","run072","RBG","RBR",0,1,1
"8754","run072","RBR","BBB",0,2,2
"8755","run072","RBR","GGB",0,1,1
"8756","run072","RBR","RBB",0,2,2
"8757","run072","RGG","BBB",0,1,1
"8758","run072","RGG","BRR",0,1,1
"8759","run072","RGG","GGR",0,1,1
"8760","run072","RGG","GRR",0,1,1
"8761","run072","RGR","GGR",0,1,1
"8762","run072","RRG","BBR",0,1,1
"8763","run072","RRG","GGR",0,1,1
"8764","run073","BBB","GGG",1,0,1
"8765","run073","BBB","RRG",1,0,1
"8766","run073","BBG","BBB",1,3,4
"8767","run073","BBG","BRB",1,1,2
"8768","run073","BBG","GBG",2,0,2
"8769","run073","BBG","GGB",2,3,5
"8770","run073","BBG","GGG",4,5,9
"8771","run073","BBG","GRG",1,0,1
"8772","run073","BBG","RRG",1,1,2
"8773","run073","BGG","RBG",1,0,1
"8774","run073","BGG","RRR",1,0,1
"8775","run073","BRR","BGB",1,0,1
"8776","run073","GBB","BBB",12,7,19
"8777","run073","GBB","BRB",1,2,3
"8778","run073","GBB","BRR",1,0,1
"8779","run073","GBB","GGG",7,16,23
"8780","run073","GBB","GGR",1,1,2
"8781","run073","GBB","RBG",3,1,4
"8782","run073","GBB","RBR",1,0,1
"8783","run073","GBB","RGG",1,0,1
"8784","run073","GBB","RGR",2,0,2
"8785","run073","GBB","RRR",1,2,3
"8786","run073","GBG","BRB",1,1,2
"8787","run073","GBG","BRR",1,0,1
"8788","run073","GBG","GGG",4,0,4
"8789","run073","GBG","RBB",1,0,1
"8790","run073","GBG","RGR",1,1,2
"8791","run073","GBG","RRG",1,0,1
"8792","run073","GGB","BBB",3,1,4
"8793","run073","GGB","BBR",1,1,2
"8794","run073","GGB","BRR",1,2,3
"8795","run073","GGB","GBG",1,0,1
"8796","run073","GGB","GGG",13,6,19
"8797","run073","GGB","RGG",1,1,2
"8798","run073","GGB","RRG",1,2,3
"8799","run073","GGB","RRR",1,1,2
"8800","run073","GGG","BBB",8,6,14
"8801","run073","GGG","BGG",1,0,1
"8802","run073","GGG","BRB",1,0,1
"8803","run073","GGG","GGB",5,0,5
"8804","run073","GGG","GGR",1,3,4
"8805","run073","GGG","RBB",1,2,3
"8806","run073","GGG","RGR",1,2,3
"8807","run073","GGG","RRG",1,0,1
"8808","run073","GGR","BRR",1,0,1
"8809","run073","GGR","GRR",1,0,1
"8810","run073","GRG","BBB",3,3,6
"8811","run073","GRG","GGB",2,1,3
"8812","run073","GRG","GGG",3,3,6
"8813","run073","GRG","RGR",1,1,2
"8814","run073","GRG","RRG",2,2,4
"8815","run073","GRR","BGB",1,0,1
"8816","run073","RBG","BBB",2,3,5
"8817","run073","RBG","RBB",1,0,1
"8818","run073","RBR","BGB",2,0,2
"8819","run073","RBR","BRB",1,0,1
"8820","run073","RBR","BRR",1,1,2
"8821","run073","RBR","GRR",4,0,4
"8822","run073","RBR","RGG",2,2,4
"8823","run073","RBR","RGR",1,0,1
"8824","run073","RGG","BBR",1,0,1
"8825","run073","RGR","BBB",2,1,3
"8826","run073","RGR","BBR",1,0,1
"8827","run073","RGR","BGB",2,3,5
"8828","run073","RGR","BGG",2,0,2
"8829","run073","RGR","BRR",1,1,2
"8830","run073","RGR","GGB",2,4,6
"8831","run073","RGR","RGG",1,0,1
"8832","run073","RRG","BBB",2,8,10
"8833","run073","RRG","BGB",1,1,2
"8834","run073","RRG","BRB",2,5,7
"8835","run073","RRG","BRR",1,4,5
"8836","run073","RRG","GGG",2,0,2
"8837","run073","RRG","GRG",1,0,1
"8838","run073","RRG","GRR",3,1,4
"8839","run073","RRG","RBB",1,0,1
"8840","run073","RRR","BBR",1,0,1
"8841","run073","RRR","BGB",2,0,2
"8842","run073","RRR","BGG",1,0,1
"8843","run073","RRR","BRB",1,0,1
"8844","run073","RRR","BRR",1,0,1
"8845","run073","RRR","RBB",1,0,1
"8846","run073","RRR","RGR",1,1,2
"8847","run073","RRR","RRG",2,1,3
"8848","run073","BBB","GRR",0,1,1
"8849","run073","BBG","RBG",0,2,2
"8850","run073","BBG","RBR",0,1,1
"8851","run073","BGB","RRG",0,1,1
"8852","run073","BGG","BBB",0,1,1
"8853","run073","BRR","BBB",0,2,2
"8854","run073","BRR","RBB",0,1,1
"8855","run073","GBB","GBG",0,1,1
"8856","run073","GBB","GGB",0,5,5
"8857","run073","GBB","GRG",0,2,2
"8858","run073","GGB","BGB",0,1,1
"8859","run073","GGB","BGG",0,1,1
"8860","run073","GGB","BRB",0,1,1
"8861","run073","GGB","RBB",0,1,1
"8862","run073","GGB","RBR",0,1,1
"8863","run073","GGG","GRR",0,1,1
"8864","run073","GGG","RBR",0,3,3
"8865","run073","GGG","RGG",0,1,1
"8866","run073","GRG","BRR",0,1,1
"8867","run073","RBB","BBB",0,1,1
"8868","run073","RBR","BBB",0,4,4
"8869","run073","RBR","BGG",0,2,2
"8870","run073","RBR","GGB",0,2,2
"8871","run073","RBR","RRR",0,1,1
"8872","run073","RGG","BBB",0,1,1
"8873","run073","RGG","GRR",0,1,1
"8874","run073","RGG","RBB",0,1,1
"8875","run073","RRG","RGG",0,1,1
"8876","run073","RRR","RGG",0,1,1
"8877","run074","BBB","GGG",1,1,2
"8878","run074","BBB","RRG",1,0,1
"8879","run074","BBG","BBB",1,0,1
"8880","run074","BBG","BRB",1,2,3
"8881","run074","BBG","GBG",2,0,2
"8882","run074","BBG","GGB",2,7,9
"8883","run074","BBG","GGG",4,3,7
"8884","run074","BBG","GRG",1,1,2
"8885","run074","BBG","RRG",1,0,1
"8886","run074","BGG","RBG",1,0,1
"8887","run074","BGG","RRR",1,0,1
"8888","run074","BRR","BGB",1,0,1
"8889","run074","GBB","BBB",12,7,19
"8890","run074","GBB","BRB",1,1,2
"8891","run074","GBB","BRR",1,0,1
"8892","run074","GBB","GGG",7,10,17
"8893","run074","GBB","GGR",1,1,2
"8894","run074","GBB","RBG",3,1,4
"8895","run074","GBB","RBR",1,0,1
"8896","run074","GBB","RGG",1,0,1
"8897","run074","GBB","RGR",2,0,2
"8898","run074","GBB","RRR",1,1,2
"8899","run074","GBG","BRB",1,3,4
"8900","run074","GBG","BRR",1,0,1
"8901","run074","GBG","GGG",4,4,8
"8902","run074","GBG","RBB",1,0,1
"8903","run074","GBG","RGR",1,0,1
"8904","run074","GBG","RRG",1,0,1
"8905","run074","GGB","BBB",3,1,4
"8906","run074","GGB","BBR",1,0,1
"8907","run074","GGB","BRR",1,4,5
"8908","run074","GGB","GBG",1,0,1
"8909","run074","GGB","GGG",13,6,19
"8910","run074","GGB","RGG",1,1,2
"8911","run074","GGB","RRG",1,0,1
"8912","run074","GGB","RRR",1,0,1
"8913","run074","GGG","BBB",8,7,15
"8914","run074","GGG","BGG",1,1,2
"8915","run074","GGG","BRB",1,1,2
"8916","run074","GGG","GGB",5,1,6
"8917","run074","GGG","GGR",1,1,2
"8918","run074","GGG","RBB",1,2,3
"8919","run074","GGG","RGR",1,1,2
"8920","run074","GGG","RRG",1,4,5
"8921","run074","GGR","BRR",1,0,1
"8922","run074","GGR","GRR",1,0,1
"8923","run074","GRG","BBB",3,2,5
"8924","run074","GRG","GGB",2,2,4
"8925","run074","GRG","GGG",3,3,6
"8926","run074","GRG","RGR",1,0,1
"8927","run074","GRG","RRG",2,0,2
"8928","run074","GRR","BGB",1,0,1
"8929","run074","RBG","BBB",2,2,4
"8930","run074","RBG","RBB",1,0,1
"8931","run074","RBR","BGB",2,1,3
"8932","run074","RBR","BRB",1,0,1
"8933","run074","RBR","BRR",1,0,1
"8934","run074","RBR","GRR",4,0,4
"8935","run074","RBR","RGG",2,0,2
"8936","run074","RBR","RGR",1,0,1
"8937","run074","RGG","BBR",1,0,1
"8938","run074","RGR","BBB",2,0,2
"8939","run074","RGR","BBR",1,0,1
"8940","run074","RGR","BGB",2,1,3
"8941","run074","RGR","BGG",2,0,2
"8942","run074","RGR","BRR",1,0,1
"8943","run074","RGR","GGB",2,4,6
"8944","run074","RGR","RGG",1,0,1
"8945","run074","RRG","BBB",2,3,5
"8946","run074","RRG","BGB",1,0,1
"8947","run074","RRG","BRB",2,4,6
"8948","run074","RRG","BRR",1,1,2
"8949","run074","RRG","GGG",2,5,7
"8950","run074","RRG","GRG",1,0,1
"8951","run074","RRG","GRR",3,1,4
"8952","run074","RRG","RBB",1,0,1
"8953","run074","RRR","BBR",1,0,1
"8954","run074","RRR","BGB",2,0,2
"8955","run074","RRR","BGG",1,0,1
"8956","run074","RRR","BRB",1,0,1
"8957","run074","RRR","BRR",1,0,1
"8958","run074","RRR","RBB",1,0,1
"8959","run074","RRR","RGR",1,0,1
"8960","run074","RRR","RRG",2,0,2
"8961","run074","BBB","GRR",0,2,2
"8962","run074","BBB","RRR",0,2,2
"8963","run074","BBG","RBG",0,1,1
"8964","run074","BGB","BBB",0,1,1
"8965","run074","BGG","BBR",0,1,1
"8966","run074","BGG","RGG",0,2,2
"8967","run074","BRB","BBB",0,2,2
"8968","run074","BRB","RBG",0,1,1
"8969","run074","BRB","RGR",0,1,1
"8970","run074","BRR","BBB",0,3,3
"8971","run074","GBB","GGB",0,5,5
"8972","run074","GBB","GRR",0,1,1
"8973","run074","GBG","BBR",0,1,1
"8974","run074","GGB","BGB",0,1,1
"8975","run074","GGB","BGG",0,1,1
"8976","run074","GGB","GGR",0,1,1
"8977","run074","GGB","RBB",0,2,2
"8978","run074","GGG","BGB",0,1,1
"8979","run074","GGG","RBG",0,1,1
"8980","run074","GGG","RBR",0,3,3
"8981","run074","GGG","RRR",0,1,1
"8982","run074","GGR","BBB",0,1,1
"8983","run074","GGR","BBR",0,1,1
"8984","run074","GRG","BGG",0,1,1
"8985","run074","GRG","BRR",0,1,1
"8986","run074","GRR","GGG",0,1,1
"8987","run074","GRR","GGR",0,1,1
"8988","run074","RBB","GRR",0,1,1
"8989","run074","RBR","BBB",0,1,1
"8990","run074","RBR","BGG",0,2,2
"8991","run074","RBR","GGB",0,2,2
"8992","run074","RGG","BBB",0,2,2
"8993","run074","RGG","GGG",0,1,1
"8994","run074","RGG","GRR",0,2,2
"8995","run074","RGR","GGG",0,1,1
"8996","run074","RGR","GGR",0,2,2
"8997","run074","RGR","RBB",0,1,1
"8998","run074","RRG","BBR",0,2,2
"8999","run074","RRG","GGR",0,1,1
"9000","run074","RRR","GGR",0,1,1
"9001","run075","BBB","GGG",1,1,2
"9002","run075","BBB","RRG",1,1,2
"9003","run075","BBG","BBB",1,1,2
"9004","run075","BBG","BRB",1,1,2
"9005","run075","BBG","GBG",2,0,2
"9006","run075","BBG","GGB",2,4,6
"9007","run075","BBG","GGG",4,6,10
"9008","run075","BBG","GRG",1,0,1
"9009","run075","BBG","RRG",1,1,2
"9010","run075","BGG","RBG",1,0,1
"9011","run075","BGG","RRR",1,0,1
"9012","run075","BRR","BGB",1,0,1
"9013","run075","GBB","BBB",12,7,19
"9014","run075","GBB","BRB",1,1,2
"9015","run075","GBB","BRR",1,0,1
"9016","run075","GBB","GGG",7,15,22
"9017","run075","GBB","GGR",1,0,1
"9018","run075","GBB","RBG",3,3,6
"9019","run075","GBB","RBR",1,0,1
"9020","run075","GBB","RGG",1,0,1
"9021","run075","GBB","RGR",2,0,2
"9022","run075","GBB","RRR",1,2,3
"9023","run075","GBG","BRB",1,1,2
"9024","run075","GBG","BRR",1,0,1
"9025","run075","GBG","GGG",4,1,5
"9026","run075","GBG","RBB",1,0,1
"9027","run075","GBG","RGR",1,1,2
"9028","run075","GBG","RRG",1,1,2
"9029","run075","GGB","BBB",3,3,6
"9030","run075","GGB","BBR",1,0,1
"9031","run075","GGB","BRR",1,1,2
"9032","run075","GGB","GBG",1,0,1
"9033","run075","GGB","GGG",13,9,22
"9034","run075","GGB","RGG",1,0,1
"9035","run075","GGB","RRG",1,1,2
"9036","run075","GGB","RRR",1,0,1
"9037","run075","GGG","BBB",8,3,11
"9038","run075","GGG","BGG",1,1,2
"9039","run075","GGG","BRB",1,0,1
"9040","run075","GGG","GGB",5,0,5
"9041","run075","GGG","GGR",1,3,4
"9042","run075","GGG","RBB",1,2,3
"9043","run075","GGG","RGR",1,0,1
"9044","run075","GGG","RRG",1,4,5
"9045","run075","GGR","BRR",1,0,1
"9046","run075","GGR","GRR",1,0,1
"9047","run075","GRG","BBB",3,1,4
"9048","run075","GRG","GGB",2,2,4
"9049","run075","GRG","GGG",3,1,4
"9050","run075","GRG","RGR",1,0,1
"9051","run075","GRG","RRG",2,1,3
"9052","run075","GRR","BGB",1,0,1
"9053","run075","RBG","BBB",2,0,2
"9054","run075","RBG","RBB",1,0,1
"9055","run075","RBR","BGB",2,1,3
"9056","run075","RBR","BRB",1,0,1
"9057","run075","RBR","BRR",1,0,1
"9058","run075","RBR","GRR",4,0,4
"9059","run075","RBR","RGG",2,0,2
"9060","run075","RBR","RGR",1,0,1
"9061","run075","RGG","BBR",1,0,1
"9062","run075","RGR","BBB",2,1,3
"9063","run075","RGR","BBR",1,0,1
"9064","run075","RGR","BGB",2,3,5
"9065","run075","RGR","BGG",2,1,3
"9066","run075","RGR","BRR",1,0,1
"9067","run075","RGR","GGB",2,3,5
"9068","run075","RGR","RGG",1,0,1
"9069","run075","RRG","BBB",2,1,3
"9070","run075","RRG","BGB",1,0,1
"9071","run075","RRG","BRB",2,5,7
"9072","run075","RRG","BRR",1,5,6
"9073","run075","RRG","GGG",2,3,5
"9074","run075","RRG","GRG",1,0,1
"9075","run075","RRG","GRR",3,2,5
"9076","run075","RRG","RBB",1,0,1
"9077","run075","RRR","BBR",1,0,1
"9078","run075","RRR","BGB",2,0,2
"9079","run075","RRR","BGG",1,0,1
"9080","run075","RRR","BRB",1,0,1
"9081","run075","RRR","BRR",1,0,1
"9082","run075","RRR","RBB",1,0,1
"9083","run075","RRR","RGR",1,1,2
"9084","run075","RRR","RRG",2,0,2
"9085","run075","BBB","RRR",0,1,1
"9086","run075","BBG","BGB",0,1,1
"9087","run075","BBG","GRR",0,1,1
"9088","run075","BBG","RBG",0,1,1
"9089","run075","BBG","RRR",0,2,2
"9090","run075","BGG","BBB",0,1,1
"9091","run075","BGG","RGG",0,1,1
"9092","run075","BRB","BBB",0,1,1
"9093","run075","BRR","BBB",0,4,4
"9094","run075","GBB","GBG",0,1,1
"9095","run075","GBB","GGB",0,4,4
"9096","run075","GBB","GRG",0,1,1
"9097","run075","GBB","RBB",0,1,1
"9098","run075","GBB","RRG",0,1,1
"9099","run075","GBG","BBB",0,2,2
"9100","run075","GGB","BGB",0,1,1
"9101","run075","GGB","GBB",0,1,1
"9102","run075","GGB","GGR",0,1,1
"9103","run075","GGB","RGR",0,2,2
"9104","run075","GGG","BRR",0,1,1
"9105","run075","GGG","RBR",0,4,4
"9106","run075","GGG","RGG",0,1,1
"9107","run075","GRG","BRB",0,1,1
"9108","run075","GRG","GGR",0,2,2
"9109","run075","GRR","BBR",0,1,1
"9110","run075","GRR","BGG",0,1,1
"9111","run075","GRR","BRB",0,1,1
"9112","run075","RBB","BRB",0,1,1
"9113","run075","RBG","GBB",0,1,1
"9114","run075","RBG","GRR",0,1,1
"9115","run075","RBR","BBB",0,3,3
"9116","run075","RBR","GGB",0,1,1
"9117","run075","RBR","RBB",0,1,1
"9118","run075","RGG","BGB",0,1,1
"9119","run075","RGG","GRR",0,2,2
"9120","run075","RGR","GGG",0,1,1
"9121","run075","RGR","RBB",0,2,2
"9122","run075","RRG","GGR",0,1,1
"9123","run076","BBB","GGG",1,0,1
"9124","run076","BBB","RRG",1,0,1
"9125","run076","BBG","BBB",1,0,1
"9126","run076","BBG","BRB",1,2,3
"9127","run076","BBG","GBG",2,2,4
"9128","run076","BBG","GGB",2,3,5
"9129","run076","BBG","GGG",4,1,5
"9130","run076","BBG","GRG",1,2,3
"9131","run076","BBG","RRG",1,0,1
"9132","run076","BGG","RBG",1,0,1
"9133","run076","BGG","RRR",1,0,1
"9134","run076","BRR","BGB",1,0,1
"9135","run076","GBB","BBB",12,3,15
"9136","run076","GBB","BRB",1,1,2
"9137","run076","GBB","BRR",1,0,1
"9138","run076","GBB","GGG",7,9,16
"9139","run076","GBB","GGR",1,0,1
"9140","run076","GBB","RBG",3,2,5
"9141","run076","GBB","RBR",1,0,1
"9142","run076","GBB","RGG",1,0,1
"9143","run076","GBB","RGR",2,0,2
"9144","run076","GBB","RRR",1,0,1
"9145","run076","GBG","BRB",1,0,1
"9146","run076","GBG","BRR",1,0,1
"9147","run076","GBG","GGG",4,1,5
"9148","run076","GBG","RBB",1,0,1
"9149","run076","GBG","RGR",1,0,1
"9150","run076","GBG","RRG",1,0,1
"9151","run076","GGB","BBB",3,3,6
"9152","run076","GGB","BBR",1,1,2
"9153","run076","GGB","BRR",1,6,7
"9154","run076","GGB","GBG",1,0,1
"9155","run076","GGB","GGG",13,11,24
"9156","run076","GGB","RGG",1,2,3
"9157","run076","GGB","RRG",1,0,1
"9158","run076","GGB","RRR",1,0,1
"9159","run076","GGG","BBB",8,6,14
"9160","run076","GGG","BGG",1,2,3
"9161","run076","GGG","BRB",1,1,2
"9162","run076","GGG","GGB",5,0,5
"9163","run076","GGG","GGR",1,1,2
"9164","run076","GGG","RBB",1,2,3
"9165","run076","GGG","RGR",1,2,3
"9166","run076","GGG","RRG",1,3,4
"9167","run076","GGR","BRR",1,0,1
"9168","run076","GGR","GRR",1,0,1
"9169","run076","GRG","BBB",3,1,4
"9170","run076","GRG","GGB",2,5,7
"9171","run076","GRG","GGG",3,1,4
"9172","run076","GRG","RGR",1,1,2
"9173","run076","GRG","RRG",2,1,3
"9174","run076","GRR","BGB",1,1,2
"9175","run076","RBG","BBB",2,1,3
"9176","run076","RBG","RBB",1,0,1
"9177","run076","RBR","BGB",2,1,3
"9178","run076","RBR","BRB",1,0,1
"9179","run076","RBR","BRR",1,0,1
"9180","run076","RBR","GRR",4,0,4
"9181","run076","RBR","RGG",2,1,3
"9182","run076","RBR","RGR",1,0,1
"9183","run076","RGG","BBR",1,0,1
"9184","run076","RGR","BBB",2,0,2
"9185","run076","RGR","BBR",1,0,1
"9186","run076","RGR","BGB",2,1,3
"9187","run076","RGR","BGG",2,0,2
"9188","run076","RGR","BRR",1,1,2
"9189","run076","RGR","GGB",2,1,3
"9190","run076","RGR","RGG",1,1,2
"9191","run076","RRG","BBB",2,5,7
"9192","run076","RRG","BGB",1,2,3
"9193","run076","RRG","BRB",2,11,13
"9194","run076","RRG","BRR",1,4,5
"9195","run076","RRG","GGG",2,3,5
"9196","run076","RRG","GRG",1,0,1
"9197","run076","RRG","GRR",3,1,4
"9198","run076","RRG","RBB",1,0,1
"9199","run076","RRR","BBR",1,0,1
"9200","run076","RRR","BGB",2,1,3
"9201","run076","RRR","BGG",1,0,1
"9202","run076","RRR","BRB",1,1,2
"9203","run076","RRR","BRR",1,0,1
"9204","run076","RRR","RBB",1,0,1
"9205","run076","RRR","RGR",1,1,2
"9206","run076","RRR","RRG",2,0,2
"9207","run076","BBG","BGB",0,1,1
"9208","run076","BBG","BGG",0,1,1
"9209","run076","BBG","RBB",0,1,1
"9210","run076","BRB","BBB",0,1,1
"9211","run076","BRB","GGG",0,1,1
"9212","run076","BRB","RBB",0,1,1
"9213","run076","BRR","BBB",0,3,3
"9214","run076","BRR","RBB",0,1,1
"9215","run076","GBB","GBG",0,1,1
"9216","run076","GBB","GGB",0,3,3
"9217","run076","GBB","GRR",0,1,1
"9218","run076","GGB","BGG",0,1,1
"9219","run076","GGB","GGR",0,1,1
"9220","run076","GGB","RBB",0,1,1
"9221","run076","GGB","RBG",0,1,1
"9222","run076","GGB","RBR",0,1,1
"9223","run076","GGG","BGB",0,1,1
"9224","run076","GGG","BRR",0,1,1
"9225","run076","GGG","RBG",0,1,1
"9226","run076","GGG","RBR",0,7,7
"9227","run076","GRG","BBR",0,1,1
"9228","run076","GRG","BGG",0,1,1
"9229","run076","GRG","GBG",0,1,1
"9230","run076","GRR","BRR",0,1,1
"9231","run076","RBB","RGG",0,1,1
"9232","run076","RBG","RGR",0,1,1
"9233","run076","RBR","BBB",0,1,1
"9234","run076","RBR","BBR",0,1,1
"9235","run076","RBR","BGG",0,1,1
"9236","run076","RBR","GGB",0,1,1
"9237","run076","RGG","BBB",0,2,2
"9238","run076","RGG","GRR",0,1,1
"9239","run076","RGR","RBB",0,1,1
"9240","run076","RGR","RRG",0,1,1
"9241","run076","RRG","BGG",0,2,2
"9242","run076","RRR","GRR",0,1,1
"9243","run077","BBB","GGG",1,0,1
"9244","run077","BBB","RRG",1,0,1
"9245","run077","BBG","BBB",1,0,1
"9246","run077","BBG","BRB",1,3,4
"9247","run077","BBG","GBG",2,0,2
"9248","run077","BBG","GGB",2,4,6
"9249","run077","BBG","GGG",4,5,9
"9250","run077","BBG","GRG",1,3,4
"9251","run077","BBG","RRG",1,1,2
"9252","run077","BGG","RBG",1,0,1
"9253","run077","BGG","RRR",1,0,1
"9254","run077","BRR","BGB",1,0,1
"9255","run077","GBB","BBB",12,5,17
"9256","run077","GBB","BRB",1,2,3
"9257","run077","GBB","BRR",1,0,1
"9258","run077","GBB","GGG",7,6,13
"9259","run077","GBB","GGR",1,2,3
"9260","run077","GBB","RBG",3,2,5
"9261","run077","GBB","RBR",1,0,1
"9262","run077","GBB","RGG",1,0,1
"9263","run077","GBB","RGR",2,0,2
"9264","run077","GBB","RRR",1,1,2
"9265","run077","GBG","BRB",1,3,4
"9266","run077","GBG","BRR",1,0,1
"9267","run077","GBG","GGG",4,1,5
"9268","run077","GBG","RBB",1,0,1
"9269","run077","GBG","RGR",1,0,1
"9270","run077","GBG","RRG",1,0,1
"9271","run077","GGB","BBB",3,1,4
"9272","run077","GGB","BBR",1,0,1
"9273","run077","GGB","BRR",1,4,5
"9274","run077","GGB","GBG",1,0,1
"9275","run077","GGB","GGG",13,10,23
"9276","run077","GGB","RGG",1,2,3
"9277","run077","GGB","RRG",1,0,1
"9278","run077","GGB","RRR",1,0,1
"9279","run077","GGG","BBB",8,2,10
"9280","run077","GGG","BGG",1,1,2
"9281","run077","GGG","BRB",1,1,2
"9282","run077","GGG","GGB",5,0,5
"9283","run077","GGG","GGR",1,0,1
"9284","run077","GGG","RBB",1,1,2
"9285","run077","GGG","RGR",1,3,4
"9286","run077","GGG","RRG",1,1,2
"9287","run077","GGR","BRR",1,0,1
"9288","run077","GGR","GRR",1,0,1
"9289","run077","GRG","BBB",3,1,4
"9290","run077","GRG","GGB",2,2,4
"9291","run077","GRG","GGG",3,3,6
"9292","run077","GRG","RGR",1,1,2
"9293","run077","GRG","RRG",2,0,2
"9294","run077","GRR","BGB",1,1,2
"9295","run077","RBG","BBB",2,2,4
"9296","run077","RBG","RBB",1,0,1
"9297","run077","RBR","BGB",2,0,2
"9298","run077","RBR","BRB",1,0,1
"9299","run077","RBR","BRR",1,1,2
"9300","run077","RBR","GRR",4,2,6
"9301","run077","RBR","RGG",2,0,2
"9302","run077","RBR","RGR",1,0,1
"9303","run077","RGG","BBR",1,1,2
"9304","run077","RGR","BBB",2,0,2
"9305","run077","RGR","BBR",1,0,1
"9306","run077","RGR","BGB",2,1,3
"9307","run077","RGR","BGG",2,0,2
"9308","run077","RGR","BRR",1,0,1
"9309","run077","RGR","GGB",2,5,7
"9310","run077","RGR","RGG",1,0,1
"9311","run077","RRG","BBB",2,4,6
"9312","run077","RRG","BGB",1,2,3
"9313","run077","RRG","BRB",2,4,6
"9314","run077","RRG","BRR",1,1,2
"9315","run077","RRG","GGG",2,5,7
"9316","run077","RRG","GRG",1,0,1
"9317","run077","RRG","GRR",3,1,4
"9318","run077","RRG","RBB",1,0,1
"9319","run077","RRR","BBR",1,0,1
"9320","run077","RRR","BGB",2,0,2
"9321","run077","RRR","BGG",1,0,1
"9322","run077","RRR","BRB",1,0,1
"9323","run077","RRR","BRR",1,0,1
"9324","run077","RRR","RBB",1,0,1
"9325","run077","RRR","RGR",1,0,1
"9326","run077","RRR","RRG",2,1,3
"9327","run077","BBG","RBB",0,1,1
"9328","run077","BBG","RRR",0,1,1
"9329","run077","BGB","RRG",0,1,1
"9330","run077","BGG","BBB",0,1,1
"9331","run077","BRB","BBB",0,3,3
"9332","run077","BRR","BBB",0,3,3
"9333","run077","BRR","BGG",0,1,1
"9334","run077","GBB","BGG",0,1,1
"9335","run077","GBB","GBG",0,1,1
"9336","run077","GBB","GGB",0,7,7
"9337","run077","GBB","GRG",0,1,1
"9338","run077","GBG","GGB",0,1,1
"9339","run077","GBG","RGG",0,1,1
"9340","run077","GGB","BGB",0,1,1
"9341","run077","GGB","BGG",0,1,1
"9342","run077","GGB","GGR",0,4,4
"9343","run077","GGB","RBB",0,1,1
"9344","run077","GGB","RBG",0,1,1
"9345","run077","GGG","BGB",0,1,1
"9346","run077","GGG","GRR",0,2,2
"9347","run077","GGG","RBG",0,1,1
"9348","run077","GGG","RBR",0,4,4
"9349","run077","GRG","BRB",0,2,2
"9350","run077","GRG","GGR",0,1,1
"9351","run077","GRR","GGG",0,1,1
"9352","run077","RBG","RBR",0,1,1
"9353","run077","RBR","BBB",0,4,4
"9354","run077","RGG","BBB",0,1,1
"9355","run077","RGG","BGB",0,1,1
"9356","run077","RGG","GGR",0,1,1
"9357","run077","RGG","GRR",0,1,1
"9358","run077","RGR","GGR",0,1,1
"9359","run077","RGR","RBB",0,1,1
"9360","run077","RGR","RRG",0,1,1
"9361","run077","RRG","GGR",0,2,2
"9362","run077","RRR","GRR",0,1,1
"9363","run078","BBB","GGG",1,0,1
"9364","run078","BBB","RRG",1,0,1
"9365","run078","BBG","BBB",1,1,2
"9366","run078","BBG","BRB",1,2,3
"9367","run078","BBG","GBG",2,1,3
"9368","run078","BBG","GGB",2,5,7
"9369","run078","BBG","GGG",4,3,7
"9370","run078","BBG","GRG",1,0,1
"9371","run078","BBG","RRG",1,0,1
"9372","run078","BGG","RBG",1,0,1
"9373","run078","BGG","RRR",1,0,1
"9374","run078","BRR","BGB",1,1,2
"9375","run078","GBB","BBB",12,7,19
"9376","run078","GBB","BRB",1,2,3
"9377","run078","GBB","BRR",1,1,2
"9378","run078","GBB","GGG",7,15,22
"9379","run078","GBB","GGR",1,1,2
"9380","run078","GBB","RBG",3,2,5
"9381","run078","GBB","RBR",1,0,1
"9382","run078","GBB","RGG",1,0,1
"9383","run078","GBB","RGR",2,0,2
"9384","run078","GBB","RRR",1,1,2
"9385","run078","GBG","BRB",1,0,1
"9386","run078","GBG","BRR",1,0,1
"9387","run078","GBG","GGG",4,2,6
"9388","run078","GBG","RBB",1,0,1
"9389","run078","GBG","RGR",1,0,1
"9390","run078","GBG","RRG",1,1,2
"9391","run078","GGB","BBB",3,2,5
"9392","run078","GGB","BBR",1,0,1
"9393","run078","GGB","BRR",1,3,4
"9394","run078","GGB","GBG",1,0,1
"9395","run078","GGB","GGG",13,5,18
"9396","run078","GGB","RGG",1,0,1
"9397","run078","GGB","RRG",1,0,1
"9398","run078","GGB","RRR",1,0,1
"9399","run078","GGG","BBB",8,4,12
"9400","run078","GGG","BGG",1,1,2
"9401","run078","GGG","BRB",1,1,2
"9402","run078","GGG","GGB",5,0,5
"9403","run078","GGG","GGR",1,1,2
"9404","run078","GGG","RBB",1,2,3
"9405","run078","GGG","RGR",1,0,1
"9406","run078","GGG","RRG",1,5,6
"9407","run078","GGR","BRR",1,0,1
"9408","run078","GGR","GRR",1,0,1
"9409","run078","GRG","BBB",3,3,6
"9410","run078","GRG","GGB",2,2,4
"9411","run078","GRG","GGG",3,0,3
"9412","run078","GRG","RGR",1,1,2
"9413","run078","GRG","RRG",2,2,4
"9414","run078","GRR","BGB",1,0,1
"9415","run078","RBG","BBB",2,3,5
"9416","run078","RBG","RBB",1,0,1
"9417","run078","RBR","BGB",2,1,3
"9418","run078","RBR","BRB",1,0,1
"9419","run078","RBR","BRR",1,0,1
"9420","run078","RBR","GRR",4,1,5
"9421","run078","RBR","RGG",2,1,3
"9422","run078","RBR","RGR",1,0,1
"9423","run078","RGG","BBR",1,0,1
"9424","run078","RGR","BBB",2,0,2
"9425","run078","RGR","BBR",1,0,1
"9426","run078","RGR","BGB",2,2,4
"9427","run078","RGR","BGG",2,0,2
"9428","run078","RGR","BRR",1,0,1
"9429","run078","RGR","GGB",2,0,2
"9430","run078","RGR","RGG",1,0,1
"9431","run078","RRG","BBB",2,7,9
"9432","run078","RRG","BGB",1,2,3
"9433","run078","RRG","BRB",2,5,7
"9434","run078","RRG","BRR",1,4,5
"9435","run078","RRG","GGG",2,1,3
"9436","run078","RRG","GRG",1,0,1
"9437","run078","RRG","GRR",3,1,4
"9438","run078","RRG","RBB",1,0,1
"9439","run078","RRR","BBR",1,0,1
"9440","run078","RRR","BGB",2,1,3
"9441","run078","RRR","BGG",1,0,1
"9442","run078","RRR","BRB",1,1,2
"9443","run078","RRR","BRR",1,0,1
"9444","run078","RRR","RBB",1,0,1
"9445","run078","RRR","RGR",1,0,1
"9446","run078","RRR","RRG",2,0,2
"9447","run078","BBB","BRB",0,1,1
"9448","run078","BBG","RBG",0,1,1
"9449","run078","BBG","RRR",0,2,2
"9450","run078","BGG","GRG",0,1,1
"9451","run078","BRB","BBB",0,2,2
"9452","run078","BRB","BBR",0,1,1
"9453","run078","BRB","BRR",0,1,1
"9454","run078","BRB","GGR",0,1,1
"9455","run078","BRB","RRR",0,1,1
"9456","run078","BRR","BBB",0,2,2
"9457","run078","GBB","GBG",0,1,1
"9458","run078","GBB","GGB",0,3,3
"9459","run078","GBB","GRG",0,3,3
"9460","run078","GBG","BBB",0,1,1
"9461","run078","GBG","GGB",0,1,1
"9462","run078","GGB","BGG",0,2,2
"9463","run078","GGB","GGR",0,1,1
"9464","run078","GGB","GRR",0,1,1
"9465","run078","GGG","RBR",0,5,5
"9466","run078","GGG","RGG",0,1,1
"9467","run078","GGG","RRR",0,1,1
"9468","run078","GRG","BGG",0,1,1
"9469","run078","GRR","BGG",0,1,1
"9470","run078","GRR","BRR",0,1,1
"9471","run078","RBG","RBR",0,1,1
"9472","run078","RBR","BBB",0,3,3
"9473","run078","RBR","GGB",0,2,2
"9474","run078","RBR","RBB",0,1,1
"9475","run078","RGG","BBB",0,1,1
"9476","run078","RGG","BRR",0,1,1
"9477","run078","RGG","GGR",0,1,1
"9478","run078","RGG","GRR",0,1,1
"9479","run078","RGG","RBB",0,1,1
"9480","run078","RGR","GGR",0,1,1
"9481","run078","RRG","BBR",0,1,1
"9482","run078","RRG","BGG",0,1,1
"9483","run078","RRG","GGR",0,1,1
"9484","run078","RRG","RGR",0,1,1
"9485","run079","BBB","GGG",1,0,1
"9486","run079","BBB","RRG",1,0,1
"9487","run079","BBG","BBB",1,0,1
"9488","run079","BBG","BRB",1,2,3
"9489","run079","BBG","GBG",2,0,2
"9490","run079","BBG","GGB",2,4,6
"9491","run079","BBG","GGG",4,8,12
"9492","run079","BBG","GRG",1,2,3
"9493","run079","BBG","RRG",1,0,1
"9494","run079","BGG","RBG",1,1,2
"9495","run079","BGG","RRR",1,0,1
"9496","run079","BRR","BGB",1,0,1
"9497","run079","GBB","BBB",12,5,17
"9498","run079","GBB","BRB",1,1,2
"9499","run079","GBB","BRR",1,1,2
"9500","run079","GBB","GGG",7,6,13
"9501","run079","GBB","GGR",1,0,1
"9502","run079","GBB","RBG",3,1,4
"9503","run079","GBB","RBR",1,0,1
"9504","run079","GBB","RGG",1,0,1
"9505","run079","GBB","RGR",2,0,2
"9506","run079","GBB","RRR",1,1,2
"9507","run079","GBG","BRB",1,0,1
"9508","run079","GBG","BRR",1,0,1
"9509","run079","GBG","GGG",4,4,8
"9510","run079","GBG","RBB",1,0,1
"9511","run079","GBG","RGR",1,0,1
"9512","run079","GBG","RRG",1,0,1
"9513","run079","GGB","BBB",3,1,4
"9514","run079","GGB","BBR",1,0,1
"9515","run079","GGB","BRR",1,2,3
"9516","run079","GGB","GBG",1,0,1
"9517","run079","GGB","GGG",13,8,21
"9518","run079","GGB","RGG",1,1,2
"9519","run079","GGB","RRG",1,1,2
"9520","run079","GGB","RRR",1,0,1
"9521","run079","GGG","BBB",8,5,13
"9522","run079","GGG","BGG",1,1,2
"9523","run079","GGG","BRB",1,1,2
"9524","run079","GGG","GGB",5,1,6
"9525","run079","GGG","GGR",1,2,3
"9526","run079","GGG","RBB",1,1,2
"9527","run079","GGG","RGR",1,3,4
"9528","run079","GGG","RRG",1,5,6
"9529","run079","GGR","BRR",1,0,1
"9530","run079","GGR","GRR",1,0,1
"9531","run079","GRG","BBB",3,1,4
"9532","run079","GRG","GGB",2,1,3
"9533","run079","GRG","GGG",3,1,4
"9534","run079","GRG","RGR",1,1,2
"9535","run079","GRG","RRG",2,0,2
"9536","run079","GRR","BGB",1,0,1
"9537","run079","RBG","BBB",2,3,5
"9538","run079","RBG","RBB",1,0,1
"9539","run079","RBR","BGB",2,0,2
"9540","run079","RBR","BRB",1,0,1
"9541","run079","RBR","BRR",1,0,1
"9542","run079","RBR","GRR",4,0,4
"9543","run079","RBR","RGG",2,1,3
"9544","run079","RBR","RGR",1,0,1
"9545","run079","RGG","BBR",1,0,1
"9546","run079","RGR","BBB",2,0,2
"9547","run079","RGR","BBR",1,0,1
"9548","run079","RGR","BGB",2,0,2
"9549","run079","RGR","BGG",2,0,2
"9550","run079","RGR","BRR",1,0,1
"9551","run079","RGR","GGB",2,3,5
"9552","run079","RGR","RGG",1,0,1
"9553","run079","RRG","BBB",2,5,7
"9554","run079","RRG","BGB",1,2,3
"9555","run079","RRG","BRB",2,2,4
"9556","run079","RRG","BRR",1,4,5
"9557","run079","RRG","GGG",2,2,4
"9558","run079","RRG","GRG",1,0,1
"9559","run079","RRG","GRR",3,3,6
"9560","run079","RRG","RBB",1,0,1
"9561","run079","RRR","BBR",1,0,1
"9562","run079","RRR","BGB",2,0,2
"9563","run079","RRR","BGG",1,0,1
"9564","run079","RRR","BRB",1,0,1
"9565","run079","RRR","BRR",1,1,2
"9566","run079","RRR","RBB",1,1,2
"9567","run079","RRR","RGR",1,0,1
"9568","run079","RRR","RRG",2,0,2
"9569","run079","BBG","BGG",0,1,1
"9570","run079","BBG","GRR",0,1,1
"9571","run079","BBG","RBG",0,1,1
"9572","run079","BBG","RRR",0,3,3
"9573","run079","BGB","BBB",0,1,1
"9574","run079","BGG","BBR",0,1,1
"9575","run079","BRB","BBB",0,2,2
"9576","run079","BRR","BBB",0,3,3
"9577","run079","BRR","RBB",0,1,1
"9578","run079","GBB","GGB",0,5,5
"9579","run079","GBB","GRR",0,1,1
"9580","run079","GBG","BBB",0,1,1
"9581","run079","GGB","BGG",0,1,1
"9582","run079","GGB","GGR",0,3,3
"9583","run079","GGB","RBB",0,1,1
"9584","run079","GGB","RBR",0,1,1
"9585","run079","GGG","RBG",0,1,1
"9586","run079","GGG","RBR",0,6,6
"9587","run079","GGG","RRR",0,1,1
"9588","run079","GGR","BBB",0,2,2
"9589","run079","GGR","BBR",0,1,1
"9590","run079","GGR","BGG",0,1,1
"9591","run079","GGR","RBB",0,1,1
"9592","run079","GRG","BRB",0,1,1
"9593","run079","GRG","GGR",0,2,2
"9594","run079","GRR","BGG",0,1,1
"9595","run079","GRR","BRR",0,1,1
"9596","run079","RBB","BBB",0,1,1
"9597","run079","RBG","GBB",0,1,1
"9598","run079","RBG","GRR",0,1,1
"9599","run079","RBR","BBB",0,4,4
"9600","run079","RBR","GGB",0,1,1
"9601","run079","RBR","RBB",0,1,1
"9602","run079","RGG","BBB",0,2,2
"9603","run079","RGG","GGR",0,1,1
"9604","run079","RGR","GGG",0,1,1
"9605","run079","RGR","RRG",0,1,1
"9606","run079","RRG","BBR",0,1,1
"9607","run079","RRG","GGR",0,1,1
"9608","run080","BBB","GGG",1,0,1
"9609","run080","BBB","RRG",1,2,3
"9610","run080","BBG","BBB",1,1,2
"9611","run080","BBG","BRB",1,5,6
"9612","run080","BBG","GBG",2,0,2
"9613","run080","BBG","GGB",2,5,7
"9614","run080","BBG","GGG",4,4,8
"9615","run080","BBG","GRG",1,2,3
"9616","run080","BBG","RRG",1,0,1
"9617","run080","BGG","RBG",1,0,1
"9618","run080","BGG","RRR",1,0,1
"9619","run080","BRR","BGB",1,0,1
"9620","run080","GBB","BBB",12,6,18
"9621","run080","GBB","BRB",1,0,1
"9622","run080","GBB","BRR",1,0,1
"9623","run080","GBB","GGG",7,12,19
"9624","run080","GBB","GGR",1,1,2
"9625","run080","GBB","RBG",3,1,4
"9626","run080","GBB","RBR",1,0,1
"9627","run080","GBB","RGG",1,0,1
"9628","run080","GBB","RGR",2,1,3
"9629","run080","GBB","RRR",1,3,4
"9630","run080","GBG","BRB",1,1,2
"9631","run080","GBG","BRR",1,0,1
"9632","run080","GBG","GGG",4,1,5
"9633","run080","GBG","RBB",1,0,1
"9634","run080","GBG","RGR",1,0,1
"9635","run080","GBG","RRG",1,1,2
"9636","run080","GGB","BBB",3,4,7
"9637","run080","GGB","BBR",1,0,1
"9638","run080","GGB","BRR",1,1,2
"9639","run080","GGB","GBG",1,0,1
"9640","run080","GGB","GGG",13,10,23
"9641","run080","GGB","RGG",1,1,2
"9642","run080","GGB","RRG",1,0,1
"9643","run080","GGB","RRR",1,1,2
"9644","run080","GGG","BBB",8,5,13
"9645","run080","GGG","BGG",1,2,3
"9646","run080","GGG","BRB",1,0,1
"9647","run080","GGG","GGB",5,1,6
"9648","run080","GGG","GGR",1,2,3
"9649","run080","GGG","RBB",1,1,2
"9650","run080","GGG","RGR",1,3,4
"9651","run080","GGG","RRG",1,3,4
"9652","run080","GGR","BRR",1,0,1
"9653","run080","GGR","GRR",1,0,1
"9654","run080","GRG","BBB",3,2,5
"9655","run080","GRG","GGB",2,0,2
"9656","run080","GRG","GGG",3,0,3
"9657","run080","GRG","RGR",1,0,1
"9658","run080","GRG","RRG",2,0,2
"9659","run080","GRR","BGB",1,0,1
"9660","run080","RBG","BBB",2,0,2
"9661","run080","RBG","RBB",1,0,1
"9662","run080","RBR","BGB",2,1,3
"9663","run080","RBR","BRB",1,0,1
"9664","run080","RBR","BRR",1,0,1
"9665","run080","RBR","GRR",4,1,5
"9666","run080","RBR","RGG",2,0,2
"9667","run080","RBR","RGR",1,0,1
"9668","run080","RGG","BBR",1,0,1
"9669","run080","RGR","BBB",2,0,2
"9670","run080","RGR","BBR",1,0,1
"9671","run080","RGR","BGB",2,1,3
"9672","run080","RGR","BGG",2,0,2
"9673","run080","RGR","BRR",1,0,1
"9674","run080","RGR","GGB",2,1,3
"9675","run080","RGR","RGG",1,0,1
"9676","run080","RRG","BBB",2,8,10
"9677","run080","RRG","BGB",1,1,2
"9678","run080","RRG","BRB",2,2,4
"9679","run080","RRG","BRR",1,5,6
"9680","run080","RRG","GGG",2,4,6
"9681","run080","RRG","GRG",1,0,1
"9682","run080","RRG","GRR",3,1,4
"9683","run080","RRG","RBB",1,1,2
"9684","run080","RRR","BBR",1,0,1
"9685","run080","RRR","BGB",2,1,3
"9686","run080","RRR","BGG",1,0,1
"9687","run080","RRR","BRB",1,0,1
"9688","run080","RRR","BRR",1,0,1
"9689","run080","RRR","RBB",1,0,1
"9690","run080","RRR","RGR",1,1,2
"9691","run080","RRR","RRG",2,0,2
"9692","run080","BBB","RRR",0,1,1
"9693","run080","BBG","BGB",0,1,1
"9694","run080","BBG","GBB",0,1,1
"9695","run080","BGB","BBB",0,1,1
"9696","run080","BRB","BBB",0,2,2
"9697","run080","BRB","BRR",0,1,1
"9698","run080","BRR","BBB",0,2,2
"9699","run080","GBB","GGB",0,3,3
"9700","run080","GBB","GRG",0,1,1
"9701","run080","GBB","GRR",0,1,1
"9702","run080","GBG","BBB",0,1,1
"9703","run080","GGB","BGG",0,1,1
"9704","run080","GGB","GGR",0,3,3
"9705","run080","GGB","RBB",0,1,1
"9706","run080","GGB","RBR",0,1,1
"9707","run080","GGG","BGB",0,1,1
"9708","run080","GGG","GRR",0,1,1
"9709","run080","GGG","RBR",0,5,5
"9710","run080","GRR","BGG",0,2,2
"9711","run080","GRR","BRB",0,1,1
"9712","run080","RBG","BBG",0,1,1
"9713","run080","RBG","BRR",0,1,1
"9714","run080","RBG","GRR",0,1,1
"9715","run080","RBR","BBB",0,2,2
"9716","run080","RBR","BGG",0,2,2
"9717","run080","RBR","GGB",0,2,2
"9718","run080","RGG","BBB",0,2,2
"9719","run080","RGG","BGB",0,1,1
"9720","run080","RGG","GRR",0,1,1
"9721","run080","RGR","GGR",0,1,1
"9722","run080","RGR","RBB",0,1,1
"9723","run080","RGR","RRG",0,1,1
"9724","run080","RRG","BBR",0,1,1
"9725","run080","RRG","GGR",0,1,1
"9726","run080","RRG","RGG",0,1,1
"9727","run081","BBB","GGG",1,1,2
"9728","run081","BBB","RRG",1,0,1
"9729","run081","BBG","BBB",1,0,1
"9730","run081","BBG","BRB",1,2,3
"9731","run081","BBG","GBG",2,0,2
"9732","run081","BBG","GGB",2,4,6
"9733","run081","BBG","GGG",4,3,7
"9734","run081","BBG","GRG",1,2,3
"9735","run081","BBG","RRG",1,0,1
"9736","run081","BGG","RBG",1,0,1
"9737","run081","BGG","RRR",1,0,1
"9738","run081","BRR","BGB",1,0,1
"9739","run081","GBB","BBB",12,10,22
"9740","run081","GBB","BRB",1,1,2
"9741","run081","GBB","BRR",1,0,1
"9742","run081","GBB","GGG",7,11,18
"9743","run081","GBB","GGR",1,0,1
"9744","run081","GBB","RBG",3,2,5
"9745","run081","GBB","RBR",1,0,1
"9746","run081","GBB","RGG",1,0,1
"9747","run081","GBB","RGR",2,1,3
"9748","run081","GBB","RRR",1,1,2
"9749","run081","GBG","BRB",1,0,1
"9750","run081","GBG","BRR",1,0,1
"9751","run081","GBG","GGG",4,2,6
"9752","run081","GBG","RBB",1,0,1
"9753","run081","GBG","RGR",1,0,1
"9754","run081","GBG","RRG",1,1,2
"9755","run081","GGB","BBB",3,2,5
"9756","run081","GGB","BBR",1,0,1
"9757","run081","GGB","BRR",1,2,3
"9758","run081","GGB","GBG",1,0,1
"9759","run081","GGB","GGG",13,8,21
"9760","run081","GGB","RGG",1,1,2
"9761","run081","GGB","RRG",1,1,2
"9762","run081","GGB","RRR",1,0,1
"9763","run081","GGG","BBB",8,5,13
"9764","run081","GGG","BGG",1,0,1
"9765","run081","GGG","BRB",1,3,4
"9766","run081","GGG","GGB",5,1,6
"9767","run081","GGG","GGR",1,0,1
"9768","run081","GGG","RBB",1,2,3
"9769","run081","GGG","RGR",1,2,3
"9770","run081","GGG","RRG",1,6,7
"9771","run081","GGR","BRR",1,0,1
"9772","run081","GGR","GRR",1,0,1
"9773","run081","GRG","BBB",3,2,5
"9774","run081","GRG","GGB",2,3,5
"9775","run081","GRG","GGG",3,2,5
"9776","run081","GRG","RGR",1,1,2
"9777","run081","GRG","RRG",2,1,3
"9778","run081","GRR","BGB",1,0,1
"9779","run081","RBG","BBB",2,1,3
"9780","run081","RBG","RBB",1,0,1
"9781","run081","RBR","BGB",2,1,3
"9782","run081","RBR","BRB",1,0,1
"9783","run081","RBR","BRR",1,1,2
"9784","run081","RBR","GRR",4,2,6
"9785","run081","RBR","RGG",2,1,3
"9786","run081","RBR","RGR",1,0,1
"9787","run081","RGG","BBR",1,0,1
"9788","run081","RGR","BBB",2,1,3
"9789","run081","RGR","BBR",1,0,1
"9790","run081","RGR","BGB",2,2,4
"9791","run081","RGR","BGG",2,1,3
"9792","run081","RGR","BRR",1,2,3
"9793","run081","RGR","GGB",2,0,2
"9794","run081","RGR","RGG",1,0,1
"9795","run081","RRG","BBB",2,4,6
"9796","run081","RRG","BGB",1,1,2
"9797","run081","RRG","BRB",2,12,14
"9798","run081","RRG","BRR",1,0,1
"9799","run081","RRG","GGG",2,1,3
"9800","run081","RRG","GRG",1,0,1
"9801","run081","RRG","GRR",3,2,5
"9802","run081","RRG","RBB",1,0,1
"9803","run081","RRR","BBR",1,0,1
"9804","run081","RRR","BGB",2,0,2
"9805","run081","RRR","BGG",1,0,1
"9806","run081","RRR","BRB",1,0,1
"9807","run081","RRR","BRR",1,0,1
"9808","run081","RRR","RBB",1,0,1
"9809","run081","RRR","RGR",1,0,1
"9810","run081","RRR","RRG",2,0,2
"9811","run081","BBB","BRB",0,1,1
"9812","run081","BBB","RRR",0,1,1
"9813","run081","BGG","BBR",0,1,1
"9814","run081","BGG","RGG",0,1,1
"9815","run081","BGG","RGR",0,1,1
"9816","run081","BRB","BBB",0,1,1
"9817","run081","BRB","BBR",0,1,1
"9818","run081","BRR","BBB",0,1,1
"9819","run081","GBB","GGB",0,1,1
"9820","run081","GBB","RBB",0,1,1
"9821","run081","GBG","GGB",0,1,1
"9822","run081","GBG","RGG",0,1,1
"9823","run081","GGB","BGB",0,1,1
"9824","run081","GGB","GGR",0,2,2
"9825","run081","GGB","RBG",0,1,1
"9826","run081","GGB","RBR",0,1,1
"9827","run081","GGG","BRR",0,2,2
"9828","run081","GGG","GRR",0,1,1
"9829","run081","GGG","RBR",0,2,2
"9830","run081","GGG","RGG",0,1,1
"9831","run081","GRG","BGG",0,1,1
"9832","run081","GRG","BRB",0,2,2
"9833","run081","GRG","GGR",0,1,1
"9834","run081","GRR","BRB",0,1,1
"9835","run081","GRR","GGR",0,1,1
"9836","run081","RBB","BBB",0,1,1
"9837","run081","RBB","BBR",0,1,1
"9838","run081","RBR","BBB",0,1,1
"9839","run081","RBR","BBR",0,1,1
"9840","run081","RBR","BGG",0,1,1
"9841","run081","RBR","GGB",0,1,1
"9842","run081","RBR","RBB",0,1,1
"9843","run081","RGG","BBB",0,2,2
"9844","run081","RGG","GRR",0,2,2
"9845","run081","RGR","GGR",0,1,1
"9846","run081","RGR","RBB",0,2,2
"9847","run081","RRG","GGR",0,1,1
"9848","run081","RRG","RGR",0,1,1
"9849","run082","BBB","GGG",1,0,1
"9850","run082","BBB","RRG",1,0,1
"9851","run082","BBG","BBB",1,0,1
"9852","run082","BBG","BRB",1,6,7
"9853","run082","BBG","GBG",2,3,5
"9854","run082","BBG","GGB",2,6,8
"9855","run082","BBG","GGG",4,5,9
"9856","run082","BBG","GRG",1,0,1
"9857","run082","BBG","RRG",1,0,1
"9858","run082","BGG","RBG",1,0,1
"9859","run082","BGG","RRR",1,0,1
"9860","run082","BRR","BGB",1,0,1
"9861","run082","GBB","BBB",12,5,17
"9862","run082","GBB","BRB",1,1,2
"9863","run082","GBB","BRR",1,1,2
"9864","run082","GBB","GGG",7,18,25
"9865","run082","GBB","GGR",1,0,1
"9866","run082","GBB","RBG",3,2,5
"9867","run082","GBB","RBR",1,0,1
"9868","run082","GBB","RGG",1,0,1
"9869","run082","GBB","RGR",2,0,2
"9870","run082","GBB","RRR",1,2,3
"9871","run082","GBG","BRB",1,1,2
"9872","run082","GBG","BRR",1,0,1
"9873","run082","GBG","GGG",4,6,10
"9874","run082","GBG","RBB",1,0,1
"9875","run082","GBG","RGR",1,0,1
"9876","run082","GBG","RRG",1,1,2
"9877","run082","GGB","BBB",3,4,7
"9878","run082","GGB","BBR",1,0,1
"9879","run082","GGB","BRR",1,2,3
"9880","run082","GGB","GBG",1,0,1
"9881","run082","GGB","GGG",13,9,22
"9882","run082","GGB","RGG",1,0,1
"9883","run082","GGB","RRG",1,0,1
"9884","run082","GGB","RRR",1,0,1
"9885","run082","GGG","BBB",8,3,11
"9886","run082","GGG","BGG",1,2,3
"9887","run082","GGG","BRB",1,0,1
"9888","run082","GGG","GGB",5,0,5
"9889","run082","GGG","GGR",1,0,1
"9890","run082","GGG","RBB",1,1,2
"9891","run082","GGG","RGR",1,0,1
"9892","run082","GGG","RRG",1,2,3
"9893","run082","GGR","BRR",1,0,1
"9894","run082","GGR","GRR",1,0,1
"9895","run082","GRG","BBB",3,0,3
"9896","run082","GRG","GGB",2,3,5
"9897","run082","GRG","GGG",3,1,4
"9898","run082","GRG","RGR",1,0,1
"9899","run082","GRG","RRG",2,0,2
"9900","run082","GRR","BGB",1,0,1
"9901","run082","RBG","BBB",2,0,2
"9902","run082","RBG","RBB",1,0,1
"9903","run082","RBR","BGB",2,1,3
"9904","run082","RBR","BRB",1,0,1
"9905","run082","RBR","BRR",1,1,2
"9906","run082","RBR","GRR",4,1,5
"9907","run082","RBR","RGG",2,1,3
"9908","run082","RBR","RGR",1,0,1
"9909","run082","RGG","BBR",1,0,1
"9910","run082","RGR","BBB",2,1,3
"9911","run082","RGR","BBR",1,1,2
"9912","run082","RGR","BGB",2,1,3
"9913","run082","RGR","BGG",2,0,2
"9914","run082","RGR","BRR",1,0,1
"9915","run082","RGR","GGB",2,0,2
"9916","run082","RGR","RGG",1,0,1
"9917","run082","RRG","BBB",2,6,8
"9918","run082","RRG","BGB",1,0,1
"9919","run082","RRG","BRB",2,6,8
"9920","run082","RRG","BRR",1,1,2
"9921","run082","RRG","GGG",2,1,3
"9922","run082","RRG","GRG",1,0,1
"9923","run082","RRG","GRR",3,0,3
"9924","run082","RRG","RBB",1,0,1
"9925","run082","RRR","BBR",1,0,1
"9926","run082","RRR","BGB",2,0,2
"9927","run082","RRR","BGG",1,0,1
"9928","run082","RRR","BRB",1,0,1
"9929","run082","RRR","BRR",1,1,2
"9930","run082","RRR","RBB",1,0,1
"9931","run082","RRR","RGR",1,0,1
"9932","run082","RRR","RRG",2,0,2
"9933","run082","BBB","GRR",0,1,1
"9934","run082","BBG","BGB",0,1,1
"9935","run082","BGG","RGG",0,1,1
"9936","run082","BRB","BBB",0,1,1
"9937","run082","BRB","BRR",0,1,1
"9938","run082","BRB","GGR",0,1,1
"9939","run082","BRB","RBB",0,1,1
"9940","run082","BRR","BBB",0,1,1
"9941","run082","BRR","BRB",0,1,1
"9942","run082","BRR","RBB",0,1,1
"9943","run082","GBB","GGB",0,4,4
"9944","run082","GBB","RRG",0,1,1
"9945","run082","GBG","BBB",0,1,1
"9946","run082","GBG","BBR",0,1,1
"9947","run082","GBG","GGB",0,1,1
"9948","run082","GGB","GBB",0,1,1
"9949","run082","GGB","RBB",0,1,1
"9950","run082","GGB","RBG",0,2,2
"9951","run082","GGB","RGR",0,1,1
"9952","run082","GGG","RBG",0,1,1
"9953","run082","GGG","RBR",0,2,2
"9954","run082","GGG","RGG",0,2,2
"9955","run082","GGG","RRR",0,1,1
"9956","run082","GGR","BGG",0,1,1
"9957","run082","GRG","BRB",0,1,1
"9958","run082","GRG","BRR",0,1,1
"9959","run082","GRG","GBG",0,1,1
"9960","run082","GRG","GGR",0,3,3
"9961","run082","GRR","BBR",0,1,1
"9962","run082","GRR","BGG",0,1,1
"9963","run082","GRR","BRR",0,1,1
"9964","run082","RBR","BBB",0,2,2
"9965","run082","RBR","GGB",0,3,3
"9966","run082","RBR","RRR",0,1,1
"9967","run082","RGG","BRR",0,1,1
"9968","run082","RGG","RBB",0,1,1
"9969","run082","RGR","GGR",0,2,2
"9970","run082","RGR","RRG",0,2,2
"9971","run082","RRG","BBR",0,2,2
"9972","run082","RRR","RBR",0,1,1
"9973","run083","BBB","GGG",1,1,2
"9974","run083","BBB","RRG",1,0,1
"9975","run083","BBG","BBB",1,1,2
"9976","run083","BBG","BRB",1,4,5
"9977","run083","BBG","GBG",2,2,4
"9978","run083","BBG","GGB",2,2,4
"9979","run083","BBG","GGG",4,9,13
"9980","run083","BBG","GRG",1,1,2
"9981","run083","BBG","RRG",1,0,1
"9982","run083","BGG","RBG",1,1,2
"9983","run083","BGG","RRR",1,0,1
"9984","run083","BRR","BGB",1,0,1
"9985","run083","GBB","BBB",12,5,17
"9986","run083","GBB","BRB",1,1,2
"9987","run083","GBB","BRR",1,0,1
"9988","run083","GBB","GGG",7,14,21
"9989","run083","GBB","GGR",1,1,2
"9990","run083","GBB","RBG",3,1,4
"9991","run083","GBB","RBR",1,0,1
"9992","run083","GBB","RGG",1,0,1
"9993","run083","GBB","RGR",2,0,2
"9994","run083","GBB","RRR",1,0,1
"9995","run083","GBG","BRB",1,0,1
"9996","run083","GBG","BRR",1,0,1
"9997","run083","GBG","GGG",4,1,5
"9998","run083","GBG","RBB",1,0,1
"9999","run083","GBG","RGR",1,0,1
"10000","run083","GBG","RRG",1,2,3
"10001","run083","GGB","BBB",3,2,5
"10002","run083","GGB","BBR",1,0,1
"10003","run083","GGB","BRR",1,0,1
"10004","run083","GGB","GBG",1,0,1
"10005","run083","GGB","GGG",13,9,22
"10006","run083","GGB","RGG",1,1,2
"10007","run083","GGB","RRG",1,0,1
"10008","run083","GGB","RRR",1,1,2
"10009","run083","GGG","BBB",8,5,13
"10010","run083","GGG","BGG",1,1,2
"10011","run083","GGG","BRB",1,0,1
"10012","run083","GGG","GGB",5,1,6
"10013","run083","GGG","GGR",1,1,2
"10014","run083","GGG","RBB",1,1,2
"10015","run083","GGG","RGR",1,1,2
"10016","run083","GGG","RRG",1,3,4
"10017","run083","GGR","BRR",1,0,1
"10018","run083","GGR","GRR",1,0,1
"10019","run083","GRG","BBB",3,1,4
"10020","run083","GRG","GGB",2,2,4
"10021","run083","GRG","GGG",3,2,5
"10022","run083","GRG","RGR",1,0,1
"10023","run083","GRG","RRG",2,2,4
"10024","run083","GRR","BGB",1,1,2
"10025","run083","RBG","BBB",2,0,2
"10026","run083","RBG","RBB",1,0,1
"10027","run083","RBR","BGB",2,0,2
"10028","run083","RBR","BRB",1,0,1
"10029","run083","RBR","BRR",1,1,2
"10030","run083","RBR","GRR",4,0,4
"10031","run083","RBR","RGG",2,2,4
"10032","run083","RBR","RGR",1,0,1
"10033","run083","RGG","BBR",1,1,2
"10034","run083","RGR","BBB",2,2,4
"10035","run083","RGR","BBR",1,0,1
"10036","run083","RGR","BGB",2,1,3
"10037","run083","RGR","BGG",2,1,3
"10038","run083","RGR","BRR",1,1,2
"10039","run083","RGR","GGB",2,3,5
"10040","run083","RGR","RGG",1,1,2
"10041","run083","RRG","BBB",2,3,5
"10042","run083","RRG","BGB",1,1,2
"10043","run083","RRG","BRB",2,7,9
"10044","run083","RRG","BRR",1,2,3
"10045","run083","RRG","GGG",2,1,3
"10046","run083","RRG","GRG",1,0,1
"10047","run083","RRG","GRR",3,0,3
"10048","run083","RRG","RBB",1,0,1
"10049","run083","RRR","BBR",1,0,1
"10050","run083","RRR","BGB",2,0,2
"10051","run083","RRR","BGG",1,0,1
"10052","run083","RRR","BRB",1,0,1
"10053","run083","RRR","BRR",1,0,1
"10054","run083","RRR","RBB",1,0,1
"10055","run083","RRR","RGR",1,0,1
"10056","run083","RRR","RRG",2,0,2
"10057","run083","BBG","RBR",0,1,1
"10058","run083","BGG","GRG",0,1,1
"10059","run083","BRB","BBB",0,1,1
"10060","run083","BRB","BBR",0,1,1
"10061","run083","BRB","BRR",0,1,1
"10062","run083","BRR","BBB",0,2,2
"10063","run083","BRR","BRB",0,1,1
"10064","run083","GBB","GGB",0,3,3
"10065","run083","GBG","RGG",0,1,1
"10066","run083","GGB","BGG",0,1,1
"10067","run083","GGB","GBB",0,1,1
"10068","run083","GGB","RBB",0,1,1
"10069","run083","GGG","BGB",0,1,1
"10070","run083","GGG","BRR",0,1,1
"10071","run083","GGG","RBG",0,1,1
"10072","run083","GGG","RBR",0,4,4
"10073","run083","GGG","RGG",0,1,1
"10074","run083","GGG","RRR",0,1,1
"10075","run083","GGR","BBB",0,1,1
"10076","run083","GGR","RBB",0,1,1
"10077","run083","GRG","BBR",0,1,1
"10078","run083","GRG","GRR",0,1,1
"10079","run083","GRR","GGG",0,1,1
"10080","run083","RBG","GBB",0,1,1
"10081","run083","RBG","GRR",0,1,1
"10082","run083","RBG","RBR",0,1,1
"10083","run083","RBR","BBB",0,3,3
"10084","run083","RBR","BBR",0,1,1
"10085","run083","RBR","GGB",0,4,4
"10086","run083","RGG","BRR",0,1,1
"10087","run083","RGG","GGR",0,1,1
"10088","run083","RGG","GRR",0,1,1
"10089","run083","RGR","RBB",0,1,1
"10090","run083","RRG","BBR",0,1,1
"10091","run083","RRG","BGG",0,1,1
"10092","run083","RRG","GGR",0,4,4
"10093","run083","RRG","RGR",0,1,1
"10094","run083","RRR","GGR",0,1,1
"10095","run083","RRR","GRR",0,1,1
"10096","run084","BBB","GGG",1,0,1
"10097","run084","BBB","RRG",1,1,2
"10098","run084","BBG","BBB",1,0,1
"10099","run084","BBG","BRB",1,1,2
"10100","run084","BBG","GBG",2,3,5
"10101","run084","BBG","GGB",2,3,5
"10102","run084","BBG","GGG",4,6,10
"10103","run084","BBG","GRG",1,1,2
"10104","run084","BBG","RRG",1,0,1
"10105","run084","BGG","RBG",1,0,1
"10106","run084","BGG","RRR",1,0,1
"10107","run084","BRR","BGB",1,0,1
"10108","run084","GBB","BBB",12,7,19
"10109","run084","GBB","BRB",1,1,2
"10110","run084","GBB","BRR",1,0,1
"10111","run084","GBB","GGG",7,10,17
"10112","run084","GBB","GGR",1,1,2
"10113","run084","GBB","RBG",3,1,4
"10114","run084","GBB","RBR",1,0,1
"10115","run084","GBB","RGG",1,0,1
"10116","run084","GBB","RGR",2,0,2
"10117","run084","GBB","RRR",1,0,1
"10118","run084","GBG","BRB",1,2,3
"10119","run084","GBG","BRR",1,0,1
"10120","run084","GBG","GGG",4,0,4
"10121","run084","GBG","RBB",1,0,1
"10122","run084","GBG","RGR",1,0,1
"10123","run084","GBG","RRG",1,0,1
"10124","run084","GGB","BBB",3,2,5
"10125","run084","GGB","BBR",1,0,1
"10126","run084","GGB","BRR",1,2,3
"10127","run084","GGB","GBG",1,0,1
"10128","run084","GGB","GGG",13,5,18
"10129","run084","GGB","RGG",1,1,2
"10130","run084","GGB","RRG",1,0,1
"10131","run084","GGB","RRR",1,1,2
"10132","run084","GGG","BBB",8,5,13
"10133","run084","GGG","BGG",1,0,1
"10134","run084","GGG","BRB",1,1,2
"10135","run084","GGG","GGB",5,1,6
"10136","run084","GGG","GGR",1,2,3
"10137","run084","GGG","RBB",1,1,2
"10138","run084","GGG","RGR",1,2,3
"10139","run084","GGG","RRG",1,3,4
"10140","run084","GGR","BRR",1,0,1
"10141","run084","GGR","GRR",1,0,1
"10142","run084","GRG","BBB",3,1,4
"10143","run084","GRG","GGB",2,4,6
"10144","run084","GRG","GGG",3,2,5
"10145","run084","GRG","RGR",1,1,2
"10146","run084","GRG","RRG",2,1,3
"10147","run084","GRR","BGB",1,0,1
"10148","run084","RBG","BBB",2,1,3
"10149","run084","RBG","RBB",1,0,1
"10150","run084","RBR","BGB",2,1,3
"10151","run084","RBR","BRB",1,0,1
"10152","run084","RBR","BRR",1,0,1
"10153","run084","RBR","GRR",4,1,5
"10154","run084","RBR","RGG",2,3,5
"10155","run084","RBR","RGR",1,0,1
"10156","run084","RGG","BBR",1,0,1
"10157","run084","RGR","BBB",2,1,3
"10158","run084","RGR","BBR",1,0,1
"10159","run084","RGR","BGB",2,0,2
"10160","run084","RGR","BGG",2,0,2
"10161","run084","RGR","BRR",1,0,1
"10162","run084","RGR","GGB",2,2,4
"10163","run084","RGR","RGG",1,0,1
"10164","run084","RRG","BBB",2,2,4
"10165","run084","RRG","BGB",1,0,1
"10166","run084","RRG","BRB",2,6,8
"10167","run084","RRG","BRR",1,1,2
"10168","run084","RRG","GGG",2,3,5
"10169","run084","RRG","GRG",1,0,1
"10170","run084","RRG","GRR",3,2,5
"10171","run084","RRG","RBB",1,0,1
"10172","run084","RRR","BBR",1,0,1
"10173","run084","RRR","BGB",2,0,2
"10174","run084","RRR","BGG",1,0,1
"10175","run084","RRR","BRB",1,1,2
"10176","run084","RRR","BRR",1,0,1
"10177","run084","RRR","RBB",1,1,2
"10178","run084","RRR","RGR",1,0,1
"10179","run084","RRR","RRG",2,0,2
"10180","run084","BBG","BGB",0,1,1
"10181","run084","BBG","GBB",0,1,1
"10182","run084","BBG","RBR",0,1,1
"10183","run084","BGB","RRG",0,1,1
"10184","run084","BGG","BBB",0,1,1
"10185","run084","BGG","RGG",0,2,2
"10186","run084","BGG","RGR",0,1,1
"10187","run084","BRB","BBB",0,3,3
"10188","run084","BRB","BRR",0,1,1
"10189","run084","BRB","GGR",0,1,1
"10190","run084","BRB","RGR",0,1,1
"10191","run084","BRR","BBB",0,3,3
"10192","run084","BRR","RBB",0,1,1
"10193","run084","GBB","GGB",0,6,6
"10194","run084","GBB","GRG",0,2,2
"10195","run084","GBB","RRG",0,1,1
"10196","run084","GBG","BBR",0,1,1
"10197","run084","GBG","RGG",0,1,1
"10198","run084","GGB","BGB",0,2,2
"10199","run084","GGB","BGG",0,1,1
"10200","run084","GGB","BRB",0,1,1
"10201","run084","GGB","GGR",0,2,2
"10202","run084","GGB","RBB",0,2,2
"10203","run084","GGB","RBR",0,1,1
"10204","run084","GGB","RGR",0,1,1
"10205","run084","GGG","BRR",0,1,1
"10206","run084","GGG","RBG",0,2,2
"10207","run084","GGG","RBR",0,3,3
"10208","run084","GGG","RGG",0,1,1
"10209","run084","GRG","RBR",0,1,1
"10210","run084","GRR","BBB",0,1,1
"10211","run084","GRR","BRB",0,1,1
"10212","run084","RBG","GRR",0,1,1
"10213","run084","RBR","BBB",0,3,3
"10214","run084","RBR","GGB",0,4,4
"10215","run084","RGG","GGR",0,1,1
"10216","run084","RGR","GGG",0,1,1
"10217","run084","RGR","RBB",0,1,1
"10218","run084","RGR","RRG",0,1,1
"10219","run084","RRG","RGR",0,1,1
"10220","run084","RRR","RBR",0,1,1
"10221","run085","BBB","GGG",1,0,1
"10222","run085","BBB","RRG",1,0,1
"10223","run085","BBG","BBB",1,1,2
"10224","run085","BBG","BRB",1,1,2
"10225","run085","BBG","GBG",2,2,4
"10226","run085","BBG","GGB",2,5,7
"10227","run085","BBG","GGG",4,4,8
"10228","run085","BBG","GRG",1,2,3
"10229","run085","BBG","RRG",1,0,1
"10230","run085","BGG","RBG",1,0,1
"10231","run085","BGG","RRR",1,0,1
"10232","run085","BRR","BGB",1,0,1
"10233","run085","GBB","BBB",12,5,17
"10234","run085","GBB","BRB",1,1,2
"10235","run085","GBB","BRR",1,1,2
"10236","run085","GBB","GGG",7,12,19
"10237","run085","GBB","GGR",1,1,2
"10238","run085","GBB","RBG",3,0,3
"10239","run085","GBB","RBR",1,0,1
"10240","run085","GBB","RGG",1,0,1
"10241","run085","GBB","RGR",2,1,3
"10242","run085","GBB","RRR",1,3,4
"10243","run085","GBG","BRB",1,0,1
"10244","run085","GBG","BRR",1,0,1
"10245","run085","GBG","GGG",4,1,5
"10246","run085","GBG","RBB",1,0,1
"10247","run085","GBG","RGR",1,0,1
"10248","run085","GBG","RRG",1,0,1
"10249","run085","GGB","BBB",3,1,4
"10250","run085","GGB","BBR",1,1,2
"10251","run085","GGB","BRR",1,4,5
"10252","run085","GGB","GBG",1,0,1
"10253","run085","GGB","GGG",13,7,20
"10254","run085","GGB","RGG",1,1,2
"10255","run085","GGB","RRG",1,1,2
"10256","run085","GGB","RRR",1,0,1
"10257","run085","GGG","BBB",8,5,13
"10258","run085","GGG","BGG",1,2,3
"10259","run085","GGG","BRB",1,0,1
"10260","run085","GGG","GGB",5,0,5
"10261","run085","GGG","GGR",1,2,3
"10262","run085","GGG","RBB",1,1,2
"10263","run085","GGG","RGR",1,0,1
"10264","run085","GGG","RRG",1,3,4
"10265","run085","GGR","BRR",1,0,1
"10266","run085","GGR","GRR",1,0,1
"10267","run085","GRG","BBB",3,3,6
"10268","run085","GRG","GGB",2,2,4
"10269","run085","GRG","GGG",3,1,4
"10270","run085","GRG","RGR",1,1,2
"10271","run085","GRG","RRG",2,1,3
"10272","run085","GRR","BGB",1,1,2
"10273","run085","RBG","BBB",2,3,5
"10274","run085","RBG","RBB",1,0,1
"10275","run085","RBR","BGB",2,0,2
"10276","run085","RBR","BRB",1,0,1
"10277","run085","RBR","BRR",1,0,1
"10278","run085","RBR","GRR",4,1,5
"10279","run085","RBR","RGG",2,1,3
"10280","run085","RBR","RGR",1,0,1
"10281","run085","RGG","BBR",1,0,1
"10282","run085","RGR","BBB",2,0,2
"10283","run085","RGR","BBR",1,0,1
"10284","run085","RGR","BGB",2,1,3
"10285","run085","RGR","BGG",2,0,2
"10286","run085","RGR","BRR",1,0,1
"10287","run085","RGR","GGB",2,3,5
"10288","run085","RGR","RGG",1,0,1
"10289","run085","RRG","BBB",2,4,6
"10290","run085","RRG","BGB",1,5,6
"10291","run085","RRG","BRB",2,2,4
"10292","run085","RRG","BRR",1,5,6
"10293","run085","RRG","GGG",2,4,6
"10294","run085","RRG","GRG",1,0,1
"10295","run085","RRG","GRR",3,5,8
"10296","run085","RRG","RBB",1,0,1
"10297","run085","RRR","BBR",1,0,1
"10298","run085","RRR","BGB",2,0,2
"10299","run085","RRR","BGG",1,0,1
"10300","run085","RRR","BRB",1,0,1
"10301","run085","RRR","BRR",1,1,2
"10302","run085","RRR","RBB",1,0,1
"10303","run085","RRR","RGR",1,1,2
"10304","run085","RRR","RRG",2,0,2
"10305","run085","BBG","RRR",0,3,3
"10306","run085","BGG","BBB",0,1,1
"10307","run085","BRB","BBB",0,1,1
"10308","run085","BRB","RBB",0,1,1
"10309","run085","BRR","BBB",0,2,2
"10310","run085","BRR","BRB",0,1,1
"10311","run085","GBB","GBG",0,1,1
"10312","run085","GBB","GGB",0,1,1
"10313","run085","GBG","BBB",0,1,1
"10314","run085","GBG","GGB",0,1,1
"10315","run085","GBG","RGG",0,1,1
"10316","run085","GGB","RBG",0,1,1
"10317","run085","GGB","RBR",0,1,1
"10318","run085","GGG","BRR",0,1,1
"10319","run085","GGG","RBG",0,1,1
"10320","run085","GGG","RBR",0,6,6
"10321","run085","GGG","RRR",0,1,1
"10322","run085","GGR","BBB",0,1,1
"10323","run085","GRG","BRR",0,1,1
"10324","run085","GRG","GGR",0,2,2
"10325","run085","GRR","BRR",0,2,2
"10326","run085","GRR","GGR",0,1,1
"10327","run085","RBG","BBG",0,1,1
"10328","run085","RBG","GBB",0,1,1
"10329","run085","RBR","BBB",0,1,1
"10330","run085","RBR","GGB",0,2,2
"10331","run085","RGG","BBB",0,2,2
"10332","run085","RGG","BRR",0,1,1
"10333","run085","RGG","GRR",0,2,2
"10334","run085","RGR","GGR",0,1,1
"10335","run085","RGR","RBB",0,1,1
"10336","run085","RGR","RRG",0,1,1
"10337","run085","RRG","BGG",0,1,1
"10338","run085","RRG","RGG",0,1,1
"10339","run086","BBB","GGG",1,0,1
"10340","run086","BBB","RRG",1,0,1
"10341","run086","BBG","BBB",1,0,1
"10342","run086","BBG","BRB",1,6,7
"10343","run086","BBG","GBG",2,1,3
"10344","run086","BBG","GGB",2,0,2
"10345","run086","BBG","GGG",4,8,12
"10346","run086","BBG","GRG",1,0,1
"10347","run086","BBG","RRG",1,0,1
"10348","run086","BGG","RBG",1,0,1
"10349","run086","BGG","RRR",1,0,1
"10350","run086","BRR","BGB",1,0,1
"10351","run086","GBB","BBB",12,8,20
"10352","run086","GBB","BRB",1,1,2
"10353","run086","GBB","BRR",1,0,1
"10354","run086","GBB","GGG",7,16,23
"10355","run086","GBB","GGR",1,1,2
"10356","run086","GBB","RBG",3,2,5
"10357","run086","GBB","RBR",1,0,1
"10358","run086","GBB","RGG",1,0,1
"10359","run086","GBB","RGR",2,0,2
"10360","run086","GBB","RRR",1,2,3
"10361","run086","GBG","BRB",1,0,1
"10362","run086","GBG","BRR",1,0,1
"10363","run086","GBG","GGG",4,1,5
"10364","run086","GBG","RBB",1,0,1
"10365","run086","GBG","RGR",1,0,1
"10366","run086","GBG","RRG",1,0,1
"10367","run086","GGB","BBB",3,1,4
"10368","run086","GGB","BBR",1,0,1
"10369","run086","GGB","BRR",1,3,4
"10370","run086","GGB","GBG",1,0,1
"10371","run086","GGB","GGG",13,6,19
"10372","run086","GGB","RGG",1,0,1
"10373","run086","GGB","RRG",1,0,1
"10374","run086","GGB","RRR",1,1,2
"10375","run086","GGG","BBB",8,3,11
"10376","run086","GGG","BGG",1,0,1
"10377","run086","GGG","BRB",1,0,1
"10378","run086","GGG","GGB",5,0,5
"10379","run086","GGG","GGR",1,3,4
"10380","run086","GGG","RBB",1,2,3
"10381","run086","GGG","RGR",1,3,4
"10382","run086","GGG","RRG",1,3,4
"10383","run086","GGR","BRR",1,0,1
"10384","run086","GGR","GRR",1,0,1
"10385","run086","GRG","BBB",3,0,3
"10386","run086","GRG","GGB",2,1,3
"10387","run086","GRG","GGG",3,3,6
"10388","run086","GRG","RGR",1,0,1
"10389","run086","GRG","RRG",2,0,2
"10390","run086","GRR","BGB",1,1,2
"10391","run086","RBG","BBB",2,1,3
"10392","run086","RBG","RBB",1,0,1
"10393","run086","RBR","BGB",2,0,2
"10394","run086","RBR","BRB",1,0,1
"10395","run086","RBR","BRR",1,0,1
"10396","run086","RBR","GRR",4,1,5
"10397","run086","RBR","RGG",2,1,3
"10398","run086","RBR","RGR",1,0,1
"10399","run086","RGG","BBR",1,1,2
"10400","run086","RGR","BBB",2,2,4
"10401","run086","RGR","BBR",1,0,1
"10402","run086","RGR","BGB",2,1,3
"10403","run086","RGR","BGG",2,0,2
"10404","run086","RGR","BRR",1,1,2
"10405","run086","RGR","GGB",2,2,4
"10406","run086","RGR","RGG",1,0,1
"10407","run086","RRG","BBB",2,7,9
"10408","run086","RRG","BGB",1,0,1
"10409","run086","RRG","BRB",2,5,7
"10410","run086","RRG","BRR",1,4,5
"10411","run086","RRG","GGG",2,5,7
"10412","run086","RRG","GRG",1,0,1
"10413","run086","RRG","GRR",3,1,4
"10414","run086","RRG","RBB",1,0,1
"10415","run086","RRR","BBR",1,0,1
"10416","run086","RRR","BGB",2,0,2
"10417","run086","RRR","BGG",1,0,1
"10418","run086","RRR","BRB",1,0,1
"10419","run086","RRR","BRR",1,0,1
"10420","run086","RRR","RBB",1,0,1
"10421","run086","RRR","RGR",1,0,1
"10422","run086","RRR","RRG",2,1,3
"10423","run086","BBB","RRR",0,1,1
"10424","run086","BBG","RBG",0,1,1
"10425","run086","BBG","RRR",0,2,2
"10426","run086","BGB","BBB",0,1,1
"10427","run086","BGG","RGG",0,1,1
"10428","run086","BRB","GGG",0,1,1
"10429","run086","BRR","BBB",0,2,2
"10430","run086","GBB","GGB",0,6,6
"10431","run086","GBB","GRG",0,1,1
"10432","run086","GBG","GGB",0,1,1
"10433","run086","GGB","BGG",0,1,1
"10434","run086","GGB","GBB",0,1,1
"10435","run086","GGB","GGR",0,2,2
"10436","run086","GGB","RBB",0,1,1
"10437","run086","GGB","RBG",0,1,1
"10438","run086","GGG","RBG",0,2,2
"10439","run086","GGG","RBR",0,2,2
"10440","run086","GGR","BBB",0,1,1
"10441","run086","GGR","BGG",0,1,1
"10442","run086","GRG","BRB",0,1,1
"10443","run086","GRG","GBG",0,1,1
"10444","run086","GRR","GGR",0,1,1
"10445","run086","RBG","BRR",0,1,1
"10446","run086","RBG","GRR",0,1,1
"10447","run086","RBG","RGR",0,1,1
"10448","run086","RBR","BBB",0,1,1
"10449","run086","RBR","BGG",0,1,1
"10450","run086","RBR","GGB",0,3,3
"10451","run086","RGG","BBB",0,2,2
"10452","run086","RGG","BRR",0,1,1
"10453","run086","RGG","RBB",0,1,1
"10454","run086","RGR","GGG",0,1,1
"10455","run086","RGR","GGR",0,1,1
"10456","run086","RGR","RRG",0,1,1
"10457","run086","RRG","GGR",0,2,2
"10458","run086","RRG","RGG",0,1,1
"10459","run086","RRR","RBR",0,1,1
"10460","run087","BBB","GGG",1,1,2
"10461","run087","BBB","RRG",1,1,2
"10462","run087","BBG","BBB",1,0,1
"10463","run087","BBG","BRB",1,2,3
"10464","run087","BBG","GBG",2,1,3
"10465","run087","BBG","GGB",2,8,10
"10466","run087","BBG","GGG",4,8,12
"10467","run087","BBG","GRG",1,4,5
"10468","run087","BBG","RRG",1,1,2
"10469","run087","BGG","RBG",1,0,1
"10470","run087","BGG","RRR",1,0,1
"10471","run087","BRR","BGB",1,1,2
"10472","run087","GBB","BBB",12,8,20
"10473","run087","GBB","BRB",1,1,2
"10474","run087","GBB","BRR",1,0,1
"10475","run087","GBB","GGG",7,11,18
"10476","run087","GBB","GGR",1,0,1
"10477","run087","GBB","RBG",3,1,4
"10478","run087","GBB","RBR",1,0,1
"10479","run087","GBB","RGG",1,0,1
"10480","run087","GBB","RGR",2,0,2
"10481","run087","GBB","RRR",1,1,2
"10482","run087","GBG","BRB",1,1,2
"10483","run087","GBG","BRR",1,0,1
"10484","run087","GBG","GGG",4,2,6
"10485","run087","GBG","RBB",1,0,1
"10486","run087","GBG","RGR",1,1,2
"10487","run087","GBG","RRG",1,0,1
"10488","run087","GGB","BBB",3,1,4
"10489","run087","GGB","BBR",1,1,2
"10490","run087","GGB","BRR",1,2,3
"10491","run087","GGB","GBG",1,0,1
"10492","run087","GGB","GGG",13,12,25
"10493","run087","GGB","RGG",1,1,2
"10494","run087","GGB","RRG",1,0,1
"10495","run087","GGB","RRR",1,1,2
"10496","run087","GGG","BBB",8,3,11
"10497","run087","GGG","BGG",1,2,3
"10498","run087","GGG","BRB",1,1,2
"10499","run087","GGG","GGB",5,0,5
"10500","run087","GGG","GGR",1,1,2
"10501","run087","GGG","RBB",1,1,2
"10502","run087","GGG","RGR",1,2,3
"10503","run087","GGG","RRG",1,2,3
"10504","run087","GGR","BRR",1,0,1
"10505","run087","GGR","GRR",1,0,1
"10506","run087","GRG","BBB",3,1,4
"10507","run087","GRG","GGB",2,0,2
"10508","run087","GRG","GGG",3,3,6
"10509","run087","GRG","RGR",1,0,1
"10510","run087","GRG","RRG",2,0,2
"10511","run087","GRR","BGB",1,0,1
"10512","run087","RBG","BBB",2,1,3
"10513","run087","RBG","RBB",1,0,1
"10514","run087","RBR","BGB",2,1,3
"10515","run087","RBR","BRB",1,0,1
"10516","run087","RBR","BRR",1,0,1
"10517","run087","RBR","GRR",4,0,4
"10518","run087","RBR","RGG",2,2,4
"10519","run087","RBR","RGR",1,0,1
"10520","run087","RGG","BBR",1,0,1
"10521","run087","RGR","BBB",2,0,2
"10522","run087","RGR","BBR",1,0,1
"10523","run087","RGR","BGB",2,0,2
"10524","run087","RGR","BGG",2,1,3
"10525","run087","RGR","BRR",1,1,2
"10526","run087","RGR","GGB",2,0,2
"10527","run087","RGR","RGG",1,0,1
"10528","run087","RRG","BBB",2,3,5
"10529","run087","RRG","BGB",1,2,3
"10530","run087","RRG","BRB",2,5,7
"10531","run087","RRG","BRR",1,5,6
"10532","run087","RRG","GGG",2,2,4
"10533","run087","RRG","GRG",1,0,1
"10534","run087","RRG","GRR",3,2,5
"10535","run087","RRG","RBB",1,0,1
"10536","run087","RRR","BBR",1,0,1
"10537","run087","RRR","BGB",2,1,3
"10538","run087","RRR","BGG",1,0,1
"10539","run087","RRR","BRB",1,0,1
"10540","run087","RRR","BRR",1,0,1
"10541","run087","RRR","RBB",1,1,2
"10542","run087","RRR","RGR",1,0,1
"10543","run087","RRR","RRG",2,0,2
"10544","run087","BBB","RBG",0,1,1
"10545","run087","BBG","BGG",0,1,1
"10546","run087","BBG","RBG",0,1,1
"10547","run087","BRB","BBB",0,1,1
"10548","run087","BRB","BRR",0,1,1
"10549","run087","BRB","GGR",0,1,1
"10550","run087","BRR","BBB",0,2,2
"10551","run087","GBB","GGB",0,2,2
"10552","run087","GBB","GRG",0,1,1
"10553","run087","GBG","BBB",0,1,1
"10554","run087","GGB","BGB",0,1,1
"10555","run087","GGB","BGG",0,1,1
"10556","run087","GGB","BRB",0,1,1
"10557","run087","GGB","RBB",0,1,1
"10558","run087","GGB","RBG",0,1,1
"10559","run087","GGG","BRR",0,2,2
"10560","run087","GGG","RBG",0,1,1
"10561","run087","GGG","RBR",0,3,3
"10562","run087","GGR","BBB",0,1,1
"10563","run087","GGR","BBR",0,1,1
"10564","run087","GGR","BGG",0,1,1
"10565","run087","GRG","BRB",0,1,1
"10566","run087","GRG","BRR",0,1,1
"10567","run087","GRG","GGR",0,2,2
"10568","run087","GRR","BGG",0,1,1
"10569","run087","RBB","GRR",0,1,1
"10570","run087","RBG","GBB",0,1,1
"10571","run087","RBG","GRR",0,1,1
"10572","run087","RBR","BBR",0,1,1
"10573","run087","RBR","BGG",0,1,1
"10574","run087","RBR","GGB",0,2,2
"10575","run087","RGG","BBB",0,2,2
"10576","run087","RGG","GGR",0,1,1
"10577","run087","RGR","GGR",0,1,1
"10578","run087","RGR","RBB",0,1,1
"10579","run087","RRR","GGR",0,1,1
"10580","run087","RRR","GRR",0,1,1
"10581","run087","RRR","RBR",0,1,1
"10582","run088","BBB","GGG",1,0,1
"10583","run088","BBB","RRG",1,1,2
"10584","run088","BBG","BBB",1,0,1
"10585","run088","BBG","BRB",1,5,6
"10586","run088","BBG","GBG",2,0,2
"10587","run088","BBG","GGB",2,2,4
"10588","run088","BBG","GGG",4,7,11
"10589","run088","BBG","GRG",1,3,4
"10590","run088","BBG","RRG",1,0,1
"10591","run088","BGG","RBG",1,0,1
"10592","run088","BGG","RRR",1,0,1
"10593","run088","BRR","BGB",1,0,1
"10594","run088","GBB","BBB",12,7,19
"10595","run088","GBB","BRB",1,2,3
"10596","run088","GBB","BRR",1,1,2
"10597","run088","GBB","GGG",7,9,16
"10598","run088","GBB","GGR",1,0,1
"10599","run088","GBB","RBG",3,3,6
"10600","run088","GBB","RBR",1,0,1
"10601","run088","GBB","RGG",1,0,1
"10602","run088","GBB","RGR",2,0,2
"10603","run088","GBB","RRR",1,4,5
"10604","run088","GBG","BRB",1,0,1
"10605","run088","GBG","BRR",1,0,1
"10606","run088","GBG","GGG",4,1,5
"10607","run088","GBG","RBB",1,0,1
"10608","run088","GBG","RGR",1,1,2
"10609","run088","GBG","RRG",1,0,1
"10610","run088","GGB","BBB",3,3,6
"10611","run088","GGB","BBR",1,1,2
"10612","run088","GGB","BRR",1,1,2
"10613","run088","GGB","GBG",1,0,1
"10614","run088","GGB","GGG",13,7,20
"10615","run088","GGB","RGG",1,0,1
"10616","run088","GGB","RRG",1,1,2
"10617","run088","GGB","RRR",1,2,3
"10618","run088","GGG","BBB",8,7,15
"10619","run088","GGG","BGG",1,0,1
"10620","run088","GGG","BRB",1,0,1
"10621","run088","GGG","GGB",5,0,5
"10622","run088","GGG","GGR",1,1,2
"10623","run088","GGG","RBB",1,3,4
"10624","run088","GGG","RGR",1,3,4
"10625","run088","GGG","RRG",1,3,4
"10626","run088","GGR","BRR",1,0,1
"10627","run088","GGR","GRR",1,0,1
"10628","run088","GRG","BBB",3,1,4
"10629","run088","GRG","GGB",2,0,2
"10630","run088","GRG","GGG",3,2,5
"10631","run088","GRG","RGR",1,0,1
"10632","run088","GRG","RRG",2,0,2
"10633","run088","GRR","BGB",1,0,1
"10634","run088","RBG","BBB",2,1,3
"10635","run088","RBG","RBB",1,0,1
"10636","run088","RBR","BGB",2,0,2
"10637","run088","RBR","BRB",1,0,1
"10638","run088","RBR","BRR",1,1,2
"10639","run088","RBR","GRR",4,1,5
"10640","run088","RBR","RGG",2,0,2
"10641","run088","RBR","RGR",1,0,1
"10642","run088","RGG","BBR",1,0,1
"10643","run088","RGR","BBB",2,2,4
"10644","run088","RGR","BBR",1,0,1
"10645","run088","RGR","BGB",2,1,3
"10646","run088","RGR","BGG",2,1,3
"10647","run088","RGR","BRR",1,1,2
"10648","run088","RGR","GGB",2,4,6
"10649","run088","RGR","RGG",1,0,1
"10650","run088","RRG","BBB",2,3,5
"10651","run088","RRG","BGB",1,1,2
"10652","run088","RRG","BRB",2,8,10
"10653","run088","RRG","BRR",1,2,3
"10654","run088","RRG","GGG",2,1,3
"10655","run088","RRG","GRG",1,0,1
"10656","run088","RRG","GRR",3,2,5
"10657","run088","RRG","RBB",1,0,1
"10658","run088","RRR","BBR",1,0,1
"10659","run088","RRR","BGB",2,0,2
"10660","run088","RRR","BGG",1,0,1
"10661","run088","RRR","BRB",1,0,1
"10662","run088","RRR","BRR",1,0,1
"10663","run088","RRR","RBB",1,0,1
"10664","run088","RRR","RGR",1,0,1
"10665","run088","RRR","RRG",2,0,2
"10666","run088","BBG","BGG",0,1,1
"10667","run088","BBG","RRR",0,1,1
"10668","run088","BRB","BBB",0,2,2
"10669","run088","BRB","GGR",0,1,1
"10670","run088","BRB","RBG",0,1,1
"10671","run088","BRB","RGR",0,1,1
"10672","run088","BRR","BGG",0,1,1
"10673","run088","BRR","BRB",0,1,1
"10674","run088","GBB","GBG",0,1,1
"10675","run088","GBB","GGB",0,4,4
"10676","run088","GBB","GRG",0,1,1
"10677","run088","GBB","RRG",0,1,1
"10678","run088","GBG","BBR",0,1,1
"10679","run088","GBG","RGG",0,1,1
"10680","run088","GGB","BGB",0,1,1
"10681","run088","GGB","BGG",0,1,1
"10682","run088","GGB","BRB",0,1,1
"10683","run088","GGB","GRR",0,1,1
"10684","run088","GGB","RBR",0,1,1
"10685","run088","GGG","BRR",0,1,1
"10686","run088","GGG","GRR",0,1,1
"10687","run088","GGG","RBR",0,3,3
"10688","run088","GGG","RRR",0,1,1
"10689","run088","GRG","BBR",0,1,1
"10690","run088","GRG","GBG",0,1,1
"10691","run088","GRR","BGG",0,1,1
"10692","run088","RBG","BBG",0,1,1
"10693","run088","RBR","BBB",0,2,2
"10694","run088","RBR","GGB",0,2,2
"10695","run088","RBR","RRR",0,1,1
"10696","run088","RGG","BGB",0,1,1
"10697","run088","RGG","BRR",0,1,1
"10698","run088","RGG","GRR",0,1,1
"10699","run088","RGR","GGR",0,1,1
"10700","run088","RGR","RBB",0,1,1
"10701","run088","RRG","BBR",0,2,2
"10702","run088","RRG","GGR",0,2,2
"10703","run088","RRG","RGR",0,1,1
"10704","run088","RRR","GRR",0,1,1
"10705","run088","RRR","RGG",0,1,1
"10706","run089","BBB","GGG",1,1,2
"10707","run089","BBB","RRG",1,2,3
"10708","run089","BBG","BBB",1,1,2
"10709","run089","BBG","BRB",1,4,5
"10710","run089","BBG","GBG",2,1,3
"10711","run089","BBG","GGB",2,6,8
"10712","run089","BBG","GGG",4,3,7
"10713","run089","BBG","GRG",1,2,3
"10714","run089","BBG","RRG",1,1,2
"10715","run089","BGG","RBG",1,0,1
"10716","run089","BGG","RRR",1,0,1
"10717","run089","BRR","BGB",1,0,1
"10718","run089","GBB","BBB",12,4,16
"10719","run089","GBB","BRB",1,3,4
"10720","run089","GBB","BRR",1,0,1
"10721","run089","GBB","GGG",7,19,26
"10722","run089","GBB","GGR",1,1,2
"10723","run089","GBB","RBG",3,0,3
"10724","run089","GBB","RBR",1,0,1
"10725","run089","GBB","RGG",1,0,1
"10726","run089","GBB","RGR",2,0,2
"10727","run089","GBB","RRR",1,1,2
"10728","run089","GBG","BRB",1,1,2
"10729","run089","GBG","BRR",1,0,1
"10730","run089","GBG","GGG",4,2,6
"10731","run089","GBG","RBB",1,0,1
"10732","run089","GBG","RGR",1,1,2
"10733","run089","GBG","RRG",1,0,1
"10734","run089","GGB","BBB",3,3,6
"10735","run089","GGB","BBR",1,0,1
"10736","run089","GGB","BRR",1,3,4
"10737","run089","GGB","GBG",1,0,1
"10738","run089","GGB","GGG",13,4,17
"10739","run089","GGB","RGG",1,2,3
"10740","run089","GGB","RRG",1,0,1
"10741","run089","GGB","RRR",1,0,1
"10742","run089","GGG","BBB",8,2,10
"10743","run089","GGG","BGG",1,1,2
"10744","run089","GGG","BRB",1,0,1
"10745","run089","GGG","GGB",5,0,5
"10746","run089","GGG","GGR",1,3,4
"10747","run089","GGG","RBB",1,0,1
"10748","run089","GGG","RGR",1,1,2
"10749","run089","GGG","RRG",1,2,3
"10750","run089","GGR","BRR",1,0,1
"10751","run089","GGR","GRR",1,0,1
"10752","run089","GRG","BBB",3,1,4
"10753","run089","GRG","GGB",2,3,5
"10754","run089","GRG","GGG",3,2,5
"10755","run089","GRG","RGR",1,0,1
"10756","run089","GRG","RRG",2,1,3
"10757","run089","GRR","BGB",1,0,1
"10758","run089","RBG","BBB",2,2,4
"10759","run089","RBG","RBB",1,0,1
"10760","run089","RBR","BGB",2,0,2
"10761","run089","RBR","BRB",1,0,1
"10762","run089","RBR","BRR",1,0,1
"10763","run089","RBR","GRR",4,1,5
"10764","run089","RBR","RGG",2,2,4
"10765","run089","RBR","RGR",1,0,1
"10766","run089","RGG","BBR",1,0,1
"10767","run089","RGR","BBB",2,0,2
"10768","run089","RGR","BBR",1,0,1
"10769","run089","RGR","BGB",2,2,4
"10770","run089","RGR","BGG",2,1,3
"10771","run089","RGR","BRR",1,0,1
"10772","run089","RGR","GGB",2,2,4
"10773","run089","RGR","RGG",1,0,1
"10774","run089","RRG","BBB",2,3,5
"10775","run089","RRG","BGB",1,1,2
"10776","run089","RRG","BRB",2,10,12
"10777","run089","RRG","BRR",1,4,5
"10778","run089","RRG","GGG",2,2,4
"10779","run089","RRG","GRG",1,0,1
"10780","run089","RRG","GRR",3,0,3
"10781","run089","RRG","RBB",1,0,1
"10782","run089","RRR","BBR",1,0,1
"10783","run089","RRR","BGB",2,1,3
"10784","run089","RRR","BGG",1,0,1
"10785","run089","RRR","BRB",1,0,1
"10786","run089","RRR","BRR",1,0,1
"10787","run089","RRR","RBB",1,0,1
"10788","run089","RRR","RGR",1,1,2
"10789","run089","RRR","RRG",2,0,2
"10790","run089","BBB","BRB",0,1,1
"10791","run089","BBG","BGG",0,1,1
"10792","run089","BBG","GRR",0,1,1
"10793","run089","BBG","RBB",0,1,1
"10794","run089","BBG","RBG",0,1,1
"10795","run089","BBG","RRR",0,2,2
"10796","run089","BGG","BBB",0,1,1
"10797","run089","BGG","RGG",0,1,1
"10798","run089","BRB","BBB",0,2,2
"10799","run089","BRB","BBR",0,1,1
"10800","run089","BRB","RBB",0,1,1
"10801","run089","BRR","BBB",0,1,1
"10802","run089","GBB","GBG",0,1,1
"10803","run089","GBB","GGB",0,4,4
"10804","run089","GBB","GRG",0,1,1
"10805","run089","GBB","GRR",0,1,1
"10806","run089","GBG","GGB",0,2,2
"10807","run089","GBG","RGG",0,1,1
"10808","run089","GGB","RBB",0,1,1
"10809","run089","GGB","RBG",0,1,1
"10810","run089","GGG","RBG",0,1,1
"10811","run089","GGG","RBR",0,1,1
"10812","run089","GRG","BRB",0,1,1
"10813","run089","GRG","BRR",0,1,1
"10814","run089","GRR","BRR",0,1,1
"10815","run089","RBG","GRR",0,1,1
"10816","run089","RBG","RBR",0,1,1
"10817","run089","RBR","BBB",0,3,3
"10818","run089","RBR","GGB",0,1,1
"10819","run089","RBR","RBB",0,2,2
"10820","run089","RGG","BBB",0,1,1
"10821","run089","RGG","BRR",0,1,1
"10822","run089","RGG","GRR",0,2,2
"10823","run089","RRG","BBR",0,1,1
"10824","run089","RRG","GGR",0,1,1
"10825","run089","RRR","GRR",0,2,2
"10826","run090","BBB","GGG",1,0,1
"10827","run090","BBB","RRG",1,0,1
"10828","run090","BBG","BBB",1,1,2
"10829","run090","BBG","BRB",1,2,3
"10830","run090","BBG","GBG",2,0,2
"10831","run090","BBG","GGB",2,3,5
"10832","run090","BBG","GGG",4,7,11
"10833","run090","BBG","GRG",1,0,1
"10834","run090","BBG","RRG",1,0,1
"10835","run090","BGG","RBG",1,0,1
"10836","run090","BGG","RRR",1,0,1
"10837","run090","BRR","BGB",1,1,2
"10838","run090","GBB","BBB",12,8,20
"10839","run090","GBB","BRB",1,1,2
"10840","run090","GBB","BRR",1,0,1
"10841","run090","GBB","GGG",7,15,22
"10842","run090","GBB","GGR",1,1,2
"10843","run090","GBB","RBG",3,1,4
"10844","run090","GBB","RBR",1,0,1
"10845","run090","GBB","RGG",1,0,1
"10846","run090","GBB","RGR",2,0,2
"10847","run090","GBB","RRR",1,0,1
"10848","run090","GBG","BRB",1,1,2
"10849","run090","GBG","BRR",1,0,1
"10850","run090","GBG","GGG",4,3,7
"10851","run090","GBG","RBB",1,0,1
"10852","run090","GBG","RGR",1,0,1
"10853","run090","GBG","RRG",1,1,2
"10854","run090","GGB","BBB",3,1,4
"10855","run090","GGB","BBR",1,0,1
"10856","run090","GGB","BRR",1,2,3
"10857","run090","GGB","GBG",1,0,1
"10858","run090","GGB","GGG",13,7,20
"10859","run090","GGB","RGG",1,1,2
"10860","run090","GGB","RRG",1,1,2
"10861","run090","GGB","RRR",1,0,1
"10862","run090","GGG","BBB",8,9,17
"10863","run090","GGG","BGG",1,0,1
"10864","run090","GGG","BRB",1,0,1
"10865","run090","GGG","GGB",5,0,5
"10866","run090","GGG","GGR",1,0,1
"10867","run090","GGG","RBB",1,1,2
"10868","run090","GGG","RGR",1,1,2
"10869","run090","GGG","RRG",1,4,5
"10870","run090","GGR","BRR",1,0,1
"10871","run090","GGR","GRR",1,0,1
"10872","run090","GRG","BBB",3,2,5
"10873","run090","GRG","GGB",2,1,3
"10874","run090","GRG","GGG",3,3,6
"10875","run090","GRG","RGR",1,0,1
"10876","run090","GRG","RRG",2,1,3
"10877","run090","GRR","BGB",1,0,1
"10878","run090","RBG","BBB",2,0,2
"10879","run090","RBG","RBB",1,0,1
"10880","run090","RBR","BGB",2,2,4
"10881","run090","RBR","BRB",1,0,1
"10882","run090","RBR","BRR",1,1,2
"10883","run090","RBR","GRR",4,0,4
"10884","run090","RBR","RGG",2,2,4
"10885","run090","RBR","RGR",1,0,1
"10886","run090","RGG","BBR",1,0,1
"10887","run090","RGR","BBB",2,1,3
"10888","run090","RGR","BBR",1,1,2
"10889","run090","RGR","BGB",2,2,4
"10890","run090","RGR","BGG",2,0,2
"10891","run090","RGR","BRR",1,0,1
"10892","run090","RGR","GGB",2,3,5
"10893","run090","RGR","RGG",1,0,1
"10894","run090","RRG","BBB",2,3,5
"10895","run090","RRG","BGB",1,0,1
"10896","run090","RRG","BRB",2,6,8
"10897","run090","RRG","BRR",1,3,4
"10898","run090","RRG","GGG",2,2,4
"10899","run090","RRG","GRG",1,0,1
"10900","run090","RRG","GRR",3,2,5
"10901","run090","RRG","RBB",1,0,1
"10902","run090","RRR","BBR",1,0,1
"10903","run090","RRR","BGB",2,0,2
"10904","run090","RRR","BGG",1,0,1
"10905","run090","RRR","BRB",1,0,1
"10906","run090","RRR","BRR",1,1,2
"10907","run090","RRR","RBB",1,0,1
"10908","run090","RRR","RGR",1,1,2
"10909","run090","RRR","RRG",2,0,2
"10910","run090","BBG","RBG",0,2,2
"10911","run090","BBG","RRR",0,1,1
"10912","run090","BGG","BBB",0,1,1
"10913","run090","BRB","BBB",0,2,2
"10914","run090","BRB","RGR",0,1,1
"10915","run090","BRR","BBB",0,2,2
"10916","run090","GBB","GGB",0,4,4
"10917","run090","GBB","GRG",0,2,2
"10918","run090","GBB","RBB",0,1,1
"10919","run090","GBB","RRG",0,1,1
"10920","run090","GBG","GGB",0,1,1
"10921","run090","GGG","BGB",0,1,1
"10922","run090","GGG","BRR",0,2,2
"10923","run090","GGG","GRR",0,2,2
"10924","run090","GGG","RBG",0,2,2
"10925","run090","GGG","RBR",0,3,3
"10926","run090","GGR","BBB",0,1,1
"10927","run090","GRG","BBR",0,1,1
"10928","run090","GRG","GGR",0,1,1
"10929","run090","GRG","GRR",0,1,1
"10930","run090","GRR","BRR",0,1,1
"10931","run090","RBR","BBB",0,3,3
"10932","run090","RBR","BGG",0,1,1
"10933","run090","RBR","GGB",0,2,2
"10934","run090","RBR","RBB",0,2,2
"10935","run090","RBR","RRR",0,1,1
"10936","run090","RGG","BBB",0,2,2
"10937","run090","RGG","BRR",0,1,1
"10938","run090","RGG","GRR",0,1,1
"10939","run090","RGR","RBB",0,1,1
"10940","run090","RGR","RRG",0,1,1
"10941","run090","RRG","BBR",0,1,1
"10942","run090","RRR","RBR",0,1,1
"10943","run090","RRR","RGG",0,1,1
"10944","run091","BBB","GGG",1,0,1
"10945","run091","BBB","RRG",1,2,3
"10946","run091","BBG","BBB",1,0,1
"10947","run091","BBG","BRB",1,2,3
"10948","run091","BBG","GBG",2,0,2
"10949","run091","BBG","GGB",2,3,5
"10950","run091","BBG","GGG",4,6,10
"10951","run091","BBG","GRG",1,1,2
"10952","run091","BBG","RRG",1,0,1
"10953","run091","BGG","RBG",1,1,2
"10954","run091","BGG","RRR",1,0,1
"10955","run091","BRR","BGB",1,0,1
"10956","run091","GBB","BBB",12,3,15
"10957","run091","GBB","BRB",1,1,2
"10958","run091","GBB","BRR",1,0,1
"10959","run091","GBB","GGG",7,17,24
"10960","run091","GBB","GGR",1,1,2
"10961","run091","GBB","RBG",3,2,5
"10962","run091","GBB","RBR",1,0,1
"10963","run091","GBB","RGG",1,0,1
"10964","run091","GBB","RGR",2,0,2
"10965","run091","GBB","RRR",1,2,3
"10966","run091","GBG","BRB",1,0,1
"10967","run091","GBG","BRR",1,0,1
"10968","run091","GBG","GGG",4,1,5
"10969","run091","GBG","RBB",1,0,1
"10970","run091","GBG","RGR",1,0,1
"10971","run091","GBG","RRG",1,2,3
"10972","run091","GGB","BBB",3,6,9
"10973","run091","GGB","BBR",1,0,1
"10974","run091","GGB","BRR",1,5,6
"10975","run091","GGB","GBG",1,0,1
"10976","run091","GGB","GGG",13,6,19
"10977","run091","GGB","RGG",1,0,1
"10978","run091","GGB","RRG",1,0,1
"10979","run091","GGB","RRR",1,1,2
"10980","run091","GGG","BBB",8,5,13
"10981","run091","GGG","BGG",1,1,2
"10982","run091","GGG","BRB",1,0,1
"10983","run091","GGG","GGB",5,0,5
"10984","run091","GGG","GGR",1,0,1
"10985","run091","GGG","RBB",1,1,2
"10986","run091","GGG","RGR",1,2,3
"10987","run091","GGG","RRG",1,3,4
"10988","run091","GGR","BRR",1,0,1
"10989","run091","GGR","GRR",1,0,1
"10990","run091","GRG","BBB",3,2,5
"10991","run091","GRG","GGB",2,1,3
"10992","run091","GRG","GGG",3,5,8
"10993","run091","GRG","RGR",1,0,1
"10994","run091","GRG","RRG",2,0,2
"10995","run091","GRR","BGB",1,0,1
"10996","run091","RBG","BBB",2,0,2
"10997","run091","RBG","RBB",1,0,1
"10998","run091","RBR","BGB",2,0,2
"10999","run091","RBR","BRB",1,0,1
"11000","run091","RBR","BRR",1,2,3
"11001","run091","RBR","GRR",4,1,5
"11002","run091","RBR","RGG",2,2,4
"11003","run091","RBR","RGR",1,0,1
"11004","run091","RGG","BBR",1,0,1
"11005","run091","RGR","BBB",2,0,2
"11006","run091","RGR","BBR",1,0,1
"11007","run091","RGR","BGB",2,2,4
"11008","run091","RGR","BGG",2,0,2
"11009","run091","RGR","BRR",1,0,1
"11010","run091","RGR","GGB",2,1,3
"11011","run091","RGR","RGG",1,1,2
"11012","run091","RRG","BBB",2,4,6
"11013","run091","RRG","BGB",1,0,1
"11014","run091","RRG","BRB",2,12,14
"11015","run091","RRG","BRR",1,2,3
"11016","run091","RRG","GGG",2,5,7
"11017","run091","RRG","GRG",1,0,1
"11018","run091","RRG","GRR",3,2,5
"11019","run091","RRG","RBB",1,0,1
"11020","run091","RRR","BBR",1,0,1
"11021","run091","RRR","BGB",2,0,2
"11022","run091","RRR","BGG",1,0,1
"11023","run091","RRR","BRB",1,0,1
"11024","run091","RRR","BRR",1,0,1
"11025","run091","RRR","RBB",1,1,2
"11026","run091","RRR","RGR",1,0,1
"11027","run091","RRR","RRG",2,0,2
"11028","run091","BBB","GRR",0,1,1
"11029","run091","BBB","RBG",0,1,1
"11030","run091","BBG","GBB",0,1,1
"11031","run091","BBG","RBB",0,1,1
"11032","run091","BBG","RRR",0,1,1
"11033","run091","BGB","BBB",0,1,1
"11034","run091","BRR","BBB",0,2,2
"11035","run091","BRR","BRB",0,1,1
"11036","run091","GBB","BGG",0,1,1
"11037","run091","GBB","GRG",0,2,2
"11038","run091","GBG","BBB",0,1,1
"11039","run091","GBG","GGB",0,1,1
"11040","run091","GBG","RBG",0,1,1
"11041","run091","GGB","BGB",0,1,1
"11042","run091","GGB","GRR",0,1,1
"11043","run091","GGG","RBG",0,1,1
"11044","run091","GGG","RBR",0,3,3
"11045","run091","GGR","BBR",0,1,1
"11046","run091","GRG","BGG",0,1,1
"11047","run091","GRG","GGR",0,2,2
"11048","run091","GRR","BBR",0,1,1
"11049","run091","RBB","BBB",0,1,1
"11050","run091","RBB","BBR",0,1,1
"11051","run091","RBG","BRR",0,1,1
"11052","run091","RBR","BBB",0,2,2
"11053","run091","RBR","GGB",0,1,1
"11054","run091","RGG","BBB",0,1,1
"11055","run091","RGG","BRR",0,2,2
"11056","run091","RGG","GGR",0,1,1
"11057","run091","RGG","GRR",0,1,1
"11058","run091","RGR","RBB",0,2,2
"11059","run091","RRG","BBR",0,1,1
"11060","run091","RRG","GGR",0,1,1
"11061","run091","RRG","RGG",0,1,1
"11062","run091","RRR","GRR",0,1,1
"11063","run092","BBB","GGG",1,0,1
"11064","run092","BBB","RRG",1,0,1
"11065","run092","BBG","BBB",1,0,1
"11066","run092","BBG","BRB",1,2,3
"11067","run092","BBG","GBG",2,2,4
"11068","run092","BBG","GGB",2,7,9
"11069","run092","BBG","GGG",4,6,10
"11070","run092","BBG","GRG",1,1,2
"11071","run092","BBG","RRG",1,0,1
"11072","run092","BGG","RBG",1,0,1
"11073","run092","BGG","RRR",1,0,1
"11074","run092","BRR","BGB",1,0,1
"11075","run092","GBB","BBB",12,3,15
"11076","run092","GBB","BRB",1,2,3
"11077","run092","GBB","BRR",1,0,1
"11078","run092","GBB","GGG",7,10,17
"11079","run092","GBB","GGR",1,0,1
"11080","run092","GBB","RBG",3,2,5
"11081","run092","GBB","RBR",1,0,1
"11082","run092","GBB","RGG",1,0,1
"11083","run092","GBB","RGR",2,0,2
"11084","run092","GBB","RRR",1,1,2
"11085","run092","GBG","BRB",1,0,1
"11086","run092","GBG","BRR",1,0,1
"11087","run092","GBG","GGG",4,0,4
"11088","run092","GBG","RBB",1,0,1
"11089","run092","GBG","RGR",1,0,1
"11090","run092","GBG","RRG",1,0,1
"11091","run092","GGB","BBB",3,3,6
"11092","run092","GGB","BBR",1,0,1
"11093","run092","GGB","BRR",1,1,2
"11094","run092","GGB","GBG",1,0,1
"11095","run092","GGB","GGG",13,12,25
"11096","run092","GGB","RGG",1,2,3
"11097","run092","GGB","RRG",1,1,2
"11098","run092","GGB","RRR",1,1,2
"11099","run092","GGG","BBB",8,4,12
"11100","run092","GGG","BGG",1,1,2
"11101","run092","GGG","BRB",1,0,1
"11102","run092","GGG","GGB",5,0,5
"11103","run092","GGG","GGR",1,2,3
"11104","run092","GGG","RBB",1,2,3
"11105","run092","GGG","RGR",1,0,1
"11106","run092","GGG","RRG",1,3,4
"11107","run092","GGR","BRR",1,0,1
"11108","run092","GGR","GRR",1,0,1
"11109","run092","GRG","BBB",3,0,3
"11110","run092","GRG","GGB",2,2,4
"11111","run092","GRG","GGG",3,1,4
"11112","run092","GRG","RGR",1,1,2
"11113","run092","GRG","RRG",2,1,3
"11114","run092","GRR","BGB",1,0,1
"11115","run092","RBG","BBB",2,2,4
"11116","run092","RBG","RBB",1,0,1
"11117","run092","RBR","BGB",2,0,2
"11118","run092","RBR","BRB",1,0,1
"11119","run092","RBR","BRR",1,1,2
"11120","run092","RBR","GRR",4,0,4
"11121","run092","RBR","RGG",2,2,4
"11122","run092","RBR","RGR",1,0,1
"11123","run092","RGG","BBR",1,0,1
"11124","run092","RGR","BBB",2,1,3
"11125","run092","RGR","BBR",1,0,1
"11126","run092","RGR","BGB",2,0,2
"11127","run092","RGR","BGG",2,1,3
"11128","run092","RGR","BRR",1,3,4
"11129","run092","RGR","GGB",2,0,2
"11130","run092","RGR","RGG",1,0,1
"11131","run092","RRG","BBB",2,5,7
"11132","run092","RRG","BGB",1,3,4
"11133","run092","RRG","BRB",2,1,3
"11134","run092","RRG","BRR",1,4,5
"11135","run092","RRG","GGG",2,2,4
"11136","run092","RRG","GRG",1,0,1
"11137","run092","RRG","GRR",3,2,5
"11138","run092","RRG","RBB",1,0,1
"11139","run092","RRR","BBR",1,0,1
"11140","run092","RRR","BGB",2,0,2
"11141","run092","RRR","BGG",1,0,1
"11142","run092","RRR","BRB",1,0,1
"11143","run092","RRR","BRR",1,0,1
"11144","run092","RRR","RBB",1,1,2
"11145","run092","RRR","RGR",1,0,1
"11146","run092","RRR","RRG",2,1,3
"11147","run092","BBB","BRB",0,1,1
"11148","run092","BBB","RBG",0,1,1
"11149","run092","BBG","GRR",0,1,1
"11150","run092","BBG","RRR",0,1,1
"11151","run092","BGB","BBB",0,1,1
"11152","run092","BGG","GRG",0,1,1
"11153","run092","BRB","BBB",0,2,2
"11154","run092","BRB","GGR",0,1,1
"11155","run092","BRR","BBB",0,3,3
"11156","run092","BRR","BGG",0,1,1
"11157","run092","BRR","BRB",0,1,1
"11158","run092","BRR","RBB",0,2,2
"11159","run092","GBB","GBG",0,1,1
"11160","run092","GBB","GGB",0,5,5
"11161","run092","GBB","GRG",0,1,1
"11162","run092","GBG","GGB",0,1,1
"11163","run092","GGB","BGB",0,2,2
"11164","run092","GGB","BGG",0,1,1
"11165","run092","GGB","RBB",0,1,1
"11166","run092","GGB","RBG",0,3,3
"11167","run092","GGB","RBR",0,1,1
"11168","run092","GGG","RBR",0,2,2
"11169","run092","GGR","BGG",0,1,1
"11170","run092","GRG","GGR",0,1,1
"11171","run092","GRR","BBR",0,1,1
"11172","run092","GRR","BRR",0,1,1
"11173","run092","GRR","GGR",0,1,1
"11174","run092","RBB","BRB",0,1,1
"11175","run092","RBB","GRR",0,1,1
"11176","run092","RBR","BBB",0,2,2
"11177","run092","RBR","BBR",0,1,1
"11178","run092","RBR","BGG",0,1,1
"11179","run092","RBR","GGB",0,1,1
"11180","run092","RBR","RBB",0,2,2
"11181","run092","RGG","BBB",0,2,2
"11182","run092","RGG","GGR",0,1,1
"11183","run092","RGG","GRR",0,1,1
"11184","run092","RGR","RBB",0,1,1
"11185","run092","RGR","RRG",0,1,1
"11186","run092","RRG","BGG",0,1,1
"11187","run092","RRG","GGR",0,2,2
"11188","run092","RRR","RGG",0,1,1
"11189","run093","BBB","GGG",1,0,1
"11190","run093","BBB","RRG",1,0,1
"11191","run093","BBG","BBB",1,0,1
"11192","run093","BBG","BRB",1,4,5
"11193","run093","BBG","GBG",2,0,2
"11194","run093","BBG","GGB",2,5,7
"11195","run093","BBG","GGG",4,5,9
"11196","run093","BBG","GRG",1,3,4
"11197","run093","BBG","RRG",1,0,1
"11198","run093","BGG","RBG",1,0,1
"11199","run093","BGG","RRR",1,0,1
"11200","run093","BRR","BGB",1,0,1
"11201","run093","GBB","BBB",12,6,18
"11202","run093","GBB","BRB",1,2,3
"11203","run093","GBB","BRR",1,0,1
"11204","run093","GBB","GGG",7,14,21
"11205","run093","GBB","GGR",1,0,1
"11206","run093","GBB","RBG",3,2,5
"11207","run093","GBB","RBR",1,0,1
"11208","run093","GBB","RGG",1,0,1
"11209","run093","GBB","RGR",2,0,2
"11210","run093","GBB","RRR",1,0,1
"11211","run093","GBG","BRB",1,1,2
"11212","run093","GBG","BRR",1,0,1
"11213","run093","GBG","GGG",4,2,6
"11214","run093","GBG","RBB",1,0,1
"11215","run093","GBG","RGR",1,0,1
"11216","run093","GBG","RRG",1,0,1
"11217","run093","GGB","BBB",3,2,5
"11218","run093","GGB","BBR",1,1,2
"11219","run093","GGB","BRR",1,2,3
"11220","run093","GGB","GBG",1,0,1
"11221","run093","GGB","GGG",13,9,22
"11222","run093","GGB","RGG",1,0,1
"11223","run093","GGB","RRG",1,0,1
"11224","run093","GGB","RRR",1,0,1
"11225","run093","GGG","BBB",8,6,14
"11226","run093","GGG","BGG",1,1,2
"11227","run093","GGG","BRB",1,1,2
"11228","run093","GGG","GGB",5,0,5
"11229","run093","GGG","GGR",1,2,3
"11230","run093","GGG","RBB",1,2,3
"11231","run093","GGG","RGR",1,3,4
"11232","run093","GGG","RRG",1,5,6
"11233","run093","GGR","BRR",1,0,1
"11234","run093","GGR","GRR",1,0,1
"11235","run093","GRG","BBB",3,1,4
"11236","run093","GRG","GGB",2,7,9
"11237","run093","GRG","GGG",3,0,3
"11238","run093","GRG","RGR",1,0,1
"11239","run093","GRG","RRG",2,0,2
"11240","run093","GRR","BGB",1,1,2
"11241","run093","RBG","BBB",2,0,2
"11242","run093","RBG","RBB",1,0,1
"11243","run093","RBR","BGB",2,0,2
"11244","run093","RBR","BRB",1,0,1
"11245","run093","RBR","BRR",1,0,1
"11246","run093","RBR","GRR",4,0,4
"11247","run093","RBR","RGG",2,2,4
"11248","run093","RBR","RGR",1,0,1
"11249","run093","RGG","BBR",1,1,2
"11250","run093","RGR","BBB",2,0,2
"11251","run093","RGR","BBR",1,0,1
"11252","run093","RGR","BGB",2,0,2
"11253","run093","RGR","BGG",2,0,2
"11254","run093","RGR","BRR",1,0,1
"11255","run093","RGR","GGB",2,0,2
"11256","run093","RGR","RGG",1,0,1
"11257","run093","RRG","BBB",2,5,7
"11258","run093","RRG","BGB",1,5,6
"11259","run093","RRG","BRB",2,9,11
"11260","run093","RRG","BRR",1,1,2
"11261","run093","RRG","GGG",2,1,3
"11262","run093","RRG","GRG",1,0,1
"11263","run093","RRG","GRR",3,3,6
"11264","run093","RRG","RBB",1,0,1
"11265","run093","RRR","BBR",1,0,1
"11266","run093","RRR","BGB",2,0,2
"11267","run093","RRR","BGG",1,0,1
"11268","run093","RRR","BRB",1,1,2
"11269","run093","RRR","BRR",1,0,1
"11270","run093","RRR","RBB",1,1,2
"11271","run093","RRR","RGR",1,0,1
"11272","run093","RRR","RRG",2,0,2
"11273","run093","BBB","RBG",0,1,1
"11274","run093","BBG","BGB",0,1,1
"11275","run093","BBG","GBB",0,1,1
"11276","run093","BGG","RGR",0,1,1
"11277","run093","BRB","BBB",0,3,3
"11278","run093","BRB","GGG",0,1,1
"11279","run093","BRB","RBG",0,1,1
"11280","run093","GBB","GGB",0,2,2
"11281","run093","GBB","GRG",0,1,1
"11282","run093","GGB","BRB",0,1,1
"11283","run093","GGB","RBB",0,1,1
"11284","run093","GGB","RBG",0,3,3
"11285","run093","GGB","RBR",0,1,1
"11286","run093","GGB","RGR",0,1,1
"11287","run093","GGG","BRR",0,1,1
"11288","run093","GGG","GRR",0,1,1
"11289","run093","GGG","RBG",0,2,2
"11290","run093","GGG","RBR",0,2,2
"11291","run093","GGR","BBR",0,1,1
"11292","run093","GRG","BRB",0,1,1
"11293","run093","GRG","GGR",0,1,1
"11294","run093","RBB","RGG",0,1,1
"11295","run093","RBG","BBG",0,1,1
"11296","run093","RBR","BBB",0,3,3
"11297","run093","RBR","GGB",0,2,2
"11298","run093","RBR","RBB",0,1,1
"11299","run093","RGG","BGB",0,1,1
"11300","run093","RGR","RBB",0,1,1
"11301","run093","RGR","RRG",0,2,2
"11302","run093","RRG","GGR",0,3,3
"11303","run093","RRR","GRR",0,1,1
"11304","run094","BBB","GGG",1,0,1
"11305","run094","BBB","RRG",1,0,1
"11306","run094","BBG","BBB",1,2,3
"11307","run094","BBG","BRB",1,4,5
"11308","run094","BBG","GBG",2,2,4
"11309","run094","BBG","GGB",2,6,8
"11310","run094","BBG","GGG",4,9,13
"11311","run094","BBG","GRG",1,1,2
"11312","run094","BBG","RRG",1,0,1
"11313","run094","BGG","RBG",1,1,2
"11314","run094","BGG","RRR",1,0,1
"11315","run094","BRR","BGB",1,1,2
"11316","run094","GBB","BBB",12,7,19
"11317","run094","GBB","BRB",1,0,1
"11318","run094","GBB","BRR",1,1,2
"11319","run094","GBB","GGG",7,11,18
"11320","run094","GBB","GGR",1,0,1
"11321","run094","GBB","RBG",3,1,4
"11322","run094","GBB","RBR",1,0,1
"11323","run094","GBB","RGG",1,0,1
"11324","run094","GBB","RGR",2,0,2
"11325","run094","GBB","RRR",1,2,3
"11326","run094","GBG","BRB",1,2,3
"11327","run094","GBG","BRR",1,0,1
"11328","run094","GBG","GGG",4,3,7
"11329","run094","GBG","RBB",1,0,1
"11330","run094","GBG","RGR",1,1,2
"11331","run094","GBG","RRG",1,0,1
"11332","run094","GGB","BBB",3,0,3
"11333","run094","GGB","BBR",1,0,1
"11334","run094","GGB","BRR",1,1,2
"11335","run094","GGB","GBG",1,0,1
"11336","run094","GGB","GGG",13,7,20
"11337","run094","GGB","RGG",1,1,2
"11338","run094","GGB","RRG",1,0,1
"11339","run094","GGB","RRR",1,1,2
"11340","run094","GGG","BBB",8,5,13
"11341","run094","GGG","BGG",1,2,3
"11342","run094","GGG","BRB",1,0,1
"11343","run094","GGG","GGB",5,0,5
"11344","run094","GGG","GGR",1,4,5
"11345","run094","GGG","RBB",1,1,2
"11346","run094","GGG","RGR",1,0,1
"11347","run094","GGG","RRG",1,3,4
"11348","run094","GGR","BRR",1,0,1
"11349","run094","GGR","GRR",1,0,1
"11350","run094","GRG","BBB",3,1,4
"11351","run094","GRG","GGB",2,1,3
"11352","run094","GRG","GGG",3,2,5
"11353","run094","GRG","RGR",1,0,1
"11354","run094","GRG","RRG",2,0,2
"11355","run094","GRR","BGB",1,0,1
"11356","run094","RBG","BBB",2,2,4
"11357","run094","RBG","RBB",1,0,1
"11358","run094","RBR","BGB",2,1,3
"11359","run094","RBR","BRB",1,0,1
"11360","run094","RBR","BRR",1,0,1
"11361","run094","RBR","GRR",4,1,5
"11362","run094","RBR","RGG",2,1,3
"11363","run094","RBR","RGR",1,0,1
"11364","run094","RGG","BBR",1,0,1
"11365","run094","RGR","BBB",2,1,3
"11366","run094","RGR","BBR",1,0,1
"11367","run094","RGR","BGB",2,0,2
"11368","run094","RGR","BGG",2,0,2
"11369","run094","RGR","BRR",1,0,1
"11370","run094","RGR","GGB",2,4,6
"11371","run094","RGR","RGG",1,0,1
"11372","run094","RRG","BBB",2,3,5
"11373","run094","RRG","BGB",1,1,2
"11374","run094","RRG","BRB",2,4,6
"11375","run094","RRG","BRR",1,3,4
"11376","run094","RRG","GGG",2,1,3
"11377","run094","RRG","GRG",1,0,1
"11378","run094","RRG","GRR",3,3,6
"11379","run094","RRG","RBB",1,1,2
"11380","run094","RRR","BBR",1,0,1
"11381","run094","RRR","BGB",2,0,2
"11382","run094","RRR","BGG",1,0,1
"11383","run094","RRR","BRB",1,0,1
"11384","run094","RRR","BRR",1,0,1
"11385","run094","RRR","RBB",1,1,2
"11386","run094","RRR","RGR",1,0,1
"11387","run094","RRR","RRG",2,0,2
"11388","run094","BBB","RBG",0,1,1
"11389","run094","BBG","GBB",0,1,1
"11390","run094","BBG","GRR",0,1,1
"11391","run094","BGG","BBB",0,1,1
"11392","run094","BGG","GRG",0,1,1
"11393","run094","BRB","BBB",0,1,1
"11394","run094","BRB","BRR",0,1,1
"11395","run094","GBB","GGB",0,2,2
"11396","run094","GBB","RBB",0,1,1
"11397","run094","GGB","BGB",0,1,1
"11398","run094","GGB","GRR",0,1,1
"11399","run094","GGB","RBB",0,2,2
"11400","run094","GGB","RBG",0,1,1
"11401","run094","GGB","RBR",0,1,1
"11402","run094","GGG","BRR",0,1,1
"11403","run094","GGG","RBR",0,2,2
"11404","run094","GGG","RRR",0,3,3
"11405","run094","GGR","BBR",0,1,1
"11406","run094","GRG","BGG",0,1,1
"11407","run094","GRG","BRB",0,1,1
"11408","run094","GRG","BRR",0,1,1
"11409","run094","GRG","GGR",0,1,1
"11410","run094","GRG","RBG",0,1,1
"11411","run094","GRG","RBR",0,1,1
"11412","run094","GRR","GGR",0,1,1
"11413","run094","RBB","BRB",0,1,1
"11414","run094","RBR","BGG",0,1,1
"11415","run094","RBR","GGB",0,2,2
"11416","run094","RBR","RBB",0,1,1
"11417","run094","RGG","BBB",0,1,1
"11418","run094","RGG","BRR",0,1,1
"11419","run094","RGG","GGR",0,1,1
"11420","run094","RGG","GRR",0,2,2
"11421","run094","RGR","GGG",0,1,1
"11422","run094","RGR","GGR",0,1,1
"11423","run094","RGR","RBB",0,3,3
"11424","run094","RRG","BBR",0,1,1
"11425","run094","RRG","GGR",0,1,1
"11426","run094","RRG","RGG",0,1,1
"11427","run094","RRR","GRR",0,2,2
"11428","run095","BBB","GGG",1,0,1
"11429","run095","BBB","RRG",1,0,1
"11430","run095","BBG","BBB",1,1,2
"11431","run095","BBG","BRB",1,2,3
"11432","run095","BBG","GBG",2,0,2
"11433","run095","BBG","GGB",2,0,2
"11434","run095","BBG","GGG",4,4,8
"11435","run095","BBG","GRG",1,1,2
"11436","run095","BBG","RRG",1,0,1
"11437","run095","BGG","RBG",1,1,2
"11438","run095","BGG","RRR",1,1,2
"11439","run095","BRR","BGB",1,0,1
"11440","run095","GBB","BBB",12,4,16
"11441","run095","GBB","BRB",1,3,4
"11442","run095","GBB","BRR",1,0,1
"11443","run095","GBB","GGG",7,15,22
"11444","run095","GBB","GGR",1,0,1
"11445","run095","GBB","RBG",3,3,6
"11446","run095","GBB","RBR",1,0,1
"11447","run095","GBB","RGG",1,0,1
"11448","run095","GBB","RGR",2,0,2
"11449","run095","GBB","RRR",1,2,3
"11450","run095","GBG","BRB",1,1,2
"11451","run095","GBG","BRR",1,0,1
"11452","run095","GBG","GGG",4,2,6
"11453","run095","GBG","RBB",1,0,1
"11454","run095","GBG","RGR",1,0,1
"11455","run095","GBG","RRG",1,1,2
"11456","run095","GGB","BBB",3,1,4
"11457","run095","GGB","BBR",1,2,3
"11458","run095","GGB","BRR",1,1,2
"11459","run095","GGB","GBG",1,0,1
"11460","run095","GGB","GGG",13,8,21
"11461","run095","GGB","RGG",1,1,2
"11462","run095","GGB","RRG",1,2,3
"11463","run095","GGB","RRR",1,1,2
"11464","run095","GGG","BBB",8,8,16
"11465","run095","GGG","BGG",1,0,1
"11466","run095","GGG","BRB",1,1,2
"11467","run095","GGG","GGB",5,0,5
"11468","run095","GGG","GGR",1,2,3
"11469","run095","GGG","RBB",1,0,1
"11470","run095","GGG","RGR",1,2,3
"11471","run095","GGG","RRG",1,4,5
"11472","run095","GGR","BRR",1,0,1
"11473","run095","GGR","GRR",1,0,1
"11474","run095","GRG","BBB",3,3,6
"11475","run095","GRG","GGB",2,2,4
"11476","run095","GRG","GGG",3,0,3
"11477","run095","GRG","RGR",1,0,1
"11478","run095","GRG","RRG",2,1,3
"11479","run095","GRR","BGB",1,0,1
"11480","run095","RBG","BBB",2,1,3
"11481","run095","RBG","RBB",1,0,1
"11482","run095","RBR","BGB",2,1,3
"11483","run095","RBR","BRB",1,0,1
"11484","run095","RBR","BRR",1,0,1
"11485","run095","RBR","GRR",4,1,5
"11486","run095","RBR","RGG",2,1,3
"11487","run095","RBR","RGR",1,0,1
"11488","run095","RGG","BBR",1,1,2
"11489","run095","RGR","BBB",2,0,2
"11490","run095","RGR","BBR",1,0,1
"11491","run095","RGR","BGB",2,1,3
"11492","run095","RGR","BGG",2,0,2
"11493","run095","RGR","BRR",1,0,1
"11494","run095","RGR","GGB",2,2,4
"11495","run095","RGR","RGG",1,0,1
"11496","run095","RRG","BBB",2,10,12
"11497","run095","RRG","BGB",1,1,2
"11498","run095","RRG","BRB",2,6,8
"11499","run095","RRG","BRR",1,5,6
"11500","run095","RRG","GGG",2,3,5
"11501","run095","RRG","GRG",1,0,1
"11502","run095","RRG","GRR",3,1,4
"11503","run095","RRG","RBB",1,0,1
"11504","run095","RRR","BBR",1,0,1
"11505","run095","RRR","BGB",2,0,2
"11506","run095","RRR","BGG",1,0,1
"11507","run095","RRR","BRB",1,0,1
"11508","run095","RRR","BRR",1,0,1
"11509","run095","RRR","RBB",1,0,1
"11510","run095","RRR","RGR",1,1,2
"11511","run095","RRR","RRG",2,0,2
"11512","run095","BBB","RRR",0,1,1
"11513","run095","BBG","GRR",0,1,1
"11514","run095","BBG","RBR",0,1,1
"11515","run095","BGB","RRG",0,1,1
"11516","run095","BGG","GRG",0,1,1
"11517","run095","BGG","RGR",0,1,1
"11518","run095","BRB","BBB",0,2,2
"11519","run095","BRB","RBB",0,1,1
"11520","run095","BRR","BBB",0,1,1
"11521","run095","GBB","BGG",0,1,1
"11522","run095","GBB","GBG",0,1,1
"11523","run095","GBB","GGB",0,3,3
"11524","run095","GBB","GRG",0,3,3
"11525","run095","GBG","RBG",0,1,1
"11526","run095","GGB","GGR",0,1,1
"11527","run095","GGB","GRR",0,1,1
"11528","run095","GGG","BGB",0,1,1
"11529","run095","GGG","BRR",0,2,2
"11530","run095","GGG","RBG",0,2,2
"11531","run095","GGG","RBR",0,1,1
"11532","run095","GGG","RGG",0,1,1
"11533","run095","GGG","RRR",0,1,1
"11534","run095","GRG","BBR",0,1,1
"11535","run095","GRR","BGG",0,1,1
"11536","run095","GRR","BRR",0,1,1
"11537","run095","GRR","GGR",0,1,1
"11538","run095","RBG","BRR",0,1,1
"11539","run095","RBR","BBB",0,1,1
"11540","run095","RBR","GGB",0,2,2
"11541","run095","RBR","RBB",0,1,1
"11542","run095","RGG","GRR",0,2,2
"11543","run095","RGR","RBB",0,1,1
"11544","run095","RGR","RRG",0,1,1
"11545","run095","RRG","GGR",0,1,1
"11546","run095","RRR","GGR",0,1,1
"11547","run095","RRR","RGG",0,1,1
"11548","run096","BBB","GGG",1,1,2
"11549","run096","BBB","RRG",1,0,1
"11550","run096","BBG","BBB",1,0,1
"11551","run096","BBG","BRB",1,3,4
"11552","run096","BBG","GBG",2,1,3
"11553","run096","BBG","GGB",2,4,6
"11554","run096","BBG","GGG",4,3,7
"11555","run096","BBG","GRG",1,5,6
"11556","run096","BBG","RRG",1,1,2
"11557","run096","BGG","RBG",1,0,1
"11558","run096","BGG","RRR",1,0,1
"11559","run096","BRR","BGB",1,0,1
"11560","run096","GBB","BBB",12,10,22
"11561","run096","GBB","BRB",1,2,3
"11562","run096","GBB","BRR",1,0,1
"11563","run096","GBB","GGG",7,7,14
"11564","run096","GBB","GGR",1,0,1
"11565","run096","GBB","RBG",3,3,6
"11566","run096","GBB","RBR",1,0,1
"11567","run096","GBB","RGG",1,0,1
"11568","run096","GBB","RGR",2,0,2
"11569","run096","GBB","RRR",1,1,2
"11570","run096","GBG","BRB",1,0,1
"11571","run096","GBG","BRR",1,0,1
"11572","run096","GBG","GGG",4,0,4
"11573","run096","GBG","RBB",1,0,1
"11574","run096","GBG","RGR",1,0,1
"11575","run096","GBG","RRG",1,0,1
"11576","run096","GGB","BBB",3,1,4
"11577","run096","GGB","BBR",1,0,1
"11578","run096","GGB","BRR",1,3,4
"11579","run096","GGB","GBG",1,0,1
"11580","run096","GGB","GGG",13,9,22
"11581","run096","GGB","RGG",1,1,2
"11582","run096","GGB","RRG",1,1,2
"11583","run096","GGB","RRR",1,1,2
"11584","run096","GGG","BBB",8,8,16
"11585","run096","GGG","BGG",1,1,2
"11586","run096","GGG","BRB",1,1,2
"11587","run096","GGG","GGB",5,0,5
"11588","run096","GGG","GGR",1,2,3
"11589","run096","GGG","RBB",1,1,2
"11590","run096","GGG","RGR",1,1,2
"11591","run096","GGG","RRG",1,4,5
"11592","run096","GGR","BRR",1,0,1
"11593","run096","GGR","GRR",1,0,1
"11594","run096","GRG","BBB",3,3,6
"11595","run096","GRG","GGB",2,2,4
"11596","run096","GRG","GGG",3,1,4
"11597","run096","GRG","RGR",1,0,1
"11598","run096","GRG","RRG",2,0,2
"11599","run096","GRR","BGB",1,1,2
"11600","run096","RBG","BBB",2,1,3
"11601","run096","RBG","RBB",1,0,1
"11602","run096","RBR","BGB",2,1,3
"11603","run096","RBR","BRB",1,0,1
"11604","run096","RBR","BRR",1,0,1
"11605","run096","RBR","GRR",4,2,6
"11606","run096","RBR","RGG",2,2,4
"11607","run096","RBR","RGR",1,0,1
"11608","run096","RGG","BBR",1,0,1
"11609","run096","RGR","BBB",2,0,2
"11610","run096","RGR","BBR",1,1,2
"11611","run096","RGR","BGB",2,0,2
"11612","run096","RGR","BGG",2,0,2
"11613","run096","RGR","BRR",1,0,1
"11614","run096","RGR","GGB",2,4,6
"11615","run096","RGR","RGG",1,0,1
"11616","run096","RRG","BBB",2,5,7
"11617","run096","RRG","BGB",1,1,2
"11618","run096","RRG","BRB",2,5,7
"11619","run096","RRG","BRR",1,0,1
"11620","run096","RRG","GGG",2,2,4
"11621","run096","RRG","GRG",1,0,1
"11622","run096","RRG","GRR",3,0,3
"11623","run096","RRG","RBB",1,0,1
"11624","run096","RRR","BBR",1,0,1
"11625","run096","RRR","BGB",2,0,2
"11626","run096","RRR","BGG",1,0,1
"11627","run096","RRR","BRB",1,0,1
"11628","run096","RRR","BRR",1,0,1
"11629","run096","RRR","RBB",1,0,1
"11630","run096","RRR","RGR",1,0,1
"11631","run096","RRR","RRG",2,2,4
"11632","run096","BBB","RRR",0,1,1
"11633","run096","BBG","RGR",0,1,1
"11634","run096","BGG","BBB",0,2,2
"11635","run096","BGG","BBR",0,1,1
"11636","run096","BRB","BBB",0,2,2
"11637","run096","BRB","BBR",0,1,1
"11638","run096","BRB","BRR",0,1,1
"11639","run096","BRR","BBB",0,1,1
"11640","run096","GBB","GBG",0,2,2
"11641","run096","GBB","GGB",0,4,4
"11642","run096","GBB","GRG",0,1,1
"11643","run096","GBG","BBB",0,1,1
"11644","run096","GBG","BBR",0,1,1
"11645","run096","GGB","BGG",0,1,1
"11646","run096","GGB","GGR",0,1,1
"11647","run096","GGB","GRR",0,1,1
"11648","run096","GGB","RBB",0,1,1
"11649","run096","GGB","RGR",0,2,2
"11650","run096","GGG","BGB",0,1,1
"11651","run096","GGG","BRR",0,2,2
"11652","run096","GGG","RBG",0,1,1
"11653","run096","GGG","RBR",0,2,2
"11654","run096","GGG","RGG",0,1,1
"11655","run096","GRR","BBB",0,1,1
"11656","run096","GRR","BBR",0,1,1
"11657","run096","GRR","GGR",0,1,1
"11658","run096","RBG","RGR",0,1,1
"11659","run096","RBR","BBB",0,6,6
"11660","run096","RBR","GGB",0,1,1
"11661","run096","RGG","GGG",0,1,1
"11662","run096","RGG","GRR",0,1,1
"11663","run096","RGR","RRG",0,1,1
"11664","run096","RRG","BBR",0,1,1
"11665","run096","RRG","BGG",0,1,1
"11666","run096","RRR","GRR",0,2,2
"11667","run096","RRR","RBR",0,1,1
"11668","run096","RRR","RGG",0,1,1
"11669","run097","BBB","GGG",1,1,2
"11670","run097","BBB","RRG",1,1,2
"11671","run097","BBG","BBB",1,0,1
"11672","run097","BBG","BRB",1,2,3
"11673","run097","BBG","GBG",2,3,5
"11674","run097","BBG","GGB",2,7,9
"11675","run097","BBG","GGG",4,6,10
"11676","run097","BBG","GRG",1,1,2
"11677","run097","BBG","RRG",1,0,1
"11678","run097","BGG","RBG",1,0,1
"11679","run097","BGG","RRR",1,0,1
"11680","run097","BRR","BGB",1,0,1
"11681","run097","GBB","BBB",12,3,15
"11682","run097","GBB","BRB",1,1,2
"11683","run097","GBB","BRR",1,1,2
"11684","run097","GBB","GGG",7,10,17
"11685","run097","GBB","GGR",1,0,1
"11686","run097","GBB","RBG",3,2,5
"11687","run097","GBB","RBR",1,0,1
"11688","run097","GBB","RGG",1,0,1
"11689","run097","GBB","RGR",2,0,2
"11690","run097","GBB","RRR",1,2,3
"11691","run097","GBG","BRB",1,1,2
"11692","run097","GBG","BRR",1,0,1
"11693","run097","GBG","GGG",4,0,4
"11694","run097","GBG","RBB",1,0,1
"11695","run097","GBG","RGR",1,0,1
"11696","run097","GBG","RRG",1,0,1
"11697","run097","GGB","BBB",3,4,7
"11698","run097","GGB","BBR",1,0,1
"11699","run097","GGB","BRR",1,3,4
"11700","run097","GGB","GBG",1,0,1
"11701","run097","GGB","GGG",13,6,19
"11702","run097","GGB","RGG",1,0,1
"11703","run097","GGB","RRG",1,1,2
"11704","run097","GGB","RRR",1,1,2
"11705","run097","GGG","BBB",8,5,13
"11706","run097","GGG","BGG",1,1,2
"11707","run097","GGG","BRB",1,0,1
"11708","run097","GGG","GGB",5,1,6
"11709","run097","GGG","GGR",1,1,2
"11710","run097","GGG","RBB",1,0,1
"11711","run097","GGG","RGR",1,2,3
"11712","run097","GGG","RRG",1,3,4
"11713","run097","GGR","BRR",1,0,1
"11714","run097","GGR","GRR",1,0,1
"11715","run097","GRG","BBB",3,1,4
"11716","run097","GRG","GGB",2,1,3
"11717","run097","GRG","GGG",3,1,4
"11718","run097","GRG","RGR",1,0,1
"11719","run097","GRG","RRG",2,2,4
"11720","run097","GRR","BGB",1,0,1
"11721","run097","RBG","BBB",2,1,3
"11722","run097","RBG","RBB",1,0,1
"11723","run097","RBR","BGB",2,0,2
"11724","run097","RBR","BRB",1,0,1
"11725","run097","RBR","BRR",1,1,2
"11726","run097","RBR","GRR",4,0,4
"11727","run097","RBR","RGG",2,2,4
"11728","run097","RBR","RGR",1,0,1
"11729","run097","RGG","BBR",1,1,2
"11730","run097","RGR","BBB",2,0,2
"11731","run097","RGR","BBR",1,0,1
"11732","run097","RGR","BGB",2,2,4
"11733","run097","RGR","BGG",2,0,2
"11734","run097","RGR","BRR",1,2,3
"11735","run097","RGR","GGB",2,0,2
"11736","run097","RGR","RGG",1,1,2
"11737","run097","RRG","BBB",2,10,12
"11738","run097","RRG","BGB",1,0,1
"11739","run097","RRG","BRB",2,6,8
"11740","run097","RRG","BRR",1,4,5
"11741","run097","RRG","GGG",2,2,4
"11742","run097","RRG","GRG",1,0,1
"11743","run097","RRG","GRR",3,3,6
"11744","run097","RRG","RBB",1,0,1
"11745","run097","RRR","BBR",1,0,1
"11746","run097","RRR","BGB",2,0,2
"11747","run097","RRR","BGG",1,0,1
"11748","run097","RRR","BRB",1,1,2
"11749","run097","RRR","BRR",1,0,1
"11750","run097","RRR","RBB",1,0,1
"11751","run097","RRR","RGR",1,1,2
"11752","run097","RRR","RRG",2,0,2
"11753","run097","BBB","GRR",0,1,1
"11754","run097","BBG","BGB",0,1,1
"11755","run097","BBG","RBB",0,1,1
"11756","run097","BBG","RBR",0,1,1
"11757","run097","BBG","RRR",0,1,1
"11758","run097","BGG","BBB",0,1,1
"11759","run097","BGG","BBR",0,1,1
"11760","run097","BGG","RGG",0,1,1
"11761","run097","BRB","BBB",0,2,2
"11762","run097","BRR","BBB",0,2,2
"11763","run097","GBB","BGG",0,1,1
"11764","run097","GBB","GGB",0,2,2
"11765","run097","GBB","GRG",0,2,2
"11766","run097","GBB","GRR",0,1,1
"11767","run097","GBB","RBB",0,1,1
"11768","run097","GGB","GGR",0,2,2
"11769","run097","GGB","RBG",0,3,3
"11770","run097","GGB","RBR",0,1,1
"11771","run097","GGG","BGB",0,1,1
"11772","run097","GGG","BRR",0,1,1
"11773","run097","GGG","RBG",0,2,2
"11774","run097","GGG","RRR",0,1,1
"11775","run097","GRG","BRB",0,1,1
"11776","run097","GRG","GGR",0,1,1
"11777","run097","GRG","GRR",0,1,1
"11778","run097","GRR","BGG",0,1,1
"11779","run097","RBG","GRR",0,1,1
"11780","run097","RBR","BBB",0,3,3
"11781","run097","RBR","GGB",0,2,2
"11782","run097","RBR","RBB",0,1,1
"11783","run097","RGG","BBB",0,1,1
"11784","run097","RGG","BRR",0,1,1
"11785","run097","RGG","GRR",0,3,3
"11786","run097","RGG","RBB",0,1,1
"11787","run097","RRG","GGR",0,1,1
"11788","run097","RRR","GRR",0,1,1
"11789","run098","BBB","GGG",1,1,2
"11790","run098","BBB","RRG",1,0,1
"11791","run098","BBG","BBB",1,0,1
"11792","run098","BBG","BRB",1,3,4
"11793","run098","BBG","GBG",2,1,3
"11794","run098","BBG","GGB",2,4,6
"11795","run098","BBG","GGG",4,6,10
"11796","run098","BBG","GRG",1,2,3
"11797","run098","BBG","RRG",1,0,1
"11798","run098","BGG","RBG",1,0,1
"11799","run098","BGG","RRR",1,0,1
"11800","run098","BRR","BGB",1,0,1
"11801","run098","GBB","BBB",12,1,13
"11802","run098","GBB","BRB",1,3,4
"11803","run098","GBB","BRR",1,0,1
"11804","run098","GBB","GGG",7,16,23
"11805","run098","GBB","GGR",1,0,1
"11806","run098","GBB","RBG",3,1,4
"11807","run098","GBB","RBR",1,0,1
"11808","run098","GBB","RGG",1,0,1
"11809","run098","GBB","RGR",2,0,2
"11810","run098","GBB","RRR",1,4,5
"11811","run098","GBG","BRB",1,0,1
"11812","run098","GBG","BRR",1,0,1
"11813","run098","GBG","GGG",4,1,5
"11814","run098","GBG","RBB",1,0,1
"11815","run098","GBG","RGR",1,1,2
"11816","run098","GBG","RRG",1,0,1
"11817","run098","GGB","BBB",3,0,3
"11818","run098","GGB","BBR",1,2,3
"11819","run098","GGB","BRR",1,1,2
"11820","run098","GGB","GBG",1,0,1
"11821","run098","GGB","GGG",13,9,22
"11822","run098","GGB","RGG",1,2,3
"11823","run098","GGB","RRG",1,0,1
"11824","run098","GGB","RRR",1,1,2
"11825","run098","GGG","BBB",8,6,14
"11826","run098","GGG","BGG",1,2,3
"11827","run098","GGG","BRB",1,1,2
"11828","run098","GGG","GGB",5,0,5
"11829","run098","GGG","GGR",1,0,1
"11830","run098","GGG","RBB",1,2,3
"11831","run098","GGG","RGR",1,2,3
"11832","run098","GGG","RRG",1,2,3
"11833","run098","GGR","BRR",1,0,1
"11834","run098","GGR","GRR",1,0,1
"11835","run098","GRG","BBB",3,1,4
"11836","run098","GRG","GGB",2,2,4
"11837","run098","GRG","GGG",3,0,3
"11838","run098","GRG","RGR",1,0,1
"11839","run098","GRG","RRG",2,0,2
"11840","run098","GRR","BGB",1,0,1
"11841","run098","RBG","BBB",2,1,3
"11842","run098","RBG","RBB",1,0,1
"11843","run098","RBR","BGB",2,0,2
"11844","run098","RBR","BRB",1,0,1
"11845","run098","RBR","BRR",1,1,2
"11846","run098","RBR","GRR",4,0,4
"11847","run098","RBR","RGG",2,2,4
"11848","run098","RBR","RGR",1,0,1
"11849","run098","RGG","BBR",1,1,2
"11850","run098","RGR","BBB",2,1,3
"11851","run098","RGR","BBR",1,0,1
"11852","run098","RGR","BGB",2,0,2
"11853","run098","RGR","BGG",2,0,2
"11854","run098","RGR","BRR",1,1,2
"11855","run098","RGR","GGB",2,1,3
"11856","run098","RGR","RGG",1,1,2
"11857","run098","RRG","BBB",2,5,7
"11858","run098","RRG","BGB",1,1,2
"11859","run098","RRG","BRB",2,6,8
"11860","run098","RRG","BRR",1,1,2
"11861","run098","RRG","GGG",2,3,5
"11862","run098","RRG","GRG",1,0,1
"11863","run098","RRG","GRR",3,2,5
"11864","run098","RRG","RBB",1,0,1
"11865","run098","RRR","BBR",1,0,1
"11866","run098","RRR","BGB",2,0,2
"11867","run098","RRR","BGG",1,0,1
"11868","run098","RRR","BRB",1,0,1
"11869","run098","RRR","BRR",1,0,1
"11870","run098","RRR","RBB",1,0,1
"11871","run098","RRR","RGR",1,0,1
"11872","run098","RRR","RRG",2,0,2
"11873","run098","BBB","GRR",0,1,1
"11874","run098","BGB","RRG",0,1,1
"11875","run098","BGG","RGG",0,2,2
"11876","run098","BRB","BBB",0,2,2
"11877","run098","BRB","RBB",0,1,1
"11878","run098","BRR","BRB",0,1,1
"11879","run098","GBB","GBG",0,1,1
"11880","run098","GBB","GGB",0,4,4
"11881","run098","GBB","GRG",0,1,1
"11882","run098","GBG","BBR",0,1,1
"11883","run098","GBG","RBG",0,1,1
"11884","run098","GGB","GGR",0,1,1
"11885","run098","GGB","RBB",0,1,1
"11886","run098","GGB","RBG",0,2,2
"11887","run098","GGG","BGB",0,1,1
"11888","run098","GGG","BRR",0,2,2
"11889","run098","GGG","RBG",0,1,1
"11890","run098","GGG","RBR",0,2,2
"11891","run098","GGG","RGG",0,1,1
"11892","run098","GGG","RRR",0,1,1
"11893","run098","GGR","BBB",0,1,1
"11894","run098","GGR","BGG",0,1,1
"11895","run098","GRG","BGG",0,1,1
"11896","run098","GRG","BRB",0,1,1
"11897","run098","GRG","GGR",0,1,1
"11898","run098","GRG","GRR",0,1,1
"11899","run098","GRG","RBR",0,1,1
"11900","run098","GRR","BBB",0,1,1
"11901","run098","GRR","BRR",0,2,2
"11902","run098","GRR","GGG",0,1,1
"11903","run098","RBB","BBB",0,1,1
"11904","run098","RBB","RGG",0,1,1
"11905","run098","RBG","BBG",0,1,1
"11906","run098","RBR","BBB",0,3,3
"11907","run098","RBR","GGB",0,1,1
"11908","run098","RBR","RBB",0,1,1
"11909","run098","RGG","BGB",0,1,1
"11910","run098","RGG","GGG",0,1,1
"11911","run098","RGG","GGR",0,1,1
"11912","run098","RGG","GRR",0,1,1
"11913","run098","RGG","RBB",0,1,1
"11914","run098","RGR","GGG",0,1,1
"11915","run098","RGR","RBB",0,1,1
"11916","run098","RRG","GGR",0,1,1
"11917","run098","RRG","RGR",0,1,1
"11918","run099","BBB","GGG",1,0,1
"11919","run099","BBB","RRG",1,0,1
"11920","run099","BBG","BBB",1,2,3
"11921","run099","BBG","BRB",1,2,3
"11922","run099","BBG","GBG",2,1,3
"11923","run099","BBG","GGB",2,3,5
"11924","run099","BBG","GGG",4,5,9
"11925","run099","BBG","GRG",1,0,1
"11926","run099","BBG","RRG",1,0,1
"11927","run099","BGG","RBG",1,0,1
"11928","run099","BGG","RRR",1,0,1
"11929","run099","BRR","BGB",1,1,2
"11930","run099","GBB","BBB",12,6,18
"11931","run099","GBB","BRB",1,0,1
"11932","run099","GBB","BRR",1,0,1
"11933","run099","GBB","GGG",7,13,20
"11934","run099","GBB","GGR",1,0,1
"11935","run099","GBB","RBG",3,1,4
"11936","run099","GBB","RBR",1,0,1
"11937","run099","GBB","RGG",1,0,1
"11938","run099","GBB","RGR",2,0,2
"11939","run099","GBB","RRR",1,3,4
"11940","run099","GBG","BRB",1,1,2
"11941","run099","GBG","BRR",1,0,1
"11942","run099","GBG","GGG",4,3,7
"11943","run099","GBG","RBB",1,0,1
"11944","run099","GBG","RGR",1,0,1
"11945","run099","GBG","RRG",1,0,1
"11946","run099","GGB","BBB",3,3,6
"11947","run099","GGB","BBR",1,0,1
"11948","run099","GGB","BRR",1,5,6
"11949","run099","GGB","GBG",1,0,1
"11950","run099","GGB","GGG",13,4,17
"11951","run099","GGB","RGG",1,3,4
"11952","run099","GGB","RRG",1,0,1
"11953","run099","GGB","RRR",1,1,2
"11954","run099","GGG","BBB",8,7,15
"11955","run099","GGG","BGG",1,1,2
"11956","run099","GGG","BRB",1,0,1
"11957","run099","GGG","GGB",5,0,5
"11958","run099","GGG","GGR",1,1,2
"11959","run099","GGG","RBB",1,2,3
"11960","run099","GGG","RGR",1,2,3
"11961","run099","GGG","RRG",1,5,6
"11962","run099","GGR","BRR",1,0,1
"11963","run099","GGR","GRR",1,0,1
"11964","run099","GRG","BBB",3,0,3
"11965","run099","GRG","GGB",2,2,4
"11966","run099","GRG","GGG",3,1,4
"11967","run099","GRG","RGR",1,0,1
"11968","run099","GRG","RRG",2,1,3
"11969","run099","GRR","BGB",1,0,1
"11970","run099","RBG","BBB",2,1,3
"11971","run099","RBG","RBB",1,0,1
"11972","run099","RBR","BGB",2,1,3
"11973","run099","RBR","BRB",1,0,1
"11974","run099","RBR","BRR",1,0,1
"11975","run099","RBR","GRR",4,1,5
"11976","run099","RBR","RGG",2,3,5
"11977","run099","RBR","RGR",1,0,1
"11978","run099","RGG","BBR",1,0,1
"11979","run099","RGR","BBB",2,0,2
"11980","run099","RGR","BBR",1,0,1
"11981","run099","RGR","BGB",2,0,2
"11982","run099","RGR","BGG",2,0,2
"11983","run099","RGR","BRR",1,2,3
"11984","run099","RGR","GGB",2,2,4
"11985","run099","RGR","RGG",1,0,1
"11986","run099","RRG","BBB",2,6,8
"11987","run099","RRG","BGB",1,1,2
"11988","run099","RRG","BRB",2,9,11
"11989","run099","RRG","BRR",1,3,4
"11990","run099","RRG","GGG",2,0,2
"11991","run099","RRG","GRG",1,0,1
"11992","run099","RRG","GRR",3,1,4
"11993","run099","RRG","RBB",1,0,1
"11994","run099","RRR","BBR",1,0,1
"11995","run099","RRR","BGB",2,0,2
"11996","run099","RRR","BGG",1,0,1
"11997","run099","RRR","BRB",1,1,2
"11998","run099","RRR","BRR",1,0,1
"11999","run099","RRR","RBB",1,0,1
"12000","run099","RRR","RGR",1,0,1
"12001","run099","RRR","RRG",2,1,3
"12002","run099","BBG","BGG",0,1,1
"12003","run099","BBG","GRR",0,1,1
"12004","run099","BBG","RRR",0,2,2
"12005","run099","BGG","BBB",0,2,2
"12006","run099","BGG","RGG",0,1,1
"12007","run099","BRB","BBB",0,2,2
"12008","run099","BRR","BBB",0,2,2
"12009","run099","BRR","BRB",0,1,1
"12010","run099","GBB","GBG",0,1,1
"12011","run099","GBB","GGB",0,4,4
"12012","run099","GBB","RBB",0,1,1
"12013","run099","GBG","BBB",0,1,1
"12014","run099","GBG","RGG",0,1,1
"12015","run099","GGB","BGG",0,1,1
"12016","run099","GGB","GGR",0,1,1
"12017","run099","GGB","GRR",0,1,1
"12018","run099","GGB","RBB",0,1,1
"12019","run099","GGB","RGR",0,1,1
"12020","run099","GGG","RBR",0,2,2
"12021","run099","GRG","BGG",0,1,1
"12022","run099","GRG","BRB",0,1,1
"12023","run099","GRG","GGR",0,2,2
"12024","run099","GRG","RBG",0,1,1
"12025","run099","GRR","BBR",0,1,1
"12026","run099","GRR","BRR",0,1,1
"12027","run099","GRR","GGR",0,1,1
"12028","run099","RBB","GRR",0,1,1
"12029","run099","RBR","BGG",0,1,1
"12030","run099","RBR","GGB",0,2,2
"12031","run099","RBR","RBB",0,1,1
"12032","run099","RGG","BRR",0,1,1
"12033","run099","RGR","RRG",0,1,1
"12034","run099","RRG","BBR",0,3,3
"12035","run099","RRG","GGR",0,2,2
"12036","run099","RRR","GRR",0,1,1
"12037","run099","RRR","RBR",0,1,1
"12038","run100","BBB","GGG",1,0,1
"12039","run100","BBB","RRG",1,0,1
"12040","run100","BBG","BBB",1,0,1
"12041","run100","BBG","BRB",1,2,3
"12042","run100","BBG","GBG",2,2,4
"12043","run100","BBG","GGB",2,2,4
"12044","run100","BBG","GGG",4,7,11
"12045","run100","BBG","GRG",1,2,3
"12046","run100","BBG","RRG",1,0,1
"12047","run100","BGG","RBG",1,0,1
"12048","run100","BGG","RRR",1,0,1
"12049","run100","BRR","BGB",1,0,1
"12050","run100","GBB","BBB",12,7,19
"12051","run100","GBB","BRB",1,2,3
"12052","run100","GBB","BRR",1,0,1
"12053","run100","GBB","GGG",7,11,18
"12054","run100","GBB","GGR",1,1,2
"12055","run100","GBB","RBG",3,1,4
"12056","run100","GBB","RBR",1,0,1
"12057","run100","GBB","RGG",1,0,1
"12058","run100","GBB","RGR",2,0,2
"12059","run100","GBB","RRR",1,0,1
"12060","run100","GBG","BRB",1,2,3
"12061","run100","GBG","BRR",1,0,1
"12062","run100","GBG","GGG",4,0,4
"12063","run100","GBG","RBB",1,0,1
"12064","run100","GBG","RGR",1,0,1
"12065","run100","GBG","RRG",1,1,2
"12066","run100","GGB","BBB",3,3,6
"12067","run100","GGB","BBR",1,0,1
"12068","run100","GGB","BRR",1,2,3
"12069","run100","GGB","GBG",1,0,1
"12070","run100","GGB","GGG",13,10,23
"12071","run100","GGB","RGG",1,0,1
"12072","run100","GGB","RRG",1,1,2
"12073","run100","GGB","RRR",1,1,2
"12074","run100","GGG","BBB",8,3,11
"12075","run100","GGG","BGG",1,1,2
"12076","run100","GGG","BRB",1,2,3
"12077","run100","GGG","GGB",5,1,6
"12078","run100","GGG","GGR",1,0,1
"12079","run100","GGG","RBB",1,2,3
"12080","run100","GGG","RGR",1,1,2
"12081","run100","GGG","RRG",1,2,3
"12082","run100","GGR","BRR",1,0,1
"12083","run100","GGR","GRR",1,0,1
"12084","run100","GRG","BBB",3,3,6
"12085","run100","GRG","GGB",2,5,7
"12086","run100","GRG","GGG",3,1,4
"12087","run100","GRG","RGR",1,0,1
"12088","run100","GRG","RRG",2,1,3
"12089","run100","GRR","BGB",1,0,1
"12090","run100","RBG","BBB",2,0,2
"12091","run100","RBG","RBB",1,0,1
"12092","run100","RBR","BGB",2,0,2
"12093","run100","RBR","BRB",1,0,1
"12094","run100","RBR","BRR",1,3,4
"12095","run100","RBR","GRR",4,1,5
"12096","run100","RBR","RGG",2,4,6
"12097","run100","RBR","RGR",1,0,1
"12098","run100","RGG","BBR",1,0,1
"12099","run100","RGR","BBB",2,2,4
"12100","run100","RGR","BBR",1,0,1
"12101","run100","RGR","BGB",2,1,3
"12102","run100","RGR","BGG",2,0,2
"12103","run100","RGR","BRR",1,1,2
"12104","run100","RGR","GGB",2,1,3
"12105","run100","RGR","RGG",1,0,1
"12106","run100","RRG","BBB",2,4,6
"12107","run100","RRG","BGB",1,2,3
"12108","run100","RRG","BRB",2,5,7
"12109","run100","RRG","BRR",1,0,1
"12110","run100","RRG","GGG",2,2,4
"12111","run100","RRG","GRG",1,0,1
"12112","run100","RRG","GRR",3,3,6
"12113","run100","RRG","RBB",1,0,1
"12114","run100","RRR","BBR",1,0,1
"12115","run100","RRR","BGB",2,0,2
"12116","run100","RRR","BGG",1,0,1
"12117","run100","RRR","BRB",1,1,2
"12118","run100","RRR","BRR",1,0,1
"12119","run100","RRR","RBB",1,0,1
"12120","run100","RRR","RGR",1,0,1
"12121","run100","RRR","RRG",2,0,2
"12122","run100","BBG","RRR",0,2,2
"12123","run100","BGG","RGG",0,1,1
"12124","run100","BRB","BBB",0,5,5
"12125","run100","BRB","GGR",0,1,1
"12126","run100","BRB","RBB",0,1,1
"12127","run100","BRB","RGR",0,1,1
"12128","run100","BRR","BBB",0,1,1
"12129","run100","GBB","BGG",0,1,1
"12130","run100","GBB","GBG",0,1,1
"12131","run100","GBB","GGB",0,1,1
"12132","run100","GBB","GRG",0,1,1
"12133","run100","GBB","GRR",0,1,1
"12134","run100","GBG","GGB",0,1,1
"12135","run100","GBG","RGG",0,1,1
"12136","run100","GGB","BGG",0,1,1
"12137","run100","GGB","GGR",0,1,1
"12138","run100","GGB","GRR",0,1,1
"12139","run100","GGB","RBB",0,1,1
"12140","run100","GGB","RBR",0,1,1
"12141","run100","GGG","GRR",0,1,1
"12142","run100","GGG","RBR",0,4,4
"12143","run100","GGG","RGG",0,1,1
"12144","run100","GRG","GBG",0,1,1
"12145","run100","GRG","GGR",0,1,1
"12146","run100","GRG","RBR",0,1,1
"12147","run100","GRR","BRR",0,1,1
"12148","run100","RBB","BBB",0,1,1
"12149","run100","RBG","GRR",0,1,1
"12150","run100","RBR","BBB",0,5,5
"12151","run100","RBR","GGB",0,1,1
"12152","run100","RGG","BRR",0,1,1
"12153","run100","RGG","GRR",0,1,1
"12154","run100","RGR","GGR",0,1,1
"12155","run100","RGR","RBB",0,2,2
"12156","run100","RRG","BBR",0,1,1
"12157","run100","RRG","GGR",0,1,1
"12158","run100","RRG","RGR",0,1,1
"12159","run100","RRR","RGG",0,1,1
