;actor;subject;observed.crowd;observed.displace;observed.totalCD;random.displace;random.crowd;runID
1;BBB;GRR;0;1;1;0;1;run001
2;BBG;BBB;1;9;10;3;7;run001
3;BBG;BBR;0;2;2;2;0;run001
4;BBG;BGB;0;1;1;0;1;run001
5;BBG;BGG;0;1;1;1;0;run001
6;BBG;BRB;0;2;2;0;2;run001
7;BBG;BRR;0;1;1;0;1;run001
8;BBG;GBB;1;1;2;2;0;run001
9;BBG;GBG;1;6;7;5;2;run001
10;BBG;GGB;0;18;18;17;1;run001
11;BBG;GGG;1;29;30;26;4;run001
12;BBG;GGR;0;2;2;2;0;run001
13;BBG;GRG;0;1;1;0;1;run001
14;BBG;GRR;0;3;3;0;3;run001
15;BBG;RBR;0;2;2;0;2;run001
16;BBG;RGR;0;2;2;1;1;run001
17;BBG;RRG;1;2;3;1;2;run001
18;BBG;RRR;0;1;1;1;0;run001
19;BGG;BBB;0;1;1;1;0;run001
20;BGG;BRB;0;1;1;0;1;run001
21;BGG;GGG;0;1;1;0;1;run001
22;BGG;RBB;0;1;1;0;1;run001
23;BGG;RBG;1;0;1;0;1;run001
24;BRB;BBB;0;1;1;0;1;run001
25;BRB;GGB;1;0;1;0;1;run001
26;BRB;GGG;0;2;2;0;2;run001
27;BRB;RBB;1;0;1;1;0;run001
28;BRR;BBB;0;1;1;0;1;run001
29;BRR;BRB;0;1;1;0;1;run001
30;BRR;GBB;1;0;1;1;0;run001
31;GBB;BBB;1;16;17;9;8;run001
32;GBB;BBG;0;2;2;1;1;run001
33;GBB;BGB;0;1;1;0;1;run001
34;GBB;BGG;0;3;3;3;0;run001
35;GBB;BRB;0;9;9;0;9;run001
36;GBB;BRR;0;2;2;2;0;run001
37;GBB;GBG;1;1;2;1;1;run001
38;GBB;GGB;2;59;61;9;52;run001
39;GBB;GGG;4;95;99;41;58;run001
40;GBB;GGR;0;1;1;1;0;run001
41;GBB;GRG;0;1;1;0;1;run001
42;GBB;GRR;1;8;9;3;6;run001
43;GBB;RBB;0;2;2;1;1;run001
44;GBB;RBG;0;1;1;1;0;run001
45;GBB;RBR;1;1;2;0;2;run001
46;GBB;RGG;0;2;2;2;0;run001
47;GBB;RGR;0;1;1;1;0;run001
48;GBB;RRG;0;3;3;0;3;run001
49;GBG;BRB;0;1;1;1;0;run001
50;GBG;BRR;0;3;3;3;0;run001
51;GBG;GGB;0;1;1;0;1;run001
52;GBG;GGR;0;3;3;2;1;run001
53;GBG;RBR;0;1;1;1;0;run001
54;GBG;RGR;1;1;2;1;1;run001
55;GBG;RRR;0;1;1;1;0;run001
56;GGB;BBB;1;8;9;6;3;run001
57;GGB;BBG;0;1;1;0;1;run001
58;GGB;BGB;0;1;1;1;0;run001
59;GGB;BRB;3;5;8;5;3;run001
60;GGB;BRR;0;1;1;1;0;run001
61;GGB;GBG;0;2;2;1;1;run001
62;GGB;GGG;4;37;41;1;40;run001
63;GGB;GGR;0;9;9;1;8;run001
64;GGB;GRR;1;4;5;5;0;run001
65;GGB;RBB;0;2;2;1;1;run001
66;GGB;RBG;0;2;2;1;1;run001
67;GGB;RBR;0;2;2;0;2;run001
68;GGB;RGG;0;1;1;0;1;run001
69;GGB;RGR;1;2;3;2;1;run001
70;GGB;RRG;1;3;4;3;1;run001
71;GGB;RRR;0;3;3;1;2;run001
72;GGG;BBB;4;22;26;7;19;run001
73;GGG;BBG;0;2;2;2;0;run001
74;GGG;BBR;0;3;3;2;1;run001
75;GGG;BGB;0;2;2;0;2;run001
76;GGG;BGG;0;3;3;3;0;run001
77;GGG;BRB;0;3;3;0;3;run001
78;GGG;BRR;0;3;3;3;0;run001
79;GGG;GBB;0;1;1;0;1;run001
80;GGG;GGB;1;3;4;0;4;run001
81;GGG;GGR;0;21;21;13;8;run001
82;GGG;GRG;0;2;2;2;0;run001
83;GGG;GRR;2;15;17;12;5;run001
84;GGG;RBB;0;1;1;1;0;run001
85;GGG;RBR;1;4;5;5;0;run001
86;GGG;RGG;1;7;8;0;8;run001
87;GGG;RGR;0;3;3;0;3;run001
88;GGG;RRG;0;2;2;0;2;run001
89;GGG;RRR;0;1;1;0;1;run001
90;GGR;BBB;0;1;1;1;0;run001
91;GGR;BGG;0;2;2;0;2;run001
92;GGR;BRB;0;1;1;0;1;run001
93;GRG;BBB;0;3;3;2;1;run001
94;GRG;BGB;0;3;3;2;1;run001
95;GRG;BGG;0;1;1;0;1;run001
96;GRG;BRB;0;5;5;5;0;run001
97;GRG;BRR;0;1;1;1;0;run001
98;GRG;GBB;0;3;3;1;2;run001
99;GRG;GGB;0;14;14;10;4;run001
100;GRG;GGG;0;10;10;9;1;run001
101;GRG;GGR;0;2;2;2;0;run001
102;GRG;GRR;0;1;1;0;1;run001
103;GRG;RBR;1;2;3;3;0;run001
104;GRG;RGG;0;2;2;2;0;run001
105;GRG;RGR;0;1;1;0;1;run001
106;GRR;BBB;0;3;3;1;2;run001
107;GRR;BBR;0;2;2;1;1;run001
108;GRR;BRB;1;8;9;0;9;run001
109;GRR;BRR;1;6;7;2;5;run001
110;GRR;GBB;0;1;1;0;1;run001
111;GRR;GBG;0;1;1;1;0;run001
112;GRR;GGR;1;9;10;9;1;run001
113;GRR;RBR;0;1;1;0;1;run001
114;GRR;RGG;1;3;4;1;3;run001
115;GRR;RGR;0;1;1;1;0;run001
116;GRR;RRR;0;1;1;0;1;run001
117;RBB;BBB;0;1;1;1;0;run001
118;RBB;GGG;0;3;3;2;1;run001
119;RBG;GRR;0;1;1;0;1;run001
120;RBG;RBR;0;1;1;1;0;run001
121;RBG;RGR;0;1;1;0;1;run001
122;RBR;BBB;0;3;3;3;0;run001
123;RBR;BRB;0;1;1;1;0;run001
124;RBR;BRR;0;2;2;0;2;run001
125;RBR;GGG;0;1;1;0;1;run001
126;RBR;GGR;1;2;3;1;2;run001
127;RBR;GRG;0;1;1;0;1;run001
128;RBR;GRR;1;15;16;10;6;run001
129;RBR;RGG;0;4;4;0;4;run001
130;RBR;RGR;0;1;1;0;1;run001
131;RBR;RRR;0;3;3;1;2;run001
132;RGG;BGG;0;1;1;1;0;run001
133;RGG;RGR;0;1;1;1;0;run001
134;RGR;BBB;0;9;9;3;6;run001
135;RGR;BBR;0;1;1;0;1;run001
136;RGR;BGB;1;8;9;4;5;run001
137;RGR;BRB;0;3;3;0;3;run001
138;RGR;BRR;0;3;3;1;2;run001
139;RGR;GBG;0;1;1;0;1;run001
140;RGR;GGB;0;3;3;2;1;run001
141;RGR;GGG;0;2;2;1;1;run001
142;RGR;GGR;0;8;8;2;6;run001
143;RGR;GRR;1;7;8;6;2;run001
144;RGR;RGG;0;6;6;5;1;run001
145;RRG;BGB;0;1;1;0;1;run001
146;RRG;BRB;0;1;1;0;1;run001
147;RRG;GGG;0;1;1;1;0;run001
148;RRG;GGR;0;1;1;0;1;run001
149;RRG;GRG;0;1;1;0;1;run001
150;RRG;GRR;0;3;3;3;0;run001
151;RRG;RBR;0;4;4;1;3;run001
152;RRG;RGG;0;1;1;1;0;run001
153;RRG;RGR;6;37;43;26;17;run001
154;RRR;BRR;0;1;1;0;1;run001
155;RRR;GGB;0;1;1;0;1;run001
156;RRR;GGG;1;5;6;3;3;run001
157;RRR;GGR;0;2;2;0;2;run001
158;RRR;GRR;0;1;1;1;0;run001
159;RRR;RGR;0;1;1;0;1;run001
160;BBB;GRR;0;1;1;0;1;run002
161;BBG;BBB;1;9;10;5;5;run002
162;BBG;BBR;0;2;2;1;1;run002
163;BBG;BGB;0;1;1;1;0;run002
164;BBG;BGG;0;1;1;1;0;run002
165;BBG;BRB;0;2;2;0;2;run002
166;BBG;BRR;0;1;1;0;1;run002
167;BBG;GBB;1;1;2;0;2;run002
168;BBG;GBG;1;6;7;3;4;run002
169;BBG;GGB;0;18;18;8;10;run002
170;BBG;GGG;1;29;30;17;13;run002
171;BBG;GGR;0;2;2;2;0;run002
172;BBG;GRG;0;1;1;0;1;run002
173;BBG;GRR;0;3;3;2;1;run002
174;BBG;RBR;0;2;2;1;1;run002
175;BBG;RGR;0;2;2;1;1;run002
176;BBG;RRG;1;2;3;2;1;run002
177;BBG;RRR;0;1;1;0;1;run002
178;BGG;BBB;0;1;1;0;1;run002
179;BGG;BRB;0;1;1;1;0;run002
180;BGG;GGG;0;1;1;0;1;run002
181;BGG;RBB;0;1;1;0;1;run002
182;BGG;RBG;1;0;1;1;0;run002
183;BRB;BBB;0;1;1;0;1;run002
184;BRB;GGB;1;0;1;1;0;run002
185;BRB;GGG;0;2;2;2;0;run002
186;BRB;RBB;1;0;1;1;0;run002
187;BRR;BBB;0;1;1;0;1;run002
188;BRR;BRB;0;1;1;1;0;run002
189;BRR;GBB;1;0;1;1;0;run002
190;GBB;BBB;1;16;17;15;2;run002
191;GBB;BBG;0;2;2;0;2;run002
192;GBB;BGB;0;1;1;1;0;run002
193;GBB;BGG;0;3;3;3;0;run002
194;GBB;BRB;0;9;9;5;4;run002
195;GBB;BRR;0;2;2;2;0;run002
196;GBB;GBG;1;1;2;0;2;run002
197;GBB;GGB;2;59;61;54;7;run002
198;GBB;GGG;4;95;99;71;28;run002
199;GBB;GGR;0;1;1;0;1;run002
200;GBB;GRG;0;1;1;0;1;run002
201;GBB;GRR;1;8;9;5;4;run002
202;GBB;RBB;0;2;2;1;1;run002
203;GBB;RBG;0;1;1;1;0;run002
204;GBB;RBR;1;1;2;2;0;run002
205;GBB;RGG;0;2;2;1;1;run002
206;GBB;RGR;0;1;1;0;1;run002
207;GBB;RRG;0;3;3;3;0;run002
208;GBG;BRB;0;1;1;0;1;run002
209;GBG;BRR;0;3;3;0;3;run002
210;GBG;GGB;0;1;1;0;1;run002
211;GBG;GGR;0;3;3;3;0;run002
212;GBG;RBR;0;1;1;0;1;run002
213;GBG;RGR;1;1;2;0;2;run002
214;GBG;RRR;0;1;1;0;1;run002
215;GGB;BBB;1;8;9;0;9;run002
216;GGB;BBG;0;1;1;1;0;run002
217;GGB;BGB;0;1;1;1;0;run002
218;GGB;BRB;3;5;8;3;5;run002
219;GGB;BRR;0;1;1;0;1;run002
220;GGB;GBG;0;2;2;1;1;run002
221;GGB;GGG;4;37;41;36;5;run002
222;GGB;GGR;0;9;9;1;8;run002
223;GGB;GRR;1;4;5;4;1;run002
224;GGB;RBB;0;2;2;1;1;run002
225;GGB;RBG;0;2;2;0;2;run002
226;GGB;RBR;0;2;2;2;0;run002
227;GGB;RGG;0;1;1;1;0;run002
228;GGB;RGR;1;2;3;1;2;run002
229;GGB;RRG;1;3;4;3;1;run002
230;GGB;RRR;0;3;3;3;0;run002
231;GGG;BBB;4;22;26;3;23;run002
232;GGG;BBG;0;2;2;0;2;run002
233;GGG;BBR;0;3;3;1;2;run002
234;GGG;BGB;0;2;2;2;0;run002
235;GGG;BGG;0;3;3;1;2;run002
236;GGG;BRB;0;3;3;1;2;run002
237;GGG;BRR;0;3;3;1;2;run002
238;GGG;GBB;0;1;1;1;0;run002
239;GGG;GGB;1;3;4;2;2;run002
240;GGG;GGR;0;21;21;14;7;run002
241;GGG;GRG;0;2;2;0;2;run002
242;GGG;GRR;2;15;17;2;15;run002
243;GGG;RBB;0;1;1;1;0;run002
244;GGG;RBR;1;4;5;5;0;run002
245;GGG;RGG;1;7;8;0;8;run002
246;GGG;RGR;0;3;3;0;3;run002
247;GGG;RRG;0;2;2;1;1;run002
248;GGG;RRR;0;1;1;0;1;run002
249;GGR;BBB;0;1;1;1;0;run002
250;GGR;BGG;0;2;2;0;2;run002
251;GGR;BRB;0;1;1;0;1;run002
252;GRG;BBB;0;3;3;3;0;run002
253;GRG;BGB;0;3;3;2;1;run002
254;GRG;BGG;0;1;1;1;0;run002
255;GRG;BRB;0;5;5;0;5;run002
256;GRG;BRR;0;1;1;1;0;run002
257;GRG;GBB;0;3;3;0;3;run002
258;GRG;GGB;0;14;14;14;0;run002
259;GRG;GGG;0;10;10;4;6;run002
260;GRG;GGR;0;2;2;2;0;run002
261;GRG;GRR;0;1;1;0;1;run002
262;GRG;RBR;1;2;3;2;1;run002
263;GRG;RGG;0;2;2;1;1;run002
264;GRG;RGR;0;1;1;1;0;run002
265;GRR;BBB;0;3;3;0;3;run002
266;GRR;BBR;0;2;2;2;0;run002
267;GRR;BRB;1;8;9;0;9;run002
268;GRR;BRR;1;6;7;3;4;run002
269;GRR;GBB;0;1;1;0;1;run002
270;GRR;GBG;0;1;1;1;0;run002
271;GRR;GGR;1;9;10;1;9;run002
272;GRR;RBR;0;1;1;0;1;run002
273;GRR;RGG;1;3;4;3;1;run002
274;GRR;RGR;0;1;1;1;0;run002
275;GRR;RRR;0;1;1;0;1;run002
276;RBB;BBB;0;1;1;1;0;run002
277;RBB;GGG;0;3;3;1;2;run002
278;RBG;GRR;0;1;1;1;0;run002
279;RBG;RBR;0;1;1;0;1;run002
280;RBG;RGR;0;1;1;0;1;run002
281;RBR;BBB;0;3;3;1;2;run002
282;RBR;BRB;0;1;1;0;1;run002
283;RBR;BRR;0;2;2;1;1;run002
284;RBR;GGG;0;1;1;0;1;run002
285;RBR;GGR;1;2;3;3;0;run002
286;RBR;GRG;0;1;1;0;1;run002
287;RBR;GRR;1;15;16;4;12;run002
288;RBR;RGG;0;4;4;3;1;run002
289;RBR;RGR;0;1;1;0;1;run002
290;RBR;RRR;0;3;3;2;1;run002
291;RGG;BGG;0;1;1;0;1;run002
292;RGG;RGR;0;1;1;0;1;run002
293;RGR;BBB;0;9;9;4;5;run002
294;RGR;BBR;0;1;1;1;0;run002
295;RGR;BGB;1;8;9;2;7;run002
296;RGR;BRB;0;3;3;2;1;run002
297;RGR;BRR;0;3;3;3;0;run002
298;RGR;GBG;0;1;1;0;1;run002
299;RGR;GGB;0;3;3;2;1;run002
300;RGR;GGG;0;2;2;2;0;run002
301;RGR;GGR;0;8;8;8;0;run002
302;RGR;GRR;1;7;8;4;4;run002
303;RGR;RGG;0;6;6;2;4;run002
304;RRG;BGB;0;1;1;1;0;run002
305;RRG;BRB;0;1;1;0;1;run002
306;RRG;GGG;0;1;1;1;0;run002
307;RRG;GGR;0;1;1;0;1;run002
308;RRG;GRG;0;1;1;1;0;run002
309;RRG;GRR;0;3;3;1;2;run002
310;RRG;RBR;0;4;4;1;3;run002
311;RRG;RGG;0;1;1;0;1;run002
312;RRG;RGR;6;37;43;31;12;run002
313;RRR;BRR;0;1;1;0;1;run002
314;RRR;GGB;0;1;1;0;1;run002
315;RRR;GGG;1;5;6;0;6;run002
316;RRR;GGR;0;2;2;2;0;run002
317;RRR;GRR;0;1;1;0;1;run002
318;RRR;RGR;0;1;1;0;1;run002
319;BBB;GRR;0;1;1;0;1;run003
320;BBG;BBB;1;9;10;9;1;run003
321;BBG;BBR;0;2;2;2;0;run003
322;BBG;BGB;0;1;1;1;0;run003
323;BBG;BGG;0;1;1;1;0;run003
324;BBG;BRB;0;2;2;2;0;run003
325;BBG;BRR;0;1;1;0;1;run003
326;BBG;GBB;1;1;2;1;1;run003
327;BBG;GBG;1;6;7;6;1;run003
328;BBG;GGB;0;18;18;7;11;run003
329;BBG;GGG;1;29;30;15;15;run003
330;BBG;GGR;0;2;2;0;2;run003
331;BBG;GRG;0;1;1;1;0;run003
332;BBG;GRR;0;3;3;0;3;run003
333;BBG;RBR;0;2;2;0;2;run003
334;BBG;RGR;0;2;2;0;2;run003
335;BBG;RRG;1;2;3;3;0;run003
336;BBG;RRR;0;1;1;0;1;run003
337;BGG;BBB;0;1;1;0;1;run003
338;BGG;BRB;0;1;1;0;1;run003
339;BGG;GGG;0;1;1;1;0;run003
340;BGG;RBB;0;1;1;1;0;run003
341;BGG;RBG;1;0;1;1;0;run003
342;BRB;BBB;0;1;1;1;0;run003
343;BRB;GGB;1;0;1;1;0;run003
344;BRB;GGG;0;2;2;0;2;run003
345;BRB;RBB;1;0;1;1;0;run003
346;BRR;BBB;0;1;1;1;0;run003
347;BRR;BRB;0;1;1;1;0;run003
348;BRR;GBB;1;0;1;1;0;run003
349;GBB;BBB;1;16;17;5;12;run003
350;GBB;BBG;0;2;2;2;0;run003
351;GBB;BGB;0;1;1;1;0;run003
352;GBB;BGG;0;3;3;2;1;run003
353;GBB;BRB;0;9;9;6;3;run003
354;GBB;BRR;0;2;2;2;0;run003
355;GBB;GBG;1;1;2;1;1;run003
356;GBB;GGB;2;59;61;36;25;run003
357;GBB;GGG;4;95;99;53;46;run003
358;GBB;GGR;0;1;1;1;0;run003
359;GBB;GRG;0;1;1;1;0;run003
360;GBB;GRR;1;8;9;3;6;run003
361;GBB;RBB;0;2;2;0;2;run003
362;GBB;RBG;0;1;1;0;1;run003
363;GBB;RBR;1;1;2;1;1;run003
364;GBB;RGG;0;2;2;0;2;run003
365;GBB;RGR;0;1;1;1;0;run003
366;GBB;RRG;0;3;3;0;3;run003
367;GBG;BRB;0;1;1;1;0;run003
368;GBG;BRR;0;3;3;2;1;run003
369;GBG;GGB;0;1;1;1;0;run003
370;GBG;GGR;0;3;3;0;3;run003
371;GBG;RBR;0;1;1;0;1;run003
372;GBG;RGR;1;1;2;0;2;run003
373;GBG;RRR;0;1;1;0;1;run003
374;GGB;BBB;1;8;9;4;5;run003
375;GGB;BBG;0;1;1;1;0;run003
376;GGB;BGB;0;1;1;1;0;run003
377;GGB;BRB;3;5;8;5;3;run003
378;GGB;BRR;0;1;1;0;1;run003
379;GGB;GBG;0;2;2;2;0;run003
380;GGB;GGG;4;37;41;39;2;run003
381;GGB;GGR;0;9;9;9;0;run003
382;GGB;GRR;1;4;5;3;2;run003
383;GGB;RBB;0;2;2;1;1;run003
384;GGB;RBG;0;2;2;0;2;run003
385;GGB;RBR;0;2;2;2;0;run003
386;GGB;RGG;0;1;1;1;0;run003
387;GGB;RGR;1;2;3;3;0;run003
388;GGB;RRG;1;3;4;1;3;run003
389;GGB;RRR;0;3;3;0;3;run003
390;GGG;BBB;4;22;26;15;11;run003
391;GGG;BBG;0;2;2;1;1;run003
392;GGG;BBR;0;3;3;0;3;run003
393;GGG;BGB;0;2;2;0;2;run003
394;GGG;BGG;0;3;3;1;2;run003
395;GGG;BRB;0;3;3;0;3;run003
396;GGG;BRR;0;3;3;1;2;run003
397;GGG;GBB;0;1;1;1;0;run003
398;GGG;GGB;1;3;4;1;3;run003
399;GGG;GGR;0;21;21;5;16;run003
400;GGG;GRG;0;2;2;1;1;run003
401;GGG;GRR;2;15;17;14;3;run003
402;GGG;RBB;0;1;1;0;1;run003
403;GGG;RBR;1;4;5;1;4;run003
404;GGG;RGG;1;7;8;1;7;run003
405;GGG;RGR;0;3;3;0;3;run003
406;GGG;RRG;0;2;2;2;0;run003
407;GGG;RRR;0;1;1;0;1;run003
408;GGR;BBB;0;1;1;1;0;run003
409;GGR;BGG;0;2;2;1;1;run003
410;GGR;BRB;0;1;1;1;0;run003
411;GRG;BBB;0;3;3;0;3;run003
412;GRG;BGB;0;3;3;3;0;run003
413;GRG;BGG;0;1;1;0;1;run003
414;GRG;BRB;0;5;5;5;0;run003
415;GRG;BRR;0;1;1;0;1;run003
416;GRG;GBB;0;3;3;2;1;run003
417;GRG;GGB;0;14;14;2;12;run003
418;GRG;GGG;0;10;10;7;3;run003
419;GRG;GGR;0;2;2;2;0;run003
420;GRG;GRR;0;1;1;0;1;run003
421;GRG;RBR;1;2;3;3;0;run003
422;GRG;RGG;0;2;2;0;2;run003
423;GRG;RGR;0;1;1;1;0;run003
424;GRR;BBB;0;3;3;3;0;run003
425;GRR;BBR;0;2;2;2;0;run003
426;GRR;BRB;1;8;9;8;1;run003
427;GRR;BRR;1;6;7;2;5;run003
428;GRR;GBB;0;1;1;1;0;run003
429;GRR;GBG;0;1;1;0;1;run003
430;GRR;GGR;1;9;10;10;0;run003
431;GRR;RBR;0;1;1;0;1;run003
432;GRR;RGG;1;3;4;4;0;run003
433;GRR;RGR;0;1;1;0;1;run003
434;GRR;RRR;0;1;1;0;1;run003
435;RBB;BBB;0;1;1;1;0;run003
436;RBB;GGG;0;3;3;1;2;run003
437;RBG;GRR;0;1;1;1;0;run003
438;RBG;RBR;0;1;1;0;1;run003
439;RBG;RGR;0;1;1;0;1;run003
440;RBR;BBB;0;3;3;1;2;run003
441;RBR;BRB;0;1;1;0;1;run003
442;RBR;BRR;0;2;2;1;1;run003
443;RBR;GGG;0;1;1;1;0;run003
444;RBR;GGR;1;2;3;3;0;run003
445;RBR;GRG;0;1;1;0;1;run003
446;RBR;GRR;1;15;16;8;8;run003
447;RBR;RGG;0;4;4;1;3;run003
448;RBR;RGR;0;1;1;1;0;run003
449;RBR;RRR;0;3;3;2;1;run003
450;RGG;BGG;0;1;1;0;1;run003
451;RGG;RGR;0;1;1;0;1;run003
452;RGR;BBB;0;9;9;2;7;run003
453;RGR;BBR;0;1;1;1;0;run003
454;RGR;BGB;1;8;9;0;9;run003
455;RGR;BRB;0;3;3;1;2;run003
456;RGR;BRR;0;3;3;1;2;run003
457;RGR;GBG;0;1;1;1;0;run003
458;RGR;GGB;0;3;3;0;3;run003
459;RGR;GGG;0;2;2;0;2;run003
460;RGR;GGR;0;8;8;8;0;run003
461;RGR;GRR;1;7;8;4;4;run003
462;RGR;RGG;0;6;6;6;0;run003
463;RRG;BGB;0;1;1;0;1;run003
464;RRG;BRB;0;1;1;0;1;run003
465;RRG;GGG;0;1;1;1;0;run003
466;RRG;GGR;0;1;1;1;0;run003
467;RRG;GRG;0;1;1;1;0;run003
468;RRG;GRR;0;3;3;3;0;run003
469;RRG;RBR;0;4;4;4;0;run003
470;RRG;RGG;0;1;1;0;1;run003
471;RRG;RGR;6;37;43;43;0;run003
472;RRR;BRR;0;1;1;1;0;run003
473;RRR;GGB;0;1;1;1;0;run003
474;RRR;GGG;1;5;6;2;4;run003
475;RRR;GGR;0;2;2;1;1;run003
476;RRR;GRR;0;1;1;0;1;run003
477;RRR;RGR;0;1;1;1;0;run003
478;BBB;GRR;0;1;1;1;0;run004
479;BBG;BBB;1;9;10;10;0;run004
480;BBG;BBR;0;2;2;2;0;run004
481;BBG;BGB;0;1;1;0;1;run004
482;BBG;BGG;0;1;1;0;1;run004
483;BBG;BRB;0;2;2;2;0;run004
484;BBG;BRR;0;1;1;1;0;run004
485;BBG;GBB;1;1;2;0;2;run004
486;BBG;GBG;1;6;7;1;6;run004
487;BBG;GGB;0;18;18;18;0;run004
488;BBG;GGG;1;29;30;23;7;run004
489;BBG;GGR;0;2;2;1;1;run004
490;BBG;GRG;0;1;1;1;0;run004
491;BBG;GRR;0;3;3;1;2;run004
492;BBG;RBR;0;2;2;1;1;run004
493;BBG;RGR;0;2;2;0;2;run004
494;BBG;RRG;1;2;3;3;0;run004
495;BBG;RRR;0;1;1;0;1;run004
496;BGG;BBB;0;1;1;0;1;run004
497;BGG;BRB;0;1;1;0;1;run004
498;BGG;GGG;0;1;1;0;1;run004
499;BGG;RBB;0;1;1;0;1;run004
500;BGG;RBG;1;0;1;1;0;run004
501;BRB;BBB;0;1;1;1;0;run004
502;BRB;GGB;1;0;1;0;1;run004
503;BRB;GGG;0;2;2;0;2;run004
504;BRB;RBB;1;0;1;1;0;run004
505;BRR;BBB;0;1;1;1;0;run004
506;BRR;BRB;0;1;1;0;1;run004
507;BRR;GBB;1;0;1;1;0;run004
508;GBB;BBB;1;16;17;4;13;run004
509;GBB;BBG;0;2;2;2;0;run004
510;GBB;BGB;0;1;1;0;1;run004
511;GBB;BGG;0;3;3;1;2;run004
512;GBB;BRB;0;9;9;4;5;run004
513;GBB;BRR;0;2;2;0;2;run004
514;GBB;GBG;1;1;2;1;1;run004
515;GBB;GGB;2;59;61;10;51;run004
516;GBB;GGG;4;95;99;79;20;run004
517;GBB;GGR;0;1;1;1;0;run004
518;GBB;GRG;0;1;1;0;1;run004
519;GBB;GRR;1;8;9;3;6;run004
520;GBB;RBB;0;2;2;0;2;run004
521;GBB;RBG;0;1;1;1;0;run004
522;GBB;RBR;1;1;2;1;1;run004
523;GBB;RGG;0;2;2;2;0;run004
524;GBB;RGR;0;1;1;1;0;run004
525;GBB;RRG;0;3;3;0;3;run004
526;GBG;BRB;0;1;1;1;0;run004
527;GBG;BRR;0;3;3;3;0;run004
528;GBG;GGB;0;1;1;1;0;run004
529;GBG;GGR;0;3;3;1;2;run004
530;GBG;RBR;0;1;1;1;0;run004
531;GBG;RGR;1;1;2;0;2;run004
532;GBG;RRR;0;1;1;0;1;run004
533;GGB;BBB;1;8;9;4;5;run004
534;GGB;BBG;0;1;1;0;1;run004
535;GGB;BGB;0;1;1;1;0;run004
536;GGB;BRB;3;5;8;3;5;run004
537;GGB;BRR;0;1;1;1;0;run004
538;GGB;GBG;0;2;2;1;1;run004
539;GGB;GGG;4;37;41;33;8;run004
540;GGB;GGR;0;9;9;9;0;run004
541;GGB;GRR;1;4;5;2;3;run004
542;GGB;RBB;0;2;2;1;1;run004
543;GGB;RBG;0;2;2;1;1;run004
544;GGB;RBR;0;2;2;2;0;run004
545;GGB;RGG;0;1;1;0;1;run004
546;GGB;RGR;1;2;3;1;2;run004
547;GGB;RRG;1;3;4;4;0;run004
548;GGB;RRR;0;3;3;0;3;run004
549;GGG;BBB;4;22;26;3;23;run004
550;GGG;BBG;0;2;2;1;1;run004
551;GGG;BBR;0;3;3;3;0;run004
552;GGG;BGB;0;2;2;2;0;run004
553;GGG;BGG;0;3;3;0;3;run004
554;GGG;BRB;0;3;3;2;1;run004
555;GGG;BRR;0;3;3;1;2;run004
556;GGG;GBB;0;1;1;0;1;run004
557;GGG;GGB;1;3;4;4;0;run004
558;GGG;GGR;0;21;21;4;17;run004
559;GGG;GRG;0;2;2;1;1;run004
560;GGG;GRR;2;15;17;0;17;run004
561;GGG;RBB;0;1;1;1;0;run004
562;GGG;RBR;1;4;5;0;5;run004
563;GGG;RGG;1;7;8;3;5;run004
564;GGG;RGR;0;3;3;2;1;run004
565;GGG;RRG;0;2;2;0;2;run004
566;GGG;RRR;0;1;1;1;0;run004
567;GGR;BBB;0;1;1;1;0;run004
568;GGR;BGG;0;2;2;1;1;run004
569;GGR;BRB;0;1;1;1;0;run004
570;GRG;BBB;0;3;3;3;0;run004
571;GRG;BGB;0;3;3;0;3;run004
572;GRG;BGG;0;1;1;0;1;run004
573;GRG;BRB;0;5;5;1;4;run004
574;GRG;BRR;0;1;1;0;1;run004
575;GRG;GBB;0;3;3;0;3;run004
576;GRG;GGB;0;14;14;13;1;run004
577;GRG;GGG;0;10;10;10;0;run004
578;GRG;GGR;0;2;2;1;1;run004
579;GRG;GRR;0;1;1;1;0;run004
580;GRG;RBR;1;2;3;1;2;run004
581;GRG;RGG;0;2;2;0;2;run004
582;GRG;RGR;0;1;1;0;1;run004
583;GRR;BBB;0;3;3;3;0;run004
584;GRR;BBR;0;2;2;2;0;run004
585;GRR;BRB;1;8;9;0;9;run004
586;GRR;BRR;1;6;7;2;5;run004
587;GRR;GBB;0;1;1;1;0;run004
588;GRR;GBG;0;1;1;0;1;run004
589;GRR;GGR;1;9;10;2;8;run004
590;GRR;RBR;0;1;1;0;1;run004
591;GRR;RGG;1;3;4;4;0;run004
592;GRR;RGR;0;1;1;0;1;run004
593;GRR;RRR;0;1;1;0;1;run004
594;RBB;BBB;0;1;1;1;0;run004
595;RBB;GGG;0;3;3;3;0;run004
596;RBG;GRR;0;1;1;1;0;run004
597;RBG;RBR;0;1;1;1;0;run004
598;RBG;RGR;0;1;1;1;0;run004
599;RBR;BBB;0;3;3;3;0;run004
600;RBR;BRB;0;1;1;0;1;run004
601;RBR;BRR;0;2;2;2;0;run004
602;RBR;GGG;0;1;1;0;1;run004
603;RBR;GGR;1;2;3;2;1;run004
604;RBR;GRG;0;1;1;0;1;run004
605;RBR;GRR;1;15;16;2;14;run004
606;RBR;RGG;0;4;4;0;4;run004
607;RBR;RGR;0;1;1;0;1;run004
608;RBR;RRR;0;3;3;1;2;run004
609;RGG;BGG;0;1;1;1;0;run004
610;RGG;RGR;0;1;1;0;1;run004
611;RGR;BBB;0;9;9;8;1;run004
612;RGR;BBR;0;1;1;0;1;run004
613;RGR;BGB;1;8;9;2;7;run004
614;RGR;BRB;0;3;3;0;3;run004
615;RGR;BRR;0;3;3;3;0;run004
616;RGR;GBG;0;1;1;0;1;run004
617;RGR;GGB;0;3;3;2;1;run004
618;RGR;GGG;0;2;2;0;2;run004
619;RGR;GGR;0;8;8;6;2;run004
620;RGR;GRR;1;7;8;8;0;run004
621;RGR;RGG;0;6;6;1;5;run004
622;RRG;BGB;0;1;1;1;0;run004
623;RRG;BRB;0;1;1;0;1;run004
624;RRG;GGG;0;1;1;0;1;run004
625;RRG;GGR;0;1;1;0;1;run004
626;RRG;GRG;0;1;1;1;0;run004
627;RRG;GRR;0;3;3;2;1;run004
628;RRG;RBR;0;4;4;2;2;run004
629;RRG;RGG;0;1;1;1;0;run004
630;RRG;RGR;6;37;43;25;18;run004
631;RRR;BRR;0;1;1;0;1;run004
632;RRR;GGB;0;1;1;1;0;run004
633;RRR;GGG;1;5;6;2;4;run004
634;RRR;GGR;0;2;2;0;2;run004
635;RRR;GRR;0;1;1;1;0;run004
636;RRR;RGR;0;1;1;0;1;run004
637;BBB;GRR;0;1;1;1;0;run005
638;BBG;BBB;1;9;10;10;0;run005
639;BBG;BBR;0;2;2;0;2;run005
640;BBG;BGB;0;1;1;0;1;run005
641;BBG;BGG;0;1;1;0;1;run005
642;BBG;BRB;0;2;2;0;2;run005
643;BBG;BRR;0;1;1;0;1;run005
644;BBG;GBB;1;1;2;0;2;run005
645;BBG;GBG;1;6;7;5;2;run005
646;BBG;GGB;0;18;18;6;12;run005
647;BBG;GGG;1;29;30;22;8;run005
648;BBG;GGR;0;2;2;2;0;run005
649;BBG;GRG;0;1;1;0;1;run005
650;BBG;GRR;0;3;3;1;2;run005
651;BBG;RBR;0;2;2;1;1;run005
652;BBG;RGR;0;2;2;2;0;run005
653;BBG;RRG;1;2;3;0;3;run005
654;BBG;RRR;0;1;1;1;0;run005
655;BGG;BBB;0;1;1;1;0;run005
656;BGG;BRB;0;1;1;1;0;run005
657;BGG;GGG;0;1;1;0;1;run005
658;BGG;RBB;0;1;1;1;0;run005
659;BGG;RBG;1;0;1;0;1;run005
660;BRB;BBB;0;1;1;0;1;run005
661;BRB;GGB;1;0;1;1;0;run005
662;BRB;GGG;0;2;2;2;0;run005
663;BRB;RBB;1;0;1;1;0;run005
664;BRR;BBB;0;1;1;0;1;run005
665;BRR;BRB;0;1;1;1;0;run005
666;BRR;GBB;1;0;1;1;0;run005
667;GBB;BBB;1;16;17;16;1;run005
668;GBB;BBG;0;2;2;1;1;run005
669;GBB;BGB;0;1;1;1;0;run005
670;GBB;BGG;0;3;3;3;0;run005
671;GBB;BRB;0;9;9;6;3;run005
672;GBB;BRR;0;2;2;2;0;run005
673;GBB;GBG;1;1;2;1;1;run005
674;GBB;GGB;2;59;61;45;16;run005
675;GBB;GGG;4;95;99;17;82;run005
676;GBB;GGR;0;1;1;1;0;run005
677;GBB;GRG;0;1;1;1;0;run005
678;GBB;GRR;1;8;9;8;1;run005
679;GBB;RBB;0;2;2;1;1;run005
680;GBB;RBG;0;1;1;1;0;run005
681;GBB;RBR;1;1;2;0;2;run005
682;GBB;RGG;0;2;2;2;0;run005
683;GBB;RGR;0;1;1;1;0;run005
684;GBB;RRG;0;3;3;3;0;run005
685;GBG;BRB;0;1;1;0;1;run005
686;GBG;BRR;0;3;3;2;1;run005
687;GBG;GGB;0;1;1;0;1;run005
688;GBG;GGR;0;3;3;1;2;run005
689;GBG;RBR;0;1;1;0;1;run005
690;GBG;RGR;1;1;2;2;0;run005
691;GBG;RRR;0;1;1;0;1;run005
692;GGB;BBB;1;8;9;7;2;run005
693;GGB;BBG;0;1;1;0;1;run005
694;GGB;BGB;0;1;1;1;0;run005
695;GGB;BRB;3;5;8;3;5;run005
696;GGB;BRR;0;1;1;1;0;run005
697;GGB;GBG;0;2;2;0;2;run005
698;GGB;GGG;4;37;41;17;24;run005
699;GGB;GGR;0;9;9;9;0;run005
700;GGB;GRR;1;4;5;0;5;run005
701;GGB;RBB;0;2;2;2;0;run005
702;GGB;RBG;0;2;2;1;1;run005
703;GGB;RBR;0;2;2;0;2;run005
704;GGB;RGG;0;1;1;1;0;run005
705;GGB;RGR;1;2;3;0;3;run005
706;GGB;RRG;1;3;4;1;3;run005
707;GGB;RRR;0;3;3;2;1;run005
708;GGG;BBB;4;22;26;8;18;run005
709;GGG;BBG;0;2;2;2;0;run005
710;GGG;BBR;0;3;3;3;0;run005
711;GGG;BGB;0;2;2;2;0;run005
712;GGG;BGG;0;3;3;2;1;run005
713;GGG;BRB;0;3;3;3;0;run005
714;GGG;BRR;0;3;3;2;1;run005
715;GGG;GBB;0;1;1;1;0;run005
716;GGG;GGB;1;3;4;0;4;run005
717;GGG;GGR;0;21;21;5;16;run005
718;GGG;GRG;0;2;2;1;1;run005
719;GGG;GRR;2;15;17;15;2;run005
720;GGG;RBB;0;1;1;0;1;run005
721;GGG;RBR;1;4;5;3;2;run005
722;GGG;RGG;1;7;8;8;0;run005
723;GGG;RGR;0;3;3;0;3;run005
724;GGG;RRG;0;2;2;0;2;run005
725;GGG;RRR;0;1;1;1;0;run005
726;GGR;BBB;0;1;1;0;1;run005
727;GGR;BGG;0;2;2;1;1;run005
728;GGR;BRB;0;1;1;0;1;run005
729;GRG;BBB;0;3;3;1;2;run005
730;GRG;BGB;0;3;3;2;1;run005
731;GRG;BGG;0;1;1;1;0;run005
732;GRG;BRB;0;5;5;5;0;run005
733;GRG;BRR;0;1;1;1;0;run005
734;GRG;GBB;0;3;3;0;3;run005
735;GRG;GGB;0;14;14;7;7;run005
736;GRG;GGG;0;10;10;10;0;run005
737;GRG;GGR;0;2;2;0;2;run005
738;GRG;GRR;0;1;1;1;0;run005
739;GRG;RBR;1;2;3;3;0;run005
740;GRG;RGG;0;2;2;0;2;run005
741;GRG;RGR;0;1;1;0;1;run005
742;GRR;BBB;0;3;3;3;0;run005
743;GRR;BBR;0;2;2;0;2;run005
744;GRR;BRB;1;8;9;8;1;run005
745;GRR;BRR;1;6;7;4;3;run005
746;GRR;GBB;0;1;1;1;0;run005
747;GRR;GBG;0;1;1;0;1;run005
748;GRR;GGR;1;9;10;10;0;run005
749;GRR;RBR;0;1;1;1;0;run005
750;GRR;RGG;1;3;4;4;0;run005
751;GRR;RGR;0;1;1;0;1;run005
752;GRR;RRR;0;1;1;0;1;run005
753;RBB;BBB;0;1;1;0;1;run005
754;RBB;GGG;0;3;3;1;2;run005
755;RBG;GRR;0;1;1;0;1;run005
756;RBG;RBR;0;1;1;1;0;run005
757;RBG;RGR;0;1;1;0;1;run005
758;RBR;BBB;0;3;3;1;2;run005
759;RBR;BRB;0;1;1;0;1;run005
760;RBR;BRR;0;2;2;2;0;run005
761;RBR;GGG;0;1;1;0;1;run005
762;RBR;GGR;1;2;3;0;3;run005
763;RBR;GRG;0;1;1;0;1;run005
764;RBR;GRR;1;15;16;8;8;run005
765;RBR;RGG;0;4;4;1;3;run005
766;RBR;RGR;0;1;1;1;0;run005
767;RBR;RRR;0;3;3;3;0;run005
768;RGG;BGG;0;1;1;1;0;run005
769;RGG;RGR;0;1;1;0;1;run005
770;RGR;BBB;0;9;9;9;0;run005
771;RGR;BBR;0;1;1;1;0;run005
772;RGR;BGB;1;8;9;2;7;run005
773;RGR;BRB;0;3;3;0;3;run005
774;RGR;BRR;0;3;3;1;2;run005
775;RGR;GBG;0;1;1;1;0;run005
776;RGR;GGB;0;3;3;1;2;run005
777;RGR;GGG;0;2;2;1;1;run005
778;RGR;GGR;0;8;8;4;4;run005
779;RGR;GRR;1;7;8;7;1;run005
780;RGR;RGG;0;6;6;1;5;run005
781;RRG;BGB;0;1;1;0;1;run005
782;RRG;BRB;0;1;1;0;1;run005
783;RRG;GGG;0;1;1;0;1;run005
784;RRG;GGR;0;1;1;0;1;run005
785;RRG;GRG;0;1;1;0;1;run005
786;RRG;GRR;0;3;3;2;1;run005
787;RRG;RBR;0;4;4;2;2;run005
788;RRG;RGG;0;1;1;0;1;run005
789;RRG;RGR;6;37;43;42;1;run005
790;RRR;BRR;0;1;1;0;1;run005
791;RRR;GGB;0;1;1;0;1;run005
792;RRR;GGG;1;5;6;4;2;run005
793;RRR;GGR;0;2;2;2;0;run005
794;RRR;GRR;0;1;1;0;1;run005
795;RRR;RGR;0;1;1;1;0;run005
796;BBB;GRR;0;1;1;0;1;run006
797;BBG;BBB;1;9;10;9;1;run006
798;BBG;BBR;0;2;2;0;2;run006
799;BBG;BGB;0;1;1;1;0;run006
800;BBG;BGG;0;1;1;1;0;run006
801;BBG;BRB;0;2;2;2;0;run006
802;BBG;BRR;0;1;1;0;1;run006
803;BBG;GBB;1;1;2;1;1;run006
804;BBG;GBG;1;6;7;1;6;run006
805;BBG;GGB;0;18;18;1;17;run006
806;BBG;GGG;1;29;30;29;1;run006
807;BBG;GGR;0;2;2;2;0;run006
808;BBG;GRG;0;1;1;0;1;run006
809;BBG;GRR;0;3;3;0;3;run006
810;BBG;RBR;0;2;2;0;2;run006
811;BBG;RGR;0;2;2;1;1;run006
812;BBG;RRG;1;2;3;2;1;run006
813;BBG;RRR;0;1;1;0;1;run006
814;BGG;BBB;0;1;1;1;0;run006
815;BGG;BRB;0;1;1;0;1;run006
816;BGG;GGG;0;1;1;1;0;run006
817;BGG;RBB;0;1;1;0;1;run006
818;BGG;RBG;1;0;1;1;0;run006
819;BRB;BBB;0;1;1;1;0;run006
820;BRB;GGB;1;0;1;1;0;run006
821;BRB;GGG;0;2;2;2;0;run006
822;BRB;RBB;1;0;1;0;1;run006
823;BRR;BBB;0;1;1;0;1;run006
824;BRR;BRB;0;1;1;1;0;run006
825;BRR;GBB;1;0;1;1;0;run006
826;GBB;BBB;1;16;17;13;4;run006
827;GBB;BBG;0;2;2;0;2;run006
828;GBB;BGB;0;1;1;1;0;run006
829;GBB;BGG;0;3;3;1;2;run006
830;GBB;BRB;0;9;9;4;5;run006
831;GBB;BRR;0;2;2;2;0;run006
832;GBB;GBG;1;1;2;0;2;run006
833;GBB;GGB;2;59;61;60;1;run006
834;GBB;GGG;4;95;99;77;22;run006
835;GBB;GGR;0;1;1;0;1;run006
836;GBB;GRG;0;1;1;0;1;run006
837;GBB;GRR;1;8;9;2;7;run006
838;GBB;RBB;0;2;2;2;0;run006
839;GBB;RBG;0;1;1;1;0;run006
840;GBB;RBR;1;1;2;1;1;run006
841;GBB;RGG;0;2;2;0;2;run006
842;GBB;RGR;0;1;1;0;1;run006
843;GBB;RRG;0;3;3;3;0;run006
844;GBG;BRB;0;1;1;1;0;run006
845;GBG;BRR;0;3;3;2;1;run006
846;GBG;GGB;0;1;1;1;0;run006
847;GBG;GGR;0;3;3;1;2;run006
848;GBG;RBR;0;1;1;1;0;run006
849;GBG;RGR;1;1;2;0;2;run006
850;GBG;RRR;0;1;1;1;0;run006
851;GGB;BBB;1;8;9;5;4;run006
852;GGB;BBG;0;1;1;1;0;run006
853;GGB;BGB;0;1;1;0;1;run006
854;GGB;BRB;3;5;8;3;5;run006
855;GGB;BRR;0;1;1;1;0;run006
856;GGB;GBG;0;2;2;2;0;run006
857;GGB;GGG;4;37;41;33;8;run006
858;GGB;GGR;0;9;9;2;7;run006
859;GGB;GRR;1;4;5;4;1;run006
860;GGB;RBB;0;2;2;1;1;run006
861;GGB;RBG;0;2;2;1;1;run006
862;GGB;RBR;0;2;2;2;0;run006
863;GGB;RGG;0;1;1;0;1;run006
864;GGB;RGR;1;2;3;3;0;run006
865;GGB;RRG;1;3;4;2;2;run006
866;GGB;RRR;0;3;3;3;0;run006
867;GGG;BBB;4;22;26;24;2;run006
868;GGG;BBG;0;2;2;2;0;run006
869;GGG;BBR;0;3;3;0;3;run006
870;GGG;BGB;0;2;2;1;1;run006
871;GGG;BGG;0;3;3;3;0;run006
872;GGG;BRB;0;3;3;0;3;run006
873;GGG;BRR;0;3;3;2;1;run006
874;GGG;GBB;0;1;1;1;0;run006
875;GGG;GGB;1;3;4;1;3;run006
876;GGG;GGR;0;21;21;2;19;run006
877;GGG;GRG;0;2;2;1;1;run006
878;GGG;GRR;2;15;17;17;0;run006
879;GGG;RBB;0;1;1;0;1;run006
880;GGG;RBR;1;4;5;3;2;run006
881;GGG;RGG;1;7;8;2;6;run006
882;GGG;RGR;0;3;3;3;0;run006
883;GGG;RRG;0;2;2;0;2;run006
884;GGG;RRR;0;1;1;1;0;run006
885;GGR;BBB;0;1;1;0;1;run006
886;GGR;BGG;0;2;2;2;0;run006
887;GGR;BRB;0;1;1;1;0;run006
888;GRG;BBB;0;3;3;3;0;run006
889;GRG;BGB;0;3;3;3;0;run006
890;GRG;BGG;0;1;1;1;0;run006
891;GRG;BRB;0;5;5;3;2;run006
892;GRG;BRR;0;1;1;0;1;run006
893;GRG;GBB;0;3;3;1;2;run006
894;GRG;GGB;0;14;14;11;3;run006
895;GRG;GGG;0;10;10;6;4;run006
896;GRG;GGR;0;2;2;1;1;run006
897;GRG;GRR;0;1;1;0;1;run006
898;GRG;RBR;1;2;3;2;1;run006
899;GRG;RGG;0;2;2;0;2;run006
900;GRG;RGR;0;1;1;0;1;run006
901;GRR;BBB;0;3;3;1;2;run006
902;GRR;BBR;0;2;2;0;2;run006
903;GRR;BRB;1;8;9;7;2;run006
904;GRR;BRR;1;6;7;5;2;run006
905;GRR;GBB;0;1;1;1;0;run006
906;GRR;GBG;0;1;1;1;0;run006
907;GRR;GGR;1;9;10;2;8;run006
908;GRR;RBR;0;1;1;1;0;run006
909;GRR;RGG;1;3;4;3;1;run006
910;GRR;RGR;0;1;1;0;1;run006
911;GRR;RRR;0;1;1;0;1;run006
912;RBB;BBB;0;1;1;0;1;run006
913;RBB;GGG;0;3;3;1;2;run006
914;RBG;GRR;0;1;1;1;0;run006
915;RBG;RBR;0;1;1;1;0;run006
916;RBG;RGR;0;1;1;0;1;run006
917;RBR;BBB;0;3;3;2;1;run006
918;RBR;BRB;0;1;1;1;0;run006
919;RBR;BRR;0;2;2;1;1;run006
920;RBR;GGG;0;1;1;1;0;run006
921;RBR;GGR;1;2;3;3;0;run006
922;RBR;GRG;0;1;1;0;1;run006
923;RBR;GRR;1;15;16;0;16;run006
924;RBR;RGG;0;4;4;2;2;run006
925;RBR;RGR;0;1;1;0;1;run006
926;RBR;RRR;0;3;3;0;3;run006
927;RGG;BGG;0;1;1;0;1;run006
928;RGG;RGR;0;1;1;0;1;run006
929;RGR;BBB;0;9;9;0;9;run006
930;RGR;BBR;0;1;1;1;0;run006
931;RGR;BGB;1;8;9;4;5;run006
932;RGR;BRB;0;3;3;2;1;run006
933;RGR;BRR;0;3;3;1;2;run006
934;RGR;GBG;0;1;1;1;0;run006
935;RGR;GGB;0;3;3;1;2;run006
936;RGR;GGG;0;2;2;2;0;run006
937;RGR;GGR;0;8;8;4;4;run006
938;RGR;GRR;1;7;8;8;0;run006
939;RGR;RGG;0;6;6;5;1;run006
940;RRG;BGB;0;1;1;0;1;run006
941;RRG;BRB;0;1;1;0;1;run006
942;RRG;GGG;0;1;1;0;1;run006
943;RRG;GGR;0;1;1;1;0;run006
944;RRG;GRG;0;1;1;1;0;run006
945;RRG;GRR;0;3;3;0;3;run006
946;RRG;RBR;0;4;4;3;1;run006
947;RRG;RGG;0;1;1;1;0;run006
948;RRG;RGR;6;37;43;17;26;run006
949;RRR;BRR;0;1;1;1;0;run006
950;RRR;GGB;0;1;1;0;1;run006
951;RRR;GGG;1;5;6;0;6;run006
952;RRR;GGR;0;2;2;0;2;run006
953;RRR;GRR;0;1;1;0;1;run006
954;RRR;RGR;0;1;1;1;0;run006
955;BBB;GRR;0;1;1;1;0;run007
956;BBG;BBB;1;9;10;2;8;run007
957;BBG;BBR;0;2;2;2;0;run007
958;BBG;BGB;0;1;1;1;0;run007
959;BBG;BGG;0;1;1;0;1;run007
960;BBG;BRB;0;2;2;1;1;run007
961;BBG;BRR;0;1;1;0;1;run007
962;BBG;GBB;1;1;2;1;1;run007
963;BBG;GBG;1;6;7;5;2;run007
964;BBG;GGB;0;18;18;7;11;run007
965;BBG;GGG;1;29;30;23;7;run007
966;BBG;GGR;0;2;2;2;0;run007
967;BBG;GRG;0;1;1;1;0;run007
968;BBG;GRR;0;3;3;3;0;run007
969;BBG;RBR;0;2;2;1;1;run007
970;BBG;RGR;0;2;2;2;0;run007
971;BBG;RRG;1;2;3;3;0;run007
972;BBG;RRR;0;1;1;0;1;run007
973;BGG;BBB;0;1;1;1;0;run007
974;BGG;BRB;0;1;1;1;0;run007
975;BGG;GGG;0;1;1;0;1;run007
976;BGG;RBB;0;1;1;1;0;run007
977;BGG;RBG;1;0;1;1;0;run007
978;BRB;BBB;0;1;1;1;0;run007
979;BRB;GGB;1;0;1;0;1;run007
980;BRB;GGG;0;2;2;2;0;run007
981;BRB;RBB;1;0;1;1;0;run007
982;BRR;BBB;0;1;1;1;0;run007
983;BRR;BRB;0;1;1;1;0;run007
984;BRR;GBB;1;0;1;0;1;run007
985;GBB;BBB;1;16;17;3;14;run007
986;GBB;BBG;0;2;2;2;0;run007
987;GBB;BGB;0;1;1;1;0;run007
988;GBB;BGG;0;3;3;1;2;run007
989;GBB;BRB;0;9;9;6;3;run007
990;GBB;BRR;0;2;2;1;1;run007
991;GBB;GBG;1;1;2;1;1;run007
992;GBB;GGB;2;59;61;55;6;run007
993;GBB;GGG;4;95;99;42;57;run007
994;GBB;GGR;0;1;1;1;0;run007
995;GBB;GRG;0;1;1;1;0;run007
996;GBB;GRR;1;8;9;0;9;run007
997;GBB;RBB;0;2;2;2;0;run007
998;GBB;RBG;0;1;1;1;0;run007
999;GBB;RBR;1;1;2;0;2;run007
1000;GBB;RGG;0;2;2;2;0;run007
1001;GBB;RGR;0;1;1;0;1;run007
1002;GBB;RRG;0;3;3;0;3;run007
1003;GBG;BRB;0;1;1;1;0;run007
1004;GBG;BRR;0;3;3;0;3;run007
1005;GBG;GGB;0;1;1;0;1;run007
1006;GBG;GGR;0;3;3;1;2;run007
1007;GBG;RBR;0;1;1;1;0;run007
1008;GBG;RGR;1;1;2;0;2;run007
1009;GBG;RRR;0;1;1;0;1;run007
1010;GGB;BBB;1;8;9;8;1;run007
1011;GGB;BBG;0;1;1;0;1;run007
1012;GGB;BGB;0;1;1;1;0;run007
1013;GGB;BRB;3;5;8;4;4;run007
1014;GGB;BRR;0;1;1;1;0;run007
1015;GGB;GBG;0;2;2;1;1;run007
1016;GGB;GGG;4;37;41;23;18;run007
1017;GGB;GGR;0;9;9;9;0;run007
1018;GGB;GRR;1;4;5;5;0;run007
1019;GGB;RBB;0;2;2;1;1;run007
1020;GGB;RBG;0;2;2;2;0;run007
1021;GGB;RBR;0;2;2;1;1;run007
1022;GGB;RGG;0;1;1;0;1;run007
1023;GGB;RGR;1;2;3;0;3;run007
1024;GGB;RRG;1;3;4;2;2;run007
1025;GGB;RRR;0;3;3;0;3;run007
1026;GGG;BBB;4;22;26;8;18;run007
1027;GGG;BBG;0;2;2;1;1;run007
1028;GGG;BBR;0;3;3;2;1;run007
1029;GGG;BGB;0;2;2;1;1;run007
1030;GGG;BGG;0;3;3;1;2;run007
1031;GGG;BRB;0;3;3;3;0;run007
1032;GGG;BRR;0;3;3;0;3;run007
1033;GGG;GBB;0;1;1;1;0;run007
1034;GGG;GGB;1;3;4;1;3;run007
1035;GGG;GGR;0;21;21;12;9;run007
1036;GGG;GRG;0;2;2;1;1;run007
1037;GGG;GRR;2;15;17;6;11;run007
1038;GGG;RBB;0;1;1;0;1;run007
1039;GGG;RBR;1;4;5;0;5;run007
1040;GGG;RGG;1;7;8;7;1;run007
1041;GGG;RGR;0;3;3;1;2;run007
1042;GGG;RRG;0;2;2;1;1;run007
1043;GGG;RRR;0;1;1;1;0;run007
1044;GGR;BBB;0;1;1;1;0;run007
1045;GGR;BGG;0;2;2;0;2;run007
1046;GGR;BRB;0;1;1;0;1;run007
1047;GRG;BBB;0;3;3;0;3;run007
1048;GRG;BGB;0;3;3;3;0;run007
1049;GRG;BGG;0;1;1;0;1;run007
1050;GRG;BRB;0;5;5;3;2;run007
1051;GRG;BRR;0;1;1;0;1;run007
1052;GRG;GBB;0;3;3;1;2;run007
1053;GRG;GGB;0;14;14;0;14;run007
1054;GRG;GGG;0;10;10;0;10;run007
1055;GRG;GGR;0;2;2;0;2;run007
1056;GRG;GRR;0;1;1;1;0;run007
1057;GRG;RBR;1;2;3;2;1;run007
1058;GRG;RGG;0;2;2;1;1;run007
1059;GRG;RGR;0;1;1;0;1;run007
1060;GRR;BBB;0;3;3;1;2;run007
1061;GRR;BBR;0;2;2;0;2;run007
1062;GRR;BRB;1;8;9;7;2;run007
1063;GRR;BRR;1;6;7;0;7;run007
1064;GRR;GBB;0;1;1;0;1;run007
1065;GRR;GBG;0;1;1;0;1;run007
1066;GRR;GGR;1;9;10;5;5;run007
1067;GRR;RBR;0;1;1;1;0;run007
1068;GRR;RGG;1;3;4;2;2;run007
1069;GRR;RGR;0;1;1;1;0;run007
1070;GRR;RRR;0;1;1;1;0;run007
1071;RBB;BBB;0;1;1;0;1;run007
1072;RBB;GGG;0;3;3;3;0;run007
1073;RBG;GRR;0;1;1;1;0;run007
1074;RBG;RBR;0;1;1;1;0;run007
1075;RBG;RGR;0;1;1;1;0;run007
1076;RBR;BBB;0;3;3;0;3;run007
1077;RBR;BRB;0;1;1;1;0;run007
1078;RBR;BRR;0;2;2;2;0;run007
1079;RBR;GGG;0;1;1;1;0;run007
1080;RBR;GGR;1;2;3;0;3;run007
1081;RBR;GRG;0;1;1;0;1;run007
1082;RBR;GRR;1;15;16;10;6;run007
1083;RBR;RGG;0;4;4;1;3;run007
1084;RBR;RGR;0;1;1;0;1;run007
1085;RBR;RRR;0;3;3;3;0;run007
1086;RGG;BGG;0;1;1;1;0;run007
1087;RGG;RGR;0;1;1;1;0;run007
1088;RGR;BBB;0;9;9;7;2;run007
1089;RGR;BBR;0;1;1;0;1;run007
1090;RGR;BGB;1;8;9;0;9;run007
1091;RGR;BRB;0;3;3;0;3;run007
1092;RGR;BRR;0;3;3;3;0;run007
1093;RGR;GBG;0;1;1;0;1;run007
1094;RGR;GGB;0;3;3;3;0;run007
1095;RGR;GGG;0;2;2;2;0;run007
1096;RGR;GGR;0;8;8;5;3;run007
1097;RGR;GRR;1;7;8;7;1;run007
1098;RGR;RGG;0;6;6;2;4;run007
1099;RRG;BGB;0;1;1;0;1;run007
1100;RRG;BRB;0;1;1;0;1;run007
1101;RRG;GGG;0;1;1;1;0;run007
1102;RRG;GGR;0;1;1;1;0;run007
1103;RRG;GRG;0;1;1;1;0;run007
1104;RRG;GRR;0;3;3;3;0;run007
1105;RRG;RBR;0;4;4;4;0;run007
1106;RRG;RGG;0;1;1;1;0;run007
1107;RRG;RGR;6;37;43;0;43;run007
1108;RRR;BRR;0;1;1;1;0;run007
1109;RRR;GGB;0;1;1;0;1;run007
1110;RRR;GGG;1;5;6;3;3;run007
1111;RRR;GGR;0;2;2;1;1;run007
1112;RRR;GRR;0;1;1;0;1;run007
1113;RRR;RGR;0;1;1;0;1;run007
1114;BBB;GRR;0;1;1;1;0;run008
1115;BBG;BBB;1;9;10;3;7;run008
1116;BBG;BBR;0;2;2;2;0;run008
1117;BBG;BGB;0;1;1;1;0;run008
1118;BBG;BGG;0;1;1;0;1;run008
1119;BBG;BRB;0;2;2;2;0;run008
1120;BBG;BRR;0;1;1;1;0;run008
1121;BBG;GBB;1;1;2;2;0;run008
1122;BBG;GBG;1;6;7;5;2;run008
1123;BBG;GGB;0;18;18;0;18;run008
1124;BBG;GGG;1;29;30;28;2;run008
1125;BBG;GGR;0;2;2;1;1;run008
1126;BBG;GRG;0;1;1;0;1;run008
1127;BBG;GRR;0;3;3;2;1;run008
1128;BBG;RBR;0;2;2;1;1;run008
1129;BBG;RGR;0;2;2;1;1;run008
1130;BBG;RRG;1;2;3;3;0;run008
1131;BBG;RRR;0;1;1;0;1;run008
1132;BGG;BBB;0;1;1;1;0;run008
1133;BGG;BRB;0;1;1;1;0;run008
1134;BGG;GGG;0;1;1;1;0;run008
1135;BGG;RBB;0;1;1;0;1;run008
1136;BGG;RBG;1;0;1;0;1;run008
1137;BRB;BBB;0;1;1;1;0;run008
1138;BRB;GGB;1;0;1;1;0;run008
1139;BRB;GGG;0;2;2;2;0;run008
1140;BRB;RBB;1;0;1;1;0;run008
1141;BRR;BBB;0;1;1;0;1;run008
1142;BRR;BRB;0;1;1;0;1;run008
1143;BRR;GBB;1;0;1;1;0;run008
1144;GBB;BBB;1;16;17;6;11;run008
1145;GBB;BBG;0;2;2;1;1;run008
1146;GBB;BGB;0;1;1;0;1;run008
1147;GBB;BGG;0;3;3;1;2;run008
1148;GBB;BRB;0;9;9;9;0;run008
1149;GBB;BRR;0;2;2;0;2;run008
1150;GBB;GBG;1;1;2;1;1;run008
1151;GBB;GGB;2;59;61;56;5;run008
1152;GBB;GGG;4;95;99;7;92;run008
1153;GBB;GGR;0;1;1;1;0;run008
1154;GBB;GRG;0;1;1;0;1;run008
1155;GBB;GRR;1;8;9;9;0;run008
1156;GBB;RBB;0;2;2;2;0;run008
1157;GBB;RBG;0;1;1;1;0;run008
1158;GBB;RBR;1;1;2;1;1;run008
1159;GBB;RGG;0;2;2;1;1;run008
1160;GBB;RGR;0;1;1;0;1;run008
1161;GBB;RRG;0;3;3;3;0;run008
1162;GBG;BRB;0;1;1;1;0;run008
1163;GBG;BRR;0;3;3;3;0;run008
1164;GBG;GGB;0;1;1;1;0;run008
1165;GBG;GGR;0;3;3;0;3;run008
1166;GBG;RBR;0;1;1;1;0;run008
1167;GBG;RGR;1;1;2;1;1;run008
1168;GBG;RRR;0;1;1;1;0;run008
1169;GGB;BBB;1;8;9;2;7;run008
1170;GGB;BBG;0;1;1;0;1;run008
1171;GGB;BGB;0;1;1;1;0;run008
1172;GGB;BRB;3;5;8;3;5;run008
1173;GGB;BRR;0;1;1;0;1;run008
1174;GGB;GBG;0;2;2;1;1;run008
1175;GGB;GGG;4;37;41;6;35;run008
1176;GGB;GGR;0;9;9;4;5;run008
1177;GGB;GRR;1;4;5;4;1;run008
1178;GGB;RBB;0;2;2;0;2;run008
1179;GGB;RBG;0;2;2;2;0;run008
1180;GGB;RBR;0;2;2;2;0;run008
1181;GGB;RGG;0;1;1;1;0;run008
1182;GGB;RGR;1;2;3;1;2;run008
1183;GGB;RRG;1;3;4;0;4;run008
1184;GGB;RRR;0;3;3;1;2;run008
1185;GGG;BBB;4;22;26;11;15;run008
1186;GGG;BBG;0;2;2;2;0;run008
1187;GGG;BBR;0;3;3;2;1;run008
1188;GGG;BGB;0;2;2;0;2;run008
1189;GGG;BGG;0;3;3;3;0;run008
1190;GGG;BRB;0;3;3;2;1;run008
1191;GGG;BRR;0;3;3;1;2;run008
1192;GGG;GBB;0;1;1;0;1;run008
1193;GGG;GGB;1;3;4;3;1;run008
1194;GGG;GGR;0;21;21;8;13;run008
1195;GGG;GRG;0;2;2;0;2;run008
1196;GGG;GRR;2;15;17;5;12;run008
1197;GGG;RBB;0;1;1;1;0;run008
1198;GGG;RBR;1;4;5;1;4;run008
1199;GGG;RGG;1;7;8;8;0;run008
1200;GGG;RGR;0;3;3;2;1;run008
1201;GGG;RRG;0;2;2;0;2;run008
1202;GGG;RRR;0;1;1;1;0;run008
1203;GGR;BBB;0;1;1;1;0;run008
1204;GGR;BGG;0;2;2;0;2;run008
1205;GGR;BRB;0;1;1;1;0;run008
1206;GRG;BBB;0;3;3;3;0;run008
1207;GRG;BGB;0;3;3;1;2;run008
1208;GRG;BGG;0;1;1;1;0;run008
1209;GRG;BRB;0;5;5;3;2;run008
1210;GRG;BRR;0;1;1;1;0;run008
1211;GRG;GBB;0;3;3;0;3;run008
1212;GRG;GGB;0;14;14;4;10;run008
1213;GRG;GGG;0;10;10;1;9;run008
1214;GRG;GGR;0;2;2;0;2;run008
1215;GRG;GRR;0;1;1;1;0;run008
1216;GRG;RBR;1;2;3;1;2;run008
1217;GRG;RGG;0;2;2;0;2;run008
1218;GRG;RGR;0;1;1;0;1;run008
1219;GRR;BBB;0;3;3;3;0;run008
1220;GRR;BBR;0;2;2;1;1;run008
1221;GRR;BRB;1;8;9;0;9;run008
1222;GRR;BRR;1;6;7;4;3;run008
1223;GRR;GBB;0;1;1;0;1;run008
1224;GRR;GBG;0;1;1;0;1;run008
1225;GRR;GGR;1;9;10;0;10;run008
1226;GRR;RBR;0;1;1;0;1;run008
1227;GRR;RGG;1;3;4;3;1;run008
1228;GRR;RGR;0;1;1;0;1;run008
1229;GRR;RRR;0;1;1;1;0;run008
1230;RBB;BBB;0;1;1;0;1;run008
1231;RBB;GGG;0;3;3;3;0;run008
1232;RBG;GRR;0;1;1;0;1;run008
1233;RBG;RBR;0;1;1;1;0;run008
1234;RBG;RGR;0;1;1;0;1;run008
1235;RBR;BBB;0;3;3;0;3;run008
1236;RBR;BRB;0;1;1;1;0;run008
1237;RBR;BRR;0;2;2;1;1;run008
1238;RBR;GGG;0;1;1;0;1;run008
1239;RBR;GGR;1;2;3;3;0;run008
1240;RBR;GRG;0;1;1;1;0;run008
1241;RBR;GRR;1;15;16;6;10;run008
1242;RBR;RGG;0;4;4;3;1;run008
1243;RBR;RGR;0;1;1;1;0;run008
1244;RBR;RRR;0;3;3;3;0;run008
1245;RGG;BGG;0;1;1;1;0;run008
1246;RGG;RGR;0;1;1;0;1;run008
1247;RGR;BBB;0;9;9;4;5;run008
1248;RGR;BBR;0;1;1;0;1;run008
1249;RGR;BGB;1;8;9;4;5;run008
1250;RGR;BRB;0;3;3;1;2;run008
1251;RGR;BRR;0;3;3;2;1;run008
1252;RGR;GBG;0;1;1;0;1;run008
1253;RGR;GGB;0;3;3;1;2;run008
1254;RGR;GGG;0;2;2;2;0;run008
1255;RGR;GGR;0;8;8;5;3;run008
1256;RGR;GRR;1;7;8;4;4;run008
1257;RGR;RGG;0;6;6;0;6;run008
1258;RRG;BGB;0;1;1;1;0;run008
1259;RRG;BRB;0;1;1;0;1;run008
1260;RRG;GGG;0;1;1;1;0;run008
1261;RRG;GGR;0;1;1;0;1;run008
1262;RRG;GRG;0;1;1;1;0;run008
1263;RRG;GRR;0;3;3;0;3;run008
1264;RRG;RBR;0;4;4;3;1;run008
1265;RRG;RGG;0;1;1;0;1;run008
1266;RRG;RGR;6;37;43;38;5;run008
1267;RRR;BRR;0;1;1;1;0;run008
1268;RRR;GGB;0;1;1;0;1;run008
1269;RRR;GGG;1;5;6;5;1;run008
1270;RRR;GGR;0;2;2;1;1;run008
1271;RRR;GRR;0;1;1;0;1;run008
1272;RRR;RGR;0;1;1;1;0;run008
1273;BBB;GRR;0;1;1;0;1;run009
1274;BBG;BBB;1;9;10;4;6;run009
1275;BBG;BBR;0;2;2;1;1;run009
1276;BBG;BGB;0;1;1;0;1;run009
1277;BBG;BGG;0;1;1;1;0;run009
1278;BBG;BRB;0;2;2;2;0;run009
1279;BBG;BRR;0;1;1;0;1;run009
1280;BBG;GBB;1;1;2;2;0;run009
1281;BBG;GBG;1;6;7;5;2;run009
1282;BBG;GGB;0;18;18;11;7;run009
1283;BBG;GGG;1;29;30;4;26;run009
1284;BBG;GGR;0;2;2;1;1;run009
1285;BBG;GRG;0;1;1;0;1;run009
1286;BBG;GRR;0;3;3;1;2;run009
1287;BBG;RBR;0;2;2;2;0;run009
1288;BBG;RGR;0;2;2;1;1;run009
1289;BBG;RRG;1;2;3;0;3;run009
1290;BBG;RRR;0;1;1;1;0;run009
1291;BGG;BBB;0;1;1;1;0;run009
1292;BGG;BRB;0;1;1;0;1;run009
1293;BGG;GGG;0;1;1;0;1;run009
1294;BGG;RBB;0;1;1;0;1;run009
1295;BGG;RBG;1;0;1;1;0;run009
1296;BRB;BBB;0;1;1;1;0;run009
1297;BRB;GGB;1;0;1;0;1;run009
1298;BRB;GGG;0;2;2;1;1;run009
1299;BRB;RBB;1;0;1;1;0;run009
1300;BRR;BBB;0;1;1;1;0;run009
1301;BRR;BRB;0;1;1;1;0;run009
1302;BRR;GBB;1;0;1;0;1;run009
1303;GBB;BBB;1;16;17;2;15;run009
1304;GBB;BBG;0;2;2;1;1;run009
1305;GBB;BGB;0;1;1;1;0;run009
1306;GBB;BGG;0;3;3;0;3;run009
1307;GBB;BRB;0;9;9;8;1;run009
1308;GBB;BRR;0;2;2;0;2;run009
1309;GBB;GBG;1;1;2;1;1;run009
1310;GBB;GGB;2;59;61;42;19;run009
1311;GBB;GGG;4;95;99;2;97;run009
1312;GBB;GGR;0;1;1;0;1;run009
1313;GBB;GRG;0;1;1;0;1;run009
1314;GBB;GRR;1;8;9;8;1;run009
1315;GBB;RBB;0;2;2;2;0;run009
1316;GBB;RBG;0;1;1;0;1;run009
1317;GBB;RBR;1;1;2;0;2;run009
1318;GBB;RGG;0;2;2;2;0;run009
1319;GBB;RGR;0;1;1;0;1;run009
1320;GBB;RRG;0;3;3;1;2;run009
1321;GBG;BRB;0;1;1;0;1;run009
1322;GBG;BRR;0;3;3;3;0;run009
1323;GBG;GGB;0;1;1;1;0;run009
1324;GBG;GGR;0;3;3;2;1;run009
1325;GBG;RBR;0;1;1;0;1;run009
1326;GBG;RGR;1;1;2;0;2;run009
1327;GBG;RRR;0;1;1;0;1;run009
1328;GGB;BBB;1;8;9;6;3;run009
1329;GGB;BBG;0;1;1;1;0;run009
1330;GGB;BGB;0;1;1;0;1;run009
1331;GGB;BRB;3;5;8;6;2;run009
1332;GGB;BRR;0;1;1;0;1;run009
1333;GGB;GBG;0;2;2;1;1;run009
1334;GGB;GGG;4;37;41;40;1;run009
1335;GGB;GGR;0;9;9;4;5;run009
1336;GGB;GRR;1;4;5;0;5;run009
1337;GGB;RBB;0;2;2;2;0;run009
1338;GGB;RBG;0;2;2;1;1;run009
1339;GGB;RBR;0;2;2;2;0;run009
1340;GGB;RGG;0;1;1;1;0;run009
1341;GGB;RGR;1;2;3;1;2;run009
1342;GGB;RRG;1;3;4;4;0;run009
1343;GGB;RRR;0;3;3;0;3;run009
1344;GGG;BBB;4;22;26;26;0;run009
1345;GGG;BBG;0;2;2;2;0;run009
1346;GGG;BBR;0;3;3;3;0;run009
1347;GGG;BGB;0;2;2;0;2;run009
1348;GGG;BGG;0;3;3;3;0;run009
1349;GGG;BRB;0;3;3;3;0;run009
1350;GGG;BRR;0;3;3;0;3;run009
1351;GGG;GBB;0;1;1;1;0;run009
1352;GGG;GGB;1;3;4;3;1;run009
1353;GGG;GGR;0;21;21;0;21;run009
1354;GGG;GRG;0;2;2;0;2;run009
1355;GGG;GRR;2;15;17;10;7;run009
1356;GGG;RBB;0;1;1;1;0;run009
1357;GGG;RBR;1;4;5;2;3;run009
1358;GGG;RGG;1;7;8;4;4;run009
1359;GGG;RGR;0;3;3;3;0;run009
1360;GGG;RRG;0;2;2;0;2;run009
1361;GGG;RRR;0;1;1;1;0;run009
1362;GGR;BBB;0;1;1;1;0;run009
1363;GGR;BGG;0;2;2;0;2;run009
1364;GGR;BRB;0;1;1;1;0;run009
1365;GRG;BBB;0;3;3;0;3;run009
1366;GRG;BGB;0;3;3;2;1;run009
1367;GRG;BGG;0;1;1;0;1;run009
1368;GRG;BRB;0;5;5;3;2;run009
1369;GRG;BRR;0;1;1;0;1;run009
1370;GRG;GBB;0;3;3;3;0;run009
1371;GRG;GGB;0;14;14;0;14;run009
1372;GRG;GGG;0;10;10;5;5;run009
1373;GRG;GGR;0;2;2;0;2;run009
1374;GRG;GRR;0;1;1;0;1;run009
1375;GRG;RBR;1;2;3;0;3;run009
1376;GRG;RGG;0;2;2;1;1;run009
1377;GRG;RGR;0;1;1;0;1;run009
1378;GRR;BBB;0;3;3;0;3;run009
1379;GRR;BBR;0;2;2;1;1;run009
1380;GRR;BRB;1;8;9;8;1;run009
1381;GRR;BRR;1;6;7;0;7;run009
1382;GRR;GBB;0;1;1;0;1;run009
1383;GRR;GBG;0;1;1;1;0;run009
1384;GRR;GGR;1;9;10;10;0;run009
1385;GRR;RBR;0;1;1;0;1;run009
1386;GRR;RGG;1;3;4;3;1;run009
1387;GRR;RGR;0;1;1;0;1;run009
1388;GRR;RRR;0;1;1;0;1;run009
1389;RBB;BBB;0;1;1;1;0;run009
1390;RBB;GGG;0;3;3;3;0;run009
1391;RBG;GRR;0;1;1;0;1;run009
1392;RBG;RBR;0;1;1;0;1;run009
1393;RBG;RGR;0;1;1;0;1;run009
1394;RBR;BBB;0;3;3;3;0;run009
1395;RBR;BRB;0;1;1;0;1;run009
1396;RBR;BRR;0;2;2;1;1;run009
1397;RBR;GGG;0;1;1;1;0;run009
1398;RBR;GGR;1;2;3;0;3;run009
1399;RBR;GRG;0;1;1;0;1;run009
1400;RBR;GRR;1;15;16;5;11;run009
1401;RBR;RGG;0;4;4;2;2;run009
1402;RBR;RGR;0;1;1;1;0;run009
1403;RBR;RRR;0;3;3;3;0;run009
1404;RGG;BGG;0;1;1;1;0;run009
1405;RGG;RGR;0;1;1;0;1;run009
1406;RGR;BBB;0;9;9;3;6;run009
1407;RGR;BBR;0;1;1;1;0;run009
1408;RGR;BGB;1;8;9;2;7;run009
1409;RGR;BRB;0;3;3;3;0;run009
1410;RGR;BRR;0;3;3;1;2;run009
1411;RGR;GBG;0;1;1;1;0;run009
1412;RGR;GGB;0;3;3;3;0;run009
1413;RGR;GGG;0;2;2;2;0;run009
1414;RGR;GGR;0;8;8;0;8;run009
1415;RGR;GRR;1;7;8;3;5;run009
1416;RGR;RGG;0;6;6;1;5;run009
1417;RRG;BGB;0;1;1;0;1;run009
1418;RRG;BRB;0;1;1;0;1;run009
1419;RRG;GGG;0;1;1;0;1;run009
1420;RRG;GGR;0;1;1;0;1;run009
1421;RRG;GRG;0;1;1;0;1;run009
1422;RRG;GRR;0;3;3;1;2;run009
1423;RRG;RBR;0;4;4;1;3;run009
1424;RRG;RGG;0;1;1;0;1;run009
1425;RRG;RGR;6;37;43;38;5;run009
1426;RRR;BRR;0;1;1;0;1;run009
1427;RRR;GGB;0;1;1;1;0;run009
1428;RRR;GGG;1;5;6;4;2;run009
1429;RRR;GGR;0;2;2;1;1;run009
1430;RRR;GRR;0;1;1;1;0;run009
1431;RRR;RGR;0;1;1;1;0;run009
1432;BBB;GRR;0;1;1;0;1;run010
1433;BBG;BBB;1;9;10;8;2;run010
1434;BBG;BBR;0;2;2;1;1;run010
1435;BBG;BGB;0;1;1;1;0;run010
1436;BBG;BGG;0;1;1;1;0;run010
1437;BBG;BRB;0;2;2;2;0;run010
1438;BBG;BRR;0;1;1;1;0;run010
1439;BBG;GBB;1;1;2;1;1;run010
1440;BBG;GBG;1;6;7;6;1;run010
1441;BBG;GGB;0;18;18;18;0;run010
1442;BBG;GGG;1;29;30;23;7;run010
1443;BBG;GGR;0;2;2;2;0;run010
1444;BBG;GRG;0;1;1;0;1;run010
1445;BBG;GRR;0;3;3;1;2;run010
1446;BBG;RBR;0;2;2;2;0;run010
1447;BBG;RGR;0;2;2;1;1;run010
1448;BBG;RRG;1;2;3;1;2;run010
1449;BBG;RRR;0;1;1;1;0;run010
1450;BGG;BBB;0;1;1;0;1;run010
1451;BGG;BRB;0;1;1;0;1;run010
1452;BGG;GGG;0;1;1;1;0;run010
1453;BGG;RBB;0;1;1;1;0;run010
1454;BGG;RBG;1;0;1;0;1;run010
1455;BRB;BBB;0;1;1;1;0;run010
1456;BRB;GGB;1;0;1;0;1;run010
1457;BRB;GGG;0;2;2;2;0;run010
1458;BRB;RBB;1;0;1;1;0;run010
1459;BRR;BBB;0;1;1;1;0;run010
1460;BRR;BRB;0;1;1;0;1;run010
1461;BRR;GBB;1;0;1;0;1;run010
1462;GBB;BBB;1;16;17;17;0;run010
1463;GBB;BBG;0;2;2;0;2;run010
1464;GBB;BGB;0;1;1;1;0;run010
1465;GBB;BGG;0;3;3;0;3;run010
1466;GBB;BRB;0;9;9;9;0;run010
1467;GBB;BRR;0;2;2;0;2;run010
1468;GBB;GBG;1;1;2;2;0;run010
1469;GBB;GGB;2;59;61;25;36;run010
1470;GBB;GGG;4;95;99;49;50;run010
1471;GBB;GGR;0;1;1;1;0;run010
1472;GBB;GRG;0;1;1;0;1;run010
1473;GBB;GRR;1;8;9;3;6;run010
1474;GBB;RBB;0;2;2;0;2;run010
1475;GBB;RBG;0;1;1;1;0;run010
1476;GBB;RBR;1;1;2;2;0;run010
1477;GBB;RGG;0;2;2;1;1;run010
1478;GBB;RGR;0;1;1;0;1;run010
1479;GBB;RRG;0;3;3;1;2;run010
1480;GBG;BRB;0;1;1;1;0;run010
1481;GBG;BRR;0;3;3;2;1;run010
1482;GBG;GGB;0;1;1;0;1;run010
1483;GBG;GGR;0;3;3;0;3;run010
1484;GBG;RBR;0;1;1;1;0;run010
1485;GBG;RGR;1;1;2;2;0;run010
1486;GBG;RRR;0;1;1;1;0;run010
1487;GGB;BBB;1;8;9;0;9;run010
1488;GGB;BBG;0;1;1;0;1;run010
1489;GGB;BGB;0;1;1;0;1;run010
1490;GGB;BRB;3;5;8;7;1;run010
1491;GGB;BRR;0;1;1;1;0;run010
1492;GGB;GBG;0;2;2;0;2;run010
1493;GGB;GGG;4;37;41;25;16;run010
1494;GGB;GGR;0;9;9;8;1;run010
1495;GGB;GRR;1;4;5;0;5;run010
1496;GGB;RBB;0;2;2;2;0;run010
1497;GGB;RBG;0;2;2;2;0;run010
1498;GGB;RBR;0;2;2;1;1;run010
1499;GGB;RGG;0;1;1;1;0;run010
1500;GGB;RGR;1;2;3;3;0;run010
1501;GGB;RRG;1;3;4;1;3;run010
1502;GGB;RRR;0;3;3;0;3;run010
1503;GGG;BBB;4;22;26;3;23;run010
1504;GGG;BBG;0;2;2;2;0;run010
1505;GGG;BBR;0;3;3;1;2;run010
1506;GGG;BGB;0;2;2;0;2;run010
1507;GGG;BGG;0;3;3;2;1;run010
1508;GGG;BRB;0;3;3;1;2;run010
1509;GGG;BRR;0;3;3;1;2;run010
1510;GGG;GBB;0;1;1;1;0;run010
1511;GGG;GGB;1;3;4;1;3;run010
1512;GGG;GGR;0;21;21;4;17;run010
1513;GGG;GRG;0;2;2;2;0;run010
1514;GGG;GRR;2;15;17;4;13;run010
1515;GGG;RBB;0;1;1;0;1;run010
1516;GGG;RBR;1;4;5;2;3;run010
1517;GGG;RGG;1;7;8;5;3;run010
1518;GGG;RGR;0;3;3;0;3;run010
1519;GGG;RRG;0;2;2;1;1;run010
1520;GGG;RRR;0;1;1;0;1;run010
1521;GGR;BBB;0;1;1;1;0;run010
1522;GGR;BGG;0;2;2;1;1;run010
1523;GGR;BRB;0;1;1;1;0;run010
1524;GRG;BBB;0;3;3;1;2;run010
1525;GRG;BGB;0;3;3;3;0;run010
1526;GRG;BGG;0;1;1;0;1;run010
1527;GRG;BRB;0;5;5;0;5;run010
1528;GRG;BRR;0;1;1;0;1;run010
1529;GRG;GBB;0;3;3;0;3;run010
1530;GRG;GGB;0;14;14;12;2;run010
1531;GRG;GGG;0;10;10;9;1;run010
1532;GRG;GGR;0;2;2;1;1;run010
1533;GRG;GRR;0;1;1;1;0;run010
1534;GRG;RBR;1;2;3;3;0;run010
1535;GRG;RGG;0;2;2;1;1;run010
1536;GRG;RGR;0;1;1;0;1;run010
1537;GRR;BBB;0;3;3;2;1;run010
1538;GRR;BBR;0;2;2;2;0;run010
1539;GRR;BRB;1;8;9;3;6;run010
1540;GRR;BRR;1;6;7;6;1;run010
1541;GRR;GBB;0;1;1;0;1;run010
1542;GRR;GBG;0;1;1;0;1;run010
1543;GRR;GGR;1;9;10;6;4;run010
1544;GRR;RBR;0;1;1;0;1;run010
1545;GRR;RGG;1;3;4;0;4;run010
1546;GRR;RGR;0;1;1;1;0;run010
1547;GRR;RRR;0;1;1;1;0;run010
1548;RBB;BBB;0;1;1;1;0;run010
1549;RBB;GGG;0;3;3;1;2;run010
1550;RBG;GRR;0;1;1;0;1;run010
1551;RBG;RBR;0;1;1;0;1;run010
1552;RBG;RGR;0;1;1;1;0;run010
1553;RBR;BBB;0;3;3;2;1;run010
1554;RBR;BRB;0;1;1;0;1;run010
1555;RBR;BRR;0;2;2;0;2;run010
1556;RBR;GGG;0;1;1;0;1;run010
1557;RBR;GGR;1;2;3;2;1;run010
1558;RBR;GRG;0;1;1;0;1;run010
1559;RBR;GRR;1;15;16;9;7;run010
1560;RBR;RGG;0;4;4;0;4;run010
1561;RBR;RGR;0;1;1;1;0;run010
1562;RBR;RRR;0;3;3;1;2;run010
1563;RGG;BGG;0;1;1;0;1;run010
1564;RGG;RGR;0;1;1;1;0;run010
1565;RGR;BBB;0;9;9;3;6;run010
1566;RGR;BBR;0;1;1;0;1;run010
1567;RGR;BGB;1;8;9;2;7;run010
1568;RGR;BRB;0;3;3;2;1;run010
1569;RGR;BRR;0;3;3;3;0;run010
1570;RGR;GBG;0;1;1;1;0;run010
1571;RGR;GGB;0;3;3;1;2;run010
1572;RGR;GGG;0;2;2;0;2;run010
1573;RGR;GGR;0;8;8;5;3;run010
1574;RGR;GRR;1;7;8;7;1;run010
1575;RGR;RGG;0;6;6;5;1;run010
1576;RRG;BGB;0;1;1;1;0;run010
1577;RRG;BRB;0;1;1;0;1;run010
1578;RRG;GGG;0;1;1;1;0;run010
1579;RRG;GGR;0;1;1;0;1;run010
1580;RRG;GRG;0;1;1;1;0;run010
1581;RRG;GRR;0;3;3;3;0;run010
1582;RRG;RBR;0;4;4;4;0;run010
1583;RRG;RGG;0;1;1;1;0;run010
1584;RRG;RGR;6;37;43;22;21;run010
1585;RRR;BRR;0;1;1;0;1;run010
1586;RRR;GGB;0;1;1;0;1;run010
1587;RRR;GGG;1;5;6;0;6;run010
1588;RRR;GGR;0;2;2;0;2;run010
1589;RRR;GRR;0;1;1;1;0;run010
1590;RRR;RGR;0;1;1;1;0;run010
1591;BBB;GRR;0;1;1;1;0;run011
1592;BBG;BBB;1;9;10;1;9;run011
1593;BBG;BBR;0;2;2;0;2;run011
1594;BBG;BGB;0;1;1;1;0;run011
1595;BBG;BGG;0;1;1;0;1;run011
1596;BBG;BRB;0;2;2;0;2;run011
1597;BBG;BRR;0;1;1;1;0;run011
1598;BBG;GBB;1;1;2;1;1;run011
1599;BBG;GBG;1;6;7;3;4;run011
1600;BBG;GGB;0;18;18;6;12;run011
1601;BBG;GGG;1;29;30;29;1;run011
1602;BBG;GGR;0;2;2;0;2;run011
1603;BBG;GRG;0;1;1;0;1;run011
1604;BBG;GRR;0;3;3;0;3;run011
1605;BBG;RBR;0;2;2;2;0;run011
1606;BBG;RGR;0;2;2;2;0;run011
1607;BBG;RRG;1;2;3;0;3;run011
1608;BBG;RRR;0;1;1;1;0;run011
1609;BGG;BBB;0;1;1;0;1;run011
1610;BGG;BRB;0;1;1;0;1;run011
1611;BGG;GGG;0;1;1;1;0;run011
1612;BGG;RBB;0;1;1;0;1;run011
1613;BGG;RBG;1;0;1;0;1;run011
1614;BRB;BBB;0;1;1;1;0;run011
1615;BRB;GGB;1;0;1;1;0;run011
1616;BRB;GGG;0;2;2;2;0;run011
1617;BRB;RBB;1;0;1;0;1;run011
1618;BRR;BBB;0;1;1;0;1;run011
1619;BRR;BRB;0;1;1;1;0;run011
1620;BRR;GBB;1;0;1;1;0;run011
1621;GBB;BBB;1;16;17;1;16;run011
1622;GBB;BBG;0;2;2;2;0;run011
1623;GBB;BGB;0;1;1;1;0;run011
1624;GBB;BGG;0;3;3;3;0;run011
1625;GBB;BRB;0;9;9;9;0;run011
1626;GBB;BRR;0;2;2;2;0;run011
1627;GBB;GBG;1;1;2;1;1;run011
1628;GBB;GGB;2;59;61;8;53;run011
1629;GBB;GGG;4;95;99;59;40;run011
1630;GBB;GGR;0;1;1;1;0;run011
1631;GBB;GRG;0;1;1;0;1;run011
1632;GBB;GRR;1;8;9;7;2;run011
1633;GBB;RBB;0;2;2;0;2;run011
1634;GBB;RBG;0;1;1;1;0;run011
1635;GBB;RBR;1;1;2;2;0;run011
1636;GBB;RGG;0;2;2;0;2;run011
1637;GBB;RGR;0;1;1;0;1;run011
1638;GBB;RRG;0;3;3;0;3;run011
1639;GBG;BRB;0;1;1;1;0;run011
1640;GBG;BRR;0;3;3;1;2;run011
1641;GBG;GGB;0;1;1;0;1;run011
1642;GBG;GGR;0;3;3;3;0;run011
1643;GBG;RBR;0;1;1;1;0;run011
1644;GBG;RGR;1;1;2;2;0;run011
1645;GBG;RRR;0;1;1;0;1;run011
1646;GGB;BBB;1;8;9;5;4;run011
1647;GGB;BBG;0;1;1;1;0;run011
1648;GGB;BGB;0;1;1;1;0;run011
1649;GGB;BRB;3;5;8;1;7;run011
1650;GGB;BRR;0;1;1;0;1;run011
1651;GGB;GBG;0;2;2;0;2;run011
1652;GGB;GGG;4;37;41;27;14;run011
1653;GGB;GGR;0;9;9;5;4;run011
1654;GGB;GRR;1;4;5;5;0;run011
1655;GGB;RBB;0;2;2;0;2;run011
1656;GGB;RBG;0;2;2;1;1;run011
1657;GGB;RBR;0;2;2;1;1;run011
1658;GGB;RGG;0;1;1;1;0;run011
1659;GGB;RGR;1;2;3;0;3;run011
1660;GGB;RRG;1;3;4;0;4;run011
1661;GGB;RRR;0;3;3;2;1;run011
1662;GGG;BBB;4;22;26;19;7;run011
1663;GGG;BBG;0;2;2;2;0;run011
1664;GGG;BBR;0;3;3;3;0;run011
1665;GGG;BGB;0;2;2;1;1;run011
1666;GGG;BGG;0;3;3;2;1;run011
1667;GGG;BRB;0;3;3;2;1;run011
1668;GGG;BRR;0;3;3;2;1;run011
1669;GGG;GBB;0;1;1;1;0;run011
1670;GGG;GGB;1;3;4;2;2;run011
1671;GGG;GGR;0;21;21;10;11;run011
1672;GGG;GRG;0;2;2;2;0;run011
1673;GGG;GRR;2;15;17;2;15;run011
1674;GGG;RBB;0;1;1;1;0;run011
1675;GGG;RBR;1;4;5;2;3;run011
1676;GGG;RGG;1;7;8;4;4;run011
1677;GGG;RGR;0;3;3;1;2;run011
1678;GGG;RRG;0;2;2;0;2;run011
1679;GGG;RRR;0;1;1;0;1;run011
1680;GGR;BBB;0;1;1;0;1;run011
1681;GGR;BGG;0;2;2;1;1;run011
1682;GGR;BRB;0;1;1;1;0;run011
1683;GRG;BBB;0;3;3;2;1;run011
1684;GRG;BGB;0;3;3;2;1;run011
1685;GRG;BGG;0;1;1;1;0;run011
1686;GRG;BRB;0;5;5;4;1;run011
1687;GRG;BRR;0;1;1;0;1;run011
1688;GRG;GBB;0;3;3;0;3;run011
1689;GRG;GGB;0;14;14;0;14;run011
1690;GRG;GGG;0;10;10;7;3;run011
1691;GRG;GGR;0;2;2;0;2;run011
1692;GRG;GRR;0;1;1;0;1;run011
1693;GRG;RBR;1;2;3;1;2;run011
1694;GRG;RGG;0;2;2;0;2;run011
1695;GRG;RGR;0;1;1;0;1;run011
1696;GRR;BBB;0;3;3;0;3;run011
1697;GRR;BBR;0;2;2;1;1;run011
1698;GRR;BRB;1;8;9;8;1;run011
1699;GRR;BRR;1;6;7;2;5;run011
1700;GRR;GBB;0;1;1;1;0;run011
1701;GRR;GBG;0;1;1;1;0;run011
1702;GRR;GGR;1;9;10;9;1;run011
1703;GRR;RBR;0;1;1;1;0;run011
1704;GRR;RGG;1;3;4;2;2;run011
1705;GRR;RGR;0;1;1;1;0;run011
1706;GRR;RRR;0;1;1;0;1;run011
1707;RBB;BBB;0;1;1;0;1;run011
1708;RBB;GGG;0;3;3;0;3;run011
1709;RBG;GRR;0;1;1;0;1;run011
1710;RBG;RBR;0;1;1;1;0;run011
1711;RBG;RGR;0;1;1;0;1;run011
1712;RBR;BBB;0;3;3;0;3;run011
1713;RBR;BRB;0;1;1;1;0;run011
1714;RBR;BRR;0;2;2;0;2;run011
1715;RBR;GGG;0;1;1;0;1;run011
1716;RBR;GGR;1;2;3;3;0;run011
1717;RBR;GRG;0;1;1;1;0;run011
1718;RBR;GRR;1;15;16;8;8;run011
1719;RBR;RGG;0;4;4;2;2;run011
1720;RBR;RGR;0;1;1;0;1;run011
1721;RBR;RRR;0;3;3;3;0;run011
1722;RGG;BGG;0;1;1;0;1;run011
1723;RGG;RGR;0;1;1;1;0;run011
1724;RGR;BBB;0;9;9;1;8;run011
1725;RGR;BBR;0;1;1;1;0;run011
1726;RGR;BGB;1;8;9;9;0;run011
1727;RGR;BRB;0;3;3;2;1;run011
1728;RGR;BRR;0;3;3;2;1;run011
1729;RGR;GBG;0;1;1;0;1;run011
1730;RGR;GGB;0;3;3;2;1;run011
1731;RGR;GGG;0;2;2;0;2;run011
1732;RGR;GGR;0;8;8;1;7;run011
1733;RGR;GRR;1;7;8;8;0;run011
1734;RGR;RGG;0;6;6;6;0;run011
1735;RRG;BGB;0;1;1;1;0;run011
1736;RRG;BRB;0;1;1;0;1;run011
1737;RRG;GGG;0;1;1;1;0;run011
1738;RRG;GGR;0;1;1;1;0;run011
1739;RRG;GRG;0;1;1;0;1;run011
1740;RRG;GRR;0;3;3;0;3;run011
1741;RRG;RBR;0;4;4;1;3;run011
1742;RRG;RGG;0;1;1;0;1;run011
1743;RRG;RGR;6;37;43;2;41;run011
1744;RRR;BRR;0;1;1;1;0;run011
1745;RRR;GGB;0;1;1;0;1;run011
1746;RRR;GGG;1;5;6;0;6;run011
1747;RRR;GGR;0;2;2;1;1;run011
1748;RRR;GRR;0;1;1;0;1;run011
1749;RRR;RGR;0;1;1;0;1;run011
1750;BBB;GRR;0;1;1;1;0;run012
1751;BBG;BBB;1;9;10;9;1;run012
1752;BBG;BBR;0;2;2;2;0;run012
1753;BBG;BGB;0;1;1;0;1;run012
1754;BBG;BGG;0;1;1;1;0;run012
1755;BBG;BRB;0;2;2;0;2;run012
1756;BBG;BRR;0;1;1;0;1;run012
1757;BBG;GBB;1;1;2;1;1;run012
1758;BBG;GBG;1;6;7;7;0;run012
1759;BBG;GGB;0;18;18;17;1;run012
1760;BBG;GGG;1;29;30;28;2;run012
1761;BBG;GGR;0;2;2;1;1;run012
1762;BBG;GRG;0;1;1;0;1;run012
1763;BBG;GRR;0;3;3;1;2;run012
1764;BBG;RBR;0;2;2;1;1;run012
1765;BBG;RGR;0;2;2;1;1;run012
1766;BBG;RRG;1;2;3;2;1;run012
1767;BBG;RRR;0;1;1;1;0;run012
1768;BGG;BBB;0;1;1;0;1;run012
1769;BGG;BRB;0;1;1;1;0;run012
1770;BGG;GGG;0;1;1;1;0;run012
1771;BGG;RBB;0;1;1;1;0;run012
1772;BGG;RBG;1;0;1;0;1;run012
1773;BRB;BBB;0;1;1;1;0;run012
1774;BRB;GGB;1;0;1;0;1;run012
1775;BRB;GGG;0;2;2;1;1;run012
1776;BRB;RBB;1;0;1;0;1;run012
1777;BRR;BBB;0;1;1;1;0;run012
1778;BRR;BRB;0;1;1;0;1;run012
1779;BRR;GBB;1;0;1;0;1;run012
1780;GBB;BBB;1;16;17;11;6;run012
1781;GBB;BBG;0;2;2;0;2;run012
1782;GBB;BGB;0;1;1;0;1;run012
1783;GBB;BGG;0;3;3;0;3;run012
1784;GBB;BRB;0;9;9;1;8;run012
1785;GBB;BRR;0;2;2;2;0;run012
1786;GBB;GBG;1;1;2;1;1;run012
1787;GBB;GGB;2;59;61;6;55;run012
1788;GBB;GGG;4;95;99;25;74;run012
1789;GBB;GGR;0;1;1;1;0;run012
1790;GBB;GRG;0;1;1;1;0;run012
1791;GBB;GRR;1;8;9;3;6;run012
1792;GBB;RBB;0;2;2;2;0;run012
1793;GBB;RBG;0;1;1;1;0;run012
1794;GBB;RBR;1;1;2;0;2;run012
1795;GBB;RGG;0;2;2;0;2;run012
1796;GBB;RGR;0;1;1;1;0;run012
1797;GBB;RRG;0;3;3;2;1;run012
1798;GBG;BRB;0;1;1;0;1;run012
1799;GBG;BRR;0;3;3;2;1;run012
1800;GBG;GGB;0;1;1;1;0;run012
1801;GBG;GGR;0;3;3;3;0;run012
1802;GBG;RBR;0;1;1;0;1;run012
1803;GBG;RGR;1;1;2;1;1;run012
1804;GBG;RRR;0;1;1;0;1;run012
1805;GGB;BBB;1;8;9;3;6;run012
1806;GGB;BBG;0;1;1;0;1;run012
1807;GGB;BGB;0;1;1;1;0;run012
1808;GGB;BRB;3;5;8;4;4;run012
1809;GGB;BRR;0;1;1;0;1;run012
1810;GGB;GBG;0;2;2;1;1;run012
1811;GGB;GGG;4;37;41;20;21;run012
1812;GGB;GGR;0;9;9;6;3;run012
1813;GGB;GRR;1;4;5;1;4;run012
1814;GGB;RBB;0;2;2;0;2;run012
1815;GGB;RBG;0;2;2;0;2;run012
1816;GGB;RBR;0;2;2;0;2;run012
1817;GGB;RGG;0;1;1;0;1;run012
1818;GGB;RGR;1;2;3;1;2;run012
1819;GGB;RRG;1;3;4;3;1;run012
1820;GGB;RRR;0;3;3;3;0;run012
1821;GGG;BBB;4;22;26;26;0;run012
1822;GGG;BBG;0;2;2;0;2;run012
1823;GGG;BBR;0;3;3;2;1;run012
1824;GGG;BGB;0;2;2;2;0;run012
1825;GGG;BGG;0;3;3;1;2;run012
1826;GGG;BRB;0;3;3;3;0;run012
1827;GGG;BRR;0;3;3;1;2;run012
1828;GGG;GBB;0;1;1;1;0;run012
1829;GGG;GGB;1;3;4;3;1;run012
1830;GGG;GGR;0;21;21;9;12;run012
1831;GGG;GRG;0;2;2;1;1;run012
1832;GGG;GRR;2;15;17;4;13;run012
1833;GGG;RBB;0;1;1;1;0;run012
1834;GGG;RBR;1;4;5;4;1;run012
1835;GGG;RGG;1;7;8;5;3;run012
1836;GGG;RGR;0;3;3;2;1;run012
1837;GGG;RRG;0;2;2;1;1;run012
1838;GGG;RRR;0;1;1;1;0;run012
1839;GGR;BBB;0;1;1;0;1;run012
1840;GGR;BGG;0;2;2;2;0;run012
1841;GGR;BRB;0;1;1;0;1;run012
1842;GRG;BBB;0;3;3;1;2;run012
1843;GRG;BGB;0;3;3;1;2;run012
1844;GRG;BGG;0;1;1;1;0;run012
1845;GRG;BRB;0;5;5;2;3;run012
1846;GRG;BRR;0;1;1;1;0;run012
1847;GRG;GBB;0;3;3;1;2;run012
1848;GRG;GGB;0;14;14;1;13;run012
1849;GRG;GGG;0;10;10;7;3;run012
1850;GRG;GGR;0;2;2;2;0;run012
1851;GRG;GRR;0;1;1;1;0;run012
1852;GRG;RBR;1;2;3;1;2;run012
1853;GRG;RGG;0;2;2;2;0;run012
1854;GRG;RGR;0;1;1;1;0;run012
1855;GRR;BBB;0;3;3;0;3;run012
1856;GRR;BBR;0;2;2;2;0;run012
1857;GRR;BRB;1;8;9;6;3;run012
1858;GRR;BRR;1;6;7;4;3;run012
1859;GRR;GBB;0;1;1;1;0;run012
1860;GRR;GBG;0;1;1;0;1;run012
1861;GRR;GGR;1;9;10;3;7;run012
1862;GRR;RBR;0;1;1;0;1;run012
1863;GRR;RGG;1;3;4;3;1;run012
1864;GRR;RGR;0;1;1;0;1;run012
1865;GRR;RRR;0;1;1;1;0;run012
1866;RBB;BBB;0;1;1;1;0;run012
1867;RBB;GGG;0;3;3;0;3;run012
1868;RBG;GRR;0;1;1;0;1;run012
1869;RBG;RBR;0;1;1;0;1;run012
1870;RBG;RGR;0;1;1;1;0;run012
1871;RBR;BBB;0;3;3;0;3;run012
1872;RBR;BRB;0;1;1;1;0;run012
1873;RBR;BRR;0;2;2;0;2;run012
1874;RBR;GGG;0;1;1;1;0;run012
1875;RBR;GGR;1;2;3;2;1;run012
1876;RBR;GRG;0;1;1;0;1;run012
1877;RBR;GRR;1;15;16;12;4;run012
1878;RBR;RGG;0;4;4;2;2;run012
1879;RBR;RGR;0;1;1;1;0;run012
1880;RBR;RRR;0;3;3;3;0;run012
1881;RGG;BGG;0;1;1;0;1;run012
1882;RGG;RGR;0;1;1;0;1;run012
1883;RGR;BBB;0;9;9;4;5;run012
1884;RGR;BBR;0;1;1;0;1;run012
1885;RGR;BGB;1;8;9;2;7;run012
1886;RGR;BRB;0;3;3;3;0;run012
1887;RGR;BRR;0;3;3;1;2;run012
1888;RGR;GBG;0;1;1;0;1;run012
1889;RGR;GGB;0;3;3;3;0;run012
1890;RGR;GGG;0;2;2;0;2;run012
1891;RGR;GGR;0;8;8;8;0;run012
1892;RGR;GRR;1;7;8;1;7;run012
1893;RGR;RGG;0;6;6;3;3;run012
1894;RRG;BGB;0;1;1;0;1;run012
1895;RRG;BRB;0;1;1;0;1;run012
1896;RRG;GGG;0;1;1;0;1;run012
1897;RRG;GGR;0;1;1;0;1;run012
1898;RRG;GRG;0;1;1;0;1;run012
1899;RRG;GRR;0;3;3;2;1;run012
1900;RRG;RBR;0;4;4;2;2;run012
1901;RRG;RGG;0;1;1;0;1;run012
1902;RRG;RGR;6;37;43;32;11;run012
1903;RRR;BRR;0;1;1;0;1;run012
1904;RRR;GGB;0;1;1;0;1;run012
1905;RRR;GGG;1;5;6;2;4;run012
1906;RRR;GGR;0;2;2;2;0;run012
1907;RRR;GRR;0;1;1;1;0;run012
1908;RRR;RGR;0;1;1;1;0;run012
1909;BBB;GRR;0;1;1;1;0;run013
1910;BBG;BBB;1;9;10;2;8;run013
1911;BBG;BBR;0;2;2;0;2;run013
1912;BBG;BGB;0;1;1;1;0;run013
1913;BBG;BGG;0;1;1;0;1;run013
1914;BBG;BRB;0;2;2;1;1;run013
1915;BBG;BRR;0;1;1;1;0;run013
1916;BBG;GBB;1;1;2;1;1;run013
1917;BBG;GBG;1;6;7;3;4;run013
1918;BBG;GGB;0;18;18;18;0;run013
1919;BBG;GGG;1;29;30;16;14;run013
1920;BBG;GGR;0;2;2;1;1;run013
1921;BBG;GRG;0;1;1;0;1;run013
1922;BBG;GRR;0;3;3;2;1;run013
1923;BBG;RBR;0;2;2;2;0;run013
1924;BBG;RGR;0;2;2;0;2;run013
1925;BBG;RRG;1;2;3;3;0;run013
1926;BBG;RRR;0;1;1;0;1;run013
1927;BGG;BBB;0;1;1;1;0;run013
1928;BGG;BRB;0;1;1;1;0;run013
1929;BGG;GGG;0;1;1;1;0;run013
1930;BGG;RBB;0;1;1;1;0;run013
1931;BGG;RBG;1;0;1;0;1;run013
1932;BRB;BBB;0;1;1;0;1;run013
1933;BRB;GGB;1;0;1;0;1;run013
1934;BRB;GGG;0;2;2;0;2;run013
1935;BRB;RBB;1;0;1;0;1;run013
1936;BRR;BBB;0;1;1;1;0;run013
1937;BRR;BRB;0;1;1;1;0;run013
1938;BRR;GBB;1;0;1;0;1;run013
1939;GBB;BBB;1;16;17;13;4;run013
1940;GBB;BBG;0;2;2;0;2;run013
1941;GBB;BGB;0;1;1;0;1;run013
1942;GBB;BGG;0;3;3;2;1;run013
1943;GBB;BRB;0;9;9;2;7;run013
1944;GBB;BRR;0;2;2;0;2;run013
1945;GBB;GBG;1;1;2;1;1;run013
1946;GBB;GGB;2;59;61;3;58;run013
1947;GBB;GGG;4;95;99;93;6;run013
1948;GBB;GGR;0;1;1;1;0;run013
1949;GBB;GRG;0;1;1;0;1;run013
1950;GBB;GRR;1;8;9;2;7;run013
1951;GBB;RBB;0;2;2;2;0;run013
1952;GBB;RBG;0;1;1;0;1;run013
1953;GBB;RBR;1;1;2;1;1;run013
1954;GBB;RGG;0;2;2;0;2;run013
1955;GBB;RGR;0;1;1;1;0;run013
1956;GBB;RRG;0;3;3;3;0;run013
1957;GBG;BRB;0;1;1;1;0;run013
1958;GBG;BRR;0;3;3;1;2;run013
1959;GBG;GGB;0;1;1;1;0;run013
1960;GBG;GGR;0;3;3;1;2;run013
1961;GBG;RBR;0;1;1;0;1;run013
1962;GBG;RGR;1;1;2;2;0;run013
1963;GBG;RRR;0;1;1;0;1;run013
1964;GGB;BBB;1;8;9;1;8;run013
1965;GGB;BBG;0;1;1;0;1;run013
1966;GGB;BGB;0;1;1;1;0;run013
1967;GGB;BRB;3;5;8;8;0;run013
1968;GGB;BRR;0;1;1;0;1;run013
1969;GGB;GBG;0;2;2;2;0;run013
1970;GGB;GGG;4;37;41;17;24;run013
1971;GGB;GGR;0;9;9;2;7;run013
1972;GGB;GRR;1;4;5;4;1;run013
1973;GGB;RBB;0;2;2;1;1;run013
1974;GGB;RBG;0;2;2;1;1;run013
1975;GGB;RBR;0;2;2;0;2;run013
1976;GGB;RGG;0;1;1;1;0;run013
1977;GGB;RGR;1;2;3;0;3;run013
1978;GGB;RRG;1;3;4;0;4;run013
1979;GGB;RRR;0;3;3;0;3;run013
1980;GGG;BBB;4;22;26;21;5;run013
1981;GGG;BBG;0;2;2;2;0;run013
1982;GGG;BBR;0;3;3;0;3;run013
1983;GGG;BGB;0;2;2;2;0;run013
1984;GGG;BGG;0;3;3;3;0;run013
1985;GGG;BRB;0;3;3;2;1;run013
1986;GGG;BRR;0;3;3;1;2;run013
1987;GGG;GBB;0;1;1;1;0;run013
1988;GGG;GGB;1;3;4;2;2;run013
1989;GGG;GGR;0;21;21;14;7;run013
1990;GGG;GRG;0;2;2;1;1;run013
1991;GGG;GRR;2;15;17;7;10;run013
1992;GGG;RBB;0;1;1;1;0;run013
1993;GGG;RBR;1;4;5;2;3;run013
1994;GGG;RGG;1;7;8;8;0;run013
1995;GGG;RGR;0;3;3;3;0;run013
1996;GGG;RRG;0;2;2;0;2;run013
1997;GGG;RRR;0;1;1;0;1;run013
1998;GGR;BBB;0;1;1;1;0;run013
1999;GGR;BGG;0;2;2;2;0;run013
2000;GGR;BRB;0;1;1;1;0;run013
2001;GRG;BBB;0;3;3;0;3;run013
2002;GRG;BGB;0;3;3;2;1;run013
2003;GRG;BGG;0;1;1;0;1;run013
2004;GRG;BRB;0;5;5;0;5;run013
2005;GRG;BRR;0;1;1;0;1;run013
2006;GRG;GBB;0;3;3;1;2;run013
2007;GRG;GGB;0;14;14;10;4;run013
2008;GRG;GGG;0;10;10;9;1;run013
2009;GRG;GGR;0;2;2;1;1;run013
2010;GRG;GRR;0;1;1;0;1;run013
2011;GRG;RBR;1;2;3;3;0;run013
2012;GRG;RGG;0;2;2;2;0;run013
2013;GRG;RGR;0;1;1;0;1;run013
2014;GRR;BBB;0;3;3;0;3;run013
2015;GRR;BBR;0;2;2;0;2;run013
2016;GRR;BRB;1;8;9;5;4;run013
2017;GRR;BRR;1;6;7;2;5;run013
2018;GRR;GBB;0;1;1;0;1;run013
2019;GRR;GBG;0;1;1;1;0;run013
2020;GRR;GGR;1;9;10;0;10;run013
2021;GRR;RBR;0;1;1;1;0;run013
2022;GRR;RGG;1;3;4;3;1;run013
2023;GRR;RGR;0;1;1;1;0;run013
2024;GRR;RRR;0;1;1;1;0;run013
2025;RBB;BBB;0;1;1;1;0;run013
2026;RBB;GGG;0;3;3;0;3;run013
2027;RBG;GRR;0;1;1;1;0;run013
2028;RBG;RBR;0;1;1;1;0;run013
2029;RBG;RGR;0;1;1;1;0;run013
2030;RBR;BBB;0;3;3;3;0;run013
2031;RBR;BRB;0;1;1;1;0;run013
2032;RBR;BRR;0;2;2;0;2;run013
2033;RBR;GGG;0;1;1;0;1;run013
2034;RBR;GGR;1;2;3;2;1;run013
2035;RBR;GRG;0;1;1;0;1;run013
2036;RBR;GRR;1;15;16;2;14;run013
2037;RBR;RGG;0;4;4;4;0;run013
2038;RBR;RGR;0;1;1;1;0;run013
2039;RBR;RRR;0;3;3;1;2;run013
2040;RGG;BGG;0;1;1;0;1;run013
2041;RGG;RGR;0;1;1;0;1;run013
2042;RGR;BBB;0;9;9;5;4;run013
2043;RGR;BBR;0;1;1;1;0;run013
2044;RGR;BGB;1;8;9;1;8;run013
2045;RGR;BRB;0;3;3;0;3;run013
2046;RGR;BRR;0;3;3;2;1;run013
2047;RGR;GBG;0;1;1;0;1;run013
2048;RGR;GGB;0;3;3;1;2;run013
2049;RGR;GGG;0;2;2;1;1;run013
2050;RGR;GGR;0;8;8;8;0;run013
2051;RGR;GRR;1;7;8;6;2;run013
2052;RGR;RGG;0;6;6;6;0;run013
2053;RRG;BGB;0;1;1;0;1;run013
2054;RRG;BRB;0;1;1;1;0;run013
2055;RRG;GGG;0;1;1;1;0;run013
2056;RRG;GGR;0;1;1;1;0;run013
2057;RRG;GRG;0;1;1;0;1;run013
2058;RRG;GRR;0;3;3;0;3;run013
2059;RRG;RBR;0;4;4;2;2;run013
2060;RRG;RGG;0;1;1;1;0;run013
2061;RRG;RGR;6;37;43;1;42;run013
2062;RRR;BRR;0;1;1;0;1;run013
2063;RRR;GGB;0;1;1;0;1;run013
2064;RRR;GGG;1;5;6;2;4;run013
2065;RRR;GGR;0;2;2;2;0;run013
2066;RRR;GRR;0;1;1;0;1;run013
2067;RRR;RGR;0;1;1;1;0;run013
2068;BBB;GRR;0;1;1;0;1;run014
2069;BBG;BBB;1;9;10;8;2;run014
2070;BBG;BBR;0;2;2;2;0;run014
2071;BBG;BGB;0;1;1;1;0;run014
2072;BBG;BGG;0;1;1;0;1;run014
2073;BBG;BRB;0;2;2;1;1;run014
2074;BBG;BRR;0;1;1;1;0;run014
2075;BBG;GBB;1;1;2;1;1;run014
2076;BBG;GBG;1;6;7;6;1;run014
2077;BBG;GGB;0;18;18;0;18;run014
2078;BBG;GGG;1;29;30;8;22;run014
2079;BBG;GGR;0;2;2;2;0;run014
2080;BBG;GRG;0;1;1;1;0;run014
2081;BBG;GRR;0;3;3;0;3;run014
2082;BBG;RBR;0;2;2;2;0;run014
2083;BBG;RGR;0;2;2;0;2;run014
2084;BBG;RRG;1;2;3;1;2;run014
2085;BBG;RRR;0;1;1;0;1;run014
2086;BGG;BBB;0;1;1;0;1;run014
2087;BGG;BRB;0;1;1;0;1;run014
2088;BGG;GGG;0;1;1;1;0;run014
2089;BGG;RBB;0;1;1;0;1;run014
2090;BGG;RBG;1;0;1;1;0;run014
2091;BRB;BBB;0;1;1;0;1;run014
2092;BRB;GGB;1;0;1;1;0;run014
2093;BRB;GGG;0;2;2;0;2;run014
2094;BRB;RBB;1;0;1;1;0;run014
2095;BRR;BBB;0;1;1;1;0;run014
2096;BRR;BRB;0;1;1;0;1;run014
2097;BRR;GBB;1;0;1;1;0;run014
2098;GBB;BBB;1;16;17;13;4;run014
2099;GBB;BBG;0;2;2;1;1;run014
2100;GBB;BGB;0;1;1;1;0;run014
2101;GBB;BGG;0;3;3;3;0;run014
2102;GBB;BRB;0;9;9;9;0;run014
2103;GBB;BRR;0;2;2;2;0;run014
2104;GBB;GBG;1;1;2;0;2;run014
2105;GBB;GGB;2;59;61;5;56;run014
2106;GBB;GGG;4;95;99;89;10;run014
2107;GBB;GGR;0;1;1;1;0;run014
2108;GBB;GRG;0;1;1;1;0;run014
2109;GBB;GRR;1;8;9;6;3;run014
2110;GBB;RBB;0;2;2;0;2;run014
2111;GBB;RBG;0;1;1;1;0;run014
2112;GBB;RBR;1;1;2;2;0;run014
2113;GBB;RGG;0;2;2;0;2;run014
2114;GBB;RGR;0;1;1;0;1;run014
2115;GBB;RRG;0;3;3;0;3;run014
2116;GBG;BRB;0;1;1;0;1;run014
2117;GBG;BRR;0;3;3;1;2;run014
2118;GBG;GGB;0;1;1;1;0;run014
2119;GBG;GGR;0;3;3;3;0;run014
2120;GBG;RBR;0;1;1;1;0;run014
2121;GBG;RGR;1;1;2;0;2;run014
2122;GBG;RRR;0;1;1;0;1;run014
2123;GGB;BBB;1;8;9;4;5;run014
2124;GGB;BBG;0;1;1;0;1;run014
2125;GGB;BGB;0;1;1;1;0;run014
2126;GGB;BRB;3;5;8;7;1;run014
2127;GGB;BRR;0;1;1;1;0;run014
2128;GGB;GBG;0;2;2;2;0;run014
2129;GGB;GGG;4;37;41;36;5;run014
2130;GGB;GGR;0;9;9;9;0;run014
2131;GGB;GRR;1;4;5;1;4;run014
2132;GGB;RBB;0;2;2;2;0;run014
2133;GGB;RBG;0;2;2;1;1;run014
2134;GGB;RBR;0;2;2;1;1;run014
2135;GGB;RGG;0;1;1;1;0;run014
2136;GGB;RGR;1;2;3;2;1;run014
2137;GGB;RRG;1;3;4;2;2;run014
2138;GGB;RRR;0;3;3;3;0;run014
2139;GGG;BBB;4;22;26;0;26;run014
2140;GGG;BBG;0;2;2;2;0;run014
2141;GGG;BBR;0;3;3;2;1;run014
2142;GGG;BGB;0;2;2;2;0;run014
2143;GGG;BGG;0;3;3;0;3;run014
2144;GGG;BRB;0;3;3;1;2;run014
2145;GGG;BRR;0;3;3;0;3;run014
2146;GGG;GBB;0;1;1;1;0;run014
2147;GGG;GGB;1;3;4;4;0;run014
2148;GGG;GGR;0;21;21;14;7;run014
2149;GGG;GRG;0;2;2;2;0;run014
2150;GGG;GRR;2;15;17;6;11;run014
2151;GGG;RBB;0;1;1;1;0;run014
2152;GGG;RBR;1;4;5;3;2;run014
2153;GGG;RGG;1;7;8;5;3;run014
2154;GGG;RGR;0;3;3;0;3;run014
2155;GGG;RRG;0;2;2;1;1;run014
2156;GGG;RRR;0;1;1;1;0;run014
2157;GGR;BBB;0;1;1;0;1;run014
2158;GGR;BGG;0;2;2;2;0;run014
2159;GGR;BRB;0;1;1;1;0;run014
2160;GRG;BBB;0;3;3;0;3;run014
2161;GRG;BGB;0;3;3;3;0;run014
2162;GRG;BGG;0;1;1;1;0;run014
2163;GRG;BRB;0;5;5;2;3;run014
2164;GRG;BRR;0;1;1;1;0;run014
2165;GRG;GBB;0;3;3;3;0;run014
2166;GRG;GGB;0;14;14;3;11;run014
2167;GRG;GGG;0;10;10;7;3;run014
2168;GRG;GGR;0;2;2;0;2;run014
2169;GRG;GRR;0;1;1;0;1;run014
2170;GRG;RBR;1;2;3;3;0;run014
2171;GRG;RGG;0;2;2;2;0;run014
2172;GRG;RGR;0;1;1;0;1;run014
2173;GRR;BBB;0;3;3;0;3;run014
2174;GRR;BBR;0;2;2;0;2;run014
2175;GRR;BRB;1;8;9;6;3;run014
2176;GRR;BRR;1;6;7;1;6;run014
2177;GRR;GBB;0;1;1;0;1;run014
2178;GRR;GBG;0;1;1;0;1;run014
2179;GRR;GGR;1;9;10;10;0;run014
2180;GRR;RBR;0;1;1;0;1;run014
2181;GRR;RGG;1;3;4;0;4;run014
2182;GRR;RGR;0;1;1;1;0;run014
2183;GRR;RRR;0;1;1;0;1;run014
2184;RBB;BBB;0;1;1;1;0;run014
2185;RBB;GGG;0;3;3;1;2;run014
2186;RBG;GRR;0;1;1;1;0;run014
2187;RBG;RBR;0;1;1;1;0;run014
2188;RBG;RGR;0;1;1;1;0;run014
2189;RBR;BBB;0;3;3;0;3;run014
2190;RBR;BRB;0;1;1;1;0;run014
2191;RBR;BRR;0;2;2;1;1;run014
2192;RBR;GGG;0;1;1;0;1;run014
2193;RBR;GGR;1;2;3;1;2;run014
2194;RBR;GRG;0;1;1;1;0;run014
2195;RBR;GRR;1;15;16;10;6;run014
2196;RBR;RGG;0;4;4;1;3;run014
2197;RBR;RGR;0;1;1;1;0;run014
2198;RBR;RRR;0;3;3;1;2;run014
2199;RGG;BGG;0;1;1;0;1;run014
2200;RGG;RGR;0;1;1;1;0;run014
2201;RGR;BBB;0;9;9;5;4;run014
2202;RGR;BBR;0;1;1;0;1;run014
2203;RGR;BGB;1;8;9;2;7;run014
2204;RGR;BRB;0;3;3;0;3;run014
2205;RGR;BRR;0;3;3;0;3;run014
2206;RGR;GBG;0;1;1;1;0;run014
2207;RGR;GGB;0;3;3;2;1;run014
2208;RGR;GGG;0;2;2;0;2;run014
2209;RGR;GGR;0;8;8;3;5;run014
2210;RGR;GRR;1;7;8;6;2;run014
2211;RGR;RGG;0;6;6;3;3;run014
2212;RRG;BGB;0;1;1;0;1;run014
2213;RRG;BRB;0;1;1;1;0;run014
2214;RRG;GGG;0;1;1;1;0;run014
2215;RRG;GGR;0;1;1;1;0;run014
2216;RRG;GRG;0;1;1;1;0;run014
2217;RRG;GRR;0;3;3;0;3;run014
2218;RRG;RBR;0;4;4;4;0;run014
2219;RRG;RGG;0;1;1;1;0;run014
2220;RRG;RGR;6;37;43;40;3;run014
2221;RRR;BRR;0;1;1;0;1;run014
2222;RRR;GGB;0;1;1;1;0;run014
2223;RRR;GGG;1;5;6;6;0;run014
2224;RRR;GGR;0;2;2;1;1;run014
2225;RRR;GRR;0;1;1;1;0;run014
2226;RRR;RGR;0;1;1;1;0;run014
2227;BBB;GRR;0;1;1;0;1;run015
2228;BBG;BBB;1;9;10;9;1;run015
2229;BBG;BBR;0;2;2;1;1;run015
2230;BBG;BGB;0;1;1;0;1;run015
2231;BBG;BGG;0;1;1;1;0;run015
2232;BBG;BRB;0;2;2;0;2;run015
2233;BBG;BRR;0;1;1;0;1;run015
2234;BBG;GBB;1;1;2;2;0;run015
2235;BBG;GBG;1;6;7;0;7;run015
2236;BBG;GGB;0;18;18;11;7;run015
2237;BBG;GGG;1;29;30;10;20;run015
2238;BBG;GGR;0;2;2;1;1;run015
2239;BBG;GRG;0;1;1;0;1;run015
2240;BBG;GRR;0;3;3;3;0;run015
2241;BBG;RBR;0;2;2;0;2;run015
2242;BBG;RGR;0;2;2;0;2;run015
2243;BBG;RRG;1;2;3;2;1;run015
2244;BBG;RRR;0;1;1;1;0;run015
2245;BGG;BBB;0;1;1;0;1;run015
2246;BGG;BRB;0;1;1;1;0;run015
2247;BGG;GGG;0;1;1;1;0;run015
2248;BGG;RBB;0;1;1;0;1;run015
2249;BGG;RBG;1;0;1;0;1;run015
2250;BRB;BBB;0;1;1;0;1;run015
2251;BRB;GGB;1;0;1;0;1;run015
2252;BRB;GGG;0;2;2;1;1;run015
2253;BRB;RBB;1;0;1;1;0;run015
2254;BRR;BBB;0;1;1;1;0;run015
2255;BRR;BRB;0;1;1;1;0;run015
2256;BRR;GBB;1;0;1;0;1;run015
2257;GBB;BBB;1;16;17;7;10;run015
2258;GBB;BBG;0;2;2;2;0;run015
2259;GBB;BGB;0;1;1;1;0;run015
2260;GBB;BGG;0;3;3;0;3;run015
2261;GBB;BRB;0;9;9;4;5;run015
2262;GBB;BRR;0;2;2;2;0;run015
2263;GBB;GBG;1;1;2;2;0;run015
2264;GBB;GGB;2;59;61;11;50;run015
2265;GBB;GGG;4;95;99;85;14;run015
2266;GBB;GGR;0;1;1;1;0;run015
2267;GBB;GRG;0;1;1;0;1;run015
2268;GBB;GRR;1;8;9;9;0;run015
2269;GBB;RBB;0;2;2;1;1;run015
2270;GBB;RBG;0;1;1;0;1;run015
2271;GBB;RBR;1;1;2;0;2;run015
2272;GBB;RGG;0;2;2;0;2;run015
2273;GBB;RGR;0;1;1;0;1;run015
2274;GBB;RRG;0;3;3;0;3;run015
2275;GBG;BRB;0;1;1;1;0;run015
2276;GBG;BRR;0;3;3;2;1;run015
2277;GBG;GGB;0;1;1;1;0;run015
2278;GBG;GGR;0;3;3;0;3;run015
2279;GBG;RBR;0;1;1;1;0;run015
2280;GBG;RGR;1;1;2;1;1;run015
2281;GBG;RRR;0;1;1;1;0;run015
2282;GGB;BBB;1;8;9;6;3;run015
2283;GGB;BBG;0;1;1;0;1;run015
2284;GGB;BGB;0;1;1;0;1;run015
2285;GGB;BRB;3;5;8;0;8;run015
2286;GGB;BRR;0;1;1;0;1;run015
2287;GGB;GBG;0;2;2;0;2;run015
2288;GGB;GGG;4;37;41;0;41;run015
2289;GGB;GGR;0;9;9;3;6;run015
2290;GGB;GRR;1;4;5;1;4;run015
2291;GGB;RBB;0;2;2;0;2;run015
2292;GGB;RBG;0;2;2;2;0;run015
2293;GGB;RBR;0;2;2;0;2;run015
2294;GGB;RGG;0;1;1;0;1;run015
2295;GGB;RGR;1;2;3;0;3;run015
2296;GGB;RRG;1;3;4;3;1;run015
2297;GGB;RRR;0;3;3;3;0;run015
2298;GGG;BBB;4;22;26;11;15;run015
2299;GGG;BBG;0;2;2;0;2;run015
2300;GGG;BBR;0;3;3;0;3;run015
2301;GGG;BGB;0;2;2;0;2;run015
2302;GGG;BGG;0;3;3;3;0;run015
2303;GGG;BRB;0;3;3;3;0;run015
2304;GGG;BRR;0;3;3;0;3;run015
2305;GGG;GBB;0;1;1;1;0;run015
2306;GGG;GGB;1;3;4;4;0;run015
2307;GGG;GGR;0;21;21;7;14;run015
2308;GGG;GRG;0;2;2;0;2;run015
2309;GGG;GRR;2;15;17;8;9;run015
2310;GGG;RBB;0;1;1;0;1;run015
2311;GGG;RBR;1;4;5;5;0;run015
2312;GGG;RGG;1;7;8;2;6;run015
2313;GGG;RGR;0;3;3;0;3;run015
2314;GGG;RRG;0;2;2;2;0;run015
2315;GGG;RRR;0;1;1;1;0;run015
2316;GGR;BBB;0;1;1;0;1;run015
2317;GGR;BGG;0;2;2;1;1;run015
2318;GGR;BRB;0;1;1;1;0;run015
2319;GRG;BBB;0;3;3;2;1;run015
2320;GRG;BGB;0;3;3;0;3;run015
2321;GRG;BGG;0;1;1;1;0;run015
2322;GRG;BRB;0;5;5;2;3;run015
2323;GRG;BRR;0;1;1;0;1;run015
2324;GRG;GBB;0;3;3;3;0;run015
2325;GRG;GGB;0;14;14;7;7;run015
2326;GRG;GGG;0;10;10;7;3;run015
2327;GRG;GGR;0;2;2;2;0;run015
2328;GRG;GRR;0;1;1;0;1;run015
2329;GRG;RBR;1;2;3;2;1;run015
2330;GRG;RGG;0;2;2;0;2;run015
2331;GRG;RGR;0;1;1;1;0;run015
2332;GRR;BBB;0;3;3;2;1;run015
2333;GRR;BBR;0;2;2;1;1;run015
2334;GRR;BRB;1;8;9;4;5;run015
2335;GRR;BRR;1;6;7;4;3;run015
2336;GRR;GBB;0;1;1;0;1;run015
2337;GRR;GBG;0;1;1;0;1;run015
2338;GRR;GGR;1;9;10;9;1;run015
2339;GRR;RBR;0;1;1;0;1;run015
2340;GRR;RGG;1;3;4;0;4;run015
2341;GRR;RGR;0;1;1;1;0;run015
2342;GRR;RRR;0;1;1;1;0;run015
2343;RBB;BBB;0;1;1;0;1;run015
2344;RBB;GGG;0;3;3;0;3;run015
2345;RBG;GRR;0;1;1;1;0;run015
2346;RBG;RBR;0;1;1;1;0;run015
2347;RBG;RGR;0;1;1;1;0;run015
2348;RBR;BBB;0;3;3;2;1;run015
2349;RBR;BRB;0;1;1;0;1;run015
2350;RBR;BRR;0;2;2;2;0;run015
2351;RBR;GGG;0;1;1;1;0;run015
2352;RBR;GGR;1;2;3;2;1;run015
2353;RBR;GRG;0;1;1;1;0;run015
2354;RBR;GRR;1;15;16;8;8;run015
2355;RBR;RGG;0;4;4;2;2;run015
2356;RBR;RGR;0;1;1;1;0;run015
2357;RBR;RRR;0;3;3;0;3;run015
2358;RGG;BGG;0;1;1;0;1;run015
2359;RGG;RGR;0;1;1;1;0;run015
2360;RGR;BBB;0;9;9;4;5;run015
2361;RGR;BBR;0;1;1;1;0;run015
2362;RGR;BGB;1;8;9;8;1;run015
2363;RGR;BRB;0;3;3;2;1;run015
2364;RGR;BRR;0;3;3;2;1;run015
2365;RGR;GBG;0;1;1;1;0;run015
2366;RGR;GGB;0;3;3;1;2;run015
2367;RGR;GGG;0;2;2;2;0;run015
2368;RGR;GGR;0;8;8;3;5;run015
2369;RGR;GRR;1;7;8;8;0;run015
2370;RGR;RGG;0;6;6;4;2;run015
2371;RRG;BGB;0;1;1;1;0;run015
2372;RRG;BRB;0;1;1;1;0;run015
2373;RRG;GGG;0;1;1;0;1;run015
2374;RRG;GGR;0;1;1;1;0;run015
2375;RRG;GRG;0;1;1;1;0;run015
2376;RRG;GRR;0;3;3;3;0;run015
2377;RRG;RBR;0;4;4;2;2;run015
2378;RRG;RGG;0;1;1;1;0;run015
2379;RRG;RGR;6;37;43;25;18;run015
2380;RRR;BRR;0;1;1;1;0;run015
2381;RRR;GGB;0;1;1;0;1;run015
2382;RRR;GGG;1;5;6;0;6;run015
2383;RRR;GGR;0;2;2;2;0;run015
2384;RRR;GRR;0;1;1;0;1;run015
2385;RRR;RGR;0;1;1;1;0;run015
2386;BBB;GRR;0;1;1;0;1;run016
2387;BBG;BBB;1;9;10;10;0;run016
2388;BBG;BBR;0;2;2;0;2;run016
2389;BBG;BGB;0;1;1;0;1;run016
2390;BBG;BGG;0;1;1;0;1;run016
2391;BBG;BRB;0;2;2;1;1;run016
2392;BBG;BRR;0;1;1;1;0;run016
2393;BBG;GBB;1;1;2;2;0;run016
2394;BBG;GBG;1;6;7;3;4;run016
2395;BBG;GGB;0;18;18;16;2;run016
2396;BBG;GGG;1;29;30;28;2;run016
2397;BBG;GGR;0;2;2;1;1;run016
2398;BBG;GRG;0;1;1;1;0;run016
2399;BBG;GRR;0;3;3;2;1;run016
2400;BBG;RBR;0;2;2;2;0;run016
2401;BBG;RGR;0;2;2;1;1;run016
2402;BBG;RRG;1;2;3;0;3;run016
2403;BBG;RRR;0;1;1;1;0;run016
2404;BGG;BBB;0;1;1;0;1;run016
2405;BGG;BRB;0;1;1;0;1;run016
2406;BGG;GGG;0;1;1;0;1;run016
2407;BGG;RBB;0;1;1;1;0;run016
2408;BGG;RBG;1;0;1;1;0;run016
2409;BRB;BBB;0;1;1;1;0;run016
2410;BRB;GGB;1;0;1;1;0;run016
2411;BRB;GGG;0;2;2;0;2;run016
2412;BRB;RBB;1;0;1;0;1;run016
2413;BRR;BBB;0;1;1;1;0;run016
2414;BRR;BRB;0;1;1;0;1;run016
2415;BRR;GBB;1;0;1;1;0;run016
2416;GBB;BBB;1;16;17;13;4;run016
2417;GBB;BBG;0;2;2;0;2;run016
2418;GBB;BGB;0;1;1;0;1;run016
2419;GBB;BGG;0;3;3;2;1;run016
2420;GBB;BRB;0;9;9;8;1;run016
2421;GBB;BRR;0;2;2;1;1;run016
2422;GBB;GBG;1;1;2;2;0;run016
2423;GBB;GGB;2;59;61;56;5;run016
2424;GBB;GGG;4;95;99;91;8;run016
2425;GBB;GGR;0;1;1;0;1;run016
2426;GBB;GRG;0;1;1;1;0;run016
2427;GBB;GRR;1;8;9;6;3;run016
2428;GBB;RBB;0;2;2;0;2;run016
2429;GBB;RBG;0;1;1;0;1;run016
2430;GBB;RBR;1;1;2;1;1;run016
2431;GBB;RGG;0;2;2;1;1;run016
2432;GBB;RGR;0;1;1;0;1;run016
2433;GBB;RRG;0;3;3;0;3;run016
2434;GBG;BRB;0;1;1;0;1;run016
2435;GBG;BRR;0;3;3;0;3;run016
2436;GBG;GGB;0;1;1;0;1;run016
2437;GBG;GGR;0;3;3;0;3;run016
2438;GBG;RBR;0;1;1;1;0;run016
2439;GBG;RGR;1;1;2;1;1;run016
2440;GBG;RRR;0;1;1;0;1;run016
2441;GGB;BBB;1;8;9;4;5;run016
2442;GGB;BBG;0;1;1;1;0;run016
2443;GGB;BGB;0;1;1;0;1;run016
2444;GGB;BRB;3;5;8;1;7;run016
2445;GGB;BRR;0;1;1;0;1;run016
2446;GGB;GBG;0;2;2;1;1;run016
2447;GGB;GGG;4;37;41;40;1;run016
2448;GGB;GGR;0;9;9;6;3;run016
2449;GGB;GRR;1;4;5;3;2;run016
2450;GGB;RBB;0;2;2;0;2;run016
2451;GGB;RBG;0;2;2;2;0;run016
2452;GGB;RBR;0;2;2;2;0;run016
2453;GGB;RGG;0;1;1;1;0;run016
2454;GGB;RGR;1;2;3;2;1;run016
2455;GGB;RRG;1;3;4;1;3;run016
2456;GGB;RRR;0;3;3;2;1;run016
2457;GGG;BBB;4;22;26;19;7;run016
2458;GGG;BBG;0;2;2;0;2;run016
2459;GGG;BBR;0;3;3;2;1;run016
2460;GGG;BGB;0;2;2;2;0;run016
2461;GGG;BGG;0;3;3;0;3;run016
2462;GGG;BRB;0;3;3;0;3;run016
2463;GGG;BRR;0;3;3;1;2;run016
2464;GGG;GBB;0;1;1;0;1;run016
2465;GGG;GGB;1;3;4;3;1;run016
2466;GGG;GGR;0;21;21;2;19;run016
2467;GGG;GRG;0;2;2;2;0;run016
2468;GGG;GRR;2;15;17;17;0;run016
2469;GGG;RBB;0;1;1;1;0;run016
2470;GGG;RBR;1;4;5;0;5;run016
2471;GGG;RGG;1;7;8;3;5;run016
2472;GGG;RGR;0;3;3;1;2;run016
2473;GGG;RRG;0;2;2;1;1;run016
2474;GGG;RRR;0;1;1;1;0;run016
2475;GGR;BBB;0;1;1;0;1;run016
2476;GGR;BGG;0;2;2;2;0;run016
2477;GGR;BRB;0;1;1;0;1;run016
2478;GRG;BBB;0;3;3;2;1;run016
2479;GRG;BGB;0;3;3;3;0;run016
2480;GRG;BGG;0;1;1;1;0;run016
2481;GRG;BRB;0;5;5;4;1;run016
2482;GRG;BRR;0;1;1;0;1;run016
2483;GRG;GBB;0;3;3;1;2;run016
2484;GRG;GGB;0;14;14;9;5;run016
2485;GRG;GGG;0;10;10;2;8;run016
2486;GRG;GGR;0;2;2;2;0;run016
2487;GRG;GRR;0;1;1;1;0;run016
2488;GRG;RBR;1;2;3;2;1;run016
2489;GRG;RGG;0;2;2;0;2;run016
2490;GRG;RGR;0;1;1;1;0;run016
2491;GRR;BBB;0;3;3;2;1;run016
2492;GRR;BBR;0;2;2;2;0;run016
2493;GRR;BRB;1;8;9;4;5;run016
2494;GRR;BRR;1;6;7;1;6;run016
2495;GRR;GBB;0;1;1;0;1;run016
2496;GRR;GBG;0;1;1;0;1;run016
2497;GRR;GGR;1;9;10;0;10;run016
2498;GRR;RBR;0;1;1;0;1;run016
2499;GRR;RGG;1;3;4;1;3;run016
2500;GRR;RGR;0;1;1;0;1;run016
2501;GRR;RRR;0;1;1;0;1;run016
2502;RBB;BBB;0;1;1;1;0;run016
2503;RBB;GGG;0;3;3;0;3;run016
2504;RBG;GRR;0;1;1;0;1;run016
2505;RBG;RBR;0;1;1;0;1;run016
2506;RBG;RGR;0;1;1;1;0;run016
2507;RBR;BBB;0;3;3;3;0;run016
2508;RBR;BRB;0;1;1;0;1;run016
2509;RBR;BRR;0;2;2;1;1;run016
2510;RBR;GGG;0;1;1;1;0;run016
2511;RBR;GGR;1;2;3;0;3;run016
2512;RBR;GRG;0;1;1;0;1;run016
2513;RBR;GRR;1;15;16;1;15;run016
2514;RBR;RGG;0;4;4;3;1;run016
2515;RBR;RGR;0;1;1;0;1;run016
2516;RBR;RRR;0;3;3;2;1;run016
2517;RGG;BGG;0;1;1;1;0;run016
2518;RGG;RGR;0;1;1;0;1;run016
2519;RGR;BBB;0;9;9;5;4;run016
2520;RGR;BBR;0;1;1;0;1;run016
2521;RGR;BGB;1;8;9;3;6;run016
2522;RGR;BRB;0;3;3;1;2;run016
2523;RGR;BRR;0;3;3;3;0;run016
2524;RGR;GBG;0;1;1;0;1;run016
2525;RGR;GGB;0;3;3;1;2;run016
2526;RGR;GGG;0;2;2;1;1;run016
2527;RGR;GGR;0;8;8;1;7;run016
2528;RGR;GRR;1;7;8;1;7;run016
2529;RGR;RGG;0;6;6;0;6;run016
2530;RRG;BGB;0;1;1;1;0;run016
2531;RRG;BRB;0;1;1;1;0;run016
2532;RRG;GGG;0;1;1;1;0;run016
2533;RRG;GGR;0;1;1;0;1;run016
2534;RRG;GRG;0;1;1;1;0;run016
2535;RRG;GRR;0;3;3;3;0;run016
2536;RRG;RBR;0;4;4;1;3;run016
2537;RRG;RGG;0;1;1;0;1;run016
2538;RRG;RGR;6;37;43;28;15;run016
2539;RRR;BRR;0;1;1;1;0;run016
2540;RRR;GGB;0;1;1;1;0;run016
2541;RRR;GGG;1;5;6;1;5;run016
2542;RRR;GGR;0;2;2;1;1;run016
2543;RRR;GRR;0;1;1;0;1;run016
2544;RRR;RGR;0;1;1;0;1;run016
2545;BBB;GRR;0;1;1;1;0;run017
2546;BBG;BBB;1;9;10;7;3;run017
2547;BBG;BBR;0;2;2;0;2;run017
2548;BBG;BGB;0;1;1;1;0;run017
2549;BBG;BGG;0;1;1;1;0;run017
2550;BBG;BRB;0;2;2;2;0;run017
2551;BBG;BRR;0;1;1;0;1;run017
2552;BBG;GBB;1;1;2;2;0;run017
2553;BBG;GBG;1;6;7;4;3;run017
2554;BBG;GGB;0;18;18;6;12;run017
2555;BBG;GGG;1;29;30;9;21;run017
2556;BBG;GGR;0;2;2;1;1;run017
2557;BBG;GRG;0;1;1;0;1;run017
2558;BBG;GRR;0;3;3;0;3;run017
2559;BBG;RBR;0;2;2;0;2;run017
2560;BBG;RGR;0;2;2;1;1;run017
2561;BBG;RRG;1;2;3;1;2;run017
2562;BBG;RRR;0;1;1;1;0;run017
2563;BGG;BBB;0;1;1;1;0;run017
2564;BGG;BRB;0;1;1;1;0;run017
2565;BGG;GGG;0;1;1;0;1;run017
2566;BGG;RBB;0;1;1;1;0;run017
2567;BGG;RBG;1;0;1;0;1;run017
2568;BRB;BBB;0;1;1;1;0;run017
2569;BRB;GGB;1;0;1;0;1;run017
2570;BRB;GGG;0;2;2;0;2;run017
2571;BRB;RBB;1;0;1;1;0;run017
2572;BRR;BBB;0;1;1;0;1;run017
2573;BRR;BRB;0;1;1;1;0;run017
2574;BRR;GBB;1;0;1;0;1;run017
2575;GBB;BBB;1;16;17;15;2;run017
2576;GBB;BBG;0;2;2;2;0;run017
2577;GBB;BGB;0;1;1;1;0;run017
2578;GBB;BGG;0;3;3;1;2;run017
2579;GBB;BRB;0;9;9;2;7;run017
2580;GBB;BRR;0;2;2;0;2;run017
2581;GBB;GBG;1;1;2;2;0;run017
2582;GBB;GGB;2;59;61;7;54;run017
2583;GBB;GGG;4;95;99;63;36;run017
2584;GBB;GGR;0;1;1;1;0;run017
2585;GBB;GRG;0;1;1;0;1;run017
2586;GBB;GRR;1;8;9;9;0;run017
2587;GBB;RBB;0;2;2;0;2;run017
2588;GBB;RBG;0;1;1;0;1;run017
2589;GBB;RBR;1;1;2;0;2;run017
2590;GBB;RGG;0;2;2;2;0;run017
2591;GBB;RGR;0;1;1;1;0;run017
2592;GBB;RRG;0;3;3;3;0;run017
2593;GBG;BRB;0;1;1;0;1;run017
2594;GBG;BRR;0;3;3;2;1;run017
2595;GBG;GGB;0;1;1;1;0;run017
2596;GBG;GGR;0;3;3;2;1;run017
2597;GBG;RBR;0;1;1;0;1;run017
2598;GBG;RGR;1;1;2;2;0;run017
2599;GBG;RRR;0;1;1;0;1;run017
2600;GGB;BBB;1;8;9;7;2;run017
2601;GGB;BBG;0;1;1;0;1;run017
2602;GGB;BGB;0;1;1;0;1;run017
2603;GGB;BRB;3;5;8;1;7;run017
2604;GGB;BRR;0;1;1;0;1;run017
2605;GGB;GBG;0;2;2;1;1;run017
2606;GGB;GGG;4;37;41;19;22;run017
2607;GGB;GGR;0;9;9;9;0;run017
2608;GGB;GRR;1;4;5;3;2;run017
2609;GGB;RBB;0;2;2;0;2;run017
2610;GGB;RBG;0;2;2;0;2;run017
2611;GGB;RBR;0;2;2;2;0;run017
2612;GGB;RGG;0;1;1;0;1;run017
2613;GGB;RGR;1;2;3;1;2;run017
2614;GGB;RRG;1;3;4;1;3;run017
2615;GGB;RRR;0;3;3;0;3;run017
2616;GGG;BBB;4;22;26;21;5;run017
2617;GGG;BBG;0;2;2;0;2;run017
2618;GGG;BBR;0;3;3;0;3;run017
2619;GGG;BGB;0;2;2;1;1;run017
2620;GGG;BGG;0;3;3;0;3;run017
2621;GGG;BRB;0;3;3;1;2;run017
2622;GGG;BRR;0;3;3;3;0;run017
2623;GGG;GBB;0;1;1;0;1;run017
2624;GGG;GGB;1;3;4;2;2;run017
2625;GGG;GGR;0;21;21;4;17;run017
2626;GGG;GRG;0;2;2;0;2;run017
2627;GGG;GRR;2;15;17;11;6;run017
2628;GGG;RBB;0;1;1;1;0;run017
2629;GGG;RBR;1;4;5;2;3;run017
2630;GGG;RGG;1;7;8;3;5;run017
2631;GGG;RGR;0;3;3;2;1;run017
2632;GGG;RRG;0;2;2;1;1;run017
2633;GGG;RRR;0;1;1;0;1;run017
2634;GGR;BBB;0;1;1;0;1;run017
2635;GGR;BGG;0;2;2;0;2;run017
2636;GGR;BRB;0;1;1;1;0;run017
2637;GRG;BBB;0;3;3;3;0;run017
2638;GRG;BGB;0;3;3;3;0;run017
2639;GRG;BGG;0;1;1;0;1;run017
2640;GRG;BRB;0;5;5;3;2;run017
2641;GRG;BRR;0;1;1;1;0;run017
2642;GRG;GBB;0;3;3;2;1;run017
2643;GRG;GGB;0;14;14;5;9;run017
2644;GRG;GGG;0;10;10;9;1;run017
2645;GRG;GGR;0;2;2;0;2;run017
2646;GRG;GRR;0;1;1;0;1;run017
2647;GRG;RBR;1;2;3;0;3;run017
2648;GRG;RGG;0;2;2;2;0;run017
2649;GRG;RGR;0;1;1;0;1;run017
2650;GRR;BBB;0;3;3;0;3;run017
2651;GRR;BBR;0;2;2;0;2;run017
2652;GRR;BRB;1;8;9;6;3;run017
2653;GRR;BRR;1;6;7;6;1;run017
2654;GRR;GBB;0;1;1;0;1;run017
2655;GRR;GBG;0;1;1;0;1;run017
2656;GRR;GGR;1;9;10;8;2;run017
2657;GRR;RBR;0;1;1;0;1;run017
2658;GRR;RGG;1;3;4;2;2;run017
2659;GRR;RGR;0;1;1;1;0;run017
2660;GRR;RRR;0;1;1;1;0;run017
2661;RBB;BBB;0;1;1;1;0;run017
2662;RBB;GGG;0;3;3;0;3;run017
2663;RBG;GRR;0;1;1;1;0;run017
2664;RBG;RBR;0;1;1;1;0;run017
2665;RBG;RGR;0;1;1;1;0;run017
2666;RBR;BBB;0;3;3;0;3;run017
2667;RBR;BRB;0;1;1;1;0;run017
2668;RBR;BRR;0;2;2;2;0;run017
2669;RBR;GGG;0;1;1;1;0;run017
2670;RBR;GGR;1;2;3;3;0;run017
2671;RBR;GRG;0;1;1;1;0;run017
2672;RBR;GRR;1;15;16;2;14;run017
2673;RBR;RGG;0;4;4;2;2;run017
2674;RBR;RGR;0;1;1;0;1;run017
2675;RBR;RRR;0;3;3;1;2;run017
2676;RGG;BGG;0;1;1;1;0;run017
2677;RGG;RGR;0;1;1;1;0;run017
2678;RGR;BBB;0;9;9;0;9;run017
2679;RGR;BBR;0;1;1;1;0;run017
2680;RGR;BGB;1;8;9;9;0;run017
2681;RGR;BRB;0;3;3;0;3;run017
2682;RGR;BRR;0;3;3;1;2;run017
2683;RGR;GBG;0;1;1;1;0;run017
2684;RGR;GGB;0;3;3;0;3;run017
2685;RGR;GGG;0;2;2;2;0;run017
2686;RGR;GGR;0;8;8;8;0;run017
2687;RGR;GRR;1;7;8;8;0;run017
2688;RGR;RGG;0;6;6;2;4;run017
2689;RRG;BGB;0;1;1;1;0;run017
2690;RRG;BRB;0;1;1;0;1;run017
2691;RRG;GGG;0;1;1;1;0;run017
2692;RRG;GGR;0;1;1;0;1;run017
2693;RRG;GRG;0;1;1;1;0;run017
2694;RRG;GRR;0;3;3;2;1;run017
2695;RRG;RBR;0;4;4;0;4;run017
2696;RRG;RGG;0;1;1;1;0;run017
2697;RRG;RGR;6;37;43;13;30;run017
2698;RRR;BRR;0;1;1;1;0;run017
2699;RRR;GGB;0;1;1;1;0;run017
2700;RRR;GGG;1;5;6;5;1;run017
2701;RRR;GGR;0;2;2;1;1;run017
2702;RRR;GRR;0;1;1;0;1;run017
2703;RRR;RGR;0;1;1;0;1;run017
2704;BBB;GRR;0;1;1;1;0;run018
2705;BBG;BBB;1;9;10;0;10;run018
2706;BBG;BBR;0;2;2;1;1;run018
2707;BBG;BGB;0;1;1;1;0;run018
2708;BBG;BGG;0;1;1;0;1;run018
2709;BBG;BRB;0;2;2;2;0;run018
2710;BBG;BRR;0;1;1;1;0;run018
2711;BBG;GBB;1;1;2;0;2;run018
2712;BBG;GBG;1;6;7;5;2;run018
2713;BBG;GGB;0;18;18;11;7;run018
2714;BBG;GGG;1;29;30;24;6;run018
2715;BBG;GGR;0;2;2;1;1;run018
2716;BBG;GRG;0;1;1;1;0;run018
2717;BBG;GRR;0;3;3;0;3;run018
2718;BBG;RBR;0;2;2;1;1;run018
2719;BBG;RGR;0;2;2;0;2;run018
2720;BBG;RRG;1;2;3;0;3;run018
2721;BBG;RRR;0;1;1;1;0;run018
2722;BGG;BBB;0;1;1;0;1;run018
2723;BGG;BRB;0;1;1;0;1;run018
2724;BGG;GGG;0;1;1;0;1;run018
2725;BGG;RBB;0;1;1;1;0;run018
2726;BGG;RBG;1;0;1;0;1;run018
2727;BRB;BBB;0;1;1;0;1;run018
2728;BRB;GGB;1;0;1;1;0;run018
2729;BRB;GGG;0;2;2;1;1;run018
2730;BRB;RBB;1;0;1;0;1;run018
2731;BRR;BBB;0;1;1;1;0;run018
2732;BRR;BRB;0;1;1;0;1;run018
2733;BRR;GBB;1;0;1;0;1;run018
2734;GBB;BBB;1;16;17;0;17;run018
2735;GBB;BBG;0;2;2;0;2;run018
2736;GBB;BGB;0;1;1;1;0;run018
2737;GBB;BGG;0;3;3;2;1;run018
2738;GBB;BRB;0;9;9;9;0;run018
2739;GBB;BRR;0;2;2;1;1;run018
2740;GBB;GBG;1;1;2;0;2;run018
2741;GBB;GGB;2;59;61;19;42;run018
2742;GBB;GGG;4;95;99;99;0;run018
2743;GBB;GGR;0;1;1;0;1;run018
2744;GBB;GRG;0;1;1;0;1;run018
2745;GBB;GRR;1;8;9;4;5;run018
2746;GBB;RBB;0;2;2;2;0;run018
2747;GBB;RBG;0;1;1;1;0;run018
2748;GBB;RBR;1;1;2;1;1;run018
2749;GBB;RGG;0;2;2;0;2;run018
2750;GBB;RGR;0;1;1;1;0;run018
2751;GBB;RRG;0;3;3;2;1;run018
2752;GBG;BRB;0;1;1;1;0;run018
2753;GBG;BRR;0;3;3;2;1;run018
2754;GBG;GGB;0;1;1;0;1;run018
2755;GBG;GGR;0;3;3;3;0;run018
2756;GBG;RBR;0;1;1;0;1;run018
2757;GBG;RGR;1;1;2;0;2;run018
2758;GBG;RRR;0;1;1;0;1;run018
2759;GGB;BBB;1;8;9;0;9;run018
2760;GGB;BBG;0;1;1;1;0;run018
2761;GGB;BGB;0;1;1;1;0;run018
2762;GGB;BRB;3;5;8;7;1;run018
2763;GGB;BRR;0;1;1;1;0;run018
2764;GGB;GBG;0;2;2;0;2;run018
2765;GGB;GGG;4;37;41;9;32;run018
2766;GGB;GGR;0;9;9;2;7;run018
2767;GGB;GRR;1;4;5;4;1;run018
2768;GGB;RBB;0;2;2;0;2;run018
2769;GGB;RBG;0;2;2;2;0;run018
2770;GGB;RBR;0;2;2;0;2;run018
2771;GGB;RGG;0;1;1;1;0;run018
2772;GGB;RGR;1;2;3;0;3;run018
2773;GGB;RRG;1;3;4;3;1;run018
2774;GGB;RRR;0;3;3;2;1;run018
2775;GGG;BBB;4;22;26;8;18;run018
2776;GGG;BBG;0;2;2;1;1;run018
2777;GGG;BBR;0;3;3;2;1;run018
2778;GGG;BGB;0;2;2;1;1;run018
2779;GGG;BGG;0;3;3;2;1;run018
2780;GGG;BRB;0;3;3;2;1;run018
2781;GGG;BRR;0;3;3;0;3;run018
2782;GGG;GBB;0;1;1;0;1;run018
2783;GGG;GGB;1;3;4;2;2;run018
2784;GGG;GGR;0;21;21;5;16;run018
2785;GGG;GRG;0;2;2;1;1;run018
2786;GGG;GRR;2;15;17;5;12;run018
2787;GGG;RBB;0;1;1;0;1;run018
2788;GGG;RBR;1;4;5;0;5;run018
2789;GGG;RGG;1;7;8;1;7;run018
2790;GGG;RGR;0;3;3;1;2;run018
2791;GGG;RRG;0;2;2;2;0;run018
2792;GGG;RRR;0;1;1;0;1;run018
2793;GGR;BBB;0;1;1;1;0;run018
2794;GGR;BGG;0;2;2;0;2;run018
2795;GGR;BRB;0;1;1;0;1;run018
2796;GRG;BBB;0;3;3;1;2;run018
2797;GRG;BGB;0;3;3;1;2;run018
2798;GRG;BGG;0;1;1;0;1;run018
2799;GRG;BRB;0;5;5;0;5;run018
2800;GRG;BRR;0;1;1;0;1;run018
2801;GRG;GBB;0;3;3;3;0;run018
2802;GRG;GGB;0;14;14;3;11;run018
2803;GRG;GGG;0;10;10;4;6;run018
2804;GRG;GGR;0;2;2;2;0;run018
2805;GRG;GRR;0;1;1;0;1;run018
2806;GRG;RBR;1;2;3;0;3;run018
2807;GRG;RGG;0;2;2;0;2;run018
2808;GRG;RGR;0;1;1;0;1;run018
2809;GRR;BBB;0;3;3;0;3;run018
2810;GRR;BBR;0;2;2;2;0;run018
2811;GRR;BRB;1;8;9;9;0;run018
2812;GRR;BRR;1;6;7;7;0;run018
2813;GRR;GBB;0;1;1;1;0;run018
2814;GRR;GBG;0;1;1;0;1;run018
2815;GRR;GGR;1;9;10;1;9;run018
2816;GRR;RBR;0;1;1;1;0;run018
2817;GRR;RGG;1;3;4;1;3;run018
2818;GRR;RGR;0;1;1;1;0;run018
2819;GRR;RRR;0;1;1;0;1;run018
2820;RBB;BBB;0;1;1;0;1;run018
2821;RBB;GGG;0;3;3;3;0;run018
2822;RBG;GRR;0;1;1;0;1;run018
2823;RBG;RBR;0;1;1;0;1;run018
2824;RBG;RGR;0;1;1;0;1;run018
2825;RBR;BBB;0;3;3;1;2;run018
2826;RBR;BRB;0;1;1;0;1;run018
2827;RBR;BRR;0;2;2;1;1;run018
2828;RBR;GGG;0;1;1;0;1;run018
2829;RBR;GGR;1;2;3;2;1;run018
2830;RBR;GRG;0;1;1;0;1;run018
2831;RBR;GRR;1;15;16;1;15;run018
2832;RBR;RGG;0;4;4;3;1;run018
2833;RBR;RGR;0;1;1;1;0;run018
2834;RBR;RRR;0;3;3;1;2;run018
2835;RGG;BGG;0;1;1;0;1;run018
2836;RGG;RGR;0;1;1;0;1;run018
2837;RGR;BBB;0;9;9;1;8;run018
2838;RGR;BBR;0;1;1;0;1;run018
2839;RGR;BGB;1;8;9;7;2;run018
2840;RGR;BRB;0;3;3;3;0;run018
2841;RGR;BRR;0;3;3;0;3;run018
2842;RGR;GBG;0;1;1;1;0;run018
2843;RGR;GGB;0;3;3;2;1;run018
2844;RGR;GGG;0;2;2;2;0;run018
2845;RGR;GGR;0;8;8;8;0;run018
2846;RGR;GRR;1;7;8;4;4;run018
2847;RGR;RGG;0;6;6;2;4;run018
2848;RRG;BGB;0;1;1;0;1;run018
2849;RRG;BRB;0;1;1;0;1;run018
2850;RRG;GGG;0;1;1;0;1;run018
2851;RRG;GGR;0;1;1;1;0;run018
2852;RRG;GRG;0;1;1;0;1;run018
2853;RRG;GRR;0;3;3;3;0;run018
2854;RRG;RBR;0;4;4;3;1;run018
2855;RRG;RGG;0;1;1;0;1;run018
2856;RRG;RGR;6;37;43;14;29;run018
2857;RRR;BRR;0;1;1;1;0;run018
2858;RRR;GGB;0;1;1;1;0;run018
2859;RRR;GGG;1;5;6;6;0;run018
2860;RRR;GGR;0;2;2;2;0;run018
2861;RRR;GRR;0;1;1;0;1;run018
2862;RRR;RGR;0;1;1;1;0;run018
2863;BBB;GRR;0;1;1;0;1;run019
2864;BBG;BBB;1;9;10;9;1;run019
2865;BBG;BBR;0;2;2;1;1;run019
2866;BBG;BGB;0;1;1;0;1;run019
2867;BBG;BGG;0;1;1;0;1;run019
2868;BBG;BRB;0;2;2;1;1;run019
2869;BBG;BRR;0;1;1;0;1;run019
2870;BBG;GBB;1;1;2;2;0;run019
2871;BBG;GBG;1;6;7;4;3;run019
2872;BBG;GGB;0;18;18;14;4;run019
2873;BBG;GGG;1;29;30;0;30;run019
2874;BBG;GGR;0;2;2;0;2;run019
2875;BBG;GRG;0;1;1;1;0;run019
2876;BBG;GRR;0;3;3;3;0;run019
2877;BBG;RBR;0;2;2;2;0;run019
2878;BBG;RGR;0;2;2;2;0;run019
2879;BBG;RRG;1;2;3;2;1;run019
2880;BBG;RRR;0;1;1;0;1;run019
2881;BGG;BBB;0;1;1;1;0;run019
2882;BGG;BRB;0;1;1;0;1;run019
2883;BGG;GGG;0;1;1;0;1;run019
2884;BGG;RBB;0;1;1;0;1;run019
2885;BGG;RBG;1;0;1;0;1;run019
2886;BRB;BBB;0;1;1;0;1;run019
2887;BRB;GGB;1;0;1;1;0;run019
2888;BRB;GGG;0;2;2;2;0;run019
2889;BRB;RBB;1;0;1;0;1;run019
2890;BRR;BBB;0;1;1;1;0;run019
2891;BRR;BRB;0;1;1;1;0;run019
2892;BRR;GBB;1;0;1;0;1;run019
2893;GBB;BBB;1;16;17;0;17;run019
2894;GBB;BBG;0;2;2;1;1;run019
2895;GBB;BGB;0;1;1;1;0;run019
2896;GBB;BGG;0;3;3;3;0;run019
2897;GBB;BRB;0;9;9;7;2;run019
2898;GBB;BRR;0;2;2;2;0;run019
2899;GBB;GBG;1;1;2;2;0;run019
2900;GBB;GGB;2;59;61;60;1;run019
2901;GBB;GGG;4;95;99;5;94;run019
2902;GBB;GGR;0;1;1;0;1;run019
2903;GBB;GRG;0;1;1;0;1;run019
2904;GBB;GRR;1;8;9;0;9;run019
2905;GBB;RBB;0;2;2;0;2;run019
2906;GBB;RBG;0;1;1;0;1;run019
2907;GBB;RBR;1;1;2;0;2;run019
2908;GBB;RGG;0;2;2;0;2;run019
2909;GBB;RGR;0;1;1;1;0;run019
2910;GBB;RRG;0;3;3;2;1;run019
2911;GBG;BRB;0;1;1;0;1;run019
2912;GBG;BRR;0;3;3;1;2;run019
2913;GBG;GGB;0;1;1;1;0;run019
2914;GBG;GGR;0;3;3;1;2;run019
2915;GBG;RBR;0;1;1;0;1;run019
2916;GBG;RGR;1;1;2;1;1;run019
2917;GBG;RRR;0;1;1;0;1;run019
2918;GGB;BBB;1;8;9;3;6;run019
2919;GGB;BBG;0;1;1;1;0;run019
2920;GGB;BGB;0;1;1;0;1;run019
2921;GGB;BRB;3;5;8;3;5;run019
2922;GGB;BRR;0;1;1;1;0;run019
2923;GGB;GBG;0;2;2;1;1;run019
2924;GGB;GGG;4;37;41;3;38;run019
2925;GGB;GGR;0;9;9;9;0;run019
2926;GGB;GRR;1;4;5;2;3;run019
2927;GGB;RBB;0;2;2;1;1;run019
2928;GGB;RBG;0;2;2;2;0;run019
2929;GGB;RBR;0;2;2;2;0;run019
2930;GGB;RGG;0;1;1;1;0;run019
2931;GGB;RGR;1;2;3;1;2;run019
2932;GGB;RRG;1;3;4;0;4;run019
2933;GGB;RRR;0;3;3;1;2;run019
2934;GGG;BBB;4;22;26;10;16;run019
2935;GGG;BBG;0;2;2;2;0;run019
2936;GGG;BBR;0;3;3;0;3;run019
2937;GGG;BGB;0;2;2;2;0;run019
2938;GGG;BGG;0;3;3;2;1;run019
2939;GGG;BRB;0;3;3;0;3;run019
2940;GGG;BRR;0;3;3;3;0;run019
2941;GGG;GBB;0;1;1;1;0;run019
2942;GGG;GGB;1;3;4;1;3;run019
2943;GGG;GGR;0;21;21;10;11;run019
2944;GGG;GRG;0;2;2;0;2;run019
2945;GGG;GRR;2;15;17;8;9;run019
2946;GGG;RBB;0;1;1;0;1;run019
2947;GGG;RBR;1;4;5;2;3;run019
2948;GGG;RGG;1;7;8;4;4;run019
2949;GGG;RGR;0;3;3;3;0;run019
2950;GGG;RRG;0;2;2;0;2;run019
2951;GGG;RRR;0;1;1;0;1;run019
2952;GGR;BBB;0;1;1;0;1;run019
2953;GGR;BGG;0;2;2;2;0;run019
2954;GGR;BRB;0;1;1;0;1;run019
2955;GRG;BBB;0;3;3;1;2;run019
2956;GRG;BGB;0;3;3;2;1;run019
2957;GRG;BGG;0;1;1;1;0;run019
2958;GRG;BRB;0;5;5;2;3;run019
2959;GRG;BRR;0;1;1;1;0;run019
2960;GRG;GBB;0;3;3;2;1;run019
2961;GRG;GGB;0;14;14;4;10;run019
2962;GRG;GGG;0;10;10;5;5;run019
2963;GRG;GGR;0;2;2;1;1;run019
2964;GRG;GRR;0;1;1;0;1;run019
2965;GRG;RBR;1;2;3;1;2;run019
2966;GRG;RGG;0;2;2;2;0;run019
2967;GRG;RGR;0;1;1;0;1;run019
2968;GRR;BBB;0;3;3;3;0;run019
2969;GRR;BBR;0;2;2;1;1;run019
2970;GRR;BRB;1;8;9;3;6;run019
2971;GRR;BRR;1;6;7;5;2;run019
2972;GRR;GBB;0;1;1;0;1;run019
2973;GRR;GBG;0;1;1;0;1;run019
2974;GRR;GGR;1;9;10;7;3;run019
2975;GRR;RBR;0;1;1;0;1;run019
2976;GRR;RGG;1;3;4;0;4;run019
2977;GRR;RGR;0;1;1;0;1;run019
2978;GRR;RRR;0;1;1;0;1;run019
2979;RBB;BBB;0;1;1;0;1;run019
2980;RBB;GGG;0;3;3;3;0;run019
2981;RBG;GRR;0;1;1;0;1;run019
2982;RBG;RBR;0;1;1;0;1;run019
2983;RBG;RGR;0;1;1;1;0;run019
2984;RBR;BBB;0;3;3;1;2;run019
2985;RBR;BRB;0;1;1;0;1;run019
2986;RBR;BRR;0;2;2;2;0;run019
2987;RBR;GGG;0;1;1;1;0;run019
2988;RBR;GGR;1;2;3;2;1;run019
2989;RBR;GRG;0;1;1;0;1;run019
2990;RBR;GRR;1;15;16;8;8;run019
2991;RBR;RGG;0;4;4;1;3;run019
2992;RBR;RGR;0;1;1;1;0;run019
2993;RBR;RRR;0;3;3;3;0;run019
2994;RGG;BGG;0;1;1;1;0;run019
2995;RGG;RGR;0;1;1;1;0;run019
2996;RGR;BBB;0;9;9;5;4;run019
2997;RGR;BBR;0;1;1;0;1;run019
2998;RGR;BGB;1;8;9;6;3;run019
2999;RGR;BRB;0;3;3;3;0;run019
3000;RGR;BRR;0;3;3;2;1;run019
3001;RGR;GBG;0;1;1;1;0;run019
3002;RGR;GGB;0;3;3;3;0;run019
3003;RGR;GGG;0;2;2;0;2;run019
3004;RGR;GGR;0;8;8;1;7;run019
3005;RGR;GRR;1;7;8;7;1;run019
3006;RGR;RGG;0;6;6;5;1;run019
3007;RRG;BGB;0;1;1;1;0;run019
3008;RRG;BRB;0;1;1;1;0;run019
3009;RRG;GGG;0;1;1;0;1;run019
3010;RRG;GGR;0;1;1;0;1;run019
3011;RRG;GRG;0;1;1;1;0;run019
3012;RRG;GRR;0;3;3;3;0;run019
3013;RRG;RBR;0;4;4;3;1;run019
3014;RRG;RGG;0;1;1;1;0;run019
3015;RRG;RGR;6;37;43;15;28;run019
3016;RRR;BRR;0;1;1;0;1;run019
3017;RRR;GGB;0;1;1;1;0;run019
3018;RRR;GGG;1;5;6;1;5;run019
3019;RRR;GGR;0;2;2;2;0;run019
3020;RRR;GRR;0;1;1;0;1;run019
3021;RRR;RGR;0;1;1;1;0;run019
3022;BBB;GRR;0;1;1;1;0;run020
3023;BBG;BBB;1;9;10;10;0;run020
3024;BBG;BBR;0;2;2;1;1;run020
3025;BBG;BGB;0;1;1;0;1;run020
3026;BBG;BGG;0;1;1;1;0;run020
3027;BBG;BRB;0;2;2;0;2;run020
3028;BBG;BRR;0;1;1;1;0;run020
3029;BBG;GBB;1;1;2;1;1;run020
3030;BBG;GBG;1;6;7;4;3;run020
3031;BBG;GGB;0;18;18;8;10;run020
3032;BBG;GGG;1;29;30;2;28;run020
3033;BBG;GGR;0;2;2;0;2;run020
3034;BBG;GRG;0;1;1;0;1;run020
3035;BBG;GRR;0;3;3;0;3;run020
3036;BBG;RBR;0;2;2;1;1;run020
3037;BBG;RGR;0;2;2;1;1;run020
3038;BBG;RRG;1;2;3;2;1;run020
3039;BBG;RRR;0;1;1;1;0;run020
3040;BGG;BBB;0;1;1;0;1;run020
3041;BGG;BRB;0;1;1;0;1;run020
3042;BGG;GGG;0;1;1;0;1;run020
3043;BGG;RBB;0;1;1;0;1;run020
3044;BGG;RBG;1;0;1;1;0;run020
3045;BRB;BBB;0;1;1;1;0;run020
3046;BRB;GGB;1;0;1;1;0;run020
3047;BRB;GGG;0;2;2;1;1;run020
3048;BRB;RBB;1;0;1;0;1;run020
3049;BRR;BBB;0;1;1;0;1;run020
3050;BRR;BRB;0;1;1;0;1;run020
3051;BRR;GBB;1;0;1;1;0;run020
3052;GBB;BBB;1;16;17;4;13;run020
3053;GBB;BBG;0;2;2;1;1;run020
3054;GBB;BGB;0;1;1;0;1;run020
3055;GBB;BGG;0;3;3;3;0;run020
3056;GBB;BRB;0;9;9;2;7;run020
3057;GBB;BRR;0;2;2;0;2;run020
3058;GBB;GBG;1;1;2;0;2;run020
3059;GBB;GGB;2;59;61;45;16;run020
3060;GBB;GGG;4;95;99;12;87;run020
3061;GBB;GGR;0;1;1;0;1;run020
3062;GBB;GRG;0;1;1;1;0;run020
3063;GBB;GRR;1;8;9;1;8;run020
3064;GBB;RBB;0;2;2;1;1;run020
3065;GBB;RBG;0;1;1;1;0;run020
3066;GBB;RBR;1;1;2;0;2;run020
3067;GBB;RGG;0;2;2;2;0;run020
3068;GBB;RGR;0;1;1;0;1;run020
3069;GBB;RRG;0;3;3;0;3;run020
3070;GBG;BRB;0;1;1;0;1;run020
3071;GBG;BRR;0;3;3;0;3;run020
3072;GBG;GGB;0;1;1;0;1;run020
3073;GBG;GGR;0;3;3;1;2;run020
3074;GBG;RBR;0;1;1;1;0;run020
3075;GBG;RGR;1;1;2;0;2;run020
3076;GBG;RRR;0;1;1;1;0;run020
3077;GGB;BBB;1;8;9;5;4;run020
3078;GGB;BBG;0;1;1;1;0;run020
3079;GGB;BGB;0;1;1;1;0;run020
3080;GGB;BRB;3;5;8;3;5;run020
3081;GGB;BRR;0;1;1;1;0;run020
3082;GGB;GBG;0;2;2;2;0;run020
3083;GGB;GGG;4;37;41;1;40;run020
3084;GGB;GGR;0;9;9;6;3;run020
3085;GGB;GRR;1;4;5;0;5;run020
3086;GGB;RBB;0;2;2;1;1;run020
3087;GGB;RBG;0;2;2;1;1;run020
3088;GGB;RBR;0;2;2;1;1;run020
3089;GGB;RGG;0;1;1;0;1;run020
3090;GGB;RGR;1;2;3;3;0;run020
3091;GGB;RRG;1;3;4;2;2;run020
3092;GGB;RRR;0;3;3;0;3;run020
3093;GGG;BBB;4;22;26;6;20;run020
3094;GGG;BBG;0;2;2;2;0;run020
3095;GGG;BBR;0;3;3;0;3;run020
3096;GGG;BGB;0;2;2;2;0;run020
3097;GGG;BGG;0;3;3;3;0;run020
3098;GGG;BRB;0;3;3;3;0;run020
3099;GGG;BRR;0;3;3;2;1;run020
3100;GGG;GBB;0;1;1;0;1;run020
3101;GGG;GGB;1;3;4;2;2;run020
3102;GGG;GGR;0;21;21;0;21;run020
3103;GGG;GRG;0;2;2;2;0;run020
3104;GGG;GRR;2;15;17;16;1;run020
3105;GGG;RBB;0;1;1;0;1;run020
3106;GGG;RBR;1;4;5;1;4;run020
3107;GGG;RGG;1;7;8;3;5;run020
3108;GGG;RGR;0;3;3;0;3;run020
3109;GGG;RRG;0;2;2;2;0;run020
3110;GGG;RRR;0;1;1;1;0;run020
3111;GGR;BBB;0;1;1;0;1;run020
3112;GGR;BGG;0;2;2;0;2;run020
3113;GGR;BRB;0;1;1;0;1;run020
3114;GRG;BBB;0;3;3;0;3;run020
3115;GRG;BGB;0;3;3;2;1;run020
3116;GRG;BGG;0;1;1;1;0;run020
3117;GRG;BRB;0;5;5;1;4;run020
3118;GRG;BRR;0;1;1;0;1;run020
3119;GRG;GBB;0;3;3;1;2;run020
3120;GRG;GGB;0;14;14;5;9;run020
3121;GRG;GGG;0;10;10;7;3;run020
3122;GRG;GGR;0;2;2;0;2;run020
3123;GRG;GRR;0;1;1;1;0;run020
3124;GRG;RBR;1;2;3;0;3;run020
3125;GRG;RGG;0;2;2;2;0;run020
3126;GRG;RGR;0;1;1;0;1;run020
3127;GRR;BBB;0;3;3;2;1;run020
3128;GRR;BBR;0;2;2;0;2;run020
3129;GRR;BRB;1;8;9;0;9;run020
3130;GRR;BRR;1;6;7;5;2;run020
3131;GRR;GBB;0;1;1;0;1;run020
3132;GRR;GBG;0;1;1;0;1;run020
3133;GRR;GGR;1;9;10;7;3;run020
3134;GRR;RBR;0;1;1;0;1;run020
3135;GRR;RGG;1;3;4;4;0;run020
3136;GRR;RGR;0;1;1;0;1;run020
3137;GRR;RRR;0;1;1;0;1;run020
3138;RBB;BBB;0;1;1;0;1;run020
3139;RBB;GGG;0;3;3;1;2;run020
3140;RBG;GRR;0;1;1;0;1;run020
3141;RBG;RBR;0;1;1;0;1;run020
3142;RBG;RGR;0;1;1;1;0;run020
3143;RBR;BBB;0;3;3;1;2;run020
3144;RBR;BRB;0;1;1;0;1;run020
3145;RBR;BRR;0;2;2;1;1;run020
3146;RBR;GGG;0;1;1;0;1;run020
3147;RBR;GGR;1;2;3;2;1;run020
3148;RBR;GRG;0;1;1;0;1;run020
3149;RBR;GRR;1;15;16;0;16;run020
3150;RBR;RGG;0;4;4;3;1;run020
3151;RBR;RGR;0;1;1;0;1;run020
3152;RBR;RRR;0;3;3;3;0;run020
3153;RGG;BGG;0;1;1;1;0;run020
3154;RGG;RGR;0;1;1;0;1;run020
3155;RGR;BBB;0;9;9;7;2;run020
3156;RGR;BBR;0;1;1;1;0;run020
3157;RGR;BGB;1;8;9;4;5;run020
3158;RGR;BRB;0;3;3;0;3;run020
3159;RGR;BRR;0;3;3;1;2;run020
3160;RGR;GBG;0;1;1;1;0;run020
3161;RGR;GGB;0;3;3;2;1;run020
3162;RGR;GGG;0;2;2;0;2;run020
3163;RGR;GGR;0;8;8;4;4;run020
3164;RGR;GRR;1;7;8;5;3;run020
3165;RGR;RGG;0;6;6;4;2;run020
3166;RRG;BGB;0;1;1;0;1;run020
3167;RRG;BRB;0;1;1;0;1;run020
3168;RRG;GGG;0;1;1;0;1;run020
3169;RRG;GGR;0;1;1;1;0;run020
3170;RRG;GRG;0;1;1;1;0;run020
3171;RRG;GRR;0;3;3;3;0;run020
3172;RRG;RBR;0;4;4;4;0;run020
3173;RRG;RGG;0;1;1;1;0;run020
3174;RRG;RGR;6;37;43;15;28;run020
3175;RRR;BRR;0;1;1;1;0;run020
3176;RRR;GGB;0;1;1;1;0;run020
3177;RRR;GGG;1;5;6;4;2;run020
3178;RRR;GGR;0;2;2;1;1;run020
3179;RRR;GRR;0;1;1;1;0;run020
3180;RRR;RGR;0;1;1;1;0;run020
3181;BBB;GRR;0;1;1;0;1;run021
3182;BBG;BBB;1;9;10;0;10;run021
3183;BBG;BBR;0;2;2;2;0;run021
3184;BBG;BGB;0;1;1;0;1;run021
3185;BBG;BGG;0;1;1;1;0;run021
3186;BBG;BRB;0;2;2;2;0;run021
3187;BBG;BRR;0;1;1;1;0;run021
3188;BBG;GBB;1;1;2;0;2;run021
3189;BBG;GBG;1;6;7;2;5;run021
3190;BBG;GGB;0;18;18;18;0;run021
3191;BBG;GGG;1;29;30;3;27;run021
3192;BBG;GGR;0;2;2;1;1;run021
3193;BBG;GRG;0;1;1;1;0;run021
3194;BBG;GRR;0;3;3;1;2;run021
3195;BBG;RBR;0;2;2;1;1;run021
3196;BBG;RGR;0;2;2;2;0;run021
3197;BBG;RRG;1;2;3;1;2;run021
3198;BBG;RRR;0;1;1;1;0;run021
3199;BGG;BBB;0;1;1;0;1;run021
3200;BGG;BRB;0;1;1;1;0;run021
3201;BGG;GGG;0;1;1;0;1;run021
3202;BGG;RBB;0;1;1;1;0;run021
3203;BGG;RBG;1;0;1;1;0;run021
3204;BRB;BBB;0;1;1;1;0;run021
3205;BRB;GGB;1;0;1;0;1;run021
3206;BRB;GGG;0;2;2;1;1;run021
3207;BRB;RBB;1;0;1;1;0;run021
3208;BRR;BBB;0;1;1;0;1;run021
3209;BRR;BRB;0;1;1;0;1;run021
3210;BRR;GBB;1;0;1;1;0;run021
3211;GBB;BBB;1;16;17;7;10;run021
3212;GBB;BBG;0;2;2;0;2;run021
3213;GBB;BGB;0;1;1;0;1;run021
3214;GBB;BGG;0;3;3;3;0;run021
3215;GBB;BRB;0;9;9;1;8;run021
3216;GBB;BRR;0;2;2;2;0;run021
3217;GBB;GBG;1;1;2;1;1;run021
3218;GBB;GGB;2;59;61;53;8;run021
3219;GBB;GGG;4;95;99;32;67;run021
3220;GBB;GGR;0;1;1;0;1;run021
3221;GBB;GRG;0;1;1;0;1;run021
3222;GBB;GRR;1;8;9;8;1;run021
3223;GBB;RBB;0;2;2;1;1;run021
3224;GBB;RBG;0;1;1;0;1;run021
3225;GBB;RBR;1;1;2;0;2;run021
3226;GBB;RGG;0;2;2;0;2;run021
3227;GBB;RGR;0;1;1;0;1;run021
3228;GBB;RRG;0;3;3;3;0;run021
3229;GBG;BRB;0;1;1;0;1;run021
3230;GBG;BRR;0;3;3;0;3;run021
3231;GBG;GGB;0;1;1;1;0;run021
3232;GBG;GGR;0;3;3;0;3;run021
3233;GBG;RBR;0;1;1;1;0;run021
3234;GBG;RGR;1;1;2;0;2;run021
3235;GBG;RRR;0;1;1;0;1;run021
3236;GGB;BBB;1;8;9;7;2;run021
3237;GGB;BBG;0;1;1;1;0;run021
3238;GGB;BGB;0;1;1;1;0;run021
3239;GGB;BRB;3;5;8;1;7;run021
3240;GGB;BRR;0;1;1;1;0;run021
3241;GGB;GBG;0;2;2;2;0;run021
3242;GGB;GGG;4;37;41;36;5;run021
3243;GGB;GGR;0;9;9;9;0;run021
3244;GGB;GRR;1;4;5;0;5;run021
3245;GGB;RBB;0;2;2;0;2;run021
3246;GGB;RBG;0;2;2;0;2;run021
3247;GGB;RBR;0;2;2;1;1;run021
3248;GGB;RGG;0;1;1;1;0;run021
3249;GGB;RGR;1;2;3;3;0;run021
3250;GGB;RRG;1;3;4;4;0;run021
3251;GGB;RRR;0;3;3;1;2;run021
3252;GGG;BBB;4;22;26;9;17;run021
3253;GGG;BBG;0;2;2;2;0;run021
3254;GGG;BBR;0;3;3;2;1;run021
3255;GGG;BGB;0;2;2;1;1;run021
3256;GGG;BGG;0;3;3;2;1;run021
3257;GGG;BRB;0;3;3;0;3;run021
3258;GGG;BRR;0;3;3;1;2;run021
3259;GGG;GBB;0;1;1;0;1;run021
3260;GGG;GGB;1;3;4;2;2;run021
3261;GGG;GGR;0;21;21;14;7;run021
3262;GGG;GRG;0;2;2;0;2;run021
3263;GGG;GRR;2;15;17;4;13;run021
3264;GGG;RBB;0;1;1;0;1;run021
3265;GGG;RBR;1;4;5;5;0;run021
3266;GGG;RGG;1;7;8;4;4;run021
3267;GGG;RGR;0;3;3;1;2;run021
3268;GGG;RRG;0;2;2;0;2;run021
3269;GGG;RRR;0;1;1;0;1;run021
3270;GGR;BBB;0;1;1;0;1;run021
3271;GGR;BGG;0;2;2;0;2;run021
3272;GGR;BRB;0;1;1;1;0;run021
3273;GRG;BBB;0;3;3;1;2;run021
3274;GRG;BGB;0;3;3;1;2;run021
3275;GRG;BGG;0;1;1;1;0;run021
3276;GRG;BRB;0;5;5;5;0;run021
3277;GRG;BRR;0;1;1;1;0;run021
3278;GRG;GBB;0;3;3;0;3;run021
3279;GRG;GGB;0;14;14;7;7;run021
3280;GRG;GGG;0;10;10;6;4;run021
3281;GRG;GGR;0;2;2;0;2;run021
3282;GRG;GRR;0;1;1;1;0;run021
3283;GRG;RBR;1;2;3;3;0;run021
3284;GRG;RGG;0;2;2;1;1;run021
3285;GRG;RGR;0;1;1;0;1;run021
3286;GRR;BBB;0;3;3;1;2;run021
3287;GRR;BBR;0;2;2;2;0;run021
3288;GRR;BRB;1;8;9;8;1;run021
3289;GRR;BRR;1;6;7;2;5;run021
3290;GRR;GBB;0;1;1;0;1;run021
3291;GRR;GBG;0;1;1;0;1;run021
3292;GRR;GGR;1;9;10;5;5;run021
3293;GRR;RBR;0;1;1;1;0;run021
3294;GRR;RGG;1;3;4;2;2;run021
3295;GRR;RGR;0;1;1;1;0;run021
3296;GRR;RRR;0;1;1;1;0;run021
3297;RBB;BBB;0;1;1;0;1;run021
3298;RBB;GGG;0;3;3;0;3;run021
3299;RBG;GRR;0;1;1;0;1;run021
3300;RBG;RBR;0;1;1;0;1;run021
3301;RBG;RGR;0;1;1;0;1;run021
3302;RBR;BBB;0;3;3;1;2;run021
3303;RBR;BRB;0;1;1;1;0;run021
3304;RBR;BRR;0;2;2;0;2;run021
3305;RBR;GGG;0;1;1;1;0;run021
3306;RBR;GGR;1;2;3;3;0;run021
3307;RBR;GRG;0;1;1;1;0;run021
3308;RBR;GRR;1;15;16;14;2;run021
3309;RBR;RGG;0;4;4;2;2;run021
3310;RBR;RGR;0;1;1;0;1;run021
3311;RBR;RRR;0;3;3;0;3;run021
3312;RGG;BGG;0;1;1;1;0;run021
3313;RGG;RGR;0;1;1;0;1;run021
3314;RGR;BBB;0;9;9;9;0;run021
3315;RGR;BBR;0;1;1;1;0;run021
3316;RGR;BGB;1;8;9;5;4;run021
3317;RGR;BRB;0;3;3;0;3;run021
3318;RGR;BRR;0;3;3;0;3;run021
3319;RGR;GBG;0;1;1;1;0;run021
3320;RGR;GGB;0;3;3;1;2;run021
3321;RGR;GGG;0;2;2;0;2;run021
3322;RGR;GGR;0;8;8;1;7;run021
3323;RGR;GRR;1;7;8;1;7;run021
3324;RGR;RGG;0;6;6;3;3;run021
3325;RRG;BGB;0;1;1;1;0;run021
3326;RRG;BRB;0;1;1;1;0;run021
3327;RRG;GGG;0;1;1;1;0;run021
3328;RRG;GGR;0;1;1;0;1;run021
3329;RRG;GRG;0;1;1;1;0;run021
3330;RRG;GRR;0;3;3;2;1;run021
3331;RRG;RBR;0;4;4;1;3;run021
3332;RRG;RGG;0;1;1;0;1;run021
3333;RRG;RGR;6;37;43;30;13;run021
3334;RRR;BRR;0;1;1;0;1;run021
3335;RRR;GGB;0;1;1;1;0;run021
3336;RRR;GGG;1;5;6;2;4;run021
3337;RRR;GGR;0;2;2;0;2;run021
3338;RRR;GRR;0;1;1;1;0;run021
3339;RRR;RGR;0;1;1;0;1;run021
3340;BBB;GRR;0;1;1;1;0;run022
3341;BBG;BBB;1;9;10;8;2;run022
3342;BBG;BBR;0;2;2;1;1;run022
3343;BBG;BGB;0;1;1;1;0;run022
3344;BBG;BGG;0;1;1;1;0;run022
3345;BBG;BRB;0;2;2;2;0;run022
3346;BBG;BRR;0;1;1;0;1;run022
3347;BBG;GBB;1;1;2;0;2;run022
3348;BBG;GBG;1;6;7;2;5;run022
3349;BBG;GGB;0;18;18;2;16;run022
3350;BBG;GGG;1;29;30;15;15;run022
3351;BBG;GGR;0;2;2;1;1;run022
3352;BBG;GRG;0;1;1;1;0;run022
3353;BBG;GRR;0;3;3;1;2;run022
3354;BBG;RBR;0;2;2;2;0;run022
3355;BBG;RGR;0;2;2;0;2;run022
3356;BBG;RRG;1;2;3;0;3;run022
3357;BBG;RRR;0;1;1;1;0;run022
3358;BGG;BBB;0;1;1;1;0;run022
3359;BGG;BRB;0;1;1;0;1;run022
3360;BGG;GGG;0;1;1;1;0;run022
3361;BGG;RBB;0;1;1;0;1;run022
3362;BGG;RBG;1;0;1;1;0;run022
3363;BRB;BBB;0;1;1;0;1;run022
3364;BRB;GGB;1;0;1;0;1;run022
3365;BRB;GGG;0;2;2;2;0;run022
3366;BRB;RBB;1;0;1;1;0;run022
3367;BRR;BBB;0;1;1;1;0;run022
3368;BRR;BRB;0;1;1;0;1;run022
3369;BRR;GBB;1;0;1;0;1;run022
3370;GBB;BBB;1;16;17;10;7;run022
3371;GBB;BBG;0;2;2;2;0;run022
3372;GBB;BGB;0;1;1;1;0;run022
3373;GBB;BGG;0;3;3;2;1;run022
3374;GBB;BRB;0;9;9;0;9;run022
3375;GBB;BRR;0;2;2;1;1;run022
3376;GBB;GBG;1;1;2;0;2;run022
3377;GBB;GGB;2;59;61;44;17;run022
3378;GBB;GGG;4;95;99;12;87;run022
3379;GBB;GGR;0;1;1;1;0;run022
3380;GBB;GRG;0;1;1;0;1;run022
3381;GBB;GRR;1;8;9;1;8;run022
3382;GBB;RBB;0;2;2;2;0;run022
3383;GBB;RBG;0;1;1;0;1;run022
3384;GBB;RBR;1;1;2;1;1;run022
3385;GBB;RGG;0;2;2;2;0;run022
3386;GBB;RGR;0;1;1;1;0;run022
3387;GBB;RRG;0;3;3;0;3;run022
3388;GBG;BRB;0;1;1;0;1;run022
3389;GBG;BRR;0;3;3;1;2;run022
3390;GBG;GGB;0;1;1;0;1;run022
3391;GBG;GGR;0;3;3;3;0;run022
3392;GBG;RBR;0;1;1;0;1;run022
3393;GBG;RGR;1;1;2;2;0;run022
3394;GBG;RRR;0;1;1;1;0;run022
3395;GGB;BBB;1;8;9;3;6;run022
3396;GGB;BBG;0;1;1;0;1;run022
3397;GGB;BGB;0;1;1;0;1;run022
3398;GGB;BRB;3;5;8;1;7;run022
3399;GGB;BRR;0;1;1;1;0;run022
3400;GGB;GBG;0;2;2;0;2;run022
3401;GGB;GGG;4;37;41;2;39;run022
3402;GGB;GGR;0;9;9;7;2;run022
3403;GGB;GRR;1;4;5;0;5;run022
3404;GGB;RBB;0;2;2;1;1;run022
3405;GGB;RBG;0;2;2;1;1;run022
3406;GGB;RBR;0;2;2;2;0;run022
3407;GGB;RGG;0;1;1;0;1;run022
3408;GGB;RGR;1;2;3;0;3;run022
3409;GGB;RRG;1;3;4;2;2;run022
3410;GGB;RRR;0;3;3;1;2;run022
3411;GGG;BBB;4;22;26;20;6;run022
3412;GGG;BBG;0;2;2;2;0;run022
3413;GGG;BBR;0;3;3;0;3;run022
3414;GGG;BGB;0;2;2;1;1;run022
3415;GGG;BGG;0;3;3;0;3;run022
3416;GGG;BRB;0;3;3;2;1;run022
3417;GGG;BRR;0;3;3;0;3;run022
3418;GGG;GBB;0;1;1;0;1;run022
3419;GGG;GGB;1;3;4;0;4;run022
3420;GGG;GGR;0;21;21;1;20;run022
3421;GGG;GRG;0;2;2;1;1;run022
3422;GGG;GRR;2;15;17;15;2;run022
3423;GGG;RBB;0;1;1;1;0;run022
3424;GGG;RBR;1;4;5;0;5;run022
3425;GGG;RGG;1;7;8;7;1;run022
3426;GGG;RGR;0;3;3;3;0;run022
3427;GGG;RRG;0;2;2;2;0;run022
3428;GGG;RRR;0;1;1;0;1;run022
3429;GGR;BBB;0;1;1;1;0;run022
3430;GGR;BGG;0;2;2;0;2;run022
3431;GGR;BRB;0;1;1;1;0;run022
3432;GRG;BBB;0;3;3;1;2;run022
3433;GRG;BGB;0;3;3;3;0;run022
3434;GRG;BGG;0;1;1;1;0;run022
3435;GRG;BRB;0;5;5;4;1;run022
3436;GRG;BRR;0;1;1;1;0;run022
3437;GRG;GBB;0;3;3;1;2;run022
3438;GRG;GGB;0;14;14;6;8;run022
3439;GRG;GGG;0;10;10;6;4;run022
3440;GRG;GGR;0;2;2;2;0;run022
3441;GRG;GRR;0;1;1;1;0;run022
3442;GRG;RBR;1;2;3;0;3;run022
3443;GRG;RGG;0;2;2;0;2;run022
3444;GRG;RGR;0;1;1;0;1;run022
3445;GRR;BBB;0;3;3;1;2;run022
3446;GRR;BBR;0;2;2;0;2;run022
3447;GRR;BRB;1;8;9;9;0;run022
3448;GRR;BRR;1;6;7;0;7;run022
3449;GRR;GBB;0;1;1;1;0;run022
3450;GRR;GBG;0;1;1;1;0;run022
3451;GRR;GGR;1;9;10;4;6;run022
3452;GRR;RBR;0;1;1;0;1;run022
3453;GRR;RGG;1;3;4;3;1;run022
3454;GRR;RGR;0;1;1;1;0;run022
3455;GRR;RRR;0;1;1;0;1;run022
3456;RBB;BBB;0;1;1;1;0;run022
3457;RBB;GGG;0;3;3;0;3;run022
3458;RBG;GRR;0;1;1;1;0;run022
3459;RBG;RBR;0;1;1;0;1;run022
3460;RBG;RGR;0;1;1;1;0;run022
3461;RBR;BBB;0;3;3;0;3;run022
3462;RBR;BRB;0;1;1;0;1;run022
3463;RBR;BRR;0;2;2;1;1;run022
3464;RBR;GGG;0;1;1;0;1;run022
3465;RBR;GGR;1;2;3;0;3;run022
3466;RBR;GRG;0;1;1;1;0;run022
3467;RBR;GRR;1;15;16;14;2;run022
3468;RBR;RGG;0;4;4;4;0;run022
3469;RBR;RGR;0;1;1;1;0;run022
3470;RBR;RRR;0;3;3;2;1;run022
3471;RGG;BGG;0;1;1;0;1;run022
3472;RGG;RGR;0;1;1;1;0;run022
3473;RGR;BBB;0;9;9;5;4;run022
3474;RGR;BBR;0;1;1;0;1;run022
3475;RGR;BGB;1;8;9;3;6;run022
3476;RGR;BRB;0;3;3;0;3;run022
3477;RGR;BRR;0;3;3;0;3;run022
3478;RGR;GBG;0;1;1;0;1;run022
3479;RGR;GGB;0;3;3;1;2;run022
3480;RGR;GGG;0;2;2;1;1;run022
3481;RGR;GGR;0;8;8;4;4;run022
3482;RGR;GRR;1;7;8;2;6;run022
3483;RGR;RGG;0;6;6;2;4;run022
3484;RRG;BGB;0;1;1;0;1;run022
3485;RRG;BRB;0;1;1;1;0;run022
3486;RRG;GGG;0;1;1;0;1;run022
3487;RRG;GGR;0;1;1;1;0;run022
3488;RRG;GRG;0;1;1;0;1;run022
3489;RRG;GRR;0;3;3;0;3;run022
3490;RRG;RBR;0;4;4;1;3;run022
3491;RRG;RGG;0;1;1;1;0;run022
3492;RRG;RGR;6;37;43;25;18;run022
3493;RRR;BRR;0;1;1;0;1;run022
3494;RRR;GGB;0;1;1;0;1;run022
3495;RRR;GGG;1;5;6;4;2;run022
3496;RRR;GGR;0;2;2;1;1;run022
3497;RRR;GRR;0;1;1;0;1;run022
3498;RRR;RGR;0;1;1;1;0;run022
3499;BBB;GRR;0;1;1;0;1;run023
3500;BBG;BBB;1;9;10;7;3;run023
3501;BBG;BBR;0;2;2;2;0;run023
3502;BBG;BGB;0;1;1;1;0;run023
3503;BBG;BGG;0;1;1;0;1;run023
3504;BBG;BRB;0;2;2;2;0;run023
3505;BBG;BRR;0;1;1;0;1;run023
3506;BBG;GBB;1;1;2;0;2;run023
3507;BBG;GBG;1;6;7;1;6;run023
3508;BBG;GGB;0;18;18;15;3;run023
3509;BBG;GGG;1;29;30;16;14;run023
3510;BBG;GGR;0;2;2;2;0;run023
3511;BBG;GRG;0;1;1;0;1;run023
3512;BBG;GRR;0;3;3;0;3;run023
3513;BBG;RBR;0;2;2;2;0;run023
3514;BBG;RGR;0;2;2;1;1;run023
3515;BBG;RRG;1;2;3;1;2;run023
3516;BBG;RRR;0;1;1;0;1;run023
3517;BGG;BBB;0;1;1;1;0;run023
3518;BGG;BRB;0;1;1;0;1;run023
3519;BGG;GGG;0;1;1;1;0;run023
3520;BGG;RBB;0;1;1;1;0;run023
3521;BGG;RBG;1;0;1;1;0;run023
3522;BRB;BBB;0;1;1;0;1;run023
3523;BRB;GGB;1;0;1;1;0;run023
3524;BRB;GGG;0;2;2;2;0;run023
3525;BRB;RBB;1;0;1;1;0;run023
3526;BRR;BBB;0;1;1;0;1;run023
3527;BRR;BRB;0;1;1;0;1;run023
3528;BRR;GBB;1;0;1;1;0;run023
3529;GBB;BBB;1;16;17;1;16;run023
3530;GBB;BBG;0;2;2;0;2;run023
3531;GBB;BGB;0;1;1;0;1;run023
3532;GBB;BGG;0;3;3;2;1;run023
3533;GBB;BRB;0;9;9;3;6;run023
3534;GBB;BRR;0;2;2;2;0;run023
3535;GBB;GBG;1;1;2;2;0;run023
3536;GBB;GGB;2;59;61;35;26;run023
3537;GBB;GGG;4;95;99;76;23;run023
3538;GBB;GGR;0;1;1;0;1;run023
3539;GBB;GRG;0;1;1;1;0;run023
3540;GBB;GRR;1;8;9;0;9;run023
3541;GBB;RBB;0;2;2;2;0;run023
3542;GBB;RBG;0;1;1;1;0;run023
3543;GBB;RBR;1;1;2;0;2;run023
3544;GBB;RGG;0;2;2;0;2;run023
3545;GBB;RGR;0;1;1;0;1;run023
3546;GBB;RRG;0;3;3;0;3;run023
3547;GBG;BRB;0;1;1;0;1;run023
3548;GBG;BRR;0;3;3;2;1;run023
3549;GBG;GGB;0;1;1;0;1;run023
3550;GBG;GGR;0;3;3;3;0;run023
3551;GBG;RBR;0;1;1;1;0;run023
3552;GBG;RGR;1;1;2;1;1;run023
3553;GBG;RRR;0;1;1;0;1;run023
3554;GGB;BBB;1;8;9;2;7;run023
3555;GGB;BBG;0;1;1;1;0;run023
3556;GGB;BGB;0;1;1;0;1;run023
3557;GGB;BRB;3;5;8;8;0;run023
3558;GGB;BRR;0;1;1;0;1;run023
3559;GGB;GBG;0;2;2;1;1;run023
3560;GGB;GGG;4;37;41;17;24;run023
3561;GGB;GGR;0;9;9;2;7;run023
3562;GGB;GRR;1;4;5;3;2;run023
3563;GGB;RBB;0;2;2;0;2;run023
3564;GGB;RBG;0;2;2;0;2;run023
3565;GGB;RBR;0;2;2;2;0;run023
3566;GGB;RGG;0;1;1;1;0;run023
3567;GGB;RGR;1;2;3;3;0;run023
3568;GGB;RRG;1;3;4;3;1;run023
3569;GGB;RRR;0;3;3;1;2;run023
3570;GGG;BBB;4;22;26;23;3;run023
3571;GGG;BBG;0;2;2;2;0;run023
3572;GGG;BBR;0;3;3;1;2;run023
3573;GGG;BGB;0;2;2;1;1;run023
3574;GGG;BGG;0;3;3;0;3;run023
3575;GGG;BRB;0;3;3;1;2;run023
3576;GGG;BRR;0;3;3;3;0;run023
3577;GGG;GBB;0;1;1;0;1;run023
3578;GGG;GGB;1;3;4;1;3;run023
3579;GGG;GGR;0;21;21;4;17;run023
3580;GGG;GRG;0;2;2;0;2;run023
3581;GGG;GRR;2;15;17;9;8;run023
3582;GGG;RBB;0;1;1;0;1;run023
3583;GGG;RBR;1;4;5;4;1;run023
3584;GGG;RGG;1;7;8;4;4;run023
3585;GGG;RGR;0;3;3;2;1;run023
3586;GGG;RRG;0;2;2;0;2;run023
3587;GGG;RRR;0;1;1;0;1;run023
3588;GGR;BBB;0;1;1;1;0;run023
3589;GGR;BGG;0;2;2;0;2;run023
3590;GGR;BRB;0;1;1;0;1;run023
3591;GRG;BBB;0;3;3;3;0;run023
3592;GRG;BGB;0;3;3;0;3;run023
3593;GRG;BGG;0;1;1;0;1;run023
3594;GRG;BRB;0;5;5;3;2;run023
3595;GRG;BRR;0;1;1;1;0;run023
3596;GRG;GBB;0;3;3;1;2;run023
3597;GRG;GGB;0;14;14;1;13;run023
3598;GRG;GGG;0;10;10;6;4;run023
3599;GRG;GGR;0;2;2;2;0;run023
3600;GRG;GRR;0;1;1;1;0;run023
3601;GRG;RBR;1;2;3;1;2;run023
3602;GRG;RGG;0;2;2;1;1;run023
3603;GRG;RGR;0;1;1;0;1;run023
3604;GRR;BBB;0;3;3;0;3;run023
3605;GRR;BBR;0;2;2;0;2;run023
3606;GRR;BRB;1;8;9;9;0;run023
3607;GRR;BRR;1;6;7;7;0;run023
3608;GRR;GBB;0;1;1;0;1;run023
3609;GRR;GBG;0;1;1;0;1;run023
3610;GRR;GGR;1;9;10;7;3;run023
3611;GRR;RBR;0;1;1;1;0;run023
3612;GRR;RGG;1;3;4;2;2;run023
3613;GRR;RGR;0;1;1;0;1;run023
3614;GRR;RRR;0;1;1;0;1;run023
3615;RBB;BBB;0;1;1;0;1;run023
3616;RBB;GGG;0;3;3;2;1;run023
3617;RBG;GRR;0;1;1;0;1;run023
3618;RBG;RBR;0;1;1;0;1;run023
3619;RBG;RGR;0;1;1;0;1;run023
3620;RBR;BBB;0;3;3;3;0;run023
3621;RBR;BRB;0;1;1;1;0;run023
3622;RBR;BRR;0;2;2;2;0;run023
3623;RBR;GGG;0;1;1;1;0;run023
3624;RBR;GGR;1;2;3;3;0;run023
3625;RBR;GRG;0;1;1;0;1;run023
3626;RBR;GRR;1;15;16;10;6;run023
3627;RBR;RGG;0;4;4;4;0;run023
3628;RBR;RGR;0;1;1;1;0;run023
3629;RBR;RRR;0;3;3;0;3;run023
3630;RGG;BGG;0;1;1;1;0;run023
3631;RGG;RGR;0;1;1;1;0;run023
3632;RGR;BBB;0;9;9;2;7;run023
3633;RGR;BBR;0;1;1;0;1;run023
3634;RGR;BGB;1;8;9;8;1;run023
3635;RGR;BRB;0;3;3;2;1;run023
3636;RGR;BRR;0;3;3;2;1;run023
3637;RGR;GBG;0;1;1;0;1;run023
3638;RGR;GGB;0;3;3;0;3;run023
3639;RGR;GGG;0;2;2;1;1;run023
3640;RGR;GGR;0;8;8;7;1;run023
3641;RGR;GRR;1;7;8;6;2;run023
3642;RGR;RGG;0;6;6;0;6;run023
3643;RRG;BGB;0;1;1;0;1;run023
3644;RRG;BRB;0;1;1;1;0;run023
3645;RRG;GGG;0;1;1;0;1;run023
3646;RRG;GGR;0;1;1;0;1;run023
3647;RRG;GRG;0;1;1;1;0;run023
3648;RRG;GRR;0;3;3;2;1;run023
3649;RRG;RBR;0;4;4;4;0;run023
3650;RRG;RGG;0;1;1;1;0;run023
3651;RRG;RGR;6;37;43;35;8;run023
3652;RRR;BRR;0;1;1;0;1;run023
3653;RRR;GGB;0;1;1;1;0;run023
3654;RRR;GGG;1;5;6;3;3;run023
3655;RRR;GGR;0;2;2;2;0;run023
3656;RRR;GRR;0;1;1;0;1;run023
3657;RRR;RGR;0;1;1;0;1;run023
3658;BBB;GRR;0;1;1;0;1;run024
3659;BBG;BBB;1;9;10;2;8;run024
3660;BBG;BBR;0;2;2;2;0;run024
3661;BBG;BGB;0;1;1;1;0;run024
3662;BBG;BGG;0;1;1;0;1;run024
3663;BBG;BRB;0;2;2;0;2;run024
3664;BBG;BRR;0;1;1;1;0;run024
3665;BBG;GBB;1;1;2;1;1;run024
3666;BBG;GBG;1;6;7;1;6;run024
3667;BBG;GGB;0;18;18;8;10;run024
3668;BBG;GGG;1;29;30;19;11;run024
3669;BBG;GGR;0;2;2;0;2;run024
3670;BBG;GRG;0;1;1;1;0;run024
3671;BBG;GRR;0;3;3;2;1;run024
3672;BBG;RBR;0;2;2;0;2;run024
3673;BBG;RGR;0;2;2;0;2;run024
3674;BBG;RRG;1;2;3;3;0;run024
3675;BBG;RRR;0;1;1;0;1;run024
3676;BGG;BBB;0;1;1;0;1;run024
3677;BGG;BRB;0;1;1;0;1;run024
3678;BGG;GGG;0;1;1;1;0;run024
3679;BGG;RBB;0;1;1;0;1;run024
3680;BGG;RBG;1;0;1;1;0;run024
3681;BRB;BBB;0;1;1;0;1;run024
3682;BRB;GGB;1;0;1;1;0;run024
3683;BRB;GGG;0;2;2;1;1;run024
3684;BRB;RBB;1;0;1;0;1;run024
3685;BRR;BBB;0;1;1;1;0;run024
3686;BRR;BRB;0;1;1;0;1;run024
3687;BRR;GBB;1;0;1;0;1;run024
3688;GBB;BBB;1;16;17;4;13;run024
3689;GBB;BBG;0;2;2;1;1;run024
3690;GBB;BGB;0;1;1;0;1;run024
3691;GBB;BGG;0;3;3;0;3;run024
3692;GBB;BRB;0;9;9;3;6;run024
3693;GBB;BRR;0;2;2;1;1;run024
3694;GBB;GBG;1;1;2;2;0;run024
3695;GBB;GGB;2;59;61;45;16;run024
3696;GBB;GGG;4;95;99;69;30;run024
3697;GBB;GGR;0;1;1;1;0;run024
3698;GBB;GRG;0;1;1;1;0;run024
3699;GBB;GRR;1;8;9;9;0;run024
3700;GBB;RBB;0;2;2;2;0;run024
3701;GBB;RBG;0;1;1;0;1;run024
3702;GBB;RBR;1;1;2;0;2;run024
3703;GBB;RGG;0;2;2;2;0;run024
3704;GBB;RGR;0;1;1;1;0;run024
3705;GBB;RRG;0;3;3;1;2;run024
3706;GBG;BRB;0;1;1;0;1;run024
3707;GBG;BRR;0;3;3;0;3;run024
3708;GBG;GGB;0;1;1;1;0;run024
3709;GBG;GGR;0;3;3;1;2;run024
3710;GBG;RBR;0;1;1;0;1;run024
3711;GBG;RGR;1;1;2;0;2;run024
3712;GBG;RRR;0;1;1;1;0;run024
3713;GGB;BBB;1;8;9;3;6;run024
3714;GGB;BBG;0;1;1;0;1;run024
3715;GGB;BGB;0;1;1;0;1;run024
3716;GGB;BRB;3;5;8;5;3;run024
3717;GGB;BRR;0;1;1;1;0;run024
3718;GGB;GBG;0;2;2;2;0;run024
3719;GGB;GGG;4;37;41;20;21;run024
3720;GGB;GGR;0;9;9;9;0;run024
3721;GGB;GRR;1;4;5;0;5;run024
3722;GGB;RBB;0;2;2;0;2;run024
3723;GGB;RBG;0;2;2;0;2;run024
3724;GGB;RBR;0;2;2;0;2;run024
3725;GGB;RGG;0;1;1;0;1;run024
3726;GGB;RGR;1;2;3;2;1;run024
3727;GGB;RRG;1;3;4;3;1;run024
3728;GGB;RRR;0;3;3;2;1;run024
3729;GGG;BBB;4;22;26;2;24;run024
3730;GGG;BBG;0;2;2;0;2;run024
3731;GGG;BBR;0;3;3;3;0;run024
3732;GGG;BGB;0;2;2;2;0;run024
3733;GGG;BGG;0;3;3;3;0;run024
3734;GGG;BRB;0;3;3;2;1;run024
3735;GGG;BRR;0;3;3;0;3;run024
3736;GGG;GBB;0;1;1;0;1;run024
3737;GGG;GGB;1;3;4;1;3;run024
3738;GGG;GGR;0;21;21;9;12;run024
3739;GGG;GRG;0;2;2;1;1;run024
3740;GGG;GRR;2;15;17;15;2;run024
3741;GGG;RBB;0;1;1;1;0;run024
3742;GGG;RBR;1;4;5;2;3;run024
3743;GGG;RGG;1;7;8;6;2;run024
3744;GGG;RGR;0;3;3;3;0;run024
3745;GGG;RRG;0;2;2;2;0;run024
3746;GGG;RRR;0;1;1;0;1;run024
3747;GGR;BBB;0;1;1;1;0;run024
3748;GGR;BGG;0;2;2;1;1;run024
3749;GGR;BRB;0;1;1;1;0;run024
3750;GRG;BBB;0;3;3;1;2;run024
3751;GRG;BGB;0;3;3;1;2;run024
3752;GRG;BGG;0;1;1;0;1;run024
3753;GRG;BRB;0;5;5;2;3;run024
3754;GRG;BRR;0;1;1;1;0;run024
3755;GRG;GBB;0;3;3;3;0;run024
3756;GRG;GGB;0;14;14;4;10;run024
3757;GRG;GGG;0;10;10;9;1;run024
3758;GRG;GGR;0;2;2;2;0;run024
3759;GRG;GRR;0;1;1;1;0;run024
3760;GRG;RBR;1;2;3;2;1;run024
3761;GRG;RGG;0;2;2;2;0;run024
3762;GRG;RGR;0;1;1;0;1;run024
3763;GRR;BBB;0;3;3;2;1;run024
3764;GRR;BBR;0;2;2;0;2;run024
3765;GRR;BRB;1;8;9;1;8;run024
3766;GRR;BRR;1;6;7;7;0;run024
3767;GRR;GBB;0;1;1;1;0;run024
3768;GRR;GBG;0;1;1;0;1;run024
3769;GRR;GGR;1;9;10;7;3;run024
3770;GRR;RBR;0;1;1;0;1;run024
3771;GRR;RGG;1;3;4;3;1;run024
3772;GRR;RGR;0;1;1;0;1;run024
3773;GRR;RRR;0;1;1;0;1;run024
3774;RBB;BBB;0;1;1;1;0;run024
3775;RBB;GGG;0;3;3;1;2;run024
3776;RBG;GRR;0;1;1;1;0;run024
3777;RBG;RBR;0;1;1;1;0;run024
3778;RBG;RGR;0;1;1;0;1;run024
3779;RBR;BBB;0;3;3;1;2;run024
3780;RBR;BRB;0;1;1;1;0;run024
3781;RBR;BRR;0;2;2;0;2;run024
3782;RBR;GGG;0;1;1;0;1;run024
3783;RBR;GGR;1;2;3;0;3;run024
3784;RBR;GRG;0;1;1;0;1;run024
3785;RBR;GRR;1;15;16;3;13;run024
3786;RBR;RGG;0;4;4;3;1;run024
3787;RBR;RGR;0;1;1;0;1;run024
3788;RBR;RRR;0;3;3;1;2;run024
3789;RGG;BGG;0;1;1;1;0;run024
3790;RGG;RGR;0;1;1;1;0;run024
3791;RGR;BBB;0;9;9;7;2;run024
3792;RGR;BBR;0;1;1;0;1;run024
3793;RGR;BGB;1;8;9;7;2;run024
3794;RGR;BRB;0;3;3;2;1;run024
3795;RGR;BRR;0;3;3;0;3;run024
3796;RGR;GBG;0;1;1;0;1;run024
3797;RGR;GGB;0;3;3;0;3;run024
3798;RGR;GGG;0;2;2;2;0;run024
3799;RGR;GGR;0;8;8;5;3;run024
3800;RGR;GRR;1;7;8;8;0;run024
3801;RGR;RGG;0;6;6;0;6;run024
3802;RRG;BGB;0;1;1;0;1;run024
3803;RRG;BRB;0;1;1;0;1;run024
3804;RRG;GGG;0;1;1;0;1;run024
3805;RRG;GGR;0;1;1;0;1;run024
3806;RRG;GRG;0;1;1;1;0;run024
3807;RRG;GRR;0;3;3;2;1;run024
3808;RRG;RBR;0;4;4;4;0;run024
3809;RRG;RGG;0;1;1;0;1;run024
3810;RRG;RGR;6;37;43;22;21;run024
3811;RRR;BRR;0;1;1;1;0;run024
3812;RRR;GGB;0;1;1;1;0;run024
3813;RRR;GGG;1;5;6;2;4;run024
3814;RRR;GGR;0;2;2;1;1;run024
3815;RRR;GRR;0;1;1;0;1;run024
3816;RRR;RGR;0;1;1;0;1;run024
3817;BBB;GRR;0;1;1;0;1;run025
3818;BBG;BBB;1;9;10;7;3;run025
3819;BBG;BBR;0;2;2;0;2;run025
3820;BBG;BGB;0;1;1;0;1;run025
3821;BBG;BGG;0;1;1;1;0;run025
3822;BBG;BRB;0;2;2;0;2;run025
3823;BBG;BRR;0;1;1;1;0;run025
3824;BBG;GBB;1;1;2;2;0;run025
3825;BBG;GBG;1;6;7;5;2;run025
3826;BBG;GGB;0;18;18;15;3;run025
3827;BBG;GGG;1;29;30;3;27;run025
3828;BBG;GGR;0;2;2;0;2;run025
3829;BBG;GRG;0;1;1;1;0;run025
3830;BBG;GRR;0;3;3;2;1;run025
3831;BBG;RBR;0;2;2;0;2;run025
3832;BBG;RGR;0;2;2;1;1;run025
3833;BBG;RRG;1;2;3;2;1;run025
3834;BBG;RRR;0;1;1;0;1;run025
3835;BGG;BBB;0;1;1;0;1;run025
3836;BGG;BRB;0;1;1;0;1;run025
3837;BGG;GGG;0;1;1;1;0;run025
3838;BGG;RBB;0;1;1;1;0;run025
3839;BGG;RBG;1;0;1;0;1;run025
3840;BRB;BBB;0;1;1;0;1;run025
3841;BRB;GGB;1;0;1;1;0;run025
3842;BRB;GGG;0;2;2;0;2;run025
3843;BRB;RBB;1;0;1;0;1;run025
3844;BRR;BBB;0;1;1;0;1;run025
3845;BRR;BRB;0;1;1;0;1;run025
3846;BRR;GBB;1;0;1;0;1;run025
3847;GBB;BBB;1;16;17;4;13;run025
3848;GBB;BBG;0;2;2;1;1;run025
3849;GBB;BGB;0;1;1;0;1;run025
3850;GBB;BGG;0;3;3;3;0;run025
3851;GBB;BRB;0;9;9;3;6;run025
3852;GBB;BRR;0;2;2;2;0;run025
3853;GBB;GBG;1;1;2;1;1;run025
3854;GBB;GGB;2;59;61;53;8;run025
3855;GBB;GGG;4;95;99;62;37;run025
3856;GBB;GGR;0;1;1;0;1;run025
3857;GBB;GRG;0;1;1;1;0;run025
3858;GBB;GRR;1;8;9;8;1;run025
3859;GBB;RBB;0;2;2;0;2;run025
3860;GBB;RBG;0;1;1;1;0;run025
3861;GBB;RBR;1;1;2;0;2;run025
3862;GBB;RGG;0;2;2;1;1;run025
3863;GBB;RGR;0;1;1;1;0;run025
3864;GBB;RRG;0;3;3;3;0;run025
3865;GBG;BRB;0;1;1;0;1;run025
3866;GBG;BRR;0;3;3;1;2;run025
3867;GBG;GGB;0;1;1;0;1;run025
3868;GBG;GGR;0;3;3;1;2;run025
3869;GBG;RBR;0;1;1;0;1;run025
3870;GBG;RGR;1;1;2;2;0;run025
3871;GBG;RRR;0;1;1;0;1;run025
3872;GGB;BBB;1;8;9;7;2;run025
3873;GGB;BBG;0;1;1;1;0;run025
3874;GGB;BGB;0;1;1;1;0;run025
3875;GGB;BRB;3;5;8;0;8;run025
3876;GGB;BRR;0;1;1;1;0;run025
3877;GGB;GBG;0;2;2;2;0;run025
3878;GGB;GGG;4;37;41;31;10;run025
3879;GGB;GGR;0;9;9;2;7;run025
3880;GGB;GRR;1;4;5;1;4;run025
3881;GGB;RBB;0;2;2;1;1;run025
3882;GGB;RBG;0;2;2;2;0;run025
3883;GGB;RBR;0;2;2;1;1;run025
3884;GGB;RGG;0;1;1;1;0;run025
3885;GGB;RGR;1;2;3;0;3;run025
3886;GGB;RRG;1;3;4;2;2;run025
3887;GGB;RRR;0;3;3;0;3;run025
3888;GGG;BBB;4;22;26;7;19;run025
3889;GGG;BBG;0;2;2;1;1;run025
3890;GGG;BBR;0;3;3;0;3;run025
3891;GGG;BGB;0;2;2;2;0;run025
3892;GGG;BGG;0;3;3;2;1;run025
3893;GGG;BRB;0;3;3;1;2;run025
3894;GGG;BRR;0;3;3;0;3;run025
3895;GGG;GBB;0;1;1;1;0;run025
3896;GGG;GGB;1;3;4;3;1;run025
3897;GGG;GGR;0;21;21;10;11;run025
3898;GGG;GRG;0;2;2;0;2;run025
3899;GGG;GRR;2;15;17;13;4;run025
3900;GGG;RBB;0;1;1;1;0;run025
3901;GGG;RBR;1;4;5;3;2;run025
3902;GGG;RGG;1;7;8;6;2;run025
3903;GGG;RGR;0;3;3;2;1;run025
3904;GGG;RRG;0;2;2;0;2;run025
3905;GGG;RRR;0;1;1;0;1;run025
3906;GGR;BBB;0;1;1;0;1;run025
3907;GGR;BGG;0;2;2;1;1;run025
3908;GGR;BRB;0;1;1;1;0;run025
3909;GRG;BBB;0;3;3;0;3;run025
3910;GRG;BGB;0;3;3;3;0;run025
3911;GRG;BGG;0;1;1;1;0;run025
3912;GRG;BRB;0;5;5;5;0;run025
3913;GRG;BRR;0;1;1;0;1;run025
3914;GRG;GBB;0;3;3;3;0;run025
3915;GRG;GGB;0;14;14;11;3;run025
3916;GRG;GGG;0;10;10;8;2;run025
3917;GRG;GGR;0;2;2;1;1;run025
3918;GRG;GRR;0;1;1;1;0;run025
3919;GRG;RBR;1;2;3;0;3;run025
3920;GRG;RGG;0;2;2;0;2;run025
3921;GRG;RGR;0;1;1;1;0;run025
3922;GRR;BBB;0;3;3;3;0;run025
3923;GRR;BBR;0;2;2;2;0;run025
3924;GRR;BRB;1;8;9;8;1;run025
3925;GRR;BRR;1;6;7;6;1;run025
3926;GRR;GBB;0;1;1;1;0;run025
3927;GRR;GBG;0;1;1;1;0;run025
3928;GRR;GGR;1;9;10;7;3;run025
3929;GRR;RBR;0;1;1;1;0;run025
3930;GRR;RGG;1;3;4;4;0;run025
3931;GRR;RGR;0;1;1;0;1;run025
3932;GRR;RRR;0;1;1;1;0;run025
3933;RBB;BBB;0;1;1;1;0;run025
3934;RBB;GGG;0;3;3;1;2;run025
3935;RBG;GRR;0;1;1;1;0;run025
3936;RBG;RBR;0;1;1;1;0;run025
3937;RBG;RGR;0;1;1;0;1;run025
3938;RBR;BBB;0;3;3;3;0;run025
3939;RBR;BRB;0;1;1;1;0;run025
3940;RBR;BRR;0;2;2;1;1;run025
3941;RBR;GGG;0;1;1;0;1;run025
3942;RBR;GGR;1;2;3;2;1;run025
3943;RBR;GRG;0;1;1;1;0;run025
3944;RBR;GRR;1;15;16;3;13;run025
3945;RBR;RGG;0;4;4;0;4;run025
3946;RBR;RGR;0;1;1;1;0;run025
3947;RBR;RRR;0;3;3;2;1;run025
3948;RGG;BGG;0;1;1;0;1;run025
3949;RGG;RGR;0;1;1;1;0;run025
3950;RGR;BBB;0;9;9;4;5;run025
3951;RGR;BBR;0;1;1;1;0;run025
3952;RGR;BGB;1;8;9;4;5;run025
3953;RGR;BRB;0;3;3;2;1;run025
3954;RGR;BRR;0;3;3;0;3;run025
3955;RGR;GBG;0;1;1;1;0;run025
3956;RGR;GGB;0;3;3;1;2;run025
3957;RGR;GGG;0;2;2;2;0;run025
3958;RGR;GGR;0;8;8;6;2;run025
3959;RGR;GRR;1;7;8;2;6;run025
3960;RGR;RGG;0;6;6;2;4;run025
3961;RRG;BGB;0;1;1;1;0;run025
3962;RRG;BRB;0;1;1;1;0;run025
3963;RRG;GGG;0;1;1;0;1;run025
3964;RRG;GGR;0;1;1;1;0;run025
3965;RRG;GRG;0;1;1;0;1;run025
3966;RRG;GRR;0;3;3;0;3;run025
3967;RRG;RBR;0;4;4;4;0;run025
3968;RRG;RGG;0;1;1;0;1;run025
3969;RRG;RGR;6;37;43;8;35;run025
3970;RRR;BRR;0;1;1;0;1;run025
3971;RRR;GGB;0;1;1;0;1;run025
3972;RRR;GGG;1;5;6;3;3;run025
3973;RRR;GGR;0;2;2;2;0;run025
3974;RRR;GRR;0;1;1;0;1;run025
3975;RRR;RGR;0;1;1;0;1;run025
3976;BBB;GRR;0;1;1;1;0;run026
3977;BBG;BBB;1;9;10;7;3;run026
3978;BBG;BBR;0;2;2;2;0;run026
3979;BBG;BGB;0;1;1;0;1;run026
3980;BBG;BGG;0;1;1;0;1;run026
3981;BBG;BRB;0;2;2;2;0;run026
3982;BBG;BRR;0;1;1;1;0;run026
3983;BBG;GBB;1;1;2;1;1;run026
3984;BBG;GBG;1;6;7;3;4;run026
3985;BBG;GGB;0;18;18;13;5;run026
3986;BBG;GGG;1;29;30;5;25;run026
3987;BBG;GGR;0;2;2;0;2;run026
3988;BBG;GRG;0;1;1;0;1;run026
3989;BBG;GRR;0;3;3;1;2;run026
3990;BBG;RBR;0;2;2;1;1;run026
3991;BBG;RGR;0;2;2;2;0;run026
3992;BBG;RRG;1;2;3;3;0;run026
3993;BBG;RRR;0;1;1;0;1;run026
3994;BGG;BBB;0;1;1;1;0;run026
3995;BGG;BRB;0;1;1;1;0;run026
3996;BGG;GGG;0;1;1;0;1;run026
3997;BGG;RBB;0;1;1;0;1;run026
3998;BGG;RBG;1;0;1;1;0;run026
3999;BRB;BBB;0;1;1;1;0;run026
4000;BRB;GGB;1;0;1;0;1;run026
4001;BRB;GGG;0;2;2;2;0;run026
4002;BRB;RBB;1;0;1;0;1;run026
4003;BRR;BBB;0;1;1;1;0;run026
4004;BRR;BRB;0;1;1;0;1;run026
4005;BRR;GBB;1;0;1;0;1;run026
4006;GBB;BBB;1;16;17;12;5;run026
4007;GBB;BBG;0;2;2;0;2;run026
4008;GBB;BGB;0;1;1;0;1;run026
4009;GBB;BGG;0;3;3;3;0;run026
4010;GBB;BRB;0;9;9;1;8;run026
4011;GBB;BRR;0;2;2;2;0;run026
4012;GBB;GBG;1;1;2;1;1;run026
4013;GBB;GGB;2;59;61;34;27;run026
4014;GBB;GGG;4;95;99;75;24;run026
4015;GBB;GGR;0;1;1;0;1;run026
4016;GBB;GRG;0;1;1;1;0;run026
4017;GBB;GRR;1;8;9;9;0;run026
4018;GBB;RBB;0;2;2;2;0;run026
4019;GBB;RBG;0;1;1;0;1;run026
4020;GBB;RBR;1;1;2;0;2;run026
4021;GBB;RGG;0;2;2;2;0;run026
4022;GBB;RGR;0;1;1;0;1;run026
4023;GBB;RRG;0;3;3;3;0;run026
4024;GBG;BRB;0;1;1;1;0;run026
4025;GBG;BRR;0;3;3;1;2;run026
4026;GBG;GGB;0;1;1;0;1;run026
4027;GBG;GGR;0;3;3;3;0;run026
4028;GBG;RBR;0;1;1;0;1;run026
4029;GBG;RGR;1;1;2;2;0;run026
4030;GBG;RRR;0;1;1;1;0;run026
4031;GGB;BBB;1;8;9;2;7;run026
4032;GGB;BBG;0;1;1;1;0;run026
4033;GGB;BGB;0;1;1;0;1;run026
4034;GGB;BRB;3;5;8;2;6;run026
4035;GGB;BRR;0;1;1;0;1;run026
4036;GGB;GBG;0;2;2;0;2;run026
4037;GGB;GGG;4;37;41;9;32;run026
4038;GGB;GGR;0;9;9;0;9;run026
4039;GGB;GRR;1;4;5;0;5;run026
4040;GGB;RBB;0;2;2;2;0;run026
4041;GGB;RBG;0;2;2;2;0;run026
4042;GGB;RBR;0;2;2;0;2;run026
4043;GGB;RGG;0;1;1;1;0;run026
4044;GGB;RGR;1;2;3;2;1;run026
4045;GGB;RRG;1;3;4;0;4;run026
4046;GGB;RRR;0;3;3;0;3;run026
4047;GGG;BBB;4;22;26;26;0;run026
4048;GGG;BBG;0;2;2;2;0;run026
4049;GGG;BBR;0;3;3;0;3;run026
4050;GGG;BGB;0;2;2;0;2;run026
4051;GGG;BGG;0;3;3;2;1;run026
4052;GGG;BRB;0;3;3;2;1;run026
4053;GGG;BRR;0;3;3;2;1;run026
4054;GGG;GBB;0;1;1;1;0;run026
4055;GGG;GGB;1;3;4;3;1;run026
4056;GGG;GGR;0;21;21;0;21;run026
4057;GGG;GRG;0;2;2;1;1;run026
4058;GGG;GRR;2;15;17;10;7;run026
4059;GGG;RBB;0;1;1;0;1;run026
4060;GGG;RBR;1;4;5;1;4;run026
4061;GGG;RGG;1;7;8;1;7;run026
4062;GGG;RGR;0;3;3;2;1;run026
4063;GGG;RRG;0;2;2;0;2;run026
4064;GGG;RRR;0;1;1;1;0;run026
4065;GGR;BBB;0;1;1;1;0;run026
4066;GGR;BGG;0;2;2;1;1;run026
4067;GGR;BRB;0;1;1;1;0;run026
4068;GRG;BBB;0;3;3;2;1;run026
4069;GRG;BGB;0;3;3;3;0;run026
4070;GRG;BGG;0;1;1;0;1;run026
4071;GRG;BRB;0;5;5;2;3;run026
4072;GRG;BRR;0;1;1;0;1;run026
4073;GRG;GBB;0;3;3;1;2;run026
4074;GRG;GGB;0;14;14;3;11;run026
4075;GRG;GGG;0;10;10;1;9;run026
4076;GRG;GGR;0;2;2;2;0;run026
4077;GRG;GRR;0;1;1;1;0;run026
4078;GRG;RBR;1;2;3;1;2;run026
4079;GRG;RGG;0;2;2;0;2;run026
4080;GRG;RGR;0;1;1;1;0;run026
4081;GRR;BBB;0;3;3;3;0;run026
4082;GRR;BBR;0;2;2;1;1;run026
4083;GRR;BRB;1;8;9;3;6;run026
4084;GRR;BRR;1;6;7;3;4;run026
4085;GRR;GBB;0;1;1;0;1;run026
4086;GRR;GBG;0;1;1;0;1;run026
4087;GRR;GGR;1;9;10;0;10;run026
4088;GRR;RBR;0;1;1;1;0;run026
4089;GRR;RGG;1;3;4;2;2;run026
4090;GRR;RGR;0;1;1;1;0;run026
4091;GRR;RRR;0;1;1;1;0;run026
4092;RBB;BBB;0;1;1;0;1;run026
4093;RBB;GGG;0;3;3;3;0;run026
4094;RBG;GRR;0;1;1;1;0;run026
4095;RBG;RBR;0;1;1;0;1;run026
4096;RBG;RGR;0;1;1;1;0;run026
4097;RBR;BBB;0;3;3;2;1;run026
4098;RBR;BRB;0;1;1;1;0;run026
4099;RBR;BRR;0;2;2;1;1;run026
4100;RBR;GGG;0;1;1;0;1;run026
4101;RBR;GGR;1;2;3;1;2;run026
4102;RBR;GRG;0;1;1;1;0;run026
4103;RBR;GRR;1;15;16;10;6;run026
4104;RBR;RGG;0;4;4;2;2;run026
4105;RBR;RGR;0;1;1;1;0;run026
4106;RBR;RRR;0;3;3;1;2;run026
4107;RGG;BGG;0;1;1;1;0;run026
4108;RGG;RGR;0;1;1;1;0;run026
4109;RGR;BBB;0;9;9;2;7;run026
4110;RGR;BBR;0;1;1;0;1;run026
4111;RGR;BGB;1;8;9;2;7;run026
4112;RGR;BRB;0;3;3;1;2;run026
4113;RGR;BRR;0;3;3;0;3;run026
4114;RGR;GBG;0;1;1;1;0;run026
4115;RGR;GGB;0;3;3;2;1;run026
4116;RGR;GGG;0;2;2;0;2;run026
4117;RGR;GGR;0;8;8;7;1;run026
4118;RGR;GRR;1;7;8;3;5;run026
4119;RGR;RGG;0;6;6;0;6;run026
4120;RRG;BGB;0;1;1;0;1;run026
4121;RRG;BRB;0;1;1;1;0;run026
4122;RRG;GGG;0;1;1;1;0;run026
4123;RRG;GGR;0;1;1;1;0;run026
4124;RRG;GRG;0;1;1;1;0;run026
4125;RRG;GRR;0;3;3;2;1;run026
4126;RRG;RBR;0;4;4;2;2;run026
4127;RRG;RGG;0;1;1;1;0;run026
4128;RRG;RGR;6;37;43;6;37;run026
4129;RRR;BRR;0;1;1;1;0;run026
4130;RRR;GGB;0;1;1;1;0;run026
4131;RRR;GGG;1;5;6;2;4;run026
4132;RRR;GGR;0;2;2;0;2;run026
4133;RRR;GRR;0;1;1;0;1;run026
4134;RRR;RGR;0;1;1;1;0;run026
4135;BBB;GRR;0;1;1;0;1;run027
4136;BBG;BBB;1;9;10;1;9;run027
4137;BBG;BBR;0;2;2;1;1;run027
4138;BBG;BGB;0;1;1;0;1;run027
4139;BBG;BGG;0;1;1;1;0;run027
4140;BBG;BRB;0;2;2;2;0;run027
4141;BBG;BRR;0;1;1;1;0;run027
4142;BBG;GBB;1;1;2;0;2;run027
4143;BBG;GBG;1;6;7;0;7;run027
4144;BBG;GGB;0;18;18;0;18;run027
4145;BBG;GGG;1;29;30;24;6;run027
4146;BBG;GGR;0;2;2;0;2;run027
4147;BBG;GRG;0;1;1;0;1;run027
4148;BBG;GRR;0;3;3;2;1;run027
4149;BBG;RBR;0;2;2;2;0;run027
4150;BBG;RGR;0;2;2;2;0;run027
4151;BBG;RRG;1;2;3;1;2;run027
4152;BBG;RRR;0;1;1;1;0;run027
4153;BGG;BBB;0;1;1;0;1;run027
4154;BGG;BRB;0;1;1;1;0;run027
4155;BGG;GGG;0;1;1;0;1;run027
4156;BGG;RBB;0;1;1;1;0;run027
4157;BGG;RBG;1;0;1;0;1;run027
4158;BRB;BBB;0;1;1;1;0;run027
4159;BRB;GGB;1;0;1;1;0;run027
4160;BRB;GGG;0;2;2;2;0;run027
4161;BRB;RBB;1;0;1;0;1;run027
4162;BRR;BBB;0;1;1;0;1;run027
4163;BRR;BRB;0;1;1;1;0;run027
4164;BRR;GBB;1;0;1;0;1;run027
4165;GBB;BBB;1;16;17;0;17;run027
4166;GBB;BBG;0;2;2;0;2;run027
4167;GBB;BGB;0;1;1;0;1;run027
4168;GBB;BGG;0;3;3;1;2;run027
4169;GBB;BRB;0;9;9;3;6;run027
4170;GBB;BRR;0;2;2;2;0;run027
4171;GBB;GBG;1;1;2;0;2;run027
4172;GBB;GGB;2;59;61;40;21;run027
4173;GBB;GGG;4;95;99;23;76;run027
4174;GBB;GGR;0;1;1;1;0;run027
4175;GBB;GRG;0;1;1;0;1;run027
4176;GBB;GRR;1;8;9;3;6;run027
4177;GBB;RBB;0;2;2;0;2;run027
4178;GBB;RBG;0;1;1;1;0;run027
4179;GBB;RBR;1;1;2;1;1;run027
4180;GBB;RGG;0;2;2;2;0;run027
4181;GBB;RGR;0;1;1;0;1;run027
4182;GBB;RRG;0;3;3;0;3;run027
4183;GBG;BRB;0;1;1;1;0;run027
4184;GBG;BRR;0;3;3;0;3;run027
4185;GBG;GGB;0;1;1;1;0;run027
4186;GBG;GGR;0;3;3;0;3;run027
4187;GBG;RBR;0;1;1;0;1;run027
4188;GBG;RGR;1;1;2;1;1;run027
4189;GBG;RRR;0;1;1;0;1;run027
4190;GGB;BBB;1;8;9;2;7;run027
4191;GGB;BBG;0;1;1;0;1;run027
4192;GGB;BGB;0;1;1;0;1;run027
4193;GGB;BRB;3;5;8;6;2;run027
4194;GGB;BRR;0;1;1;0;1;run027
4195;GGB;GBG;0;2;2;1;1;run027
4196;GGB;GGG;4;37;41;2;39;run027
4197;GGB;GGR;0;9;9;4;5;run027
4198;GGB;GRR;1;4;5;2;3;run027
4199;GGB;RBB;0;2;2;2;0;run027
4200;GGB;RBG;0;2;2;2;0;run027
4201;GGB;RBR;0;2;2;1;1;run027
4202;GGB;RGG;0;1;1;1;0;run027
4203;GGB;RGR;1;2;3;3;0;run027
4204;GGB;RRG;1;3;4;3;1;run027
4205;GGB;RRR;0;3;3;0;3;run027
4206;GGG;BBB;4;22;26;18;8;run027
4207;GGG;BBG;0;2;2;2;0;run027
4208;GGG;BBR;0;3;3;2;1;run027
4209;GGG;BGB;0;2;2;2;0;run027
4210;GGG;BGG;0;3;3;3;0;run027
4211;GGG;BRB;0;3;3;3;0;run027
4212;GGG;BRR;0;3;3;0;3;run027
4213;GGG;GBB;0;1;1;0;1;run027
4214;GGG;GGB;1;3;4;4;0;run027
4215;GGG;GGR;0;21;21;21;0;run027
4216;GGG;GRG;0;2;2;0;2;run027
4217;GGG;GRR;2;15;17;9;8;run027
4218;GGG;RBB;0;1;1;0;1;run027
4219;GGG;RBR;1;4;5;4;1;run027
4220;GGG;RGG;1;7;8;4;4;run027
4221;GGG;RGR;0;3;3;3;0;run027
4222;GGG;RRG;0;2;2;0;2;run027
4223;GGG;RRR;0;1;1;1;0;run027
4224;GGR;BBB;0;1;1;1;0;run027
4225;GGR;BGG;0;2;2;2;0;run027
4226;GGR;BRB;0;1;1;1;0;run027
4227;GRG;BBB;0;3;3;3;0;run027
4228;GRG;BGB;0;3;3;0;3;run027
4229;GRG;BGG;0;1;1;0;1;run027
4230;GRG;BRB;0;5;5;4;1;run027
4231;GRG;BRR;0;1;1;0;1;run027
4232;GRG;GBB;0;3;3;2;1;run027
4233;GRG;GGB;0;14;14;13;1;run027
4234;GRG;GGG;0;10;10;7;3;run027
4235;GRG;GGR;0;2;2;0;2;run027
4236;GRG;GRR;0;1;1;1;0;run027
4237;GRG;RBR;1;2;3;1;2;run027
4238;GRG;RGG;0;2;2;2;0;run027
4239;GRG;RGR;0;1;1;0;1;run027
4240;GRR;BBB;0;3;3;0;3;run027
4241;GRR;BBR;0;2;2;1;1;run027
4242;GRR;BRB;1;8;9;3;6;run027
4243;GRR;BRR;1;6;7;0;7;run027
4244;GRR;GBB;0;1;1;0;1;run027
4245;GRR;GBG;0;1;1;0;1;run027
4246;GRR;GGR;1;9;10;5;5;run027
4247;GRR;RBR;0;1;1;0;1;run027
4248;GRR;RGG;1;3;4;4;0;run027
4249;GRR;RGR;0;1;1;0;1;run027
4250;GRR;RRR;0;1;1;0;1;run027
4251;RBB;BBB;0;1;1;0;1;run027
4252;RBB;GGG;0;3;3;2;1;run027
4253;RBG;GRR;0;1;1;0;1;run027
4254;RBG;RBR;0;1;1;1;0;run027
4255;RBG;RGR;0;1;1;0;1;run027
4256;RBR;BBB;0;3;3;2;1;run027
4257;RBR;BRB;0;1;1;1;0;run027
4258;RBR;BRR;0;2;2;0;2;run027
4259;RBR;GGG;0;1;1;0;1;run027
4260;RBR;GGR;1;2;3;3;0;run027
4261;RBR;GRG;0;1;1;1;0;run027
4262;RBR;GRR;1;15;16;8;8;run027
4263;RBR;RGG;0;4;4;2;2;run027
4264;RBR;RGR;0;1;1;1;0;run027
4265;RBR;RRR;0;3;3;0;3;run027
4266;RGG;BGG;0;1;1;0;1;run027
4267;RGG;RGR;0;1;1;1;0;run027
4268;RGR;BBB;0;9;9;2;7;run027
4269;RGR;BBR;0;1;1;0;1;run027
4270;RGR;BGB;1;8;9;4;5;run027
4271;RGR;BRB;0;3;3;0;3;run027
4272;RGR;BRR;0;3;3;1;2;run027
4273;RGR;GBG;0;1;1;1;0;run027
4274;RGR;GGB;0;3;3;3;0;run027
4275;RGR;GGG;0;2;2;2;0;run027
4276;RGR;GGR;0;8;8;1;7;run027
4277;RGR;GRR;1;7;8;3;5;run027
4278;RGR;RGG;0;6;6;6;0;run027
4279;RRG;BGB;0;1;1;0;1;run027
4280;RRG;BRB;0;1;1;1;0;run027
4281;RRG;GGG;0;1;1;0;1;run027
4282;RRG;GGR;0;1;1;0;1;run027
4283;RRG;GRG;0;1;1;0;1;run027
4284;RRG;GRR;0;3;3;0;3;run027
4285;RRG;RBR;0;4;4;1;3;run027
4286;RRG;RGG;0;1;1;0;1;run027
4287;RRG;RGR;6;37;43;34;9;run027
4288;RRR;BRR;0;1;1;0;1;run027
4289;RRR;GGB;0;1;1;0;1;run027
4290;RRR;GGG;1;5;6;3;3;run027
4291;RRR;GGR;0;2;2;1;1;run027
4292;RRR;GRR;0;1;1;1;0;run027
4293;RRR;RGR;0;1;1;0;1;run027
4294;BBB;GRR;0;1;1;0;1;run028
4295;BBG;BBB;1;9;10;0;10;run028
4296;BBG;BBR;0;2;2;0;2;run028
4297;BBG;BGB;0;1;1;0;1;run028
4298;BBG;BGG;0;1;1;1;0;run028
4299;BBG;BRB;0;2;2;1;1;run028
4300;BBG;BRR;0;1;1;0;1;run028
4301;BBG;GBB;1;1;2;2;0;run028
4302;BBG;GBG;1;6;7;0;7;run028
4303;BBG;GGB;0;18;18;18;0;run028
4304;BBG;GGG;1;29;30;24;6;run028
4305;BBG;GGR;0;2;2;0;2;run028
4306;BBG;GRG;0;1;1;0;1;run028
4307;BBG;GRR;0;3;3;3;0;run028
4308;BBG;RBR;0;2;2;0;2;run028
4309;BBG;RGR;0;2;2;2;0;run028
4310;BBG;RRG;1;2;3;0;3;run028
4311;BBG;RRR;0;1;1;1;0;run028
4312;BGG;BBB;0;1;1;1;0;run028
4313;BGG;BRB;0;1;1;1;0;run028
4314;BGG;GGG;0;1;1;0;1;run028
4315;BGG;RBB;0;1;1;1;0;run028
4316;BGG;RBG;1;0;1;0;1;run028
4317;BRB;BBB;0;1;1;1;0;run028
4318;BRB;GGB;1;0;1;0;1;run028
4319;BRB;GGG;0;2;2;2;0;run028
4320;BRB;RBB;1;0;1;0;1;run028
4321;BRR;BBB;0;1;1;0;1;run028
4322;BRR;BRB;0;1;1;0;1;run028
4323;BRR;GBB;1;0;1;1;0;run028
4324;GBB;BBB;1;16;17;5;12;run028
4325;GBB;BBG;0;2;2;2;0;run028
4326;GBB;BGB;0;1;1;1;0;run028
4327;GBB;BGG;0;3;3;2;1;run028
4328;GBB;BRB;0;9;9;7;2;run028
4329;GBB;BRR;0;2;2;1;1;run028
4330;GBB;GBG;1;1;2;0;2;run028
4331;GBB;GGB;2;59;61;49;12;run028
4332;GBB;GGG;4;95;99;7;92;run028
4333;GBB;GGR;0;1;1;1;0;run028
4334;GBB;GRG;0;1;1;0;1;run028
4335;GBB;GRR;1;8;9;9;0;run028
4336;GBB;RBB;0;2;2;1;1;run028
4337;GBB;RBG;0;1;1;1;0;run028
4338;GBB;RBR;1;1;2;0;2;run028
4339;GBB;RGG;0;2;2;2;0;run028
4340;GBB;RGR;0;1;1;1;0;run028
4341;GBB;RRG;0;3;3;0;3;run028
4342;GBG;BRB;0;1;1;0;1;run028
4343;GBG;BRR;0;3;3;1;2;run028
4344;GBG;GGB;0;1;1;0;1;run028
4345;GBG;GGR;0;3;3;2;1;run028
4346;GBG;RBR;0;1;1;0;1;run028
4347;GBG;RGR;1;1;2;2;0;run028
4348;GBG;RRR;0;1;1;1;0;run028
4349;GGB;BBB;1;8;9;7;2;run028
4350;GGB;BBG;0;1;1;1;0;run028
4351;GGB;BGB;0;1;1;0;1;run028
4352;GGB;BRB;3;5;8;2;6;run028
4353;GGB;BRR;0;1;1;1;0;run028
4354;GGB;GBG;0;2;2;2;0;run028
4355;GGB;GGG;4;37;41;7;34;run028
4356;GGB;GGR;0;9;9;9;0;run028
4357;GGB;GRR;1;4;5;1;4;run028
4358;GGB;RBB;0;2;2;1;1;run028
4359;GGB;RBG;0;2;2;2;0;run028
4360;GGB;RBR;0;2;2;0;2;run028
4361;GGB;RGG;0;1;1;1;0;run028
4362;GGB;RGR;1;2;3;3;0;run028
4363;GGB;RRG;1;3;4;4;0;run028
4364;GGB;RRR;0;3;3;2;1;run028
4365;GGG;BBB;4;22;26;9;17;run028
4366;GGG;BBG;0;2;2;2;0;run028
4367;GGG;BBR;0;3;3;3;0;run028
4368;GGG;BGB;0;2;2;1;1;run028
4369;GGG;BGG;0;3;3;1;2;run028
4370;GGG;BRB;0;3;3;0;3;run028
4371;GGG;BRR;0;3;3;2;1;run028
4372;GGG;GBB;0;1;1;0;1;run028
4373;GGG;GGB;1;3;4;2;2;run028
4374;GGG;GGR;0;21;21;13;8;run028
4375;GGG;GRG;0;2;2;0;2;run028
4376;GGG;GRR;2;15;17;1;16;run028
4377;GGG;RBB;0;1;1;1;0;run028
4378;GGG;RBR;1;4;5;2;3;run028
4379;GGG;RGG;1;7;8;5;3;run028
4380;GGG;RGR;0;3;3;3;0;run028
4381;GGG;RRG;0;2;2;1;1;run028
4382;GGG;RRR;0;1;1;1;0;run028
4383;GGR;BBB;0;1;1;1;0;run028
4384;GGR;BGG;0;2;2;2;0;run028
4385;GGR;BRB;0;1;1;1;0;run028
4386;GRG;BBB;0;3;3;0;3;run028
4387;GRG;BGB;0;3;3;1;2;run028
4388;GRG;BGG;0;1;1;0;1;run028
4389;GRG;BRB;0;5;5;4;1;run028
4390;GRG;BRR;0;1;1;0;1;run028
4391;GRG;GBB;0;3;3;3;0;run028
4392;GRG;GGB;0;14;14;4;10;run028
4393;GRG;GGG;0;10;10;7;3;run028
4394;GRG;GGR;0;2;2;1;1;run028
4395;GRG;GRR;0;1;1;0;1;run028
4396;GRG;RBR;1;2;3;3;0;run028
4397;GRG;RGG;0;2;2;2;0;run028
4398;GRG;RGR;0;1;1;1;0;run028
4399;GRR;BBB;0;3;3;0;3;run028
4400;GRR;BBR;0;2;2;1;1;run028
4401;GRR;BRB;1;8;9;2;7;run028
4402;GRR;BRR;1;6;7;4;3;run028
4403;GRR;GBB;0;1;1;1;0;run028
4404;GRR;GBG;0;1;1;0;1;run028
4405;GRR;GGR;1;9;10;2;8;run028
4406;GRR;RBR;0;1;1;0;1;run028
4407;GRR;RGG;1;3;4;3;1;run028
4408;GRR;RGR;0;1;1;1;0;run028
4409;GRR;RRR;0;1;1;1;0;run028
4410;RBB;BBB;0;1;1;0;1;run028
4411;RBB;GGG;0;3;3;3;0;run028
4412;RBG;GRR;0;1;1;0;1;run028
4413;RBG;RBR;0;1;1;1;0;run028
4414;RBG;RGR;0;1;1;1;0;run028
4415;RBR;BBB;0;3;3;0;3;run028
4416;RBR;BRB;0;1;1;1;0;run028
4417;RBR;BRR;0;2;2;0;2;run028
4418;RBR;GGG;0;1;1;0;1;run028
4419;RBR;GGR;1;2;3;3;0;run028
4420;RBR;GRG;0;1;1;1;0;run028
4421;RBR;GRR;1;15;16;9;7;run028
4422;RBR;RGG;0;4;4;1;3;run028
4423;RBR;RGR;0;1;1;1;0;run028
4424;RBR;RRR;0;3;3;2;1;run028
4425;RGG;BGG;0;1;1;0;1;run028
4426;RGG;RGR;0;1;1;0;1;run028
4427;RGR;BBB;0;9;9;9;0;run028
4428;RGR;BBR;0;1;1;1;0;run028
4429;RGR;BGB;1;8;9;8;1;run028
4430;RGR;BRB;0;3;3;2;1;run028
4431;RGR;BRR;0;3;3;2;1;run028
4432;RGR;GBG;0;1;1;1;0;run028
4433;RGR;GGB;0;3;3;2;1;run028
4434;RGR;GGG;0;2;2;2;0;run028
4435;RGR;GGR;0;8;8;7;1;run028
4436;RGR;GRR;1;7;8;0;8;run028
4437;RGR;RGG;0;6;6;6;0;run028
4438;RRG;BGB;0;1;1;1;0;run028
4439;RRG;BRB;0;1;1;1;0;run028
4440;RRG;GGG;0;1;1;1;0;run028
4441;RRG;GGR;0;1;1;0;1;run028
4442;RRG;GRG;0;1;1;1;0;run028
4443;RRG;GRR;0;3;3;0;3;run028
4444;RRG;RBR;0;4;4;0;4;run028
4445;RRG;RGG;0;1;1;0;1;run028
4446;RRG;RGR;6;37;43;29;14;run028
4447;RRR;BRR;0;1;1;0;1;run028
4448;RRR;GGB;0;1;1;0;1;run028
4449;RRR;GGG;1;5;6;4;2;run028
4450;RRR;GGR;0;2;2;2;0;run028
4451;RRR;GRR;0;1;1;1;0;run028
4452;RRR;RGR;0;1;1;0;1;run028
4453;BBB;GRR;0;1;1;0;1;run029
4454;BBG;BBB;1;9;10;9;1;run029
4455;BBG;BBR;0;2;2;1;1;run029
4456;BBG;BGB;0;1;1;0;1;run029
4457;BBG;BGG;0;1;1;0;1;run029
4458;BBG;BRB;0;2;2;2;0;run029
4459;BBG;BRR;0;1;1;1;0;run029
4460;BBG;GBB;1;1;2;1;1;run029
4461;BBG;GBG;1;6;7;0;7;run029
4462;BBG;GGB;0;18;18;7;11;run029
4463;BBG;GGG;1;29;30;25;5;run029
4464;BBG;GGR;0;2;2;1;1;run029
4465;BBG;GRG;0;1;1;1;0;run029
4466;BBG;GRR;0;3;3;3;0;run029
4467;BBG;RBR;0;2;2;1;1;run029
4468;BBG;RGR;0;2;2;1;1;run029
4469;BBG;RRG;1;2;3;2;1;run029
4470;BBG;RRR;0;1;1;0;1;run029
4471;BGG;BBB;0;1;1;1;0;run029
4472;BGG;BRB;0;1;1;0;1;run029
4473;BGG;GGG;0;1;1;0;1;run029
4474;BGG;RBB;0;1;1;0;1;run029
4475;BGG;RBG;1;0;1;0;1;run029
4476;BRB;BBB;0;1;1;1;0;run029
4477;BRB;GGB;1;0;1;1;0;run029
4478;BRB;GGG;0;2;2;0;2;run029
4479;BRB;RBB;1;0;1;0;1;run029
4480;BRR;BBB;0;1;1;0;1;run029
4481;BRR;BRB;0;1;1;1;0;run029
4482;BRR;GBB;1;0;1;0;1;run029
4483;GBB;BBB;1;16;17;0;17;run029
4484;GBB;BBG;0;2;2;2;0;run029
4485;GBB;BGB;0;1;1;0;1;run029
4486;GBB;BGG;0;3;3;2;1;run029
4487;GBB;BRB;0;9;9;2;7;run029
4488;GBB;BRR;0;2;2;0;2;run029
4489;GBB;GBG;1;1;2;0;2;run029
4490;GBB;GGB;2;59;61;31;30;run029
4491;GBB;GGG;4;95;99;30;69;run029
4492;GBB;GGR;0;1;1;1;0;run029
4493;GBB;GRG;0;1;1;1;0;run029
4494;GBB;GRR;1;8;9;8;1;run029
4495;GBB;RBB;0;2;2;2;0;run029
4496;GBB;RBG;0;1;1;1;0;run029
4497;GBB;RBR;1;1;2;0;2;run029
4498;GBB;RGG;0;2;2;2;0;run029
4499;GBB;RGR;0;1;1;1;0;run029
4500;GBB;RRG;0;3;3;1;2;run029
4501;GBG;BRB;0;1;1;1;0;run029
4502;GBG;BRR;0;3;3;3;0;run029
4503;GBG;GGB;0;1;1;0;1;run029
4504;GBG;GGR;0;3;3;1;2;run029
4505;GBG;RBR;0;1;1;0;1;run029
4506;GBG;RGR;1;1;2;0;2;run029
4507;GBG;RRR;0;1;1;0;1;run029
4508;GGB;BBB;1;8;9;3;6;run029
4509;GGB;BBG;0;1;1;0;1;run029
4510;GGB;BGB;0;1;1;1;0;run029
4511;GGB;BRB;3;5;8;1;7;run029
4512;GGB;BRR;0;1;1;1;0;run029
4513;GGB;GBG;0;2;2;2;0;run029
4514;GGB;GGG;4;37;41;11;30;run029
4515;GGB;GGR;0;9;9;9;0;run029
4516;GGB;GRR;1;4;5;3;2;run029
4517;GGB;RBB;0;2;2;1;1;run029
4518;GGB;RBG;0;2;2;2;0;run029
4519;GGB;RBR;0;2;2;2;0;run029
4520;GGB;RGG;0;1;1;0;1;run029
4521;GGB;RGR;1;2;3;1;2;run029
4522;GGB;RRG;1;3;4;0;4;run029
4523;GGB;RRR;0;3;3;2;1;run029
4524;GGG;BBB;4;22;26;25;1;run029
4525;GGG;BBG;0;2;2;2;0;run029
4526;GGG;BBR;0;3;3;2;1;run029
4527;GGG;BGB;0;2;2;1;1;run029
4528;GGG;BGG;0;3;3;1;2;run029
4529;GGG;BRB;0;3;3;2;1;run029
4530;GGG;BRR;0;3;3;1;2;run029
4531;GGG;GBB;0;1;1;1;0;run029
4532;GGG;GGB;1;3;4;0;4;run029
4533;GGG;GGR;0;21;21;8;13;run029
4534;GGG;GRG;0;2;2;0;2;run029
4535;GGG;GRR;2;15;17;4;13;run029
4536;GGG;RBB;0;1;1;1;0;run029
4537;GGG;RBR;1;4;5;3;2;run029
4538;GGG;RGG;1;7;8;8;0;run029
4539;GGG;RGR;0;3;3;2;1;run029
4540;GGG;RRG;0;2;2;0;2;run029
4541;GGG;RRR;0;1;1;0;1;run029
4542;GGR;BBB;0;1;1;1;0;run029
4543;GGR;BGG;0;2;2;2;0;run029
4544;GGR;BRB;0;1;1;1;0;run029
4545;GRG;BBB;0;3;3;3;0;run029
4546;GRG;BGB;0;3;3;1;2;run029
4547;GRG;BGG;0;1;1;0;1;run029
4548;GRG;BRB;0;5;5;3;2;run029
4549;GRG;BRR;0;1;1;1;0;run029
4550;GRG;GBB;0;3;3;2;1;run029
4551;GRG;GGB;0;14;14;7;7;run029
4552;GRG;GGG;0;10;10;6;4;run029
4553;GRG;GGR;0;2;2;2;0;run029
4554;GRG;GRR;0;1;1;1;0;run029
4555;GRG;RBR;1;2;3;2;1;run029
4556;GRG;RGG;0;2;2;1;1;run029
4557;GRG;RGR;0;1;1;0;1;run029
4558;GRR;BBB;0;3;3;2;1;run029
4559;GRR;BBR;0;2;2;2;0;run029
4560;GRR;BRB;1;8;9;4;5;run029
4561;GRR;BRR;1;6;7;3;4;run029
4562;GRR;GBB;0;1;1;0;1;run029
4563;GRR;GBG;0;1;1;1;0;run029
4564;GRR;GGR;1;9;10;9;1;run029
4565;GRR;RBR;0;1;1;1;0;run029
4566;GRR;RGG;1;3;4;1;3;run029
4567;GRR;RGR;0;1;1;1;0;run029
4568;GRR;RRR;0;1;1;0;1;run029
4569;RBB;BBB;0;1;1;0;1;run029
4570;RBB;GGG;0;3;3;3;0;run029
4571;RBG;GRR;0;1;1;0;1;run029
4572;RBG;RBR;0;1;1;1;0;run029
4573;RBG;RGR;0;1;1;1;0;run029
4574;RBR;BBB;0;3;3;2;1;run029
4575;RBR;BRB;0;1;1;0;1;run029
4576;RBR;BRR;0;2;2;2;0;run029
4577;RBR;GGG;0;1;1;1;0;run029
4578;RBR;GGR;1;2;3;1;2;run029
4579;RBR;GRG;0;1;1;0;1;run029
4580;RBR;GRR;1;15;16;10;6;run029
4581;RBR;RGG;0;4;4;1;3;run029
4582;RBR;RGR;0;1;1;1;0;run029
4583;RBR;RRR;0;3;3;0;3;run029
4584;RGG;BGG;0;1;1;0;1;run029
4585;RGG;RGR;0;1;1;1;0;run029
4586;RGR;BBB;0;9;9;1;8;run029
4587;RGR;BBR;0;1;1;0;1;run029
4588;RGR;BGB;1;8;9;6;3;run029
4589;RGR;BRB;0;3;3;1;2;run029
4590;RGR;BRR;0;3;3;0;3;run029
4591;RGR;GBG;0;1;1;0;1;run029
4592;RGR;GGB;0;3;3;0;3;run029
4593;RGR;GGG;0;2;2;0;2;run029
4594;RGR;GGR;0;8;8;3;5;run029
4595;RGR;GRR;1;7;8;6;2;run029
4596;RGR;RGG;0;6;6;1;5;run029
4597;RRG;BGB;0;1;1;0;1;run029
4598;RRG;BRB;0;1;1;1;0;run029
4599;RRG;GGG;0;1;1;1;0;run029
4600;RRG;GGR;0;1;1;1;0;run029
4601;RRG;GRG;0;1;1;0;1;run029
4602;RRG;GRR;0;3;3;3;0;run029
4603;RRG;RBR;0;4;4;3;1;run029
4604;RRG;RGG;0;1;1;0;1;run029
4605;RRG;RGR;6;37;43;22;21;run029
4606;RRR;BRR;0;1;1;0;1;run029
4607;RRR;GGB;0;1;1;0;1;run029
4608;RRR;GGG;1;5;6;3;3;run029
4609;RRR;GGR;0;2;2;1;1;run029
4610;RRR;GRR;0;1;1;1;0;run029
4611;RRR;RGR;0;1;1;0;1;run029
4612;BBB;GRR;0;1;1;1;0;run030
4613;BBG;BBB;1;9;10;1;9;run030
4614;BBG;BBR;0;2;2;1;1;run030
4615;BBG;BGB;0;1;1;0;1;run030
4616;BBG;BGG;0;1;1;1;0;run030
4617;BBG;BRB;0;2;2;1;1;run030
4618;BBG;BRR;0;1;1;0;1;run030
4619;BBG;GBB;1;1;2;1;1;run030
4620;BBG;GBG;1;6;7;4;3;run030
4621;BBG;GGB;0;18;18;18;0;run030
4622;BBG;GGG;1;29;30;3;27;run030
4623;BBG;GGR;0;2;2;0;2;run030
4624;BBG;GRG;0;1;1;0;1;run030
4625;BBG;GRR;0;3;3;3;0;run030
4626;BBG;RBR;0;2;2;1;1;run030
4627;BBG;RGR;0;2;2;0;2;run030
4628;BBG;RRG;1;2;3;1;2;run030
4629;BBG;RRR;0;1;1;0;1;run030
4630;BGG;BBB;0;1;1;1;0;run030
4631;BGG;BRB;0;1;1;0;1;run030
4632;BGG;GGG;0;1;1;1;0;run030
4633;BGG;RBB;0;1;1;1;0;run030
4634;BGG;RBG;1;0;1;0;1;run030
4635;BRB;BBB;0;1;1;0;1;run030
4636;BRB;GGB;1;0;1;0;1;run030
4637;BRB;GGG;0;2;2;0;2;run030
4638;BRB;RBB;1;0;1;0;1;run030
4639;BRR;BBB;0;1;1;0;1;run030
4640;BRR;BRB;0;1;1;1;0;run030
4641;BRR;GBB;1;0;1;0;1;run030
4642;GBB;BBB;1;16;17;15;2;run030
4643;GBB;BBG;0;2;2;0;2;run030
4644;GBB;BGB;0;1;1;0;1;run030
4645;GBB;BGG;0;3;3;1;2;run030
4646;GBB;BRB;0;9;9;8;1;run030
4647;GBB;BRR;0;2;2;2;0;run030
4648;GBB;GBG;1;1;2;1;1;run030
4649;GBB;GGB;2;59;61;18;43;run030
4650;GBB;GGG;4;95;99;49;50;run030
4651;GBB;GGR;0;1;1;0;1;run030
4652;GBB;GRG;0;1;1;1;0;run030
4653;GBB;GRR;1;8;9;2;7;run030
4654;GBB;RBB;0;2;2;2;0;run030
4655;GBB;RBG;0;1;1;0;1;run030
4656;GBB;RBR;1;1;2;2;0;run030
4657;GBB;RGG;0;2;2;0;2;run030
4658;GBB;RGR;0;1;1;1;0;run030
4659;GBB;RRG;0;3;3;1;2;run030
4660;GBG;BRB;0;1;1;1;0;run030
4661;GBG;BRR;0;3;3;2;1;run030
4662;GBG;GGB;0;1;1;1;0;run030
4663;GBG;GGR;0;3;3;0;3;run030
4664;GBG;RBR;0;1;1;0;1;run030
4665;GBG;RGR;1;1;2;2;0;run030
4666;GBG;RRR;0;1;1;0;1;run030
4667;GGB;BBB;1;8;9;9;0;run030
4668;GGB;BBG;0;1;1;1;0;run030
4669;GGB;BGB;0;1;1;1;0;run030
4670;GGB;BRB;3;5;8;1;7;run030
4671;GGB;BRR;0;1;1;1;0;run030
4672;GGB;GBG;0;2;2;0;2;run030
4673;GGB;GGG;4;37;41;1;40;run030
4674;GGB;GGR;0;9;9;2;7;run030
4675;GGB;GRR;1;4;5;4;1;run030
4676;GGB;RBB;0;2;2;1;1;run030
4677;GGB;RBG;0;2;2;2;0;run030
4678;GGB;RBR;0;2;2;1;1;run030
4679;GGB;RGG;0;1;1;0;1;run030
4680;GGB;RGR;1;2;3;0;3;run030
4681;GGB;RRG;1;3;4;0;4;run030
4682;GGB;RRR;0;3;3;0;3;run030
4683;GGG;BBB;4;22;26;26;0;run030
4684;GGG;BBG;0;2;2;2;0;run030
4685;GGG;BBR;0;3;3;1;2;run030
4686;GGG;BGB;0;2;2;2;0;run030
4687;GGG;BGG;0;3;3;1;2;run030
4688;GGG;BRB;0;3;3;1;2;run030
4689;GGG;BRR;0;3;3;1;2;run030
4690;GGG;GBB;0;1;1;1;0;run030
4691;GGG;GGB;1;3;4;4;0;run030
4692;GGG;GGR;0;21;21;9;12;run030
4693;GGG;GRG;0;2;2;0;2;run030
4694;GGG;GRR;2;15;17;14;3;run030
4695;GGG;RBB;0;1;1;0;1;run030
4696;GGG;RBR;1;4;5;4;1;run030
4697;GGG;RGG;1;7;8;5;3;run030
4698;GGG;RGR;0;3;3;2;1;run030
4699;GGG;RRG;0;2;2;0;2;run030
4700;GGG;RRR;0;1;1;1;0;run030
4701;GGR;BBB;0;1;1;0;1;run030
4702;GGR;BGG;0;2;2;0;2;run030
4703;GGR;BRB;0;1;1;1;0;run030
4704;GRG;BBB;0;3;3;1;2;run030
4705;GRG;BGB;0;3;3;3;0;run030
4706;GRG;BGG;0;1;1;1;0;run030
4707;GRG;BRB;0;5;5;0;5;run030
4708;GRG;BRR;0;1;1;1;0;run030
4709;GRG;GBB;0;3;3;2;1;run030
4710;GRG;GGB;0;14;14;2;12;run030
4711;GRG;GGG;0;10;10;0;10;run030
4712;GRG;GGR;0;2;2;0;2;run030
4713;GRG;GRR;0;1;1;0;1;run030
4714;GRG;RBR;1;2;3;1;2;run030
4715;GRG;RGG;0;2;2;1;1;run030
4716;GRG;RGR;0;1;1;0;1;run030
4717;GRR;BBB;0;3;3;2;1;run030
4718;GRR;BBR;0;2;2;0;2;run030
4719;GRR;BRB;1;8;9;5;4;run030
4720;GRR;BRR;1;6;7;3;4;run030
4721;GRR;GBB;0;1;1;1;0;run030
4722;GRR;GBG;0;1;1;0;1;run030
4723;GRR;GGR;1;9;10;8;2;run030
4724;GRR;RBR;0;1;1;1;0;run030
4725;GRR;RGG;1;3;4;3;1;run030
4726;GRR;RGR;0;1;1;1;0;run030
4727;GRR;RRR;0;1;1;1;0;run030
4728;RBB;BBB;0;1;1;0;1;run030
4729;RBB;GGG;0;3;3;2;1;run030
4730;RBG;GRR;0;1;1;1;0;run030
4731;RBG;RBR;0;1;1;0;1;run030
4732;RBG;RGR;0;1;1;0;1;run030
4733;RBR;BBB;0;3;3;1;2;run030
4734;RBR;BRB;0;1;1;0;1;run030
4735;RBR;BRR;0;2;2;1;1;run030
4736;RBR;GGG;0;1;1;0;1;run030
4737;RBR;GGR;1;2;3;2;1;run030
4738;RBR;GRG;0;1;1;0;1;run030
4739;RBR;GRR;1;15;16;8;8;run030
4740;RBR;RGG;0;4;4;2;2;run030
4741;RBR;RGR;0;1;1;1;0;run030
4742;RBR;RRR;0;3;3;1;2;run030
4743;RGG;BGG;0;1;1;1;0;run030
4744;RGG;RGR;0;1;1;1;0;run030
4745;RGR;BBB;0;9;9;8;1;run030
4746;RGR;BBR;0;1;1;1;0;run030
4747;RGR;BGB;1;8;9;6;3;run030
4748;RGR;BRB;0;3;3;1;2;run030
4749;RGR;BRR;0;3;3;3;0;run030
4750;RGR;GBG;0;1;1;1;0;run030
4751;RGR;GGB;0;3;3;1;2;run030
4752;RGR;GGG;0;2;2;0;2;run030
4753;RGR;GGR;0;8;8;2;6;run030
4754;RGR;GRR;1;7;8;6;2;run030
4755;RGR;RGG;0;6;6;0;6;run030
4756;RRG;BGB;0;1;1;1;0;run030
4757;RRG;BRB;0;1;1;0;1;run030
4758;RRG;GGG;0;1;1;0;1;run030
4759;RRG;GGR;0;1;1;1;0;run030
4760;RRG;GRG;0;1;1;1;0;run030
4761;RRG;GRR;0;3;3;0;3;run030
4762;RRG;RBR;0;4;4;2;2;run030
4763;RRG;RGG;0;1;1;0;1;run030
4764;RRG;RGR;6;37;43;12;31;run030
4765;RRR;BRR;0;1;1;1;0;run030
4766;RRR;GGB;0;1;1;0;1;run030
4767;RRR;GGG;1;5;6;0;6;run030
4768;RRR;GGR;0;2;2;0;2;run030
4769;RRR;GRR;0;1;1;1;0;run030
4770;RRR;RGR;0;1;1;1;0;run030
4771;BBB;GRR;0;1;1;0;1;run031
4772;BBG;BBB;1;9;10;0;10;run031
4773;BBG;BBR;0;2;2;2;0;run031
4774;BBG;BGB;0;1;1;1;0;run031
4775;BBG;BGG;0;1;1;1;0;run031
4776;BBG;BRB;0;2;2;2;0;run031
4777;BBG;BRR;0;1;1;0;1;run031
4778;BBG;GBB;1;1;2;2;0;run031
4779;BBG;GBG;1;6;7;5;2;run031
4780;BBG;GGB;0;18;18;8;10;run031
4781;BBG;GGG;1;29;30;10;20;run031
4782;BBG;GGR;0;2;2;0;2;run031
4783;BBG;GRG;0;1;1;0;1;run031
4784;BBG;GRR;0;3;3;1;2;run031
4785;BBG;RBR;0;2;2;1;1;run031
4786;BBG;RGR;0;2;2;1;1;run031
4787;BBG;RRG;1;2;3;0;3;run031
4788;BBG;RRR;0;1;1;1;0;run031
4789;BGG;BBB;0;1;1;1;0;run031
4790;BGG;BRB;0;1;1;0;1;run031
4791;BGG;GGG;0;1;1;0;1;run031
4792;BGG;RBB;0;1;1;1;0;run031
4793;BGG;RBG;1;0;1;1;0;run031
4794;BRB;BBB;0;1;1;0;1;run031
4795;BRB;GGB;1;0;1;0;1;run031
4796;BRB;GGG;0;2;2;2;0;run031
4797;BRB;RBB;1;0;1;1;0;run031
4798;BRR;BBB;0;1;1;1;0;run031
4799;BRR;BRB;0;1;1;1;0;run031
4800;BRR;GBB;1;0;1;1;0;run031
4801;GBB;BBB;1;16;17;6;11;run031
4802;GBB;BBG;0;2;2;1;1;run031
4803;GBB;BGB;0;1;1;1;0;run031
4804;GBB;BGG;0;3;3;1;2;run031
4805;GBB;BRB;0;9;9;4;5;run031
4806;GBB;BRR;0;2;2;1;1;run031
4807;GBB;GBG;1;1;2;2;0;run031
4808;GBB;GGB;2;59;61;56;5;run031
4809;GBB;GGG;4;95;99;98;1;run031
4810;GBB;GGR;0;1;1;1;0;run031
4811;GBB;GRG;0;1;1;1;0;run031
4812;GBB;GRR;1;8;9;4;5;run031
4813;GBB;RBB;0;2;2;1;1;run031
4814;GBB;RBG;0;1;1;1;0;run031
4815;GBB;RBR;1;1;2;2;0;run031
4816;GBB;RGG;0;2;2;2;0;run031
4817;GBB;RGR;0;1;1;1;0;run031
4818;GBB;RRG;0;3;3;3;0;run031
4819;GBG;BRB;0;1;1;1;0;run031
4820;GBG;BRR;0;3;3;0;3;run031
4821;GBG;GGB;0;1;1;0;1;run031
4822;GBG;GGR;0;3;3;2;1;run031
4823;GBG;RBR;0;1;1;1;0;run031
4824;GBG;RGR;1;1;2;0;2;run031
4825;GBG;RRR;0;1;1;1;0;run031
4826;GGB;BBB;1;8;9;1;8;run031
4827;GGB;BBG;0;1;1;0;1;run031
4828;GGB;BGB;0;1;1;1;0;run031
4829;GGB;BRB;3;5;8;4;4;run031
4830;GGB;BRR;0;1;1;0;1;run031
4831;GGB;GBG;0;2;2;0;2;run031
4832;GGB;GGG;4;37;41;26;15;run031
4833;GGB;GGR;0;9;9;3;6;run031
4834;GGB;GRR;1;4;5;4;1;run031
4835;GGB;RBB;0;2;2;2;0;run031
4836;GGB;RBG;0;2;2;2;0;run031
4837;GGB;RBR;0;2;2;0;2;run031
4838;GGB;RGG;0;1;1;1;0;run031
4839;GGB;RGR;1;2;3;3;0;run031
4840;GGB;RRG;1;3;4;4;0;run031
4841;GGB;RRR;0;3;3;0;3;run031
4842;GGG;BBB;4;22;26;4;22;run031
4843;GGG;BBG;0;2;2;2;0;run031
4844;GGG;BBR;0;3;3;1;2;run031
4845;GGG;BGB;0;2;2;0;2;run031
4846;GGG;BGG;0;3;3;0;3;run031
4847;GGG;BRB;0;3;3;0;3;run031
4848;GGG;BRR;0;3;3;0;3;run031
4849;GGG;GBB;0;1;1;1;0;run031
4850;GGG;GGB;1;3;4;4;0;run031
4851;GGG;GGR;0;21;21;1;20;run031
4852;GGG;GRG;0;2;2;2;0;run031
4853;GGG;GRR;2;15;17;10;7;run031
4854;GGG;RBB;0;1;1;0;1;run031
4855;GGG;RBR;1;4;5;1;4;run031
4856;GGG;RGG;1;7;8;4;4;run031
4857;GGG;RGR;0;3;3;0;3;run031
4858;GGG;RRG;0;2;2;1;1;run031
4859;GGG;RRR;0;1;1;1;0;run031
4860;GGR;BBB;0;1;1;0;1;run031
4861;GGR;BGG;0;2;2;1;1;run031
4862;GGR;BRB;0;1;1;1;0;run031
4863;GRG;BBB;0;3;3;0;3;run031
4864;GRG;BGB;0;3;3;1;2;run031
4865;GRG;BGG;0;1;1;0;1;run031
4866;GRG;BRB;0;5;5;2;3;run031
4867;GRG;BRR;0;1;1;0;1;run031
4868;GRG;GBB;0;3;3;0;3;run031
4869;GRG;GGB;0;14;14;12;2;run031
4870;GRG;GGG;0;10;10;3;7;run031
4871;GRG;GGR;0;2;2;0;2;run031
4872;GRG;GRR;0;1;1;0;1;run031
4873;GRG;RBR;1;2;3;1;2;run031
4874;GRG;RGG;0;2;2;1;1;run031
4875;GRG;RGR;0;1;1;1;0;run031
4876;GRR;BBB;0;3;3;3;0;run031
4877;GRR;BBR;0;2;2;1;1;run031
4878;GRR;BRB;1;8;9;7;2;run031
4879;GRR;BRR;1;6;7;5;2;run031
4880;GRR;GBB;0;1;1;0;1;run031
4881;GRR;GBG;0;1;1;0;1;run031
4882;GRR;GGR;1;9;10;2;8;run031
4883;GRR;RBR;0;1;1;0;1;run031
4884;GRR;RGG;1;3;4;1;3;run031
4885;GRR;RGR;0;1;1;1;0;run031
4886;GRR;RRR;0;1;1;0;1;run031
4887;RBB;BBB;0;1;1;1;0;run031
4888;RBB;GGG;0;3;3;0;3;run031
4889;RBG;GRR;0;1;1;0;1;run031
4890;RBG;RBR;0;1;1;1;0;run031
4891;RBG;RGR;0;1;1;1;0;run031
4892;RBR;BBB;0;3;3;3;0;run031
4893;RBR;BRB;0;1;1;1;0;run031
4894;RBR;BRR;0;2;2;2;0;run031
4895;RBR;GGG;0;1;1;1;0;run031
4896;RBR;GGR;1;2;3;2;1;run031
4897;RBR;GRG;0;1;1;0;1;run031
4898;RBR;GRR;1;15;16;13;3;run031
4899;RBR;RGG;0;4;4;2;2;run031
4900;RBR;RGR;0;1;1;0;1;run031
4901;RBR;RRR;0;3;3;0;3;run031
4902;RGG;BGG;0;1;1;0;1;run031
4903;RGG;RGR;0;1;1;0;1;run031
4904;RGR;BBB;0;9;9;0;9;run031
4905;RGR;BBR;0;1;1;1;0;run031
4906;RGR;BGB;1;8;9;8;1;run031
4907;RGR;BRB;0;3;3;1;2;run031
4908;RGR;BRR;0;3;3;1;2;run031
4909;RGR;GBG;0;1;1;0;1;run031
4910;RGR;GGB;0;3;3;3;0;run031
4911;RGR;GGG;0;2;2;2;0;run031
4912;RGR;GGR;0;8;8;2;6;run031
4913;RGR;GRR;1;7;8;8;0;run031
4914;RGR;RGG;0;6;6;2;4;run031
4915;RRG;BGB;0;1;1;0;1;run031
4916;RRG;BRB;0;1;1;0;1;run031
4917;RRG;GGG;0;1;1;1;0;run031
4918;RRG;GGR;0;1;1;0;1;run031
4919;RRG;GRG;0;1;1;1;0;run031
4920;RRG;GRR;0;3;3;1;2;run031
4921;RRG;RBR;0;4;4;0;4;run031
4922;RRG;RGG;0;1;1;1;0;run031
4923;RRG;RGR;6;37;43;26;17;run031
4924;RRR;BRR;0;1;1;1;0;run031
4925;RRR;GGB;0;1;1;1;0;run031
4926;RRR;GGG;1;5;6;5;1;run031
4927;RRR;GGR;0;2;2;0;2;run031
4928;RRR;GRR;0;1;1;0;1;run031
4929;RRR;RGR;0;1;1;1;0;run031
4930;BBB;GRR;0;1;1;0;1;run032
4931;BBG;BBB;1;9;10;5;5;run032
4932;BBG;BBR;0;2;2;2;0;run032
4933;BBG;BGB;0;1;1;1;0;run032
4934;BBG;BGG;0;1;1;0;1;run032
4935;BBG;BRB;0;2;2;0;2;run032
4936;BBG;BRR;0;1;1;1;0;run032
4937;BBG;GBB;1;1;2;0;2;run032
4938;BBG;GBG;1;6;7;6;1;run032
4939;BBG;GGB;0;18;18;18;0;run032
4940;BBG;GGG;1;29;30;5;25;run032
4941;BBG;GGR;0;2;2;0;2;run032
4942;BBG;GRG;0;1;1;1;0;run032
4943;BBG;GRR;0;3;3;2;1;run032
4944;BBG;RBR;0;2;2;1;1;run032
4945;BBG;RGR;0;2;2;0;2;run032
4946;BBG;RRG;1;2;3;2;1;run032
4947;BBG;RRR;0;1;1;0;1;run032
4948;BGG;BBB;0;1;1;0;1;run032
4949;BGG;BRB;0;1;1;1;0;run032
4950;BGG;GGG;0;1;1;0;1;run032
4951;BGG;RBB;0;1;1;1;0;run032
4952;BGG;RBG;1;0;1;1;0;run032
4953;BRB;BBB;0;1;1;0;1;run032
4954;BRB;GGB;1;0;1;0;1;run032
4955;BRB;GGG;0;2;2;0;2;run032
4956;BRB;RBB;1;0;1;0;1;run032
4957;BRR;BBB;0;1;1;1;0;run032
4958;BRR;BRB;0;1;1;0;1;run032
4959;BRR;GBB;1;0;1;1;0;run032
4960;GBB;BBB;1;16;17;14;3;run032
4961;GBB;BBG;0;2;2;1;1;run032
4962;GBB;BGB;0;1;1;1;0;run032
4963;GBB;BGG;0;3;3;0;3;run032
4964;GBB;BRB;0;9;9;4;5;run032
4965;GBB;BRR;0;2;2;1;1;run032
4966;GBB;GBG;1;1;2;0;2;run032
4967;GBB;GGB;2;59;61;35;26;run032
4968;GBB;GGG;4;95;99;22;77;run032
4969;GBB;GGR;0;1;1;1;0;run032
4970;GBB;GRG;0;1;1;1;0;run032
4971;GBB;GRR;1;8;9;0;9;run032
4972;GBB;RBB;0;2;2;0;2;run032
4973;GBB;RBG;0;1;1;1;0;run032
4974;GBB;RBR;1;1;2;0;2;run032
4975;GBB;RGG;0;2;2;1;1;run032
4976;GBB;RGR;0;1;1;0;1;run032
4977;GBB;RRG;0;3;3;1;2;run032
4978;GBG;BRB;0;1;1;0;1;run032
4979;GBG;BRR;0;3;3;3;0;run032
4980;GBG;GGB;0;1;1;0;1;run032
4981;GBG;GGR;0;3;3;0;3;run032
4982;GBG;RBR;0;1;1;0;1;run032
4983;GBG;RGR;1;1;2;0;2;run032
4984;GBG;RRR;0;1;1;1;0;run032
4985;GGB;BBB;1;8;9;1;8;run032
4986;GGB;BBG;0;1;1;1;0;run032
4987;GGB;BGB;0;1;1;0;1;run032
4988;GGB;BRB;3;5;8;3;5;run032
4989;GGB;BRR;0;1;1;1;0;run032
4990;GGB;GBG;0;2;2;0;2;run032
4991;GGB;GGG;4;37;41;18;23;run032
4992;GGB;GGR;0;9;9;5;4;run032
4993;GGB;GRR;1;4;5;1;4;run032
4994;GGB;RBB;0;2;2;0;2;run032
4995;GGB;RBG;0;2;2;1;1;run032
4996;GGB;RBR;0;2;2;2;0;run032
4997;GGB;RGG;0;1;1;1;0;run032
4998;GGB;RGR;1;2;3;1;2;run032
4999;GGB;RRG;1;3;4;3;1;run032
5000;GGB;RRR;0;3;3;1;2;run032
5001;GGG;BBB;4;22;26;14;12;run032
5002;GGG;BBG;0;2;2;2;0;run032
5003;GGG;BBR;0;3;3;1;2;run032
5004;GGG;BGB;0;2;2;0;2;run032
5005;GGG;BGG;0;3;3;2;1;run032
5006;GGG;BRB;0;3;3;3;0;run032
5007;GGG;BRR;0;3;3;0;3;run032
5008;GGG;GBB;0;1;1;0;1;run032
5009;GGG;GGB;1;3;4;1;3;run032
5010;GGG;GGR;0;21;21;8;13;run032
5011;GGG;GRG;0;2;2;0;2;run032
5012;GGG;GRR;2;15;17;9;8;run032
5013;GGG;RBB;0;1;1;1;0;run032
5014;GGG;RBR;1;4;5;4;1;run032
5015;GGG;RGG;1;7;8;4;4;run032
5016;GGG;RGR;0;3;3;0;3;run032
5017;GGG;RRG;0;2;2;2;0;run032
5018;GGG;RRR;0;1;1;1;0;run032
5019;GGR;BBB;0;1;1;1;0;run032
5020;GGR;BGG;0;2;2;0;2;run032
5021;GGR;BRB;0;1;1;1;0;run032
5022;GRG;BBB;0;3;3;0;3;run032
5023;GRG;BGB;0;3;3;3;0;run032
5024;GRG;BGG;0;1;1;0;1;run032
5025;GRG;BRB;0;5;5;1;4;run032
5026;GRG;BRR;0;1;1;1;0;run032
5027;GRG;GBB;0;3;3;2;1;run032
5028;GRG;GGB;0;14;14;11;3;run032
5029;GRG;GGG;0;10;10;4;6;run032
5030;GRG;GGR;0;2;2;2;0;run032
5031;GRG;GRR;0;1;1;0;1;run032
5032;GRG;RBR;1;2;3;1;2;run032
5033;GRG;RGG;0;2;2;0;2;run032
5034;GRG;RGR;0;1;1;1;0;run032
5035;GRR;BBB;0;3;3;0;3;run032
5036;GRR;BBR;0;2;2;0;2;run032
5037;GRR;BRB;1;8;9;8;1;run032
5038;GRR;BRR;1;6;7;6;1;run032
5039;GRR;GBB;0;1;1;1;0;run032
5040;GRR;GBG;0;1;1;1;0;run032
5041;GRR;GGR;1;9;10;0;10;run032
5042;GRR;RBR;0;1;1;0;1;run032
5043;GRR;RGG;1;3;4;4;0;run032
5044;GRR;RGR;0;1;1;0;1;run032
5045;GRR;RRR;0;1;1;1;0;run032
5046;RBB;BBB;0;1;1;1;0;run032
5047;RBB;GGG;0;3;3;2;1;run032
5048;RBG;GRR;0;1;1;0;1;run032
5049;RBG;RBR;0;1;1;0;1;run032
5050;RBG;RGR;0;1;1;1;0;run032
5051;RBR;BBB;0;3;3;1;2;run032
5052;RBR;BRB;0;1;1;1;0;run032
5053;RBR;BRR;0;2;2;2;0;run032
5054;RBR;GGG;0;1;1;0;1;run032
5055;RBR;GGR;1;2;3;1;2;run032
5056;RBR;GRG;0;1;1;0;1;run032
5057;RBR;GRR;1;15;16;5;11;run032
5058;RBR;RGG;0;4;4;3;1;run032
5059;RBR;RGR;0;1;1;0;1;run032
5060;RBR;RRR;0;3;3;3;0;run032
5061;RGG;BGG;0;1;1;0;1;run032
5062;RGG;RGR;0;1;1;0;1;run032
5063;RGR;BBB;0;9;9;5;4;run032
5064;RGR;BBR;0;1;1;1;0;run032
5065;RGR;BGB;1;8;9;2;7;run032
5066;RGR;BRB;0;3;3;3;0;run032
5067;RGR;BRR;0;3;3;1;2;run032
5068;RGR;GBG;0;1;1;1;0;run032
5069;RGR;GGB;0;3;3;1;2;run032
5070;RGR;GGG;0;2;2;2;0;run032
5071;RGR;GGR;0;8;8;8;0;run032
5072;RGR;GRR;1;7;8;7;1;run032
5073;RGR;RGG;0;6;6;4;2;run032
5074;RRG;BGB;0;1;1;0;1;run032
5075;RRG;BRB;0;1;1;0;1;run032
5076;RRG;GGG;0;1;1;0;1;run032
5077;RRG;GGR;0;1;1;1;0;run032
5078;RRG;GRG;0;1;1;0;1;run032
5079;RRG;GRR;0;3;3;3;0;run032
5080;RRG;RBR;0;4;4;3;1;run032
5081;RRG;RGG;0;1;1;0;1;run032
5082;RRG;RGR;6;37;43;8;35;run032
5083;RRR;BRR;0;1;1;0;1;run032
5084;RRR;GGB;0;1;1;0;1;run032
5085;RRR;GGG;1;5;6;0;6;run032
5086;RRR;GGR;0;2;2;1;1;run032
5087;RRR;GRR;0;1;1;1;0;run032
5088;RRR;RGR;0;1;1;1;0;run032
5089;BBB;GRR;0;1;1;1;0;run033
5090;BBG;BBB;1;9;10;7;3;run033
5091;BBG;BBR;0;2;2;1;1;run033
5092;BBG;BGB;0;1;1;1;0;run033
5093;BBG;BGG;0;1;1;0;1;run033
5094;BBG;BRB;0;2;2;1;1;run033
5095;BBG;BRR;0;1;1;1;0;run033
5096;BBG;GBB;1;1;2;0;2;run033
5097;BBG;GBG;1;6;7;4;3;run033
5098;BBG;GGB;0;18;18;4;14;run033
5099;BBG;GGG;1;29;30;15;15;run033
5100;BBG;GGR;0;2;2;0;2;run033
5101;BBG;GRG;0;1;1;0;1;run033
5102;BBG;GRR;0;3;3;1;2;run033
5103;BBG;RBR;0;2;2;1;1;run033
5104;BBG;RGR;0;2;2;1;1;run033
5105;BBG;RRG;1;2;3;1;2;run033
5106;BBG;RRR;0;1;1;1;0;run033
5107;BGG;BBB;0;1;1;0;1;run033
5108;BGG;BRB;0;1;1;0;1;run033
5109;BGG;GGG;0;1;1;1;0;run033
5110;BGG;RBB;0;1;1;1;0;run033
5111;BGG;RBG;1;0;1;1;0;run033
5112;BRB;BBB;0;1;1;0;1;run033
5113;BRB;GGB;1;0;1;0;1;run033
5114;BRB;GGG;0;2;2;2;0;run033
5115;BRB;RBB;1;0;1;0;1;run033
5116;BRR;BBB;0;1;1;1;0;run033
5117;BRR;BRB;0;1;1;1;0;run033
5118;BRR;GBB;1;0;1;0;1;run033
5119;GBB;BBB;1;16;17;16;1;run033
5120;GBB;BBG;0;2;2;2;0;run033
5121;GBB;BGB;0;1;1;1;0;run033
5122;GBB;BGG;0;3;3;2;1;run033
5123;GBB;BRB;0;9;9;0;9;run033
5124;GBB;BRR;0;2;2;0;2;run033
5125;GBB;GBG;1;1;2;1;1;run033
5126;GBB;GGB;2;59;61;14;47;run033
5127;GBB;GGG;4;95;99;78;21;run033
5128;GBB;GGR;0;1;1;1;0;run033
5129;GBB;GRG;0;1;1;0;1;run033
5130;GBB;GRR;1;8;9;2;7;run033
5131;GBB;RBB;0;2;2;1;1;run033
5132;GBB;RBG;0;1;1;1;0;run033
5133;GBB;RBR;1;1;2;0;2;run033
5134;GBB;RGG;0;2;2;1;1;run033
5135;GBB;RGR;0;1;1;1;0;run033
5136;GBB;RRG;0;3;3;0;3;run033
5137;GBG;BRB;0;1;1;0;1;run033
5138;GBG;BRR;0;3;3;2;1;run033
5139;GBG;GGB;0;1;1;1;0;run033
5140;GBG;GGR;0;3;3;2;1;run033
5141;GBG;RBR;0;1;1;0;1;run033
5142;GBG;RGR;1;1;2;0;2;run033
5143;GBG;RRR;0;1;1;1;0;run033
5144;GGB;BBB;1;8;9;3;6;run033
5145;GGB;BBG;0;1;1;0;1;run033
5146;GGB;BGB;0;1;1;0;1;run033
5147;GGB;BRB;3;5;8;3;5;run033
5148;GGB;BRR;0;1;1;1;0;run033
5149;GGB;GBG;0;2;2;2;0;run033
5150;GGB;GGG;4;37;41;4;37;run033
5151;GGB;GGR;0;9;9;4;5;run033
5152;GGB;GRR;1;4;5;2;3;run033
5153;GGB;RBB;0;2;2;1;1;run033
5154;GGB;RBG;0;2;2;0;2;run033
5155;GGB;RBR;0;2;2;1;1;run033
5156;GGB;RGG;0;1;1;1;0;run033
5157;GGB;RGR;1;2;3;3;0;run033
5158;GGB;RRG;1;3;4;0;4;run033
5159;GGB;RRR;0;3;3;2;1;run033
5160;GGG;BBB;4;22;26;8;18;run033
5161;GGG;BBG;0;2;2;0;2;run033
5162;GGG;BBR;0;3;3;2;1;run033
5163;GGG;BGB;0;2;2;2;0;run033
5164;GGG;BGG;0;3;3;2;1;run033
5165;GGG;BRB;0;3;3;3;0;run033
5166;GGG;BRR;0;3;3;1;2;run033
5167;GGG;GBB;0;1;1;0;1;run033
5168;GGG;GGB;1;3;4;3;1;run033
5169;GGG;GGR;0;21;21;3;18;run033
5170;GGG;GRG;0;2;2;1;1;run033
5171;GGG;GRR;2;15;17;11;6;run033
5172;GGG;RBB;0;1;1;0;1;run033
5173;GGG;RBR;1;4;5;0;5;run033
5174;GGG;RGG;1;7;8;7;1;run033
5175;GGG;RGR;0;3;3;1;2;run033
5176;GGG;RRG;0;2;2;0;2;run033
5177;GGG;RRR;0;1;1;1;0;run033
5178;GGR;BBB;0;1;1;1;0;run033
5179;GGR;BGG;0;2;2;1;1;run033
5180;GGR;BRB;0;1;1;1;0;run033
5181;GRG;BBB;0;3;3;1;2;run033
5182;GRG;BGB;0;3;3;2;1;run033
5183;GRG;BGG;0;1;1;0;1;run033
5184;GRG;BRB;0;5;5;0;5;run033
5185;GRG;BRR;0;1;1;0;1;run033
5186;GRG;GBB;0;3;3;2;1;run033
5187;GRG;GGB;0;14;14;4;10;run033
5188;GRG;GGG;0;10;10;7;3;run033
5189;GRG;GGR;0;2;2;2;0;run033
5190;GRG;GRR;0;1;1;0;1;run033
5191;GRG;RBR;1;2;3;2;1;run033
5192;GRG;RGG;0;2;2;2;0;run033
5193;GRG;RGR;0;1;1;0;1;run033
5194;GRR;BBB;0;3;3;3;0;run033
5195;GRR;BBR;0;2;2;1;1;run033
5196;GRR;BRB;1;8;9;6;3;run033
5197;GRR;BRR;1;6;7;1;6;run033
5198;GRR;GBB;0;1;1;1;0;run033
5199;GRR;GBG;0;1;1;1;0;run033
5200;GRR;GGR;1;9;10;3;7;run033
5201;GRR;RBR;0;1;1;0;1;run033
5202;GRR;RGG;1;3;4;3;1;run033
5203;GRR;RGR;0;1;1;1;0;run033
5204;GRR;RRR;0;1;1;1;0;run033
5205;RBB;BBB;0;1;1;0;1;run033
5206;RBB;GGG;0;3;3;2;1;run033
5207;RBG;GRR;0;1;1;1;0;run033
5208;RBG;RBR;0;1;1;0;1;run033
5209;RBG;RGR;0;1;1;1;0;run033
5210;RBR;BBB;0;3;3;2;1;run033
5211;RBR;BRB;0;1;1;0;1;run033
5212;RBR;BRR;0;2;2;0;2;run033
5213;RBR;GGG;0;1;1;0;1;run033
5214;RBR;GGR;1;2;3;1;2;run033
5215;RBR;GRG;0;1;1;1;0;run033
5216;RBR;GRR;1;15;16;8;8;run033
5217;RBR;RGG;0;4;4;2;2;run033
5218;RBR;RGR;0;1;1;0;1;run033
5219;RBR;RRR;0;3;3;1;2;run033
5220;RGG;BGG;0;1;1;1;0;run033
5221;RGG;RGR;0;1;1;0;1;run033
5222;RGR;BBB;0;9;9;8;1;run033
5223;RGR;BBR;0;1;1;1;0;run033
5224;RGR;BGB;1;8;9;6;3;run033
5225;RGR;BRB;0;3;3;2;1;run033
5226;RGR;BRR;0;3;3;2;1;run033
5227;RGR;GBG;0;1;1;1;0;run033
5228;RGR;GGB;0;3;3;3;0;run033
5229;RGR;GGG;0;2;2;1;1;run033
5230;RGR;GGR;0;8;8;2;6;run033
5231;RGR;GRR;1;7;8;6;2;run033
5232;RGR;RGG;0;6;6;3;3;run033
5233;RRG;BGB;0;1;1;0;1;run033
5234;RRG;BRB;0;1;1;0;1;run033
5235;RRG;GGG;0;1;1;0;1;run033
5236;RRG;GGR;0;1;1;1;0;run033
5237;RRG;GRG;0;1;1;0;1;run033
5238;RRG;GRR;0;3;3;0;3;run033
5239;RRG;RBR;0;4;4;3;1;run033
5240;RRG;RGG;0;1;1;0;1;run033
5241;RRG;RGR;6;37;43;3;40;run033
5242;RRR;BRR;0;1;1;1;0;run033
5243;RRR;GGB;0;1;1;1;0;run033
5244;RRR;GGG;1;5;6;0;6;run033
5245;RRR;GGR;0;2;2;1;1;run033
5246;RRR;GRR;0;1;1;1;0;run033
5247;RRR;RGR;0;1;1;1;0;run033
5248;BBB;GRR;0;1;1;0;1;run034
5249;BBG;BBB;1;9;10;0;10;run034
5250;BBG;BBR;0;2;2;0;2;run034
5251;BBG;BGB;0;1;1;1;0;run034
5252;BBG;BGG;0;1;1;1;0;run034
5253;BBG;BRB;0;2;2;1;1;run034
5254;BBG;BRR;0;1;1;1;0;run034
5255;BBG;GBB;1;1;2;0;2;run034
5256;BBG;GBG;1;6;7;2;5;run034
5257;BBG;GGB;0;18;18;15;3;run034
5258;BBG;GGG;1;29;30;27;3;run034
5259;BBG;GGR;0;2;2;2;0;run034
5260;BBG;GRG;0;1;1;0;1;run034
5261;BBG;GRR;0;3;3;0;3;run034
5262;BBG;RBR;0;2;2;2;0;run034
5263;BBG;RGR;0;2;2;0;2;run034
5264;BBG;RRG;1;2;3;2;1;run034
5265;BBG;RRR;0;1;1;1;0;run034
5266;BGG;BBB;0;1;1;0;1;run034
5267;BGG;BRB;0;1;1;1;0;run034
5268;BGG;GGG;0;1;1;0;1;run034
5269;BGG;RBB;0;1;1;1;0;run034
5270;BGG;RBG;1;0;1;0;1;run034
5271;BRB;BBB;0;1;1;1;0;run034
5272;BRB;GGB;1;0;1;0;1;run034
5273;BRB;GGG;0;2;2;2;0;run034
5274;BRB;RBB;1;0;1;0;1;run034
5275;BRR;BBB;0;1;1;0;1;run034
5276;BRR;BRB;0;1;1;0;1;run034
5277;BRR;GBB;1;0;1;1;0;run034
5278;GBB;BBB;1;16;17;8;9;run034
5279;GBB;BBG;0;2;2;2;0;run034
5280;GBB;BGB;0;1;1;1;0;run034
5281;GBB;BGG;0;3;3;0;3;run034
5282;GBB;BRB;0;9;9;3;6;run034
5283;GBB;BRR;0;2;2;0;2;run034
5284;GBB;GBG;1;1;2;0;2;run034
5285;GBB;GGB;2;59;61;17;44;run034
5286;GBB;GGG;4;95;99;93;6;run034
5287;GBB;GGR;0;1;1;1;0;run034
5288;GBB;GRG;0;1;1;0;1;run034
5289;GBB;GRR;1;8;9;8;1;run034
5290;GBB;RBB;0;2;2;1;1;run034
5291;GBB;RBG;0;1;1;1;0;run034
5292;GBB;RBR;1;1;2;0;2;run034
5293;GBB;RGG;0;2;2;0;2;run034
5294;GBB;RGR;0;1;1;1;0;run034
5295;GBB;RRG;0;3;3;2;1;run034
5296;GBG;BRB;0;1;1;1;0;run034
5297;GBG;BRR;0;3;3;1;2;run034
5298;GBG;GGB;0;1;1;1;0;run034
5299;GBG;GGR;0;3;3;3;0;run034
5300;GBG;RBR;0;1;1;1;0;run034
5301;GBG;RGR;1;1;2;1;1;run034
5302;GBG;RRR;0;1;1;0;1;run034
5303;GGB;BBB;1;8;9;4;5;run034
5304;GGB;BBG;0;1;1;0;1;run034
5305;GGB;BGB;0;1;1;1;0;run034
5306;GGB;BRB;3;5;8;4;4;run034
5307;GGB;BRR;0;1;1;0;1;run034
5308;GGB;GBG;0;2;2;2;0;run034
5309;GGB;GGG;4;37;41;34;7;run034
5310;GGB;GGR;0;9;9;0;9;run034
5311;GGB;GRR;1;4;5;4;1;run034
5312;GGB;RBB;0;2;2;0;2;run034
5313;GGB;RBG;0;2;2;1;1;run034
5314;GGB;RBR;0;2;2;1;1;run034
5315;GGB;RGG;0;1;1;0;1;run034
5316;GGB;RGR;1;2;3;1;2;run034
5317;GGB;RRG;1;3;4;1;3;run034
5318;GGB;RRR;0;3;3;2;1;run034
5319;GGG;BBB;4;22;26;12;14;run034
5320;GGG;BBG;0;2;2;0;2;run034
5321;GGG;BBR;0;3;3;0;3;run034
5322;GGG;BGB;0;2;2;0;2;run034
5323;GGG;BGG;0;3;3;3;0;run034
5324;GGG;BRB;0;3;3;3;0;run034
5325;GGG;BRR;0;3;3;3;0;run034
5326;GGG;GBB;0;1;1;0;1;run034
5327;GGG;GGB;1;3;4;3;1;run034
5328;GGG;GGR;0;21;21;7;14;run034
5329;GGG;GRG;0;2;2;0;2;run034
5330;GGG;GRR;2;15;17;10;7;run034
5331;GGG;RBB;0;1;1;1;0;run034
5332;GGG;RBR;1;4;5;3;2;run034
5333;GGG;RGG;1;7;8;5;3;run034
5334;GGG;RGR;0;3;3;1;2;run034
5335;GGG;RRG;0;2;2;2;0;run034
5336;GGG;RRR;0;1;1;1;0;run034
5337;GGR;BBB;0;1;1;1;0;run034
5338;GGR;BGG;0;2;2;2;0;run034
5339;GGR;BRB;0;1;1;0;1;run034
5340;GRG;BBB;0;3;3;3;0;run034
5341;GRG;BGB;0;3;3;0;3;run034
5342;GRG;BGG;0;1;1;1;0;run034
5343;GRG;BRB;0;5;5;1;4;run034
5344;GRG;BRR;0;1;1;0;1;run034
5345;GRG;GBB;0;3;3;1;2;run034
5346;GRG;GGB;0;14;14;3;11;run034
5347;GRG;GGG;0;10;10;10;0;run034
5348;GRG;GGR;0;2;2;1;1;run034
5349;GRG;GRR;0;1;1;0;1;run034
5350;GRG;RBR;1;2;3;1;2;run034
5351;GRG;RGG;0;2;2;1;1;run034
5352;GRG;RGR;0;1;1;1;0;run034
5353;GRR;BBB;0;3;3;1;2;run034
5354;GRR;BBR;0;2;2;0;2;run034
5355;GRR;BRB;1;8;9;8;1;run034
5356;GRR;BRR;1;6;7;1;6;run034
5357;GRR;GBB;0;1;1;1;0;run034
5358;GRR;GBG;0;1;1;0;1;run034
5359;GRR;GGR;1;9;10;5;5;run034
5360;GRR;RBR;0;1;1;0;1;run034
5361;GRR;RGG;1;3;4;4;0;run034
5362;GRR;RGR;0;1;1;1;0;run034
5363;GRR;RRR;0;1;1;1;0;run034
5364;RBB;BBB;0;1;1;0;1;run034
5365;RBB;GGG;0;3;3;3;0;run034
5366;RBG;GRR;0;1;1;0;1;run034
5367;RBG;RBR;0;1;1;1;0;run034
5368;RBG;RGR;0;1;1;1;0;run034
5369;RBR;BBB;0;3;3;0;3;run034
5370;RBR;BRB;0;1;1;1;0;run034
5371;RBR;BRR;0;2;2;1;1;run034
5372;RBR;GGG;0;1;1;0;1;run034
5373;RBR;GGR;1;2;3;2;1;run034
5374;RBR;GRG;0;1;1;1;0;run034
5375;RBR;GRR;1;15;16;8;8;run034
5376;RBR;RGG;0;4;4;1;3;run034
5377;RBR;RGR;0;1;1;0;1;run034
5378;RBR;RRR;0;3;3;2;1;run034
5379;RGG;BGG;0;1;1;1;0;run034
5380;RGG;RGR;0;1;1;1;0;run034
5381;RGR;BBB;0;9;9;8;1;run034
5382;RGR;BBR;0;1;1;0;1;run034
5383;RGR;BGB;1;8;9;8;1;run034
5384;RGR;BRB;0;3;3;1;2;run034
5385;RGR;BRR;0;3;3;0;3;run034
5386;RGR;GBG;0;1;1;1;0;run034
5387;RGR;GGB;0;3;3;2;1;run034
5388;RGR;GGG;0;2;2;0;2;run034
5389;RGR;GGR;0;8;8;7;1;run034
5390;RGR;GRR;1;7;8;6;2;run034
5391;RGR;RGG;0;6;6;4;2;run034
5392;RRG;BGB;0;1;1;1;0;run034
5393;RRG;BRB;0;1;1;1;0;run034
5394;RRG;GGG;0;1;1;1;0;run034
5395;RRG;GGR;0;1;1;0;1;run034
5396;RRG;GRG;0;1;1;1;0;run034
5397;RRG;GRR;0;3;3;3;0;run034
5398;RRG;RBR;0;4;4;1;3;run034
5399;RRG;RGG;0;1;1;1;0;run034
5400;RRG;RGR;6;37;43;26;17;run034
5401;RRR;BRR;0;1;1;0;1;run034
5402;RRR;GGB;0;1;1;0;1;run034
5403;RRR;GGG;1;5;6;1;5;run034
5404;RRR;GGR;0;2;2;1;1;run034
5405;RRR;GRR;0;1;1;1;0;run034
5406;RRR;RGR;0;1;1;1;0;run034
5407;BBB;GRR;0;1;1;1;0;run035
5408;BBG;BBB;1;9;10;5;5;run035
5409;BBG;BBR;0;2;2;0;2;run035
5410;BBG;BGB;0;1;1;0;1;run035
5411;BBG;BGG;0;1;1;0;1;run035
5412;BBG;BRB;0;2;2;0;2;run035
5413;BBG;BRR;0;1;1;1;0;run035
5414;BBG;GBB;1;1;2;0;2;run035
5415;BBG;GBG;1;6;7;1;6;run035
5416;BBG;GGB;0;18;18;1;17;run035
5417;BBG;GGG;1;29;30;8;22;run035
5418;BBG;GGR;0;2;2;1;1;run035
5419;BBG;GRG;0;1;1;0;1;run035
5420;BBG;GRR;0;3;3;0;3;run035
5421;BBG;RBR;0;2;2;2;0;run035
5422;BBG;RGR;0;2;2;0;2;run035
5423;BBG;RRG;1;2;3;0;3;run035
5424;BBG;RRR;0;1;1;0;1;run035
5425;BGG;BBB;0;1;1;1;0;run035
5426;BGG;BRB;0;1;1;0;1;run035
5427;BGG;GGG;0;1;1;1;0;run035
5428;BGG;RBB;0;1;1;0;1;run035
5429;BGG;RBG;1;0;1;0;1;run035
5430;BRB;BBB;0;1;1;0;1;run035
5431;BRB;GGB;1;0;1;0;1;run035
5432;BRB;GGG;0;2;2;2;0;run035
5433;BRB;RBB;1;0;1;1;0;run035
5434;BRR;BBB;0;1;1;0;1;run035
5435;BRR;BRB;0;1;1;1;0;run035
5436;BRR;GBB;1;0;1;1;0;run035
5437;GBB;BBB;1;16;17;8;9;run035
5438;GBB;BBG;0;2;2;0;2;run035
5439;GBB;BGB;0;1;1;1;0;run035
5440;GBB;BGG;0;3;3;3;0;run035
5441;GBB;BRB;0;9;9;8;1;run035
5442;GBB;BRR;0;2;2;1;1;run035
5443;GBB;GBG;1;1;2;2;0;run035
5444;GBB;GGB;2;59;61;4;57;run035
5445;GBB;GGG;4;95;99;41;58;run035
5446;GBB;GGR;0;1;1;0;1;run035
5447;GBB;GRG;0;1;1;0;1;run035
5448;GBB;GRR;1;8;9;5;4;run035
5449;GBB;RBB;0;2;2;1;1;run035
5450;GBB;RBG;0;1;1;0;1;run035
5451;GBB;RBR;1;1;2;2;0;run035
5452;GBB;RGG;0;2;2;2;0;run035
5453;GBB;RGR;0;1;1;1;0;run035
5454;GBB;RRG;0;3;3;1;2;run035
5455;GBG;BRB;0;1;1;1;0;run035
5456;GBG;BRR;0;3;3;0;3;run035
5457;GBG;GGB;0;1;1;0;1;run035
5458;GBG;GGR;0;3;3;2;1;run035
5459;GBG;RBR;0;1;1;1;0;run035
5460;GBG;RGR;1;1;2;2;0;run035
5461;GBG;RRR;0;1;1;0;1;run035
5462;GGB;BBB;1;8;9;0;9;run035
5463;GGB;BBG;0;1;1;0;1;run035
5464;GGB;BGB;0;1;1;0;1;run035
5465;GGB;BRB;3;5;8;1;7;run035
5466;GGB;BRR;0;1;1;0;1;run035
5467;GGB;GBG;0;2;2;0;2;run035
5468;GGB;GGG;4;37;41;5;36;run035
5469;GGB;GGR;0;9;9;8;1;run035
5470;GGB;GRR;1;4;5;3;2;run035
5471;GGB;RBB;0;2;2;1;1;run035
5472;GGB;RBG;0;2;2;2;0;run035
5473;GGB;RBR;0;2;2;0;2;run035
5474;GGB;RGG;0;1;1;1;0;run035
5475;GGB;RGR;1;2;3;3;0;run035
5476;GGB;RRG;1;3;4;2;2;run035
5477;GGB;RRR;0;3;3;3;0;run035
5478;GGG;BBB;4;22;26;14;12;run035
5479;GGG;BBG;0;2;2;0;2;run035
5480;GGG;BBR;0;3;3;0;3;run035
5481;GGG;BGB;0;2;2;1;1;run035
5482;GGG;BGG;0;3;3;0;3;run035
5483;GGG;BRB;0;3;3;0;3;run035
5484;GGG;BRR;0;3;3;0;3;run035
5485;GGG;GBB;0;1;1;0;1;run035
5486;GGG;GGB;1;3;4;3;1;run035
5487;GGG;GGR;0;21;21;17;4;run035
5488;GGG;GRG;0;2;2;1;1;run035
5489;GGG;GRR;2;15;17;2;15;run035
5490;GGG;RBB;0;1;1;1;0;run035
5491;GGG;RBR;1;4;5;2;3;run035
5492;GGG;RGG;1;7;8;4;4;run035
5493;GGG;RGR;0;3;3;1;2;run035
5494;GGG;RRG;0;2;2;0;2;run035
5495;GGG;RRR;0;1;1;0;1;run035
5496;GGR;BBB;0;1;1;0;1;run035
5497;GGR;BGG;0;2;2;1;1;run035
5498;GGR;BRB;0;1;1;0;1;run035
5499;GRG;BBB;0;3;3;0;3;run035
5500;GRG;BGB;0;3;3;2;1;run035
5501;GRG;BGG;0;1;1;1;0;run035
5502;GRG;BRB;0;5;5;4;1;run035
5503;GRG;BRR;0;1;1;1;0;run035
5504;GRG;GBB;0;3;3;2;1;run035
5505;GRG;GGB;0;14;14;4;10;run035
5506;GRG;GGG;0;10;10;4;6;run035
5507;GRG;GGR;0;2;2;2;0;run035
5508;GRG;GRR;0;1;1;1;0;run035
5509;GRG;RBR;1;2;3;2;1;run035
5510;GRG;RGG;0;2;2;1;1;run035
5511;GRG;RGR;0;1;1;0;1;run035
5512;GRR;BBB;0;3;3;2;1;run035
5513;GRR;BBR;0;2;2;2;0;run035
5514;GRR;BRB;1;8;9;4;5;run035
5515;GRR;BRR;1;6;7;3;4;run035
5516;GRR;GBB;0;1;1;1;0;run035
5517;GRR;GBG;0;1;1;0;1;run035
5518;GRR;GGR;1;9;10;9;1;run035
5519;GRR;RBR;0;1;1;0;1;run035
5520;GRR;RGG;1;3;4;3;1;run035
5521;GRR;RGR;0;1;1;0;1;run035
5522;GRR;RRR;0;1;1;1;0;run035
5523;RBB;BBB;0;1;1;0;1;run035
5524;RBB;GGG;0;3;3;3;0;run035
5525;RBG;GRR;0;1;1;1;0;run035
5526;RBG;RBR;0;1;1;1;0;run035
5527;RBG;RGR;0;1;1;1;0;run035
5528;RBR;BBB;0;3;3;3;0;run035
5529;RBR;BRB;0;1;1;1;0;run035
5530;RBR;BRR;0;2;2;2;0;run035
5531;RBR;GGG;0;1;1;0;1;run035
5532;RBR;GGR;1;2;3;2;1;run035
5533;RBR;GRG;0;1;1;0;1;run035
5534;RBR;GRR;1;15;16;6;10;run035
5535;RBR;RGG;0;4;4;2;2;run035
5536;RBR;RGR;0;1;1;1;0;run035
5537;RBR;RRR;0;3;3;2;1;run035
5538;RGG;BGG;0;1;1;1;0;run035
5539;RGG;RGR;0;1;1;1;0;run035
5540;RGR;BBB;0;9;9;5;4;run035
5541;RGR;BBR;0;1;1;1;0;run035
5542;RGR;BGB;1;8;9;9;0;run035
5543;RGR;BRB;0;3;3;3;0;run035
5544;RGR;BRR;0;3;3;0;3;run035
5545;RGR;GBG;0;1;1;0;1;run035
5546;RGR;GGB;0;3;3;3;0;run035
5547;RGR;GGG;0;2;2;2;0;run035
5548;RGR;GGR;0;8;8;8;0;run035
5549;RGR;GRR;1;7;8;3;5;run035
5550;RGR;RGG;0;6;6;2;4;run035
5551;RRG;BGB;0;1;1;0;1;run035
5552;RRG;BRB;0;1;1;1;0;run035
5553;RRG;GGG;0;1;1;0;1;run035
5554;RRG;GGR;0;1;1;0;1;run035
5555;RRG;GRG;0;1;1;1;0;run035
5556;RRG;GRR;0;3;3;1;2;run035
5557;RRG;RBR;0;4;4;0;4;run035
5558;RRG;RGG;0;1;1;0;1;run035
5559;RRG;RGR;6;37;43;27;16;run035
5560;RRR;BRR;0;1;1;0;1;run035
5561;RRR;GGB;0;1;1;1;0;run035
5562;RRR;GGG;1;5;6;2;4;run035
5563;RRR;GGR;0;2;2;2;0;run035
5564;RRR;GRR;0;1;1;1;0;run035
5565;RRR;RGR;0;1;1;0;1;run035
5566;BBB;GRR;0;1;1;0;1;run036
5567;BBG;BBB;1;9;10;2;8;run036
5568;BBG;BBR;0;2;2;0;2;run036
5569;BBG;BGB;0;1;1;0;1;run036
5570;BBG;BGG;0;1;1;1;0;run036
5571;BBG;BRB;0;2;2;2;0;run036
5572;BBG;BRR;0;1;1;0;1;run036
5573;BBG;GBB;1;1;2;0;2;run036
5574;BBG;GBG;1;6;7;6;1;run036
5575;BBG;GGB;0;18;18;11;7;run036
5576;BBG;GGG;1;29;30;27;3;run036
5577;BBG;GGR;0;2;2;2;0;run036
5578;BBG;GRG;0;1;1;0;1;run036
5579;BBG;GRR;0;3;3;0;3;run036
5580;BBG;RBR;0;2;2;1;1;run036
5581;BBG;RGR;0;2;2;1;1;run036
5582;BBG;RRG;1;2;3;2;1;run036
5583;BBG;RRR;0;1;1;0;1;run036
5584;BGG;BBB;0;1;1;1;0;run036
5585;BGG;BRB;0;1;1;0;1;run036
5586;BGG;GGG;0;1;1;1;0;run036
5587;BGG;RBB;0;1;1;1;0;run036
5588;BGG;RBG;1;0;1;0;1;run036
5589;BRB;BBB;0;1;1;1;0;run036
5590;BRB;GGB;1;0;1;0;1;run036
5591;BRB;GGG;0;2;2;1;1;run036
5592;BRB;RBB;1;0;1;0;1;run036
5593;BRR;BBB;0;1;1;1;0;run036
5594;BRR;BRB;0;1;1;1;0;run036
5595;BRR;GBB;1;0;1;0;1;run036
5596;GBB;BBB;1;16;17;16;1;run036
5597;GBB;BBG;0;2;2;0;2;run036
5598;GBB;BGB;0;1;1;0;1;run036
5599;GBB;BGG;0;3;3;3;0;run036
5600;GBB;BRB;0;9;9;9;0;run036
5601;GBB;BRR;0;2;2;0;2;run036
5602;GBB;GBG;1;1;2;1;1;run036
5603;GBB;GGB;2;59;61;40;21;run036
5604;GBB;GGG;4;95;99;55;44;run036
5605;GBB;GGR;0;1;1;1;0;run036
5606;GBB;GRG;0;1;1;1;0;run036
5607;GBB;GRR;1;8;9;7;2;run036
5608;GBB;RBB;0;2;2;1;1;run036
5609;GBB;RBG;0;1;1;1;0;run036
5610;GBB;RBR;1;1;2;1;1;run036
5611;GBB;RGG;0;2;2;2;0;run036
5612;GBB;RGR;0;1;1;1;0;run036
5613;GBB;RRG;0;3;3;2;1;run036
5614;GBG;BRB;0;1;1;1;0;run036
5615;GBG;BRR;0;3;3;3;0;run036
5616;GBG;GGB;0;1;1;1;0;run036
5617;GBG;GGR;0;3;3;3;0;run036
5618;GBG;RBR;0;1;1;1;0;run036
5619;GBG;RGR;1;1;2;2;0;run036
5620;GBG;RRR;0;1;1;1;0;run036
5621;GGB;BBB;1;8;9;6;3;run036
5622;GGB;BBG;0;1;1;1;0;run036
5623;GGB;BGB;0;1;1;0;1;run036
5624;GGB;BRB;3;5;8;8;0;run036
5625;GGB;BRR;0;1;1;0;1;run036
5626;GGB;GBG;0;2;2;2;0;run036
5627;GGB;GGG;4;37;41;5;36;run036
5628;GGB;GGR;0;9;9;8;1;run036
5629;GGB;GRR;1;4;5;1;4;run036
5630;GGB;RBB;0;2;2;1;1;run036
5631;GGB;RBG;0;2;2;2;0;run036
5632;GGB;RBR;0;2;2;1;1;run036
5633;GGB;RGG;0;1;1;1;0;run036
5634;GGB;RGR;1;2;3;1;2;run036
5635;GGB;RRG;1;3;4;1;3;run036
5636;GGB;RRR;0;3;3;1;2;run036
5637;GGG;BBB;4;22;26;4;22;run036
5638;GGG;BBG;0;2;2;1;1;run036
5639;GGG;BBR;0;3;3;2;1;run036
5640;GGG;BGB;0;2;2;0;2;run036
5641;GGG;BGG;0;3;3;2;1;run036
5642;GGG;BRB;0;3;3;1;2;run036
5643;GGG;BRR;0;3;3;0;3;run036
5644;GGG;GBB;0;1;1;1;0;run036
5645;GGG;GGB;1;3;4;3;1;run036
5646;GGG;GGR;0;21;21;4;17;run036
5647;GGG;GRG;0;2;2;2;0;run036
5648;GGG;GRR;2;15;17;8;9;run036
5649;GGG;RBB;0;1;1;1;0;run036
5650;GGG;RBR;1;4;5;4;1;run036
5651;GGG;RGG;1;7;8;7;1;run036
5652;GGG;RGR;0;3;3;3;0;run036
5653;GGG;RRG;0;2;2;1;1;run036
5654;GGG;RRR;0;1;1;1;0;run036
5655;GGR;BBB;0;1;1;1;0;run036
5656;GGR;BGG;0;2;2;1;1;run036
5657;GGR;BRB;0;1;1;1;0;run036
5658;GRG;BBB;0;3;3;1;2;run036
5659;GRG;BGB;0;3;3;2;1;run036
5660;GRG;BGG;0;1;1;1;0;run036
5661;GRG;BRB;0;5;5;0;5;run036
5662;GRG;BRR;0;1;1;1;0;run036
5663;GRG;GBB;0;3;3;2;1;run036
5664;GRG;GGB;0;14;14;10;4;run036
5665;GRG;GGG;0;10;10;6;4;run036
5666;GRG;GGR;0;2;2;0;2;run036
5667;GRG;GRR;0;1;1;0;1;run036
5668;GRG;RBR;1;2;3;0;3;run036
5669;GRG;RGG;0;2;2;0;2;run036
5670;GRG;RGR;0;1;1;1;0;run036
5671;GRR;BBB;0;3;3;3;0;run036
5672;GRR;BBR;0;2;2;1;1;run036
5673;GRR;BRB;1;8;9;5;4;run036
5674;GRR;BRR;1;6;7;5;2;run036
5675;GRR;GBB;0;1;1;0;1;run036
5676;GRR;GBG;0;1;1;0;1;run036
5677;GRR;GGR;1;9;10;1;9;run036
5678;GRR;RBR;0;1;1;0;1;run036
5679;GRR;RGG;1;3;4;3;1;run036
5680;GRR;RGR;0;1;1;0;1;run036
5681;GRR;RRR;0;1;1;1;0;run036
5682;RBB;BBB;0;1;1;0;1;run036
5683;RBB;GGG;0;3;3;1;2;run036
5684;RBG;GRR;0;1;1;0;1;run036
5685;RBG;RBR;0;1;1;0;1;run036
5686;RBG;RGR;0;1;1;1;0;run036
5687;RBR;BBB;0;3;3;1;2;run036
5688;RBR;BRB;0;1;1;1;0;run036
5689;RBR;BRR;0;2;2;2;0;run036
5690;RBR;GGG;0;1;1;0;1;run036
5691;RBR;GGR;1;2;3;2;1;run036
5692;RBR;GRG;0;1;1;0;1;run036
5693;RBR;GRR;1;15;16;10;6;run036
5694;RBR;RGG;0;4;4;0;4;run036
5695;RBR;RGR;0;1;1;1;0;run036
5696;RBR;RRR;0;3;3;0;3;run036
5697;RGG;BGG;0;1;1;0;1;run036
5698;RGG;RGR;0;1;1;0;1;run036
5699;RGR;BBB;0;9;9;3;6;run036
5700;RGR;BBR;0;1;1;1;0;run036
5701;RGR;BGB;1;8;9;3;6;run036
5702;RGR;BRB;0;3;3;3;0;run036
5703;RGR;BRR;0;3;3;1;2;run036
5704;RGR;GBG;0;1;1;1;0;run036
5705;RGR;GGB;0;3;3;3;0;run036
5706;RGR;GGG;0;2;2;0;2;run036
5707;RGR;GGR;0;8;8;7;1;run036
5708;RGR;GRR;1;7;8;6;2;run036
5709;RGR;RGG;0;6;6;6;0;run036
5710;RRG;BGB;0;1;1;0;1;run036
5711;RRG;BRB;0;1;1;0;1;run036
5712;RRG;GGG;0;1;1;1;0;run036
5713;RRG;GGR;0;1;1;0;1;run036
5714;RRG;GRG;0;1;1;0;1;run036
5715;RRG;GRR;0;3;3;2;1;run036
5716;RRG;RBR;0;4;4;4;0;run036
5717;RRG;RGG;0;1;1;1;0;run036
5718;RRG;RGR;6;37;43;35;8;run036
5719;RRR;BRR;0;1;1;0;1;run036
5720;RRR;GGB;0;1;1;0;1;run036
5721;RRR;GGG;1;5;6;3;3;run036
5722;RRR;GGR;0;2;2;0;2;run036
5723;RRR;GRR;0;1;1;1;0;run036
5724;RRR;RGR;0;1;1;1;0;run036
5725;BBB;GRR;0;1;1;1;0;run037
5726;BBG;BBB;1;9;10;7;3;run037
5727;BBG;BBR;0;2;2;1;1;run037
5728;BBG;BGB;0;1;1;0;1;run037
5729;BBG;BGG;0;1;1;1;0;run037
5730;BBG;BRB;0;2;2;0;2;run037
5731;BBG;BRR;0;1;1;1;0;run037
5732;BBG;GBB;1;1;2;0;2;run037
5733;BBG;GBG;1;6;7;3;4;run037
5734;BBG;GGB;0;18;18;3;15;run037
5735;BBG;GGG;1;29;30;4;26;run037
5736;BBG;GGR;0;2;2;2;0;run037
5737;BBG;GRG;0;1;1;1;0;run037
5738;BBG;GRR;0;3;3;2;1;run037
5739;BBG;RBR;0;2;2;2;0;run037
5740;BBG;RGR;0;2;2;0;2;run037
5741;BBG;RRG;1;2;3;3;0;run037
5742;BBG;RRR;0;1;1;0;1;run037
5743;BGG;BBB;0;1;1;0;1;run037
5744;BGG;BRB;0;1;1;1;0;run037
5745;BGG;GGG;0;1;1;1;0;run037
5746;BGG;RBB;0;1;1;0;1;run037
5747;BGG;RBG;1;0;1;0;1;run037
5748;BRB;BBB;0;1;1;1;0;run037
5749;BRB;GGB;1;0;1;1;0;run037
5750;BRB;GGG;0;2;2;0;2;run037
5751;BRB;RBB;1;0;1;0;1;run037
5752;BRR;BBB;0;1;1;0;1;run037
5753;BRR;BRB;0;1;1;1;0;run037
5754;BRR;GBB;1;0;1;1;0;run037
5755;GBB;BBB;1;16;17;9;8;run037
5756;GBB;BBG;0;2;2;0;2;run037
5757;GBB;BGB;0;1;1;0;1;run037
5758;GBB;BGG;0;3;3;3;0;run037
5759;GBB;BRB;0;9;9;4;5;run037
5760;GBB;BRR;0;2;2;0;2;run037
5761;GBB;GBG;1;1;2;1;1;run037
5762;GBB;GGB;2;59;61;47;14;run037
5763;GBB;GGG;4;95;99;5;94;run037
5764;GBB;GGR;0;1;1;0;1;run037
5765;GBB;GRG;0;1;1;1;0;run037
5766;GBB;GRR;1;8;9;3;6;run037
5767;GBB;RBB;0;2;2;0;2;run037
5768;GBB;RBG;0;1;1;0;1;run037
5769;GBB;RBR;1;1;2;1;1;run037
5770;GBB;RGG;0;2;2;1;1;run037
5771;GBB;RGR;0;1;1;0;1;run037
5772;GBB;RRG;0;3;3;3;0;run037
5773;GBG;BRB;0;1;1;0;1;run037
5774;GBG;BRR;0;3;3;3;0;run037
5775;GBG;GGB;0;1;1;0;1;run037
5776;GBG;GGR;0;3;3;2;1;run037
5777;GBG;RBR;0;1;1;1;0;run037
5778;GBG;RGR;1;1;2;0;2;run037
5779;GBG;RRR;0;1;1;1;0;run037
5780;GGB;BBB;1;8;9;6;3;run037
5781;GGB;BBG;0;1;1;0;1;run037
5782;GGB;BGB;0;1;1;1;0;run037
5783;GGB;BRB;3;5;8;1;7;run037
5784;GGB;BRR;0;1;1;1;0;run037
5785;GGB;GBG;0;2;2;2;0;run037
5786;GGB;GGG;4;37;41;28;13;run037
5787;GGB;GGR;0;9;9;8;1;run037
5788;GGB;GRR;1;4;5;3;2;run037
5789;GGB;RBB;0;2;2;1;1;run037
5790;GGB;RBG;0;2;2;0;2;run037
5791;GGB;RBR;0;2;2;1;1;run037
5792;GGB;RGG;0;1;1;0;1;run037
5793;GGB;RGR;1;2;3;3;0;run037
5794;GGB;RRG;1;3;4;4;0;run037
5795;GGB;RRR;0;3;3;2;1;run037
5796;GGG;BBB;4;22;26;18;8;run037
5797;GGG;BBG;0;2;2;1;1;run037
5798;GGG;BBR;0;3;3;2;1;run037
5799;GGG;BGB;0;2;2;0;2;run037
5800;GGG;BGG;0;3;3;2;1;run037
5801;GGG;BRB;0;3;3;1;2;run037
5802;GGG;BRR;0;3;3;3;0;run037
5803;GGG;GBB;0;1;1;1;0;run037
5804;GGG;GGB;1;3;4;2;2;run037
5805;GGG;GGR;0;21;21;4;17;run037
5806;GGG;GRG;0;2;2;0;2;run037
5807;GGG;GRR;2;15;17;6;11;run037
5808;GGG;RBB;0;1;1;1;0;run037
5809;GGG;RBR;1;4;5;0;5;run037
5810;GGG;RGG;1;7;8;3;5;run037
5811;GGG;RGR;0;3;3;1;2;run037
5812;GGG;RRG;0;2;2;2;0;run037
5813;GGG;RRR;0;1;1;1;0;run037
5814;GGR;BBB;0;1;1;0;1;run037
5815;GGR;BGG;0;2;2;2;0;run037
5816;GGR;BRB;0;1;1;1;0;run037
5817;GRG;BBB;0;3;3;1;2;run037
5818;GRG;BGB;0;3;3;2;1;run037
5819;GRG;BGG;0;1;1;0;1;run037
5820;GRG;BRB;0;5;5;5;0;run037
5821;GRG;BRR;0;1;1;0;1;run037
5822;GRG;GBB;0;3;3;3;0;run037
5823;GRG;GGB;0;14;14;0;14;run037
5824;GRG;GGG;0;10;10;0;10;run037
5825;GRG;GGR;0;2;2;2;0;run037
5826;GRG;GRR;0;1;1;1;0;run037
5827;GRG;RBR;1;2;3;2;1;run037
5828;GRG;RGG;0;2;2;0;2;run037
5829;GRG;RGR;0;1;1;0;1;run037
5830;GRR;BBB;0;3;3;0;3;run037
5831;GRR;BBR;0;2;2;0;2;run037
5832;GRR;BRB;1;8;9;3;6;run037
5833;GRR;BRR;1;6;7;2;5;run037
5834;GRR;GBB;0;1;1;0;1;run037
5835;GRR;GBG;0;1;1;1;0;run037
5836;GRR;GGR;1;9;10;8;2;run037
5837;GRR;RBR;0;1;1;0;1;run037
5838;GRR;RGG;1;3;4;4;0;run037
5839;GRR;RGR;0;1;1;0;1;run037
5840;GRR;RRR;0;1;1;1;0;run037
5841;RBB;BBB;0;1;1;0;1;run037
5842;RBB;GGG;0;3;3;0;3;run037
5843;RBG;GRR;0;1;1;1;0;run037
5844;RBG;RBR;0;1;1;0;1;run037
5845;RBG;RGR;0;1;1;0;1;run037
5846;RBR;BBB;0;3;3;2;1;run037
5847;RBR;BRB;0;1;1;1;0;run037
5848;RBR;BRR;0;2;2;0;2;run037
5849;RBR;GGG;0;1;1;1;0;run037
5850;RBR;GGR;1;2;3;0;3;run037
5851;RBR;GRG;0;1;1;1;0;run037
5852;RBR;GRR;1;15;16;0;16;run037
5853;RBR;RGG;0;4;4;4;0;run037
5854;RBR;RGR;0;1;1;0;1;run037
5855;RBR;RRR;0;3;3;0;3;run037
5856;RGG;BGG;0;1;1;1;0;run037
5857;RGG;RGR;0;1;1;1;0;run037
5858;RGR;BBB;0;9;9;6;3;run037
5859;RGR;BBR;0;1;1;1;0;run037
5860;RGR;BGB;1;8;9;3;6;run037
5861;RGR;BRB;0;3;3;2;1;run037
5862;RGR;BRR;0;3;3;1;2;run037
5863;RGR;GBG;0;1;1;0;1;run037
5864;RGR;GGB;0;3;3;0;3;run037
5865;RGR;GGG;0;2;2;1;1;run037
5866;RGR;GGR;0;8;8;2;6;run037
5867;RGR;GRR;1;7;8;0;8;run037
5868;RGR;RGG;0;6;6;2;4;run037
5869;RRG;BGB;0;1;1;1;0;run037
5870;RRG;BRB;0;1;1;1;0;run037
5871;RRG;GGG;0;1;1;1;0;run037
5872;RRG;GGR;0;1;1;0;1;run037
5873;RRG;GRG;0;1;1;0;1;run037
5874;RRG;GRR;0;3;3;0;3;run037
5875;RRG;RBR;0;4;4;4;0;run037
5876;RRG;RGG;0;1;1;0;1;run037
5877;RRG;RGR;6;37;43;37;6;run037
5878;RRR;BRR;0;1;1;1;0;run037
5879;RRR;GGB;0;1;1;0;1;run037
5880;RRR;GGG;1;5;6;3;3;run037
5881;RRR;GGR;0;2;2;0;2;run037
5882;RRR;GRR;0;1;1;0;1;run037
5883;RRR;RGR;0;1;1;0;1;run037
5884;BBB;GRR;0;1;1;0;1;run038
5885;BBG;BBB;1;9;10;0;10;run038
5886;BBG;BBR;0;2;2;0;2;run038
5887;BBG;BGB;0;1;1;0;1;run038
5888;BBG;BGG;0;1;1;1;0;run038
5889;BBG;BRB;0;2;2;1;1;run038
5890;BBG;BRR;0;1;1;1;0;run038
5891;BBG;GBB;1;1;2;2;0;run038
5892;BBG;GBG;1;6;7;2;5;run038
5893;BBG;GGB;0;18;18;7;11;run038
5894;BBG;GGG;1;29;30;14;16;run038
5895;BBG;GGR;0;2;2;1;1;run038
5896;BBG;GRG;0;1;1;1;0;run038
5897;BBG;GRR;0;3;3;2;1;run038
5898;BBG;RBR;0;2;2;0;2;run038
5899;BBG;RGR;0;2;2;1;1;run038
5900;BBG;RRG;1;2;3;0;3;run038
5901;BBG;RRR;0;1;1;0;1;run038
5902;BGG;BBB;0;1;1;1;0;run038
5903;BGG;BRB;0;1;1;0;1;run038
5904;BGG;GGG;0;1;1;0;1;run038
5905;BGG;RBB;0;1;1;0;1;run038
5906;BGG;RBG;1;0;1;0;1;run038
5907;BRB;BBB;0;1;1;1;0;run038
5908;BRB;GGB;1;0;1;1;0;run038
5909;BRB;GGG;0;2;2;0;2;run038
5910;BRB;RBB;1;0;1;1;0;run038
5911;BRR;BBB;0;1;1;1;0;run038
5912;BRR;BRB;0;1;1;1;0;run038
5913;BRR;GBB;1;0;1;0;1;run038
5914;GBB;BBB;1;16;17;1;16;run038
5915;GBB;BBG;0;2;2;2;0;run038
5916;GBB;BGB;0;1;1;0;1;run038
5917;GBB;BGG;0;3;3;2;1;run038
5918;GBB;BRB;0;9;9;8;1;run038
5919;GBB;BRR;0;2;2;2;0;run038
5920;GBB;GBG;1;1;2;0;2;run038
5921;GBB;GGB;2;59;61;51;10;run038
5922;GBB;GGG;4;95;99;28;71;run038
5923;GBB;GGR;0;1;1;1;0;run038
5924;GBB;GRG;0;1;1;0;1;run038
5925;GBB;GRR;1;8;9;8;1;run038
5926;GBB;RBB;0;2;2;1;1;run038
5927;GBB;RBG;0;1;1;0;1;run038
5928;GBB;RBR;1;1;2;0;2;run038
5929;GBB;RGG;0;2;2;1;1;run038
5930;GBB;RGR;0;1;1;1;0;run038
5931;GBB;RRG;0;3;3;3;0;run038
5932;GBG;BRB;0;1;1;0;1;run038
5933;GBG;BRR;0;3;3;3;0;run038
5934;GBG;GGB;0;1;1;1;0;run038
5935;GBG;GGR;0;3;3;1;2;run038
5936;GBG;RBR;0;1;1;0;1;run038
5937;GBG;RGR;1;1;2;1;1;run038
5938;GBG;RRR;0;1;1;0;1;run038
5939;GGB;BBB;1;8;9;0;9;run038
5940;GGB;BBG;0;1;1;0;1;run038
5941;GGB;BGB;0;1;1;0;1;run038
5942;GGB;BRB;3;5;8;8;0;run038
5943;GGB;BRR;0;1;1;1;0;run038
5944;GGB;GBG;0;2;2;1;1;run038
5945;GGB;GGG;4;37;41;9;32;run038
5946;GGB;GGR;0;9;9;5;4;run038
5947;GGB;GRR;1;4;5;2;3;run038
5948;GGB;RBB;0;2;2;2;0;run038
5949;GGB;RBG;0;2;2;0;2;run038
5950;GGB;RBR;0;2;2;1;1;run038
5951;GGB;RGG;0;1;1;1;0;run038
5952;GGB;RGR;1;2;3;1;2;run038
5953;GGB;RRG;1;3;4;4;0;run038
5954;GGB;RRR;0;3;3;3;0;run038
5955;GGG;BBB;4;22;26;22;4;run038
5956;GGG;BBG;0;2;2;1;1;run038
5957;GGG;BBR;0;3;3;0;3;run038
5958;GGG;BGB;0;2;2;1;1;run038
5959;GGG;BGG;0;3;3;1;2;run038
5960;GGG;BRB;0;3;3;2;1;run038
5961;GGG;BRR;0;3;3;0;3;run038
5962;GGG;GBB;0;1;1;1;0;run038
5963;GGG;GGB;1;3;4;3;1;run038
5964;GGG;GGR;0;21;21;18;3;run038
5965;GGG;GRG;0;2;2;2;0;run038
5966;GGG;GRR;2;15;17;8;9;run038
5967;GGG;RBB;0;1;1;1;0;run038
5968;GGG;RBR;1;4;5;4;1;run038
5969;GGG;RGG;1;7;8;7;1;run038
5970;GGG;RGR;0;3;3;2;1;run038
5971;GGG;RRG;0;2;2;0;2;run038
5972;GGG;RRR;0;1;1;1;0;run038
5973;GGR;BBB;0;1;1;1;0;run038
5974;GGR;BGG;0;2;2;1;1;run038
5975;GGR;BRB;0;1;1;1;0;run038
5976;GRG;BBB;0;3;3;1;2;run038
5977;GRG;BGB;0;3;3;0;3;run038
5978;GRG;BGG;0;1;1;0;1;run038
5979;GRG;BRB;0;5;5;0;5;run038
5980;GRG;BRR;0;1;1;0;1;run038
5981;GRG;GBB;0;3;3;3;0;run038
5982;GRG;GGB;0;14;14;5;9;run038
5983;GRG;GGG;0;10;10;6;4;run038
5984;GRG;GGR;0;2;2;1;1;run038
5985;GRG;GRR;0;1;1;0;1;run038
5986;GRG;RBR;1;2;3;2;1;run038
5987;GRG;RGG;0;2;2;2;0;run038
5988;GRG;RGR;0;1;1;1;0;run038
5989;GRR;BBB;0;3;3;1;2;run038
5990;GRR;BBR;0;2;2;2;0;run038
5991;GRR;BRB;1;8;9;9;0;run038
5992;GRR;BRR;1;6;7;2;5;run038
5993;GRR;GBB;0;1;1;1;0;run038
5994;GRR;GBG;0;1;1;1;0;run038
5995;GRR;GGR;1;9;10;9;1;run038
5996;GRR;RBR;0;1;1;1;0;run038
5997;GRR;RGG;1;3;4;1;3;run038
5998;GRR;RGR;0;1;1;1;0;run038
5999;GRR;RRR;0;1;1;0;1;run038
6000;RBB;BBB;0;1;1;1;0;run038
6001;RBB;GGG;0;3;3;1;2;run038
6002;RBG;GRR;0;1;1;0;1;run038
6003;RBG;RBR;0;1;1;1;0;run038
6004;RBG;RGR;0;1;1;0;1;run038
6005;RBR;BBB;0;3;3;3;0;run038
6006;RBR;BRB;0;1;1;0;1;run038
6007;RBR;BRR;0;2;2;1;1;run038
6008;RBR;GGG;0;1;1;1;0;run038
6009;RBR;GGR;1;2;3;0;3;run038
6010;RBR;GRG;0;1;1;1;0;run038
6011;RBR;GRR;1;15;16;3;13;run038
6012;RBR;RGG;0;4;4;1;3;run038
6013;RBR;RGR;0;1;1;1;0;run038
6014;RBR;RRR;0;3;3;3;0;run038
6015;RGG;BGG;0;1;1;0;1;run038
6016;RGG;RGR;0;1;1;1;0;run038
6017;RGR;BBB;0;9;9;7;2;run038
6018;RGR;BBR;0;1;1;1;0;run038
6019;RGR;BGB;1;8;9;7;2;run038
6020;RGR;BRB;0;3;3;0;3;run038
6021;RGR;BRR;0;3;3;1;2;run038
6022;RGR;GBG;0;1;1;0;1;run038
6023;RGR;GGB;0;3;3;1;2;run038
6024;RGR;GGG;0;2;2;2;0;run038
6025;RGR;GGR;0;8;8;6;2;run038
6026;RGR;GRR;1;7;8;6;2;run038
6027;RGR;RGG;0;6;6;1;5;run038
6028;RRG;BGB;0;1;1;0;1;run038
6029;RRG;BRB;0;1;1;0;1;run038
6030;RRG;GGG;0;1;1;1;0;run038
6031;RRG;GGR;0;1;1;1;0;run038
6032;RRG;GRG;0;1;1;0;1;run038
6033;RRG;GRR;0;3;3;0;3;run038
6034;RRG;RBR;0;4;4;0;4;run038
6035;RRG;RGG;0;1;1;1;0;run038
6036;RRG;RGR;6;37;43;22;21;run038
6037;RRR;BRR;0;1;1;0;1;run038
6038;RRR;GGB;0;1;1;1;0;run038
6039;RRR;GGG;1;5;6;6;0;run038
6040;RRR;GGR;0;2;2;1;1;run038
6041;RRR;GRR;0;1;1;0;1;run038
6042;RRR;RGR;0;1;1;1;0;run038
6043;BBB;GRR;0;1;1;0;1;run039
6044;BBG;BBB;1;9;10;2;8;run039
6045;BBG;BBR;0;2;2;1;1;run039
6046;BBG;BGB;0;1;1;0;1;run039
6047;BBG;BGG;0;1;1;1;0;run039
6048;BBG;BRB;0;2;2;0;2;run039
6049;BBG;BRR;0;1;1;1;0;run039
6050;BBG;GBB;1;1;2;1;1;run039
6051;BBG;GBG;1;6;7;1;6;run039
6052;BBG;GGB;0;18;18;12;6;run039
6053;BBG;GGG;1;29;30;13;17;run039
6054;BBG;GGR;0;2;2;1;1;run039
6055;BBG;GRG;0;1;1;1;0;run039
6056;BBG;GRR;0;3;3;3;0;run039
6057;BBG;RBR;0;2;2;2;0;run039
6058;BBG;RGR;0;2;2;1;1;run039
6059;BBG;RRG;1;2;3;0;3;run039
6060;BBG;RRR;0;1;1;1;0;run039
6061;BGG;BBB;0;1;1;1;0;run039
6062;BGG;BRB;0;1;1;0;1;run039
6063;BGG;GGG;0;1;1;0;1;run039
6064;BGG;RBB;0;1;1;0;1;run039
6065;BGG;RBG;1;0;1;0;1;run039
6066;BRB;BBB;0;1;1;1;0;run039
6067;BRB;GGB;1;0;1;1;0;run039
6068;BRB;GGG;0;2;2;2;0;run039
6069;BRB;RBB;1;0;1;1;0;run039
6070;BRR;BBB;0;1;1;1;0;run039
6071;BRR;BRB;0;1;1;0;1;run039
6072;BRR;GBB;1;0;1;1;0;run039
6073;GBB;BBB;1;16;17;5;12;run039
6074;GBB;BBG;0;2;2;2;0;run039
6075;GBB;BGB;0;1;1;0;1;run039
6076;GBB;BGG;0;3;3;1;2;run039
6077;GBB;BRB;0;9;9;8;1;run039
6078;GBB;BRR;0;2;2;1;1;run039
6079;GBB;GBG;1;1;2;2;0;run039
6080;GBB;GGB;2;59;61;8;53;run039
6081;GBB;GGG;4;95;99;54;45;run039
6082;GBB;GGR;0;1;1;1;0;run039
6083;GBB;GRG;0;1;1;0;1;run039
6084;GBB;GRR;1;8;9;9;0;run039
6085;GBB;RBB;0;2;2;0;2;run039
6086;GBB;RBG;0;1;1;1;0;run039
6087;GBB;RBR;1;1;2;2;0;run039
6088;GBB;RGG;0;2;2;0;2;run039
6089;GBB;RGR;0;1;1;0;1;run039
6090;GBB;RRG;0;3;3;1;2;run039
6091;GBG;BRB;0;1;1;0;1;run039
6092;GBG;BRR;0;3;3;2;1;run039
6093;GBG;GGB;0;1;1;1;0;run039
6094;GBG;GGR;0;3;3;1;2;run039
6095;GBG;RBR;0;1;1;0;1;run039
6096;GBG;RGR;1;1;2;2;0;run039
6097;GBG;RRR;0;1;1;1;0;run039
6098;GGB;BBB;1;8;9;4;5;run039
6099;GGB;BBG;0;1;1;1;0;run039
6100;GGB;BGB;0;1;1;0;1;run039
6101;GGB;BRB;3;5;8;4;4;run039
6102;GGB;BRR;0;1;1;1;0;run039
6103;GGB;GBG;0;2;2;0;2;run039
6104;GGB;GGG;4;37;41;39;2;run039
6105;GGB;GGR;0;9;9;0;9;run039
6106;GGB;GRR;1;4;5;2;3;run039
6107;GGB;RBB;0;2;2;0;2;run039
6108;GGB;RBG;0;2;2;1;1;run039
6109;GGB;RBR;0;2;2;2;0;run039
6110;GGB;RGG;0;1;1;0;1;run039
6111;GGB;RGR;1;2;3;2;1;run039
6112;GGB;RRG;1;3;4;4;0;run039
6113;GGB;RRR;0;3;3;0;3;run039
6114;GGG;BBB;4;22;26;25;1;run039
6115;GGG;BBG;0;2;2;0;2;run039
6116;GGG;BBR;0;3;3;3;0;run039
6117;GGG;BGB;0;2;2;1;1;run039
6118;GGG;BGG;0;3;3;0;3;run039
6119;GGG;BRB;0;3;3;3;0;run039
6120;GGG;BRR;0;3;3;3;0;run039
6121;GGG;GBB;0;1;1;0;1;run039
6122;GGG;GGB;1;3;4;3;1;run039
6123;GGG;GGR;0;21;21;8;13;run039
6124;GGG;GRG;0;2;2;0;2;run039
6125;GGG;GRR;2;15;17;6;11;run039
6126;GGG;RBB;0;1;1;1;0;run039
6127;GGG;RBR;1;4;5;4;1;run039
6128;GGG;RGG;1;7;8;7;1;run039
6129;GGG;RGR;0;3;3;1;2;run039
6130;GGG;RRG;0;2;2;2;0;run039
6131;GGG;RRR;0;1;1;1;0;run039
6132;GGR;BBB;0;1;1;0;1;run039
6133;GGR;BGG;0;2;2;0;2;run039
6134;GGR;BRB;0;1;1;0;1;run039
6135;GRG;BBB;0;3;3;2;1;run039
6136;GRG;BGB;0;3;3;3;0;run039
6137;GRG;BGG;0;1;1;1;0;run039
6138;GRG;BRB;0;5;5;5;0;run039
6139;GRG;BRR;0;1;1;1;0;run039
6140;GRG;GBB;0;3;3;0;3;run039
6141;GRG;GGB;0;14;14;3;11;run039
6142;GRG;GGG;0;10;10;3;7;run039
6143;GRG;GGR;0;2;2;0;2;run039
6144;GRG;GRR;0;1;1;1;0;run039
6145;GRG;RBR;1;2;3;1;2;run039
6146;GRG;RGG;0;2;2;2;0;run039
6147;GRG;RGR;0;1;1;0;1;run039
6148;GRR;BBB;0;3;3;3;0;run039
6149;GRR;BBR;0;2;2;2;0;run039
6150;GRR;BRB;1;8;9;9;0;run039
6151;GRR;BRR;1;6;7;6;1;run039
6152;GRR;GBB;0;1;1;1;0;run039
6153;GRR;GBG;0;1;1;0;1;run039
6154;GRR;GGR;1;9;10;8;2;run039
6155;GRR;RBR;0;1;1;1;0;run039
6156;GRR;RGG;1;3;4;2;2;run039
6157;GRR;RGR;0;1;1;1;0;run039
6158;GRR;RRR;0;1;1;0;1;run039
6159;RBB;BBB;0;1;1;0;1;run039
6160;RBB;GGG;0;3;3;1;2;run039
6161;RBG;GRR;0;1;1;1;0;run039
6162;RBG;RBR;0;1;1;0;1;run039
6163;RBG;RGR;0;1;1;1;0;run039
6164;RBR;BBB;0;3;3;2;1;run039
6165;RBR;BRB;0;1;1;1;0;run039
6166;RBR;BRR;0;2;2;0;2;run039
6167;RBR;GGG;0;1;1;0;1;run039
6168;RBR;GGR;1;2;3;1;2;run039
6169;RBR;GRG;0;1;1;0;1;run039
6170;RBR;GRR;1;15;16;4;12;run039
6171;RBR;RGG;0;4;4;3;1;run039
6172;RBR;RGR;0;1;1;0;1;run039
6173;RBR;RRR;0;3;3;2;1;run039
6174;RGG;BGG;0;1;1;0;1;run039
6175;RGG;RGR;0;1;1;0;1;run039
6176;RGR;BBB;0;9;9;8;1;run039
6177;RGR;BBR;0;1;1;0;1;run039
6178;RGR;BGB;1;8;9;7;2;run039
6179;RGR;BRB;0;3;3;1;2;run039
6180;RGR;BRR;0;3;3;2;1;run039
6181;RGR;GBG;0;1;1;0;1;run039
6182;RGR;GGB;0;3;3;0;3;run039
6183;RGR;GGG;0;2;2;1;1;run039
6184;RGR;GGR;0;8;8;7;1;run039
6185;RGR;GRR;1;7;8;6;2;run039
6186;RGR;RGG;0;6;6;3;3;run039
6187;RRG;BGB;0;1;1;1;0;run039
6188;RRG;BRB;0;1;1;0;1;run039
6189;RRG;GGG;0;1;1;1;0;run039
6190;RRG;GGR;0;1;1;0;1;run039
6191;RRG;GRG;0;1;1;1;0;run039
6192;RRG;GRR;0;3;3;0;3;run039
6193;RRG;RBR;0;4;4;0;4;run039
6194;RRG;RGG;0;1;1;1;0;run039
6195;RRG;RGR;6;37;43;16;27;run039
6196;RRR;BRR;0;1;1;1;0;run039
6197;RRR;GGB;0;1;1;0;1;run039
6198;RRR;GGG;1;5;6;2;4;run039
6199;RRR;GGR;0;2;2;1;1;run039
6200;RRR;GRR;0;1;1;0;1;run039
6201;RRR;RGR;0;1;1;0;1;run039
6202;BBB;GRR;0;1;1;1;0;run040
6203;BBG;BBB;1;9;10;6;4;run040
6204;BBG;BBR;0;2;2;1;1;run040
6205;BBG;BGB;0;1;1;0;1;run040
6206;BBG;BGG;0;1;1;1;0;run040
6207;BBG;BRB;0;2;2;2;0;run040
6208;BBG;BRR;0;1;1;1;0;run040
6209;BBG;GBB;1;1;2;0;2;run040
6210;BBG;GBG;1;6;7;5;2;run040
6211;BBG;GGB;0;18;18;15;3;run040
6212;BBG;GGG;1;29;30;28;2;run040
6213;BBG;GGR;0;2;2;2;0;run040
6214;BBG;GRG;0;1;1;1;0;run040
6215;BBG;GRR;0;3;3;3;0;run040
6216;BBG;RBR;0;2;2;2;0;run040
6217;BBG;RGR;0;2;2;0;2;run040
6218;BBG;RRG;1;2;3;0;3;run040
6219;BBG;RRR;0;1;1;1;0;run040
6220;BGG;BBB;0;1;1;1;0;run040
6221;BGG;BRB;0;1;1;0;1;run040
6222;BGG;GGG;0;1;1;0;1;run040
6223;BGG;RBB;0;1;1;0;1;run040
6224;BGG;RBG;1;0;1;0;1;run040
6225;BRB;BBB;0;1;1;0;1;run040
6226;BRB;GGB;1;0;1;1;0;run040
6227;BRB;GGG;0;2;2;1;1;run040
6228;BRB;RBB;1;0;1;1;0;run040
6229;BRR;BBB;0;1;1;1;0;run040
6230;BRR;BRB;0;1;1;0;1;run040
6231;BRR;GBB;1;0;1;0;1;run040
6232;GBB;BBB;1;16;17;4;13;run040
6233;GBB;BBG;0;2;2;0;2;run040
6234;GBB;BGB;0;1;1;1;0;run040
6235;GBB;BGG;0;3;3;0;3;run040
6236;GBB;BRB;0;9;9;5;4;run040
6237;GBB;BRR;0;2;2;0;2;run040
6238;GBB;GBG;1;1;2;2;0;run040
6239;GBB;GGB;2;59;61;18;43;run040
6240;GBB;GGG;4;95;99;50;49;run040
6241;GBB;GGR;0;1;1;0;1;run040
6242;GBB;GRG;0;1;1;1;0;run040
6243;GBB;GRR;1;8;9;7;2;run040
6244;GBB;RBB;0;2;2;2;0;run040
6245;GBB;RBG;0;1;1;0;1;run040
6246;GBB;RBR;1;1;2;0;2;run040
6247;GBB;RGG;0;2;2;1;1;run040
6248;GBB;RGR;0;1;1;1;0;run040
6249;GBB;RRG;0;3;3;0;3;run040
6250;GBG;BRB;0;1;1;0;1;run040
6251;GBG;BRR;0;3;3;0;3;run040
6252;GBG;GGB;0;1;1;0;1;run040
6253;GBG;GGR;0;3;3;1;2;run040
6254;GBG;RBR;0;1;1;1;0;run040
6255;GBG;RGR;1;1;2;2;0;run040
6256;GBG;RRR;0;1;1;0;1;run040
6257;GGB;BBB;1;8;9;7;2;run040
6258;GGB;BBG;0;1;1;1;0;run040
6259;GGB;BGB;0;1;1;1;0;run040
6260;GGB;BRB;3;5;8;1;7;run040
6261;GGB;BRR;0;1;1;1;0;run040
6262;GGB;GBG;0;2;2;0;2;run040
6263;GGB;GGG;4;37;41;19;22;run040
6264;GGB;GGR;0;9;9;7;2;run040
6265;GGB;GRR;1;4;5;5;0;run040
6266;GGB;RBB;0;2;2;0;2;run040
6267;GGB;RBG;0;2;2;1;1;run040
6268;GGB;RBR;0;2;2;2;0;run040
6269;GGB;RGG;0;1;1;1;0;run040
6270;GGB;RGR;1;2;3;3;0;run040
6271;GGB;RRG;1;3;4;0;4;run040
6272;GGB;RRR;0;3;3;0;3;run040
6273;GGG;BBB;4;22;26;25;1;run040
6274;GGG;BBG;0;2;2;2;0;run040
6275;GGG;BBR;0;3;3;3;0;run040
6276;GGG;BGB;0;2;2;2;0;run040
6277;GGG;BGG;0;3;3;0;3;run040
6278;GGG;BRB;0;3;3;3;0;run040
6279;GGG;BRR;0;3;3;2;1;run040
6280;GGG;GBB;0;1;1;0;1;run040
6281;GGG;GGB;1;3;4;3;1;run040
6282;GGG;GGR;0;21;21;5;16;run040
6283;GGG;GRG;0;2;2;0;2;run040
6284;GGG;GRR;2;15;17;13;4;run040
6285;GGG;RBB;0;1;1;1;0;run040
6286;GGG;RBR;1;4;5;2;3;run040
6287;GGG;RGG;1;7;8;4;4;run040
6288;GGG;RGR;0;3;3;0;3;run040
6289;GGG;RRG;0;2;2;2;0;run040
6290;GGG;RRR;0;1;1;1;0;run040
6291;GGR;BBB;0;1;1;0;1;run040
6292;GGR;BGG;0;2;2;2;0;run040
6293;GGR;BRB;0;1;1;0;1;run040
6294;GRG;BBB;0;3;3;3;0;run040
6295;GRG;BGB;0;3;3;0;3;run040
6296;GRG;BGG;0;1;1;0;1;run040
6297;GRG;BRB;0;5;5;2;3;run040
6298;GRG;BRR;0;1;1;0;1;run040
6299;GRG;GBB;0;3;3;3;0;run040
6300;GRG;GGB;0;14;14;3;11;run040
6301;GRG;GGG;0;10;10;0;10;run040
6302;GRG;GGR;0;2;2;0;2;run040
6303;GRG;GRR;0;1;1;1;0;run040
6304;GRG;RBR;1;2;3;2;1;run040
6305;GRG;RGG;0;2;2;1;1;run040
6306;GRG;RGR;0;1;1;1;0;run040
6307;GRR;BBB;0;3;3;0;3;run040
6308;GRR;BBR;0;2;2;2;0;run040
6309;GRR;BRB;1;8;9;2;7;run040
6310;GRR;BRR;1;6;7;4;3;run040
6311;GRR;GBB;0;1;1;0;1;run040
6312;GRR;GBG;0;1;1;0;1;run040
6313;GRR;GGR;1;9;10;8;2;run040
6314;GRR;RBR;0;1;1;0;1;run040
6315;GRR;RGG;1;3;4;1;3;run040
6316;GRR;RGR;0;1;1;0;1;run040
6317;GRR;RRR;0;1;1;1;0;run040
6318;RBB;BBB;0;1;1;0;1;run040
6319;RBB;GGG;0;3;3;1;2;run040
6320;RBG;GRR;0;1;1;0;1;run040
6321;RBG;RBR;0;1;1;0;1;run040
6322;RBG;RGR;0;1;1;0;1;run040
6323;RBR;BBB;0;3;3;3;0;run040
6324;RBR;BRB;0;1;1;0;1;run040
6325;RBR;BRR;0;2;2;0;2;run040
6326;RBR;GGG;0;1;1;0;1;run040
6327;RBR;GGR;1;2;3;3;0;run040
6328;RBR;GRG;0;1;1;0;1;run040
6329;RBR;GRR;1;15;16;2;14;run040
6330;RBR;RGG;0;4;4;4;0;run040
6331;RBR;RGR;0;1;1;1;0;run040
6332;RBR;RRR;0;3;3;3;0;run040
6333;RGG;BGG;0;1;1;0;1;run040
6334;RGG;RGR;0;1;1;1;0;run040
6335;RGR;BBB;0;9;9;7;2;run040
6336;RGR;BBR;0;1;1;0;1;run040
6337;RGR;BGB;1;8;9;7;2;run040
6338;RGR;BRB;0;3;3;3;0;run040
6339;RGR;BRR;0;3;3;1;2;run040
6340;RGR;GBG;0;1;1;0;1;run040
6341;RGR;GGB;0;3;3;1;2;run040
6342;RGR;GGG;0;2;2;1;1;run040
6343;RGR;GGR;0;8;8;2;6;run040
6344;RGR;GRR;1;7;8;2;6;run040
6345;RGR;RGG;0;6;6;6;0;run040
6346;RRG;BGB;0;1;1;0;1;run040
6347;RRG;BRB;0;1;1;1;0;run040
6348;RRG;GGG;0;1;1;1;0;run040
6349;RRG;GGR;0;1;1;0;1;run040
6350;RRG;GRG;0;1;1;0;1;run040
6351;RRG;GRR;0;3;3;1;2;run040
6352;RRG;RBR;0;4;4;4;0;run040
6353;RRG;RGG;0;1;1;1;0;run040
6354;RRG;RGR;6;37;43;40;3;run040
6355;RRR;BRR;0;1;1;0;1;run040
6356;RRR;GGB;0;1;1;1;0;run040
6357;RRR;GGG;1;5;6;0;6;run040
6358;RRR;GGR;0;2;2;0;2;run040
6359;RRR;GRR;0;1;1;0;1;run040
6360;RRR;RGR;0;1;1;0;1;run040
6361;BBB;GRR;0;1;1;1;0;run041
6362;BBG;BBB;1;9;10;2;8;run041
6363;BBG;BBR;0;2;2;0;2;run041
6364;BBG;BGB;0;1;1;1;0;run041
6365;BBG;BGG;0;1;1;1;0;run041
6366;BBG;BRB;0;2;2;1;1;run041
6367;BBG;BRR;0;1;1;0;1;run041
6368;BBG;GBB;1;1;2;1;1;run041
6369;BBG;GBG;1;6;7;5;2;run041
6370;BBG;GGB;0;18;18;17;1;run041
6371;BBG;GGG;1;29;30;1;29;run041
6372;BBG;GGR;0;2;2;2;0;run041
6373;BBG;GRG;0;1;1;1;0;run041
6374;BBG;GRR;0;3;3;2;1;run041
6375;BBG;RBR;0;2;2;0;2;run041
6376;BBG;RGR;0;2;2;0;2;run041
6377;BBG;RRG;1;2;3;1;2;run041
6378;BBG;RRR;0;1;1;0;1;run041
6379;BGG;BBB;0;1;1;1;0;run041
6380;BGG;BRB;0;1;1;1;0;run041
6381;BGG;GGG;0;1;1;0;1;run041
6382;BGG;RBB;0;1;1;1;0;run041
6383;BGG;RBG;1;0;1;0;1;run041
6384;BRB;BBB;0;1;1;1;0;run041
6385;BRB;GGB;1;0;1;0;1;run041
6386;BRB;GGG;0;2;2;1;1;run041
6387;BRB;RBB;1;0;1;0;1;run041
6388;BRR;BBB;0;1;1;1;0;run041
6389;BRR;BRB;0;1;1;1;0;run041
6390;BRR;GBB;1;0;1;1;0;run041
6391;GBB;BBB;1;16;17;17;0;run041
6392;GBB;BBG;0;2;2;1;1;run041
6393;GBB;BGB;0;1;1;1;0;run041
6394;GBB;BGG;0;3;3;3;0;run041
6395;GBB;BRB;0;9;9;4;5;run041
6396;GBB;BRR;0;2;2;2;0;run041
6397;GBB;GBG;1;1;2;0;2;run041
6398;GBB;GGB;2;59;61;53;8;run041
6399;GBB;GGG;4;95;99;42;57;run041
6400;GBB;GGR;0;1;1;1;0;run041
6401;GBB;GRG;0;1;1;0;1;run041
6402;GBB;GRR;1;8;9;8;1;run041
6403;GBB;RBB;0;2;2;0;2;run041
6404;GBB;RBG;0;1;1;1;0;run041
6405;GBB;RBR;1;1;2;0;2;run041
6406;GBB;RGG;0;2;2;1;1;run041
6407;GBB;RGR;0;1;1;0;1;run041
6408;GBB;RRG;0;3;3;2;1;run041
6409;GBG;BRB;0;1;1;0;1;run041
6410;GBG;BRR;0;3;3;3;0;run041
6411;GBG;GGB;0;1;1;1;0;run041
6412;GBG;GGR;0;3;3;3;0;run041
6413;GBG;RBR;0;1;1;0;1;run041
6414;GBG;RGR;1;1;2;0;2;run041
6415;GBG;RRR;0;1;1;0;1;run041
6416;GGB;BBB;1;8;9;1;8;run041
6417;GGB;BBG;0;1;1;0;1;run041
6418;GGB;BGB;0;1;1;0;1;run041
6419;GGB;BRB;3;5;8;1;7;run041
6420;GGB;BRR;0;1;1;0;1;run041
6421;GGB;GBG;0;2;2;0;2;run041
6422;GGB;GGG;4;37;41;18;23;run041
6423;GGB;GGR;0;9;9;5;4;run041
6424;GGB;GRR;1;4;5;0;5;run041
6425;GGB;RBB;0;2;2;2;0;run041
6426;GGB;RBG;0;2;2;0;2;run041
6427;GGB;RBR;0;2;2;1;1;run041
6428;GGB;RGG;0;1;1;0;1;run041
6429;GGB;RGR;1;2;3;3;0;run041
6430;GGB;RRG;1;3;4;1;3;run041
6431;GGB;RRR;0;3;3;1;2;run041
6432;GGG;BBB;4;22;26;8;18;run041
6433;GGG;BBG;0;2;2;0;2;run041
6434;GGG;BBR;0;3;3;1;2;run041
6435;GGG;BGB;0;2;2;2;0;run041
6436;GGG;BGG;0;3;3;2;1;run041
6437;GGG;BRB;0;3;3;2;1;run041
6438;GGG;BRR;0;3;3;3;0;run041
6439;GGG;GBB;0;1;1;0;1;run041
6440;GGG;GGB;1;3;4;3;1;run041
6441;GGG;GGR;0;21;21;17;4;run041
6442;GGG;GRG;0;2;2;1;1;run041
6443;GGG;GRR;2;15;17;14;3;run041
6444;GGG;RBB;0;1;1;0;1;run041
6445;GGG;RBR;1;4;5;0;5;run041
6446;GGG;RGG;1;7;8;6;2;run041
6447;GGG;RGR;0;3;3;2;1;run041
6448;GGG;RRG;0;2;2;2;0;run041
6449;GGG;RRR;0;1;1;0;1;run041
6450;GGR;BBB;0;1;1;1;0;run041
6451;GGR;BGG;0;2;2;2;0;run041
6452;GGR;BRB;0;1;1;1;0;run041
6453;GRG;BBB;0;3;3;2;1;run041
6454;GRG;BGB;0;3;3;2;1;run041
6455;GRG;BGG;0;1;1;1;0;run041
6456;GRG;BRB;0;5;5;4;1;run041
6457;GRG;BRR;0;1;1;1;0;run041
6458;GRG;GBB;0;3;3;2;1;run041
6459;GRG;GGB;0;14;14;10;4;run041
6460;GRG;GGG;0;10;10;1;9;run041
6461;GRG;GGR;0;2;2;1;1;run041
6462;GRG;GRR;0;1;1;1;0;run041
6463;GRG;RBR;1;2;3;2;1;run041
6464;GRG;RGG;0;2;2;2;0;run041
6465;GRG;RGR;0;1;1;1;0;run041
6466;GRR;BBB;0;3;3;3;0;run041
6467;GRR;BBR;0;2;2;2;0;run041
6468;GRR;BRB;1;8;9;9;0;run041
6469;GRR;BRR;1;6;7;1;6;run041
6470;GRR;GBB;0;1;1;1;0;run041
6471;GRR;GBG;0;1;1;1;0;run041
6472;GRR;GGR;1;9;10;7;3;run041
6473;GRR;RBR;0;1;1;0;1;run041
6474;GRR;RGG;1;3;4;3;1;run041
6475;GRR;RGR;0;1;1;0;1;run041
6476;GRR;RRR;0;1;1;0;1;run041
6477;RBB;BBB;0;1;1;1;0;run041
6478;RBB;GGG;0;3;3;1;2;run041
6479;RBG;GRR;0;1;1;0;1;run041
6480;RBG;RBR;0;1;1;1;0;run041
6481;RBG;RGR;0;1;1;0;1;run041
6482;RBR;BBB;0;3;3;2;1;run041
6483;RBR;BRB;0;1;1;0;1;run041
6484;RBR;BRR;0;2;2;1;1;run041
6485;RBR;GGG;0;1;1;0;1;run041
6486;RBR;GGR;1;2;3;0;3;run041
6487;RBR;GRG;0;1;1;0;1;run041
6488;RBR;GRR;1;15;16;5;11;run041
6489;RBR;RGG;0;4;4;2;2;run041
6490;RBR;RGR;0;1;1;1;0;run041
6491;RBR;RRR;0;3;3;3;0;run041
6492;RGG;BGG;0;1;1;1;0;run041
6493;RGG;RGR;0;1;1;1;0;run041
6494;RGR;BBB;0;9;9;2;7;run041
6495;RGR;BBR;0;1;1;0;1;run041
6496;RGR;BGB;1;8;9;8;1;run041
6497;RGR;BRB;0;3;3;1;2;run041
6498;RGR;BRR;0;3;3;2;1;run041
6499;RGR;GBG;0;1;1;1;0;run041
6500;RGR;GGB;0;3;3;1;2;run041
6501;RGR;GGG;0;2;2;0;2;run041
6502;RGR;GGR;0;8;8;3;5;run041
6503;RGR;GRR;1;7;8;4;4;run041
6504;RGR;RGG;0;6;6;0;6;run041
6505;RRG;BGB;0;1;1;1;0;run041
6506;RRG;BRB;0;1;1;1;0;run041
6507;RRG;GGG;0;1;1;1;0;run041
6508;RRG;GGR;0;1;1;0;1;run041
6509;RRG;GRG;0;1;1;0;1;run041
6510;RRG;GRR;0;3;3;3;0;run041
6511;RRG;RBR;0;4;4;0;4;run041
6512;RRG;RGG;0;1;1;0;1;run041
6513;RRG;RGR;6;37;43;15;28;run041
6514;RRR;BRR;0;1;1;0;1;run041
6515;RRR;GGB;0;1;1;1;0;run041
6516;RRR;GGG;1;5;6;6;0;run041
6517;RRR;GGR;0;2;2;2;0;run041
6518;RRR;GRR;0;1;1;0;1;run041
6519;RRR;RGR;0;1;1;0;1;run041
6520;BBB;GRR;0;1;1;0;1;run042
6521;BBG;BBB;1;9;10;4;6;run042
6522;BBG;BBR;0;2;2;0;2;run042
6523;BBG;BGB;0;1;1;0;1;run042
6524;BBG;BGG;0;1;1;1;0;run042
6525;BBG;BRB;0;2;2;1;1;run042
6526;BBG;BRR;0;1;1;1;0;run042
6527;BBG;GBB;1;1;2;0;2;run042
6528;BBG;GBG;1;6;7;7;0;run042
6529;BBG;GGB;0;18;18;14;4;run042
6530;BBG;GGG;1;29;30;23;7;run042
6531;BBG;GGR;0;2;2;2;0;run042
6532;BBG;GRG;0;1;1;1;0;run042
6533;BBG;GRR;0;3;3;0;3;run042
6534;BBG;RBR;0;2;2;0;2;run042
6535;BBG;RGR;0;2;2;1;1;run042
6536;BBG;RRG;1;2;3;3;0;run042
6537;BBG;RRR;0;1;1;1;0;run042
6538;BGG;BBB;0;1;1;1;0;run042
6539;BGG;BRB;0;1;1;0;1;run042
6540;BGG;GGG;0;1;1;0;1;run042
6541;BGG;RBB;0;1;1;0;1;run042
6542;BGG;RBG;1;0;1;0;1;run042
6543;BRB;BBB;0;1;1;0;1;run042
6544;BRB;GGB;1;0;1;1;0;run042
6545;BRB;GGG;0;2;2;0;2;run042
6546;BRB;RBB;1;0;1;0;1;run042
6547;BRR;BBB;0;1;1;0;1;run042
6548;BRR;BRB;0;1;1;0;1;run042
6549;BRR;GBB;1;0;1;1;0;run042
6550;GBB;BBB;1;16;17;1;16;run042
6551;GBB;BBG;0;2;2;2;0;run042
6552;GBB;BGB;0;1;1;1;0;run042
6553;GBB;BGG;0;3;3;0;3;run042
6554;GBB;BRB;0;9;9;9;0;run042
6555;GBB;BRR;0;2;2;1;1;run042
6556;GBB;GBG;1;1;2;2;0;run042
6557;GBB;GGB;2;59;61;14;47;run042
6558;GBB;GGG;4;95;99;21;78;run042
6559;GBB;GGR;0;1;1;1;0;run042
6560;GBB;GRG;0;1;1;1;0;run042
6561;GBB;GRR;1;8;9;3;6;run042
6562;GBB;RBB;0;2;2;1;1;run042
6563;GBB;RBG;0;1;1;1;0;run042
6564;GBB;RBR;1;1;2;0;2;run042
6565;GBB;RGG;0;2;2;0;2;run042
6566;GBB;RGR;0;1;1;1;0;run042
6567;GBB;RRG;0;3;3;1;2;run042
6568;GBG;BRB;0;1;1;1;0;run042
6569;GBG;BRR;0;3;3;1;2;run042
6570;GBG;GGB;0;1;1;0;1;run042
6571;GBG;GGR;0;3;3;3;0;run042
6572;GBG;RBR;0;1;1;0;1;run042
6573;GBG;RGR;1;1;2;0;2;run042
6574;GBG;RRR;0;1;1;0;1;run042
6575;GGB;BBB;1;8;9;9;0;run042
6576;GGB;BBG;0;1;1;1;0;run042
6577;GGB;BGB;0;1;1;1;0;run042
6578;GGB;BRB;3;5;8;5;3;run042
6579;GGB;BRR;0;1;1;1;0;run042
6580;GGB;GBG;0;2;2;2;0;run042
6581;GGB;GGG;4;37;41;20;21;run042
6582;GGB;GGR;0;9;9;1;8;run042
6583;GGB;GRR;1;4;5;5;0;run042
6584;GGB;RBB;0;2;2;1;1;run042
6585;GGB;RBG;0;2;2;1;1;run042
6586;GGB;RBR;0;2;2;0;2;run042
6587;GGB;RGG;0;1;1;0;1;run042
6588;GGB;RGR;1;2;3;0;3;run042
6589;GGB;RRG;1;3;4;3;1;run042
6590;GGB;RRR;0;3;3;0;3;run042
6591;GGG;BBB;4;22;26;9;17;run042
6592;GGG;BBG;0;2;2;0;2;run042
6593;GGG;BBR;0;3;3;0;3;run042
6594;GGG;BGB;0;2;2;0;2;run042
6595;GGG;BGG;0;3;3;2;1;run042
6596;GGG;BRB;0;3;3;2;1;run042
6597;GGG;BRR;0;3;3;0;3;run042
6598;GGG;GBB;0;1;1;1;0;run042
6599;GGG;GGB;1;3;4;4;0;run042
6600;GGG;GGR;0;21;21;13;8;run042
6601;GGG;GRG;0;2;2;0;2;run042
6602;GGG;GRR;2;15;17;1;16;run042
6603;GGG;RBB;0;1;1;1;0;run042
6604;GGG;RBR;1;4;5;0;5;run042
6605;GGG;RGG;1;7;8;1;7;run042
6606;GGG;RGR;0;3;3;0;3;run042
6607;GGG;RRG;0;2;2;1;1;run042
6608;GGG;RRR;0;1;1;1;0;run042
6609;GGR;BBB;0;1;1;0;1;run042
6610;GGR;BGG;0;2;2;0;2;run042
6611;GGR;BRB;0;1;1;1;0;run042
6612;GRG;BBB;0;3;3;0;3;run042
6613;GRG;BGB;0;3;3;3;0;run042
6614;GRG;BGG;0;1;1;0;1;run042
6615;GRG;BRB;0;5;5;1;4;run042
6616;GRG;BRR;0;1;1;1;0;run042
6617;GRG;GBB;0;3;3;2;1;run042
6618;GRG;GGB;0;14;14;12;2;run042
6619;GRG;GGG;0;10;10;4;6;run042
6620;GRG;GGR;0;2;2;1;1;run042
6621;GRG;GRR;0;1;1;0;1;run042
6622;GRG;RBR;1;2;3;3;0;run042
6623;GRG;RGG;0;2;2;1;1;run042
6624;GRG;RGR;0;1;1;1;0;run042
6625;GRR;BBB;0;3;3;0;3;run042
6626;GRR;BBR;0;2;2;0;2;run042
6627;GRR;BRB;1;8;9;8;1;run042
6628;GRR;BRR;1;6;7;0;7;run042
6629;GRR;GBB;0;1;1;0;1;run042
6630;GRR;GBG;0;1;1;1;0;run042
6631;GRR;GGR;1;9;10;10;0;run042
6632;GRR;RBR;0;1;1;0;1;run042
6633;GRR;RGG;1;3;4;1;3;run042
6634;GRR;RGR;0;1;1;1;0;run042
6635;GRR;RRR;0;1;1;1;0;run042
6636;RBB;BBB;0;1;1;0;1;run042
6637;RBB;GGG;0;3;3;2;1;run042
6638;RBG;GRR;0;1;1;1;0;run042
6639;RBG;RBR;0;1;1;0;1;run042
6640;RBG;RGR;0;1;1;0;1;run042
6641;RBR;BBB;0;3;3;1;2;run042
6642;RBR;BRB;0;1;1;0;1;run042
6643;RBR;BRR;0;2;2;0;2;run042
6644;RBR;GGG;0;1;1;0;1;run042
6645;RBR;GGR;1;2;3;3;0;run042
6646;RBR;GRG;0;1;1;1;0;run042
6647;RBR;GRR;1;15;16;10;6;run042
6648;RBR;RGG;0;4;4;1;3;run042
6649;RBR;RGR;0;1;1;1;0;run042
6650;RBR;RRR;0;3;3;3;0;run042
6651;RGG;BGG;0;1;1;0;1;run042
6652;RGG;RGR;0;1;1;0;1;run042
6653;RGR;BBB;0;9;9;8;1;run042
6654;RGR;BBR;0;1;1;0;1;run042
6655;RGR;BGB;1;8;9;8;1;run042
6656;RGR;BRB;0;3;3;2;1;run042
6657;RGR;BRR;0;3;3;2;1;run042
6658;RGR;GBG;0;1;1;1;0;run042
6659;RGR;GGB;0;3;3;0;3;run042
6660;RGR;GGG;0;2;2;1;1;run042
6661;RGR;GGR;0;8;8;5;3;run042
6662;RGR;GRR;1;7;8;7;1;run042
6663;RGR;RGG;0;6;6;6;0;run042
6664;RRG;BGB;0;1;1;0;1;run042
6665;RRG;BRB;0;1;1;1;0;run042
6666;RRG;GGG;0;1;1;0;1;run042
6667;RRG;GGR;0;1;1;1;0;run042
6668;RRG;GRG;0;1;1;0;1;run042
6669;RRG;GRR;0;3;3;3;0;run042
6670;RRG;RBR;0;4;4;0;4;run042
6671;RRG;RGG;0;1;1;1;0;run042
6672;RRG;RGR;6;37;43;30;13;run042
6673;RRR;BRR;0;1;1;1;0;run042
6674;RRR;GGB;0;1;1;1;0;run042
6675;RRR;GGG;1;5;6;5;1;run042
6676;RRR;GGR;0;2;2;1;1;run042
6677;RRR;GRR;0;1;1;1;0;run042
6678;RRR;RGR;0;1;1;0;1;run042
6679;BBB;GRR;0;1;1;1;0;run043
6680;BBG;BBB;1;9;10;7;3;run043
6681;BBG;BBR;0;2;2;0;2;run043
6682;BBG;BGB;0;1;1;1;0;run043
6683;BBG;BGG;0;1;1;0;1;run043
6684;BBG;BRB;0;2;2;1;1;run043
6685;BBG;BRR;0;1;1;1;0;run043
6686;BBG;GBB;1;1;2;0;2;run043
6687;BBG;GBG;1;6;7;6;1;run043
6688;BBG;GGB;0;18;18;6;12;run043
6689;BBG;GGG;1;29;30;1;29;run043
6690;BBG;GGR;0;2;2;2;0;run043
6691;BBG;GRG;0;1;1;1;0;run043
6692;BBG;GRR;0;3;3;2;1;run043
6693;BBG;RBR;0;2;2;1;1;run043
6694;BBG;RGR;0;2;2;0;2;run043
6695;BBG;RRG;1;2;3;3;0;run043
6696;BBG;RRR;0;1;1;0;1;run043
6697;BGG;BBB;0;1;1;0;1;run043
6698;BGG;BRB;0;1;1;0;1;run043
6699;BGG;GGG;0;1;1;1;0;run043
6700;BGG;RBB;0;1;1;0;1;run043
6701;BGG;RBG;1;0;1;0;1;run043
6702;BRB;BBB;0;1;1;1;0;run043
6703;BRB;GGB;1;0;1;1;0;run043
6704;BRB;GGG;0;2;2;1;1;run043
6705;BRB;RBB;1;0;1;1;0;run043
6706;BRR;BBB;0;1;1;0;1;run043
6707;BRR;BRB;0;1;1;0;1;run043
6708;BRR;GBB;1;0;1;1;0;run043
6709;GBB;BBB;1;16;17;0;17;run043
6710;GBB;BBG;0;2;2;0;2;run043
6711;GBB;BGB;0;1;1;1;0;run043
6712;GBB;BGG;0;3;3;3;0;run043
6713;GBB;BRB;0;9;9;7;2;run043
6714;GBB;BRR;0;2;2;1;1;run043
6715;GBB;GBG;1;1;2;2;0;run043
6716;GBB;GGB;2;59;61;50;11;run043
6717;GBB;GGG;4;95;99;68;31;run043
6718;GBB;GGR;0;1;1;0;1;run043
6719;GBB;GRG;0;1;1;1;0;run043
6720;GBB;GRR;1;8;9;0;9;run043
6721;GBB;RBB;0;2;2;1;1;run043
6722;GBB;RBG;0;1;1;0;1;run043
6723;GBB;RBR;1;1;2;2;0;run043
6724;GBB;RGG;0;2;2;1;1;run043
6725;GBB;RGR;0;1;1;0;1;run043
6726;GBB;RRG;0;3;3;2;1;run043
6727;GBG;BRB;0;1;1;1;0;run043
6728;GBG;BRR;0;3;3;2;1;run043
6729;GBG;GGB;0;1;1;0;1;run043
6730;GBG;GGR;0;3;3;1;2;run043
6731;GBG;RBR;0;1;1;1;0;run043
6732;GBG;RGR;1;1;2;2;0;run043
6733;GBG;RRR;0;1;1;1;0;run043
6734;GGB;BBB;1;8;9;5;4;run043
6735;GGB;BBG;0;1;1;1;0;run043
6736;GGB;BGB;0;1;1;0;1;run043
6737;GGB;BRB;3;5;8;0;8;run043
6738;GGB;BRR;0;1;1;0;1;run043
6739;GGB;GBG;0;2;2;0;2;run043
6740;GGB;GGG;4;37;41;26;15;run043
6741;GGB;GGR;0;9;9;5;4;run043
6742;GGB;GRR;1;4;5;3;2;run043
6743;GGB;RBB;0;2;2;2;0;run043
6744;GGB;RBG;0;2;2;2;0;run043
6745;GGB;RBR;0;2;2;1;1;run043
6746;GGB;RGG;0;1;1;0;1;run043
6747;GGB;RGR;1;2;3;0;3;run043
6748;GGB;RRG;1;3;4;1;3;run043
6749;GGB;RRR;0;3;3;2;1;run043
6750;GGG;BBB;4;22;26;10;16;run043
6751;GGG;BBG;0;2;2;0;2;run043
6752;GGG;BBR;0;3;3;0;3;run043
6753;GGG;BGB;0;2;2;1;1;run043
6754;GGG;BGG;0;3;3;3;0;run043
6755;GGG;BRB;0;3;3;1;2;run043
6756;GGG;BRR;0;3;3;0;3;run043
6757;GGG;GBB;0;1;1;1;0;run043
6758;GGG;GGB;1;3;4;2;2;run043
6759;GGG;GGR;0;21;21;2;19;run043
6760;GGG;GRG;0;2;2;0;2;run043
6761;GGG;GRR;2;15;17;12;5;run043
6762;GGG;RBB;0;1;1;0;1;run043
6763;GGG;RBR;1;4;5;0;5;run043
6764;GGG;RGG;1;7;8;4;4;run043
6765;GGG;RGR;0;3;3;1;2;run043
6766;GGG;RRG;0;2;2;0;2;run043
6767;GGG;RRR;0;1;1;0;1;run043
6768;GGR;BBB;0;1;1;1;0;run043
6769;GGR;BGG;0;2;2;1;1;run043
6770;GGR;BRB;0;1;1;0;1;run043
6771;GRG;BBB;0;3;3;3;0;run043
6772;GRG;BGB;0;3;3;1;2;run043
6773;GRG;BGG;0;1;1;1;0;run043
6774;GRG;BRB;0;5;5;3;2;run043
6775;GRG;BRR;0;1;1;0;1;run043
6776;GRG;GBB;0;3;3;3;0;run043
6777;GRG;GGB;0;14;14;9;5;run043
6778;GRG;GGG;0;10;10;7;3;run043
6779;GRG;GGR;0;2;2;0;2;run043
6780;GRG;GRR;0;1;1;0;1;run043
6781;GRG;RBR;1;2;3;1;2;run043
6782;GRG;RGG;0;2;2;2;0;run043
6783;GRG;RGR;0;1;1;1;0;run043
6784;GRR;BBB;0;3;3;1;2;run043
6785;GRR;BBR;0;2;2;1;1;run043
6786;GRR;BRB;1;8;9;8;1;run043
6787;GRR;BRR;1;6;7;0;7;run043
6788;GRR;GBB;0;1;1;1;0;run043
6789;GRR;GBG;0;1;1;1;0;run043
6790;GRR;GGR;1;9;10;2;8;run043
6791;GRR;RBR;0;1;1;1;0;run043
6792;GRR;RGG;1;3;4;1;3;run043
6793;GRR;RGR;0;1;1;0;1;run043
6794;GRR;RRR;0;1;1;1;0;run043
6795;RBB;BBB;0;1;1;1;0;run043
6796;RBB;GGG;0;3;3;0;3;run043
6797;RBG;GRR;0;1;1;0;1;run043
6798;RBG;RBR;0;1;1;1;0;run043
6799;RBG;RGR;0;1;1;1;0;run043
6800;RBR;BBB;0;3;3;3;0;run043
6801;RBR;BRB;0;1;1;0;1;run043
6802;RBR;BRR;0;2;2;0;2;run043
6803;RBR;GGG;0;1;1;1;0;run043
6804;RBR;GGR;1;2;3;0;3;run043
6805;RBR;GRG;0;1;1;1;0;run043
6806;RBR;GRR;1;15;16;5;11;run043
6807;RBR;RGG;0;4;4;1;3;run043
6808;RBR;RGR;0;1;1;1;0;run043
6809;RBR;RRR;0;3;3;3;0;run043
6810;RGG;BGG;0;1;1;0;1;run043
6811;RGG;RGR;0;1;1;0;1;run043
6812;RGR;BBB;0;9;9;1;8;run043
6813;RGR;BBR;0;1;1;1;0;run043
6814;RGR;BGB;1;8;9;7;2;run043
6815;RGR;BRB;0;3;3;2;1;run043
6816;RGR;BRR;0;3;3;2;1;run043
6817;RGR;GBG;0;1;1;1;0;run043
6818;RGR;GGB;0;3;3;0;3;run043
6819;RGR;GGG;0;2;2;2;0;run043
6820;RGR;GGR;0;8;8;1;7;run043
6821;RGR;GRR;1;7;8;4;4;run043
6822;RGR;RGG;0;6;6;2;4;run043
6823;RRG;BGB;0;1;1;0;1;run043
6824;RRG;BRB;0;1;1;0;1;run043
6825;RRG;GGG;0;1;1;1;0;run043
6826;RRG;GGR;0;1;1;0;1;run043
6827;RRG;GRG;0;1;1;0;1;run043
6828;RRG;GRR;0;3;3;1;2;run043
6829;RRG;RBR;0;4;4;1;3;run043
6830;RRG;RGG;0;1;1;0;1;run043
6831;RRG;RGR;6;37;43;24;19;run043
6832;RRR;BRR;0;1;1;1;0;run043
6833;RRR;GGB;0;1;1;0;1;run043
6834;RRR;GGG;1;5;6;1;5;run043
6835;RRR;GGR;0;2;2;1;1;run043
6836;RRR;GRR;0;1;1;1;0;run043
6837;RRR;RGR;0;1;1;1;0;run043
6838;BBB;GRR;0;1;1;0;1;run044
6839;BBG;BBB;1;9;10;10;0;run044
6840;BBG;BBR;0;2;2;2;0;run044
6841;BBG;BGB;0;1;1;0;1;run044
6842;BBG;BGG;0;1;1;1;0;run044
6843;BBG;BRB;0;2;2;0;2;run044
6844;BBG;BRR;0;1;1;0;1;run044
6845;BBG;GBB;1;1;2;0;2;run044
6846;BBG;GBG;1;6;7;0;7;run044
6847;BBG;GGB;0;18;18;1;17;run044
6848;BBG;GGG;1;29;30;14;16;run044
6849;BBG;GGR;0;2;2;1;1;run044
6850;BBG;GRG;0;1;1;1;0;run044
6851;BBG;GRR;0;3;3;1;2;run044
6852;BBG;RBR;0;2;2;1;1;run044
6853;BBG;RGR;0;2;2;0;2;run044
6854;BBG;RRG;1;2;3;0;3;run044
6855;BBG;RRR;0;1;1;0;1;run044
6856;BGG;BBB;0;1;1;0;1;run044
6857;BGG;BRB;0;1;1;0;1;run044
6858;BGG;GGG;0;1;1;1;0;run044
6859;BGG;RBB;0;1;1;1;0;run044
6860;BGG;RBG;1;0;1;0;1;run044
6861;BRB;BBB;0;1;1;1;0;run044
6862;BRB;GGB;1;0;1;0;1;run044
6863;BRB;GGG;0;2;2;0;2;run044
6864;BRB;RBB;1;0;1;1;0;run044
6865;BRR;BBB;0;1;1;0;1;run044
6866;BRR;BRB;0;1;1;0;1;run044
6867;BRR;GBB;1;0;1;1;0;run044
6868;GBB;BBB;1;16;17;16;1;run044
6869;GBB;BBG;0;2;2;1;1;run044
6870;GBB;BGB;0;1;1;0;1;run044
6871;GBB;BGG;0;3;3;1;2;run044
6872;GBB;BRB;0;9;9;4;5;run044
6873;GBB;BRR;0;2;2;2;0;run044
6874;GBB;GBG;1;1;2;0;2;run044
6875;GBB;GGB;2;59;61;6;55;run044
6876;GBB;GGG;4;95;99;36;63;run044
6877;GBB;GGR;0;1;1;0;1;run044
6878;GBB;GRG;0;1;1;1;0;run044
6879;GBB;GRR;1;8;9;0;9;run044
6880;GBB;RBB;0;2;2;1;1;run044
6881;GBB;RBG;0;1;1;1;0;run044
6882;GBB;RBR;1;1;2;0;2;run044
6883;GBB;RGG;0;2;2;1;1;run044
6884;GBB;RGR;0;1;1;1;0;run044
6885;GBB;RRG;0;3;3;3;0;run044
6886;GBG;BRB;0;1;1;1;0;run044
6887;GBG;BRR;0;3;3;2;1;run044
6888;GBG;GGB;0;1;1;0;1;run044
6889;GBG;GGR;0;3;3;0;3;run044
6890;GBG;RBR;0;1;1;1;0;run044
6891;GBG;RGR;1;1;2;0;2;run044
6892;GBG;RRR;0;1;1;1;0;run044
6893;GGB;BBB;1;8;9;1;8;run044
6894;GGB;BBG;0;1;1;0;1;run044
6895;GGB;BGB;0;1;1;1;0;run044
6896;GGB;BRB;3;5;8;7;1;run044
6897;GGB;BRR;0;1;1;1;0;run044
6898;GGB;GBG;0;2;2;0;2;run044
6899;GGB;GGG;4;37;41;38;3;run044
6900;GGB;GGR;0;9;9;9;0;run044
6901;GGB;GRR;1;4;5;0;5;run044
6902;GGB;RBB;0;2;2;0;2;run044
6903;GGB;RBG;0;2;2;2;0;run044
6904;GGB;RBR;0;2;2;1;1;run044
6905;GGB;RGG;0;1;1;1;0;run044
6906;GGB;RGR;1;2;3;0;3;run044
6907;GGB;RRG;1;3;4;1;3;run044
6908;GGB;RRR;0;3;3;2;1;run044
6909;GGG;BBB;4;22;26;5;21;run044
6910;GGG;BBG;0;2;2;2;0;run044
6911;GGG;BBR;0;3;3;2;1;run044
6912;GGG;BGB;0;2;2;1;1;run044
6913;GGG;BGG;0;3;3;3;0;run044
6914;GGG;BRB;0;3;3;2;1;run044
6915;GGG;BRR;0;3;3;2;1;run044
6916;GGG;GBB;0;1;1;1;0;run044
6917;GGG;GGB;1;3;4;1;3;run044
6918;GGG;GGR;0;21;21;6;15;run044
6919;GGG;GRG;0;2;2;2;0;run044
6920;GGG;GRR;2;15;17;14;3;run044
6921;GGG;RBB;0;1;1;0;1;run044
6922;GGG;RBR;1;4;5;4;1;run044
6923;GGG;RGG;1;7;8;4;4;run044
6924;GGG;RGR;0;3;3;0;3;run044
6925;GGG;RRG;0;2;2;0;2;run044
6926;GGG;RRR;0;1;1;1;0;run044
6927;GGR;BBB;0;1;1;1;0;run044
6928;GGR;BGG;0;2;2;1;1;run044
6929;GGR;BRB;0;1;1;0;1;run044
6930;GRG;BBB;0;3;3;1;2;run044
6931;GRG;BGB;0;3;3;3;0;run044
6932;GRG;BGG;0;1;1;0;1;run044
6933;GRG;BRB;0;5;5;3;2;run044
6934;GRG;BRR;0;1;1;1;0;run044
6935;GRG;GBB;0;3;3;0;3;run044
6936;GRG;GGB;0;14;14;5;9;run044
6937;GRG;GGG;0;10;10;6;4;run044
6938;GRG;GGR;0;2;2;0;2;run044
6939;GRG;GRR;0;1;1;0;1;run044
6940;GRG;RBR;1;2;3;3;0;run044
6941;GRG;RGG;0;2;2;2;0;run044
6942;GRG;RGR;0;1;1;1;0;run044
6943;GRR;BBB;0;3;3;0;3;run044
6944;GRR;BBR;0;2;2;2;0;run044
6945;GRR;BRB;1;8;9;1;8;run044
6946;GRR;BRR;1;6;7;4;3;run044
6947;GRR;GBB;0;1;1;1;0;run044
6948;GRR;GBG;0;1;1;1;0;run044
6949;GRR;GGR;1;9;10;0;10;run044
6950;GRR;RBR;0;1;1;0;1;run044
6951;GRR;RGG;1;3;4;2;2;run044
6952;GRR;RGR;0;1;1;0;1;run044
6953;GRR;RRR;0;1;1;1;0;run044
6954;RBB;BBB;0;1;1;1;0;run044
6955;RBB;GGG;0;3;3;2;1;run044
6956;RBG;GRR;0;1;1;0;1;run044
6957;RBG;RBR;0;1;1;0;1;run044
6958;RBG;RGR;0;1;1;0;1;run044
6959;RBR;BBB;0;3;3;3;0;run044
6960;RBR;BRB;0;1;1;1;0;run044
6961;RBR;BRR;0;2;2;2;0;run044
6962;RBR;GGG;0;1;1;1;0;run044
6963;RBR;GGR;1;2;3;0;3;run044
6964;RBR;GRG;0;1;1;0;1;run044
6965;RBR;GRR;1;15;16;4;12;run044
6966;RBR;RGG;0;4;4;0;4;run044
6967;RBR;RGR;0;1;1;1;0;run044
6968;RBR;RRR;0;3;3;1;2;run044
6969;RGG;BGG;0;1;1;0;1;run044
6970;RGG;RGR;0;1;1;0;1;run044
6971;RGR;BBB;0;9;9;1;8;run044
6972;RGR;BBR;0;1;1;1;0;run044
6973;RGR;BGB;1;8;9;9;0;run044
6974;RGR;BRB;0;3;3;1;2;run044
6975;RGR;BRR;0;3;3;1;2;run044
6976;RGR;GBG;0;1;1;0;1;run044
6977;RGR;GGB;0;3;3;3;0;run044
6978;RGR;GGG;0;2;2;1;1;run044
6979;RGR;GGR;0;8;8;3;5;run044
6980;RGR;GRR;1;7;8;5;3;run044
6981;RGR;RGG;0;6;6;1;5;run044
6982;RRG;BGB;0;1;1;1;0;run044
6983;RRG;BRB;0;1;1;1;0;run044
6984;RRG;GGG;0;1;1;1;0;run044
6985;RRG;GGR;0;1;1;0;1;run044
6986;RRG;GRG;0;1;1;1;0;run044
6987;RRG;GRR;0;3;3;2;1;run044
6988;RRG;RBR;0;4;4;3;1;run044
6989;RRG;RGG;0;1;1;1;0;run044
6990;RRG;RGR;6;37;43;23;20;run044
6991;RRR;BRR;0;1;1;0;1;run044
6992;RRR;GGB;0;1;1;0;1;run044
6993;RRR;GGG;1;5;6;0;6;run044
6994;RRR;GGR;0;2;2;1;1;run044
6995;RRR;GRR;0;1;1;0;1;run044
6996;RRR;RGR;0;1;1;1;0;run044
6997;BBB;GRR;0;1;1;0;1;run045
6998;BBG;BBB;1;9;10;10;0;run045
6999;BBG;BBR;0;2;2;1;1;run045
7000;BBG;BGB;0;1;1;1;0;run045
7001;BBG;BGG;0;1;1;0;1;run045
7002;BBG;BRB;0;2;2;1;1;run045
7003;BBG;BRR;0;1;1;0;1;run045
7004;BBG;GBB;1;1;2;2;0;run045
7005;BBG;GBG;1;6;7;7;0;run045
7006;BBG;GGB;0;18;18;15;3;run045
7007;BBG;GGG;1;29;30;6;24;run045
7008;BBG;GGR;0;2;2;0;2;run045
7009;BBG;GRG;0;1;1;1;0;run045
7010;BBG;GRR;0;3;3;3;0;run045
7011;BBG;RBR;0;2;2;0;2;run045
7012;BBG;RGR;0;2;2;0;2;run045
7013;BBG;RRG;1;2;3;2;1;run045
7014;BBG;RRR;0;1;1;1;0;run045
7015;BGG;BBB;0;1;1;1;0;run045
7016;BGG;BRB;0;1;1;1;0;run045
7017;BGG;GGG;0;1;1;0;1;run045
7018;BGG;RBB;0;1;1;1;0;run045
7019;BGG;RBG;1;0;1;1;0;run045
7020;BRB;BBB;0;1;1;0;1;run045
7021;BRB;GGB;1;0;1;1;0;run045
7022;BRB;GGG;0;2;2;0;2;run045
7023;BRB;RBB;1;0;1;0;1;run045
7024;BRR;BBB;0;1;1;1;0;run045
7025;BRR;BRB;0;1;1;0;1;run045
7026;BRR;GBB;1;0;1;1;0;run045
7027;GBB;BBB;1;16;17;13;4;run045
7028;GBB;BBG;0;2;2;2;0;run045
7029;GBB;BGB;0;1;1;1;0;run045
7030;GBB;BGG;0;3;3;1;2;run045
7031;GBB;BRB;0;9;9;1;8;run045
7032;GBB;BRR;0;2;2;0;2;run045
7033;GBB;GBG;1;1;2;0;2;run045
7034;GBB;GGB;2;59;61;4;57;run045
7035;GBB;GGG;4;95;99;49;50;run045
7036;GBB;GGR;0;1;1;1;0;run045
7037;GBB;GRG;0;1;1;1;0;run045
7038;GBB;GRR;1;8;9;7;2;run045
7039;GBB;RBB;0;2;2;1;1;run045
7040;GBB;RBG;0;1;1;0;1;run045
7041;GBB;RBR;1;1;2;0;2;run045
7042;GBB;RGG;0;2;2;1;1;run045
7043;GBB;RGR;0;1;1;0;1;run045
7044;GBB;RRG;0;3;3;1;2;run045
7045;GBG;BRB;0;1;1;0;1;run045
7046;GBG;BRR;0;3;3;2;1;run045
7047;GBG;GGB;0;1;1;0;1;run045
7048;GBG;GGR;0;3;3;3;0;run045
7049;GBG;RBR;0;1;1;1;0;run045
7050;GBG;RGR;1;1;2;1;1;run045
7051;GBG;RRR;0;1;1;0;1;run045
7052;GGB;BBB;1;8;9;2;7;run045
7053;GGB;BBG;0;1;1;0;1;run045
7054;GGB;BGB;0;1;1;1;0;run045
7055;GGB;BRB;3;5;8;8;0;run045
7056;GGB;BRR;0;1;1;1;0;run045
7057;GGB;GBG;0;2;2;1;1;run045
7058;GGB;GGG;4;37;41;24;17;run045
7059;GGB;GGR;0;9;9;3;6;run045
7060;GGB;GRR;1;4;5;0;5;run045
7061;GGB;RBB;0;2;2;2;0;run045
7062;GGB;RBG;0;2;2;2;0;run045
7063;GGB;RBR;0;2;2;1;1;run045
7064;GGB;RGG;0;1;1;0;1;run045
7065;GGB;RGR;1;2;3;2;1;run045
7066;GGB;RRG;1;3;4;1;3;run045
7067;GGB;RRR;0;3;3;1;2;run045
7068;GGG;BBB;4;22;26;6;20;run045
7069;GGG;BBG;0;2;2;2;0;run045
7070;GGG;BBR;0;3;3;1;2;run045
7071;GGG;BGB;0;2;2;0;2;run045
7072;GGG;BGG;0;3;3;0;3;run045
7073;GGG;BRB;0;3;3;2;1;run045
7074;GGG;BRR;0;3;3;2;1;run045
7075;GGG;GBB;0;1;1;1;0;run045
7076;GGG;GGB;1;3;4;2;2;run045
7077;GGG;GGR;0;21;21;11;10;run045
7078;GGG;GRG;0;2;2;0;2;run045
7079;GGG;GRR;2;15;17;7;10;run045
7080;GGG;RBB;0;1;1;1;0;run045
7081;GGG;RBR;1;4;5;5;0;run045
7082;GGG;RGG;1;7;8;6;2;run045
7083;GGG;RGR;0;3;3;0;3;run045
7084;GGG;RRG;0;2;2;0;2;run045
7085;GGG;RRR;0;1;1;1;0;run045
7086;GGR;BBB;0;1;1;1;0;run045
7087;GGR;BGG;0;2;2;0;2;run045
7088;GGR;BRB;0;1;1;0;1;run045
7089;GRG;BBB;0;3;3;0;3;run045
7090;GRG;BGB;0;3;3;3;0;run045
7091;GRG;BGG;0;1;1;1;0;run045
7092;GRG;BRB;0;5;5;2;3;run045
7093;GRG;BRR;0;1;1;0;1;run045
7094;GRG;GBB;0;3;3;1;2;run045
7095;GRG;GGB;0;14;14;0;14;run045
7096;GRG;GGG;0;10;10;9;1;run045
7097;GRG;GGR;0;2;2;2;0;run045
7098;GRG;GRR;0;1;1;0;1;run045
7099;GRG;RBR;1;2;3;0;3;run045
7100;GRG;RGG;0;2;2;1;1;run045
7101;GRG;RGR;0;1;1;0;1;run045
7102;GRR;BBB;0;3;3;3;0;run045
7103;GRR;BBR;0;2;2;0;2;run045
7104;GRR;BRB;1;8;9;1;8;run045
7105;GRR;BRR;1;6;7;3;4;run045
7106;GRR;GBB;0;1;1;0;1;run045
7107;GRR;GBG;0;1;1;0;1;run045
7108;GRR;GGR;1;9;10;2;8;run045
7109;GRR;RBR;0;1;1;0;1;run045
7110;GRR;RGG;1;3;4;4;0;run045
7111;GRR;RGR;0;1;1;0;1;run045
7112;GRR;RRR;0;1;1;1;0;run045
7113;RBB;BBB;0;1;1;0;1;run045
7114;RBB;GGG;0;3;3;0;3;run045
7115;RBG;GRR;0;1;1;0;1;run045
7116;RBG;RBR;0;1;1;1;0;run045
7117;RBG;RGR;0;1;1;0;1;run045
7118;RBR;BBB;0;3;3;2;1;run045
7119;RBR;BRB;0;1;1;0;1;run045
7120;RBR;BRR;0;2;2;0;2;run045
7121;RBR;GGG;0;1;1;1;0;run045
7122;RBR;GGR;1;2;3;2;1;run045
7123;RBR;GRG;0;1;1;0;1;run045
7124;RBR;GRR;1;15;16;12;4;run045
7125;RBR;RGG;0;4;4;0;4;run045
7126;RBR;RGR;0;1;1;0;1;run045
7127;RBR;RRR;0;3;3;1;2;run045
7128;RGG;BGG;0;1;1;0;1;run045
7129;RGG;RGR;0;1;1;1;0;run045
7130;RGR;BBB;0;9;9;2;7;run045
7131;RGR;BBR;0;1;1;1;0;run045
7132;RGR;BGB;1;8;9;2;7;run045
7133;RGR;BRB;0;3;3;0;3;run045
7134;RGR;BRR;0;3;3;1;2;run045
7135;RGR;GBG;0;1;1;1;0;run045
7136;RGR;GGB;0;3;3;0;3;run045
7137;RGR;GGG;0;2;2;2;0;run045
7138;RGR;GGR;0;8;8;2;6;run045
7139;RGR;GRR;1;7;8;5;3;run045
7140;RGR;RGG;0;6;6;5;1;run045
7141;RRG;BGB;0;1;1;0;1;run045
7142;RRG;BRB;0;1;1;0;1;run045
7143;RRG;GGG;0;1;1;1;0;run045
7144;RRG;GGR;0;1;1;1;0;run045
7145;RRG;GRG;0;1;1;0;1;run045
7146;RRG;GRR;0;3;3;3;0;run045
7147;RRG;RBR;0;4;4;1;3;run045
7148;RRG;RGG;0;1;1;0;1;run045
7149;RRG;RGR;6;37;43;32;11;run045
7150;RRR;BRR;0;1;1;1;0;run045
7151;RRR;GGB;0;1;1;0;1;run045
7152;RRR;GGG;1;5;6;2;4;run045
7153;RRR;GGR;0;2;2;1;1;run045
7154;RRR;GRR;0;1;1;1;0;run045
7155;RRR;RGR;0;1;1;0;1;run045
7156;BBB;GRR;0;1;1;1;0;run046
7157;BBG;BBB;1;9;10;0;10;run046
7158;BBG;BBR;0;2;2;2;0;run046
7159;BBG;BGB;0;1;1;1;0;run046
7160;BBG;BGG;0;1;1;1;0;run046
7161;BBG;BRB;0;2;2;0;2;run046
7162;BBG;BRR;0;1;1;0;1;run046
7163;BBG;GBB;1;1;2;1;1;run046
7164;BBG;GBG;1;6;7;4;3;run046
7165;BBG;GGB;0;18;18;6;12;run046
7166;BBG;GGG;1;29;30;26;4;run046
7167;BBG;GGR;0;2;2;2;0;run046
7168;BBG;GRG;0;1;1;1;0;run046
7169;BBG;GRR;0;3;3;3;0;run046
7170;BBG;RBR;0;2;2;1;1;run046
7171;BBG;RGR;0;2;2;2;0;run046
7172;BBG;RRG;1;2;3;3;0;run046
7173;BBG;RRR;0;1;1;0;1;run046
7174;BGG;BBB;0;1;1;0;1;run046
7175;BGG;BRB;0;1;1;1;0;run046
7176;BGG;GGG;0;1;1;0;1;run046
7177;BGG;RBB;0;1;1;0;1;run046
7178;BGG;RBG;1;0;1;0;1;run046
7179;BRB;BBB;0;1;1;0;1;run046
7180;BRB;GGB;1;0;1;1;0;run046
7181;BRB;GGG;0;2;2;1;1;run046
7182;BRB;RBB;1;0;1;0;1;run046
7183;BRR;BBB;0;1;1;1;0;run046
7184;BRR;BRB;0;1;1;0;1;run046
7185;BRR;GBB;1;0;1;0;1;run046
7186;GBB;BBB;1;16;17;4;13;run046
7187;GBB;BBG;0;2;2;0;2;run046
7188;GBB;BGB;0;1;1;0;1;run046
7189;GBB;BGG;0;3;3;2;1;run046
7190;GBB;BRB;0;9;9;2;7;run046
7191;GBB;BRR;0;2;2;2;0;run046
7192;GBB;GBG;1;1;2;1;1;run046
7193;GBB;GGB;2;59;61;43;18;run046
7194;GBB;GGG;4;95;99;87;12;run046
7195;GBB;GGR;0;1;1;0;1;run046
7196;GBB;GRG;0;1;1;0;1;run046
7197;GBB;GRR;1;8;9;4;5;run046
7198;GBB;RBB;0;2;2;2;0;run046
7199;GBB;RBG;0;1;1;0;1;run046
7200;GBB;RBR;1;1;2;0;2;run046
7201;GBB;RGG;0;2;2;0;2;run046
7202;GBB;RGR;0;1;1;1;0;run046
7203;GBB;RRG;0;3;3;2;1;run046
7204;GBG;BRB;0;1;1;0;1;run046
7205;GBG;BRR;0;3;3;1;2;run046
7206;GBG;GGB;0;1;1;0;1;run046
7207;GBG;GGR;0;3;3;3;0;run046
7208;GBG;RBR;0;1;1;1;0;run046
7209;GBG;RGR;1;1;2;0;2;run046
7210;GBG;RRR;0;1;1;1;0;run046
7211;GGB;BBB;1;8;9;2;7;run046
7212;GGB;BBG;0;1;1;0;1;run046
7213;GGB;BGB;0;1;1;1;0;run046
7214;GGB;BRB;3;5;8;1;7;run046
7215;GGB;BRR;0;1;1;0;1;run046
7216;GGB;GBG;0;2;2;2;0;run046
7217;GGB;GGG;4;37;41;3;38;run046
7218;GGB;GGR;0;9;9;9;0;run046
7219;GGB;GRR;1;4;5;2;3;run046
7220;GGB;RBB;0;2;2;2;0;run046
7221;GGB;RBG;0;2;2;2;0;run046
7222;GGB;RBR;0;2;2;1;1;run046
7223;GGB;RGG;0;1;1;1;0;run046
7224;GGB;RGR;1;2;3;2;1;run046
7225;GGB;RRG;1;3;4;4;0;run046
7226;GGB;RRR;0;3;3;3;0;run046
7227;GGG;BBB;4;22;26;13;13;run046
7228;GGG;BBG;0;2;2;0;2;run046
7229;GGG;BBR;0;3;3;3;0;run046
7230;GGG;BGB;0;2;2;0;2;run046
7231;GGG;BGG;0;3;3;3;0;run046
7232;GGG;BRB;0;3;3;3;0;run046
7233;GGG;BRR;0;3;3;2;1;run046
7234;GGG;GBB;0;1;1;0;1;run046
7235;GGG;GGB;1;3;4;2;2;run046
7236;GGG;GGR;0;21;21;3;18;run046
7237;GGG;GRG;0;2;2;2;0;run046
7238;GGG;GRR;2;15;17;6;11;run046
7239;GGG;RBB;0;1;1;0;1;run046
7240;GGG;RBR;1;4;5;2;3;run046
7241;GGG;RGG;1;7;8;6;2;run046
7242;GGG;RGR;0;3;3;3;0;run046
7243;GGG;RRG;0;2;2;0;2;run046
7244;GGG;RRR;0;1;1;1;0;run046
7245;GGR;BBB;0;1;1;0;1;run046
7246;GGR;BGG;0;2;2;1;1;run046
7247;GGR;BRB;0;1;1;0;1;run046
7248;GRG;BBB;0;3;3;3;0;run046
7249;GRG;BGB;0;3;3;0;3;run046
7250;GRG;BGG;0;1;1;0;1;run046
7251;GRG;BRB;0;5;5;3;2;run046
7252;GRG;BRR;0;1;1;1;0;run046
7253;GRG;GBB;0;3;3;1;2;run046
7254;GRG;GGB;0;14;14;10;4;run046
7255;GRG;GGG;0;10;10;0;10;run046
7256;GRG;GGR;0;2;2;1;1;run046
7257;GRG;GRR;0;1;1;1;0;run046
7258;GRG;RBR;1;2;3;1;2;run046
7259;GRG;RGG;0;2;2;2;0;run046
7260;GRG;RGR;0;1;1;0;1;run046
7261;GRR;BBB;0;3;3;0;3;run046
7262;GRR;BBR;0;2;2;1;1;run046
7263;GRR;BRB;1;8;9;8;1;run046
7264;GRR;BRR;1;6;7;7;0;run046
7265;GRR;GBB;0;1;1;0;1;run046
7266;GRR;GBG;0;1;1;1;0;run046
7267;GRR;GGR;1;9;10;5;5;run046
7268;GRR;RBR;0;1;1;0;1;run046
7269;GRR;RGG;1;3;4;4;0;run046
7270;GRR;RGR;0;1;1;1;0;run046
7271;GRR;RRR;0;1;1;1;0;run046
7272;RBB;BBB;0;1;1;1;0;run046
7273;RBB;GGG;0;3;3;3;0;run046
7274;RBG;GRR;0;1;1;1;0;run046
7275;RBG;RBR;0;1;1;1;0;run046
7276;RBG;RGR;0;1;1;0;1;run046
7277;RBR;BBB;0;3;3;3;0;run046
7278;RBR;BRB;0;1;1;1;0;run046
7279;RBR;BRR;0;2;2;0;2;run046
7280;RBR;GGG;0;1;1;1;0;run046
7281;RBR;GGR;1;2;3;3;0;run046
7282;RBR;GRG;0;1;1;0;1;run046
7283;RBR;GRR;1;15;16;10;6;run046
7284;RBR;RGG;0;4;4;3;1;run046
7285;RBR;RGR;0;1;1;0;1;run046
7286;RBR;RRR;0;3;3;2;1;run046
7287;RGG;BGG;0;1;1;1;0;run046
7288;RGG;RGR;0;1;1;0;1;run046
7289;RGR;BBB;0;9;9;6;3;run046
7290;RGR;BBR;0;1;1;1;0;run046
7291;RGR;BGB;1;8;9;6;3;run046
7292;RGR;BRB;0;3;3;2;1;run046
7293;RGR;BRR;0;3;3;0;3;run046
7294;RGR;GBG;0;1;1;1;0;run046
7295;RGR;GGB;0;3;3;0;3;run046
7296;RGR;GGG;0;2;2;2;0;run046
7297;RGR;GGR;0;8;8;0;8;run046
7298;RGR;GRR;1;7;8;5;3;run046
7299;RGR;RGG;0;6;6;4;2;run046
7300;RRG;BGB;0;1;1;0;1;run046
7301;RRG;BRB;0;1;1;0;1;run046
7302;RRG;GGG;0;1;1;1;0;run046
7303;RRG;GGR;0;1;1;0;1;run046
7304;RRG;GRG;0;1;1;0;1;run046
7305;RRG;GRR;0;3;3;3;0;run046
7306;RRG;RBR;0;4;4;0;4;run046
7307;RRG;RGG;0;1;1;0;1;run046
7308;RRG;RGR;6;37;43;17;26;run046
7309;RRR;BRR;0;1;1;0;1;run046
7310;RRR;GGB;0;1;1;0;1;run046
7311;RRR;GGG;1;5;6;0;6;run046
7312;RRR;GGR;0;2;2;0;2;run046
7313;RRR;GRR;0;1;1;1;0;run046
7314;RRR;RGR;0;1;1;1;0;run046
7315;BBB;GRR;0;1;1;0;1;run047
7316;BBG;BBB;1;9;10;8;2;run047
7317;BBG;BBR;0;2;2;1;1;run047
7318;BBG;BGB;0;1;1;0;1;run047
7319;BBG;BGG;0;1;1;1;0;run047
7320;BBG;BRB;0;2;2;0;2;run047
7321;BBG;BRR;0;1;1;1;0;run047
7322;BBG;GBB;1;1;2;0;2;run047
7323;BBG;GBG;1;6;7;6;1;run047
7324;BBG;GGB;0;18;18;5;13;run047
7325;BBG;GGG;1;29;30;8;22;run047
7326;BBG;GGR;0;2;2;1;1;run047
7327;BBG;GRG;0;1;1;1;0;run047
7328;BBG;GRR;0;3;3;0;3;run047
7329;BBG;RBR;0;2;2;0;2;run047
7330;BBG;RGR;0;2;2;0;2;run047
7331;BBG;RRG;1;2;3;3;0;run047
7332;BBG;RRR;0;1;1;0;1;run047
7333;BGG;BBB;0;1;1;0;1;run047
7334;BGG;BRB;0;1;1;1;0;run047
7335;BGG;GGG;0;1;1;0;1;run047
7336;BGG;RBB;0;1;1;0;1;run047
7337;BGG;RBG;1;0;1;1;0;run047
7338;BRB;BBB;0;1;1;0;1;run047
7339;BRB;GGB;1;0;1;1;0;run047
7340;BRB;GGG;0;2;2;0;2;run047
7341;BRB;RBB;1;0;1;1;0;run047
7342;BRR;BBB;0;1;1;0;1;run047
7343;BRR;BRB;0;1;1;1;0;run047
7344;BRR;GBB;1;0;1;0;1;run047
7345;GBB;BBB;1;16;17;16;1;run047
7346;GBB;BBG;0;2;2;1;1;run047
7347;GBB;BGB;0;1;1;1;0;run047
7348;GBB;BGG;0;3;3;0;3;run047
7349;GBB;BRB;0;9;9;4;5;run047
7350;GBB;BRR;0;2;2;0;2;run047
7351;GBB;GBG;1;1;2;0;2;run047
7352;GBB;GGB;2;59;61;20;41;run047
7353;GBB;GGG;4;95;99;47;52;run047
7354;GBB;GGR;0;1;1;0;1;run047
7355;GBB;GRG;0;1;1;0;1;run047
7356;GBB;GRR;1;8;9;7;2;run047
7357;GBB;RBB;0;2;2;1;1;run047
7358;GBB;RBG;0;1;1;1;0;run047
7359;GBB;RBR;1;1;2;0;2;run047
7360;GBB;RGG;0;2;2;2;0;run047
7361;GBB;RGR;0;1;1;0;1;run047
7362;GBB;RRG;0;3;3;1;2;run047
7363;GBG;BRB;0;1;1;0;1;run047
7364;GBG;BRR;0;3;3;3;0;run047
7365;GBG;GGB;0;1;1;0;1;run047
7366;GBG;GGR;0;3;3;2;1;run047
7367;GBG;RBR;0;1;1;1;0;run047
7368;GBG;RGR;1;1;2;0;2;run047
7369;GBG;RRR;0;1;1;1;0;run047
7370;GGB;BBB;1;8;9;2;7;run047
7371;GGB;BBG;0;1;1;0;1;run047
7372;GGB;BGB;0;1;1;1;0;run047
7373;GGB;BRB;3;5;8;1;7;run047
7374;GGB;BRR;0;1;1;1;0;run047
7375;GGB;GBG;0;2;2;2;0;run047
7376;GGB;GGG;4;37;41;23;18;run047
7377;GGB;GGR;0;9;9;2;7;run047
7378;GGB;GRR;1;4;5;1;4;run047
7379;GGB;RBB;0;2;2;2;0;run047
7380;GGB;RBG;0;2;2;2;0;run047
7381;GGB;RBR;0;2;2;1;1;run047
7382;GGB;RGG;0;1;1;1;0;run047
7383;GGB;RGR;1;2;3;2;1;run047
7384;GGB;RRG;1;3;4;4;0;run047
7385;GGB;RRR;0;3;3;1;2;run047
7386;GGG;BBB;4;22;26;0;26;run047
7387;GGG;BBG;0;2;2;2;0;run047
7388;GGG;BBR;0;3;3;2;1;run047
7389;GGG;BGB;0;2;2;1;1;run047
7390;GGG;BGG;0;3;3;2;1;run047
7391;GGG;BRB;0;3;3;1;2;run047
7392;GGG;BRR;0;3;3;0;3;run047
7393;GGG;GBB;0;1;1;0;1;run047
7394;GGG;GGB;1;3;4;3;1;run047
7395;GGG;GGR;0;21;21;0;21;run047
7396;GGG;GRG;0;2;2;2;0;run047
7397;GGG;GRR;2;15;17;12;5;run047
7398;GGG;RBB;0;1;1;0;1;run047
7399;GGG;RBR;1;4;5;2;3;run047
7400;GGG;RGG;1;7;8;6;2;run047
7401;GGG;RGR;0;3;3;2;1;run047
7402;GGG;RRG;0;2;2;1;1;run047
7403;GGG;RRR;0;1;1;0;1;run047
7404;GGR;BBB;0;1;1;0;1;run047
7405;GGR;BGG;0;2;2;2;0;run047
7406;GGR;BRB;0;1;1;1;0;run047
7407;GRG;BBB;0;3;3;3;0;run047
7408;GRG;BGB;0;3;3;3;0;run047
7409;GRG;BGG;0;1;1;0;1;run047
7410;GRG;BRB;0;5;5;2;3;run047
7411;GRG;BRR;0;1;1;1;0;run047
7412;GRG;GBB;0;3;3;2;1;run047
7413;GRG;GGB;0;14;14;8;6;run047
7414;GRG;GGG;0;10;10;2;8;run047
7415;GRG;GGR;0;2;2;2;0;run047
7416;GRG;GRR;0;1;1;0;1;run047
7417;GRG;RBR;1;2;3;2;1;run047
7418;GRG;RGG;0;2;2;0;2;run047
7419;GRG;RGR;0;1;1;0;1;run047
7420;GRR;BBB;0;3;3;3;0;run047
7421;GRR;BBR;0;2;2;1;1;run047
7422;GRR;BRB;1;8;9;7;2;run047
7423;GRR;BRR;1;6;7;3;4;run047
7424;GRR;GBB;0;1;1;0;1;run047
7425;GRR;GBG;0;1;1;1;0;run047
7426;GRR;GGR;1;9;10;10;0;run047
7427;GRR;RBR;0;1;1;0;1;run047
7428;GRR;RGG;1;3;4;4;0;run047
7429;GRR;RGR;0;1;1;1;0;run047
7430;GRR;RRR;0;1;1;1;0;run047
7431;RBB;BBB;0;1;1;1;0;run047
7432;RBB;GGG;0;3;3;2;1;run047
7433;RBG;GRR;0;1;1;0;1;run047
7434;RBG;RBR;0;1;1;1;0;run047
7435;RBG;RGR;0;1;1;0;1;run047
7436;RBR;BBB;0;3;3;1;2;run047
7437;RBR;BRB;0;1;1;0;1;run047
7438;RBR;BRR;0;2;2;0;2;run047
7439;RBR;GGG;0;1;1;0;1;run047
7440;RBR;GGR;1;2;3;2;1;run047
7441;RBR;GRG;0;1;1;0;1;run047
7442;RBR;GRR;1;15;16;3;13;run047
7443;RBR;RGG;0;4;4;2;2;run047
7444;RBR;RGR;0;1;1;0;1;run047
7445;RBR;RRR;0;3;3;1;2;run047
7446;RGG;BGG;0;1;1;0;1;run047
7447;RGG;RGR;0;1;1;1;0;run047
7448;RGR;BBB;0;9;9;7;2;run047
7449;RGR;BBR;0;1;1;1;0;run047
7450;RGR;BGB;1;8;9;3;6;run047
7451;RGR;BRB;0;3;3;1;2;run047
7452;RGR;BRR;0;3;3;2;1;run047
7453;RGR;GBG;0;1;1;0;1;run047
7454;RGR;GGB;0;3;3;3;0;run047
7455;RGR;GGG;0;2;2;0;2;run047
7456;RGR;GGR;0;8;8;8;0;run047
7457;RGR;GRR;1;7;8;6;2;run047
7458;RGR;RGG;0;6;6;2;4;run047
7459;RRG;BGB;0;1;1;1;0;run047
7460;RRG;BRB;0;1;1;0;1;run047
7461;RRG;GGG;0;1;1;1;0;run047
7462;RRG;GGR;0;1;1;1;0;run047
7463;RRG;GRG;0;1;1;1;0;run047
7464;RRG;GRR;0;3;3;0;3;run047
7465;RRG;RBR;0;4;4;4;0;run047
7466;RRG;RGG;0;1;1;1;0;run047
7467;RRG;RGR;6;37;43;2;41;run047
7468;RRR;BRR;0;1;1;0;1;run047
7469;RRR;GGB;0;1;1;0;1;run047
7470;RRR;GGG;1;5;6;2;4;run047
7471;RRR;GGR;0;2;2;1;1;run047
7472;RRR;GRR;0;1;1;1;0;run047
7473;RRR;RGR;0;1;1;0;1;run047
7474;BBB;GRR;0;1;1;0;1;run048
7475;BBG;BBB;1;9;10;9;1;run048
7476;BBG;BBR;0;2;2;2;0;run048
7477;BBG;BGB;0;1;1;0;1;run048
7478;BBG;BGG;0;1;1;0;1;run048
7479;BBG;BRB;0;2;2;2;0;run048
7480;BBG;BRR;0;1;1;0;1;run048
7481;BBG;GBB;1;1;2;2;0;run048
7482;BBG;GBG;1;6;7;1;6;run048
7483;BBG;GGB;0;18;18;11;7;run048
7484;BBG;GGG;1;29;30;24;6;run048
7485;BBG;GGR;0;2;2;0;2;run048
7486;BBG;GRG;0;1;1;1;0;run048
7487;BBG;GRR;0;3;3;0;3;run048
7488;BBG;RBR;0;2;2;2;0;run048
7489;BBG;RGR;0;2;2;0;2;run048
7490;BBG;RRG;1;2;3;0;3;run048
7491;BBG;RRR;0;1;1;0;1;run048
7492;BGG;BBB;0;1;1;0;1;run048
7493;BGG;BRB;0;1;1;1;0;run048
7494;BGG;GGG;0;1;1;0;1;run048
7495;BGG;RBB;0;1;1;0;1;run048
7496;BGG;RBG;1;0;1;0;1;run048
7497;BRB;BBB;0;1;1;1;0;run048
7498;BRB;GGB;1;0;1;0;1;run048
7499;BRB;GGG;0;2;2;1;1;run048
7500;BRB;RBB;1;0;1;1;0;run048
7501;BRR;BBB;0;1;1;0;1;run048
7502;BRR;BRB;0;1;1;1;0;run048
7503;BRR;GBB;1;0;1;1;0;run048
7504;GBB;BBB;1;16;17;10;7;run048
7505;GBB;BBG;0;2;2;2;0;run048
7506;GBB;BGB;0;1;1;0;1;run048
7507;GBB;BGG;0;3;3;1;2;run048
7508;GBB;BRB;0;9;9;7;2;run048
7509;GBB;BRR;0;2;2;0;2;run048
7510;GBB;GBG;1;1;2;1;1;run048
7511;GBB;GGB;2;59;61;56;5;run048
7512;GBB;GGG;4;95;99;42;57;run048
7513;GBB;GGR;0;1;1;1;0;run048
7514;GBB;GRG;0;1;1;0;1;run048
7515;GBB;GRR;1;8;9;8;1;run048
7516;GBB;RBB;0;2;2;2;0;run048
7517;GBB;RBG;0;1;1;0;1;run048
7518;GBB;RBR;1;1;2;0;2;run048
7519;GBB;RGG;0;2;2;0;2;run048
7520;GBB;RGR;0;1;1;1;0;run048
7521;GBB;RRG;0;3;3;0;3;run048
7522;GBG;BRB;0;1;1;0;1;run048
7523;GBG;BRR;0;3;3;3;0;run048
7524;GBG;GGB;0;1;1;1;0;run048
7525;GBG;GGR;0;3;3;1;2;run048
7526;GBG;RBR;0;1;1;1;0;run048
7527;GBG;RGR;1;1;2;1;1;run048
7528;GBG;RRR;0;1;1;1;0;run048
7529;GGB;BBB;1;8;9;2;7;run048
7530;GGB;BBG;0;1;1;1;0;run048
7531;GGB;BGB;0;1;1;1;0;run048
7532;GGB;BRB;3;5;8;3;5;run048
7533;GGB;BRR;0;1;1;0;1;run048
7534;GGB;GBG;0;2;2;0;2;run048
7535;GGB;GGG;4;37;41;7;34;run048
7536;GGB;GGR;0;9;9;6;3;run048
7537;GGB;GRR;1;4;5;4;1;run048
7538;GGB;RBB;0;2;2;0;2;run048
7539;GGB;RBG;0;2;2;2;0;run048
7540;GGB;RBR;0;2;2;2;0;run048
7541;GGB;RGG;0;1;1;1;0;run048
7542;GGB;RGR;1;2;3;0;3;run048
7543;GGB;RRG;1;3;4;1;3;run048
7544;GGB;RRR;0;3;3;3;0;run048
7545;GGG;BBB;4;22;26;15;11;run048
7546;GGG;BBG;0;2;2;2;0;run048
7547;GGG;BBR;0;3;3;0;3;run048
7548;GGG;BGB;0;2;2;1;1;run048
7549;GGG;BGG;0;3;3;2;1;run048
7550;GGG;BRB;0;3;3;2;1;run048
7551;GGG;BRR;0;3;3;2;1;run048
7552;GGG;GBB;0;1;1;1;0;run048
7553;GGG;GGB;1;3;4;4;0;run048
7554;GGG;GGR;0;21;21;4;17;run048
7555;GGG;GRG;0;2;2;2;0;run048
7556;GGG;GRR;2;15;17;4;13;run048
7557;GGG;RBB;0;1;1;1;0;run048
7558;GGG;RBR;1;4;5;5;0;run048
7559;GGG;RGG;1;7;8;3;5;run048
7560;GGG;RGR;0;3;3;0;3;run048
7561;GGG;RRG;0;2;2;1;1;run048
7562;GGG;RRR;0;1;1;0;1;run048
7563;GGR;BBB;0;1;1;0;1;run048
7564;GGR;BGG;0;2;2;2;0;run048
7565;GGR;BRB;0;1;1;0;1;run048
7566;GRG;BBB;0;3;3;0;3;run048
7567;GRG;BGB;0;3;3;0;3;run048
7568;GRG;BGG;0;1;1;1;0;run048
7569;GRG;BRB;0;5;5;1;4;run048
7570;GRG;BRR;0;1;1;1;0;run048
7571;GRG;GBB;0;3;3;1;2;run048
7572;GRG;GGB;0;14;14;1;13;run048
7573;GRG;GGG;0;10;10;9;1;run048
7574;GRG;GGR;0;2;2;0;2;run048
7575;GRG;GRR;0;1;1;0;1;run048
7576;GRG;RBR;1;2;3;2;1;run048
7577;GRG;RGG;0;2;2;2;0;run048
7578;GRG;RGR;0;1;1;1;0;run048
7579;GRR;BBB;0;3;3;2;1;run048
7580;GRR;BBR;0;2;2;2;0;run048
7581;GRR;BRB;1;8;9;3;6;run048
7582;GRR;BRR;1;6;7;4;3;run048
7583;GRR;GBB;0;1;1;1;0;run048
7584;GRR;GBG;0;1;1;1;0;run048
7585;GRR;GGR;1;9;10;5;5;run048
7586;GRR;RBR;0;1;1;0;1;run048
7587;GRR;RGG;1;3;4;4;0;run048
7588;GRR;RGR;0;1;1;1;0;run048
7589;GRR;RRR;0;1;1;0;1;run048
7590;RBB;BBB;0;1;1;0;1;run048
7591;RBB;GGG;0;3;3;0;3;run048
7592;RBG;GRR;0;1;1;1;0;run048
7593;RBG;RBR;0;1;1;1;0;run048
7594;RBG;RGR;0;1;1;0;1;run048
7595;RBR;BBB;0;3;3;2;1;run048
7596;RBR;BRB;0;1;1;1;0;run048
7597;RBR;BRR;0;2;2;2;0;run048
7598;RBR;GGG;0;1;1;0;1;run048
7599;RBR;GGR;1;2;3;3;0;run048
7600;RBR;GRG;0;1;1;0;1;run048
7601;RBR;GRR;1;15;16;16;0;run048
7602;RBR;RGG;0;4;4;3;1;run048
7603;RBR;RGR;0;1;1;1;0;run048
7604;RBR;RRR;0;3;3;1;2;run048
7605;RGG;BGG;0;1;1;0;1;run048
7606;RGG;RGR;0;1;1;1;0;run048
7607;RGR;BBB;0;9;9;4;5;run048
7608;RGR;BBR;0;1;1;0;1;run048
7609;RGR;BGB;1;8;9;4;5;run048
7610;RGR;BRB;0;3;3;0;3;run048
7611;RGR;BRR;0;3;3;1;2;run048
7612;RGR;GBG;0;1;1;1;0;run048
7613;RGR;GGB;0;3;3;2;1;run048
7614;RGR;GGG;0;2;2;2;0;run048
7615;RGR;GGR;0;8;8;4;4;run048
7616;RGR;GRR;1;7;8;8;0;run048
7617;RGR;RGG;0;6;6;5;1;run048
7618;RRG;BGB;0;1;1;1;0;run048
7619;RRG;BRB;0;1;1;0;1;run048
7620;RRG;GGG;0;1;1;0;1;run048
7621;RRG;GGR;0;1;1;0;1;run048
7622;RRG;GRG;0;1;1;1;0;run048
7623;RRG;GRR;0;3;3;2;1;run048
7624;RRG;RBR;0;4;4;2;2;run048
7625;RRG;RGG;0;1;1;0;1;run048
7626;RRG;RGR;6;37;43;9;34;run048
7627;RRR;BRR;0;1;1;1;0;run048
7628;RRR;GGB;0;1;1;0;1;run048
7629;RRR;GGG;1;5;6;1;5;run048
7630;RRR;GGR;0;2;2;2;0;run048
7631;RRR;GRR;0;1;1;0;1;run048
7632;RRR;RGR;0;1;1;1;0;run048
7633;BBB;GRR;0;1;1;0;1;run049
7634;BBG;BBB;1;9;10;4;6;run049
7635;BBG;BBR;0;2;2;2;0;run049
7636;BBG;BGB;0;1;1;0;1;run049
7637;BBG;BGG;0;1;1;0;1;run049
7638;BBG;BRB;0;2;2;2;0;run049
7639;BBG;BRR;0;1;1;1;0;run049
7640;BBG;GBB;1;1;2;1;1;run049
7641;BBG;GBG;1;6;7;2;5;run049
7642;BBG;GGB;0;18;18;14;4;run049
7643;BBG;GGG;1;29;30;7;23;run049
7644;BBG;GGR;0;2;2;2;0;run049
7645;BBG;GRG;0;1;1;0;1;run049
7646;BBG;GRR;0;3;3;3;0;run049
7647;BBG;RBR;0;2;2;0;2;run049
7648;BBG;RGR;0;2;2;2;0;run049
7649;BBG;RRG;1;2;3;1;2;run049
7650;BBG;RRR;0;1;1;1;0;run049
7651;BGG;BBB;0;1;1;0;1;run049
7652;BGG;BRB;0;1;1;0;1;run049
7653;BGG;GGG;0;1;1;1;0;run049
7654;BGG;RBB;0;1;1;0;1;run049
7655;BGG;RBG;1;0;1;0;1;run049
7656;BRB;BBB;0;1;1;1;0;run049
7657;BRB;GGB;1;0;1;0;1;run049
7658;BRB;GGG;0;2;2;0;2;run049
7659;BRB;RBB;1;0;1;0;1;run049
7660;BRR;BBB;0;1;1;1;0;run049
7661;BRR;BRB;0;1;1;1;0;run049
7662;BRR;GBB;1;0;1;0;1;run049
7663;GBB;BBB;1;16;17;1;16;run049
7664;GBB;BBG;0;2;2;0;2;run049
7665;GBB;BGB;0;1;1;0;1;run049
7666;GBB;BGG;0;3;3;3;0;run049
7667;GBB;BRB;0;9;9;9;0;run049
7668;GBB;BRR;0;2;2;0;2;run049
7669;GBB;GBG;1;1;2;2;0;run049
7670;GBB;GGB;2;59;61;38;23;run049
7671;GBB;GGG;4;95;99;60;39;run049
7672;GBB;GGR;0;1;1;0;1;run049
7673;GBB;GRG;0;1;1;1;0;run049
7674;GBB;GRR;1;8;9;0;9;run049
7675;GBB;RBB;0;2;2;2;0;run049
7676;GBB;RBG;0;1;1;0;1;run049
7677;GBB;RBR;1;1;2;1;1;run049
7678;GBB;RGG;0;2;2;0;2;run049
7679;GBB;RGR;0;1;1;1;0;run049
7680;GBB;RRG;0;3;3;1;2;run049
7681;GBG;BRB;0;1;1;0;1;run049
7682;GBG;BRR;0;3;3;0;3;run049
7683;GBG;GGB;0;1;1;0;1;run049
7684;GBG;GGR;0;3;3;3;0;run049
7685;GBG;RBR;0;1;1;0;1;run049
7686;GBG;RGR;1;1;2;1;1;run049
7687;GBG;RRR;0;1;1;1;0;run049
7688;GGB;BBB;1;8;9;2;7;run049
7689;GGB;BBG;0;1;1;0;1;run049
7690;GGB;BGB;0;1;1;1;0;run049
7691;GGB;BRB;3;5;8;0;8;run049
7692;GGB;BRR;0;1;1;1;0;run049
7693;GGB;GBG;0;2;2;2;0;run049
7694;GGB;GGG;4;37;41;2;39;run049
7695;GGB;GGR;0;9;9;4;5;run049
7696;GGB;GRR;1;4;5;4;1;run049
7697;GGB;RBB;0;2;2;1;1;run049
7698;GGB;RBG;0;2;2;1;1;run049
7699;GGB;RBR;0;2;2;0;2;run049
7700;GGB;RGG;0;1;1;1;0;run049
7701;GGB;RGR;1;2;3;1;2;run049
7702;GGB;RRG;1;3;4;0;4;run049
7703;GGB;RRR;0;3;3;2;1;run049
7704;GGG;BBB;4;22;26;26;0;run049
7705;GGG;BBG;0;2;2;2;0;run049
7706;GGG;BBR;0;3;3;2;1;run049
7707;GGG;BGB;0;2;2;1;1;run049
7708;GGG;BGG;0;3;3;1;2;run049
7709;GGG;BRB;0;3;3;0;3;run049
7710;GGG;BRR;0;3;3;1;2;run049
7711;GGG;GBB;0;1;1;0;1;run049
7712;GGG;GGB;1;3;4;1;3;run049
7713;GGG;GGR;0;21;21;4;17;run049
7714;GGG;GRG;0;2;2;2;0;run049
7715;GGG;GRR;2;15;17;9;8;run049
7716;GGG;RBB;0;1;1;0;1;run049
7717;GGG;RBR;1;4;5;2;3;run049
7718;GGG;RGG;1;7;8;8;0;run049
7719;GGG;RGR;0;3;3;3;0;run049
7720;GGG;RRG;0;2;2;2;0;run049
7721;GGG;RRR;0;1;1;1;0;run049
7722;GGR;BBB;0;1;1;1;0;run049
7723;GGR;BGG;0;2;2;0;2;run049
7724;GGR;BRB;0;1;1;1;0;run049
7725;GRG;BBB;0;3;3;1;2;run049
7726;GRG;BGB;0;3;3;0;3;run049
7727;GRG;BGG;0;1;1;0;1;run049
7728;GRG;BRB;0;5;5;3;2;run049
7729;GRG;BRR;0;1;1;0;1;run049
7730;GRG;GBB;0;3;3;3;0;run049
7731;GRG;GGB;0;14;14;7;7;run049
7732;GRG;GGG;0;10;10;6;4;run049
7733;GRG;GGR;0;2;2;0;2;run049
7734;GRG;GRR;0;1;1;1;0;run049
7735;GRG;RBR;1;2;3;3;0;run049
7736;GRG;RGG;0;2;2;1;1;run049
7737;GRG;RGR;0;1;1;0;1;run049
7738;GRR;BBB;0;3;3;2;1;run049
7739;GRR;BBR;0;2;2;2;0;run049
7740;GRR;BRB;1;8;9;0;9;run049
7741;GRR;BRR;1;6;7;2;5;run049
7742;GRR;GBB;0;1;1;1;0;run049
7743;GRR;GBG;0;1;1;0;1;run049
7744;GRR;GGR;1;9;10;7;3;run049
7745;GRR;RBR;0;1;1;1;0;run049
7746;GRR;RGG;1;3;4;4;0;run049
7747;GRR;RGR;0;1;1;0;1;run049
7748;GRR;RRR;0;1;1;0;1;run049
7749;RBB;BBB;0;1;1;1;0;run049
7750;RBB;GGG;0;3;3;1;2;run049
7751;RBG;GRR;0;1;1;0;1;run049
7752;RBG;RBR;0;1;1;0;1;run049
7753;RBG;RGR;0;1;1;1;0;run049
7754;RBR;BBB;0;3;3;0;3;run049
7755;RBR;BRB;0;1;1;1;0;run049
7756;RBR;BRR;0;2;2;1;1;run049
7757;RBR;GGG;0;1;1;1;0;run049
7758;RBR;GGR;1;2;3;2;1;run049
7759;RBR;GRG;0;1;1;0;1;run049
7760;RBR;GRR;1;15;16;1;15;run049
7761;RBR;RGG;0;4;4;3;1;run049
7762;RBR;RGR;0;1;1;1;0;run049
7763;RBR;RRR;0;3;3;2;1;run049
7764;RGG;BGG;0;1;1;1;0;run049
7765;RGG;RGR;0;1;1;0;1;run049
7766;RGR;BBB;0;9;9;5;4;run049
7767;RGR;BBR;0;1;1;0;1;run049
7768;RGR;BGB;1;8;9;7;2;run049
7769;RGR;BRB;0;3;3;1;2;run049
7770;RGR;BRR;0;3;3;3;0;run049
7771;RGR;GBG;0;1;1;1;0;run049
7772;RGR;GGB;0;3;3;3;0;run049
7773;RGR;GGG;0;2;2;2;0;run049
7774;RGR;GGR;0;8;8;0;8;run049
7775;RGR;GRR;1;7;8;1;7;run049
7776;RGR;RGG;0;6;6;1;5;run049
7777;RRG;BGB;0;1;1;0;1;run049
7778;RRG;BRB;0;1;1;1;0;run049
7779;RRG;GGG;0;1;1;1;0;run049
7780;RRG;GGR;0;1;1;0;1;run049
7781;RRG;GRG;0;1;1;0;1;run049
7782;RRG;GRR;0;3;3;0;3;run049
7783;RRG;RBR;0;4;4;1;3;run049
7784;RRG;RGG;0;1;1;1;0;run049
7785;RRG;RGR;6;37;43;15;28;run049
7786;RRR;BRR;0;1;1;0;1;run049
7787;RRR;GGB;0;1;1;1;0;run049
7788;RRR;GGG;1;5;6;2;4;run049
7789;RRR;GGR;0;2;2;2;0;run049
7790;RRR;GRR;0;1;1;1;0;run049
7791;RRR;RGR;0;1;1;0;1;run049
7792;BBB;GRR;0;1;1;1;0;run050
7793;BBG;BBB;1;9;10;10;0;run050
7794;BBG;BBR;0;2;2;2;0;run050
7795;BBG;BGB;0;1;1;0;1;run050
7796;BBG;BGG;0;1;1;1;0;run050
7797;BBG;BRB;0;2;2;1;1;run050
7798;BBG;BRR;0;1;1;0;1;run050
7799;BBG;GBB;1;1;2;2;0;run050
7800;BBG;GBG;1;6;7;7;0;run050
7801;BBG;GGB;0;18;18;15;3;run050
7802;BBG;GGG;1;29;30;17;13;run050
7803;BBG;GGR;0;2;2;2;0;run050
7804;BBG;GRG;0;1;1;0;1;run050
7805;BBG;GRR;0;3;3;0;3;run050
7806;BBG;RBR;0;2;2;2;0;run050
7807;BBG;RGR;0;2;2;1;1;run050
7808;BBG;RRG;1;2;3;2;1;run050
7809;BBG;RRR;0;1;1;1;0;run050
7810;BGG;BBB;0;1;1;0;1;run050
7811;BGG;BRB;0;1;1;1;0;run050
7812;BGG;GGG;0;1;1;0;1;run050
7813;BGG;RBB;0;1;1;1;0;run050
7814;BGG;RBG;1;0;1;0;1;run050
7815;BRB;BBB;0;1;1;0;1;run050
7816;BRB;GGB;1;0;1;1;0;run050
7817;BRB;GGG;0;2;2;1;1;run050
7818;BRB;RBB;1;0;1;0;1;run050
7819;BRR;BBB;0;1;1;1;0;run050
7820;BRR;BRB;0;1;1;1;0;run050
7821;BRR;GBB;1;0;1;0;1;run050
7822;GBB;BBB;1;16;17;1;16;run050
7823;GBB;BBG;0;2;2;0;2;run050
7824;GBB;BGB;0;1;1;1;0;run050
7825;GBB;BGG;0;3;3;2;1;run050
7826;GBB;BRB;0;9;9;9;0;run050
7827;GBB;BRR;0;2;2;2;0;run050
7828;GBB;GBG;1;1;2;2;0;run050
7829;GBB;GGB;2;59;61;6;55;run050
7830;GBB;GGG;4;95;99;84;15;run050
7831;GBB;GGR;0;1;1;1;0;run050
7832;GBB;GRG;0;1;1;1;0;run050
7833;GBB;GRR;1;8;9;3;6;run050
7834;GBB;RBB;0;2;2;2;0;run050
7835;GBB;RBG;0;1;1;1;0;run050
7836;GBB;RBR;1;1;2;2;0;run050
7837;GBB;RGG;0;2;2;1;1;run050
7838;GBB;RGR;0;1;1;0;1;run050
7839;GBB;RRG;0;3;3;3;0;run050
7840;GBG;BRB;0;1;1;0;1;run050
7841;GBG;BRR;0;3;3;3;0;run050
7842;GBG;GGB;0;1;1;1;0;run050
7843;GBG;GGR;0;3;3;1;2;run050
7844;GBG;RBR;0;1;1;0;1;run050
7845;GBG;RGR;1;1;2;1;1;run050
7846;GBG;RRR;0;1;1;1;0;run050
7847;GGB;BBB;1;8;9;1;8;run050
7848;GGB;BBG;0;1;1;1;0;run050
7849;GGB;BGB;0;1;1;0;1;run050
7850;GGB;BRB;3;5;8;7;1;run050
7851;GGB;BRR;0;1;1;1;0;run050
7852;GGB;GBG;0;2;2;1;1;run050
7853;GGB;GGG;4;37;41;14;27;run050
7854;GGB;GGR;0;9;9;3;6;run050
7855;GGB;GRR;1;4;5;3;2;run050
7856;GGB;RBB;0;2;2;2;0;run050
7857;GGB;RBG;0;2;2;2;0;run050
7858;GGB;RBR;0;2;2;0;2;run050
7859;GGB;RGG;0;1;1;0;1;run050
7860;GGB;RGR;1;2;3;3;0;run050
7861;GGB;RRG;1;3;4;2;2;run050
7862;GGB;RRR;0;3;3;0;3;run050
7863;GGG;BBB;4;22;26;19;7;run050
7864;GGG;BBG;0;2;2;0;2;run050
7865;GGG;BBR;0;3;3;1;2;run050
7866;GGG;BGB;0;2;2;1;1;run050
7867;GGG;BGG;0;3;3;1;2;run050
7868;GGG;BRB;0;3;3;1;2;run050
7869;GGG;BRR;0;3;3;0;3;run050
7870;GGG;GBB;0;1;1;1;0;run050
7871;GGG;GGB;1;3;4;4;0;run050
7872;GGG;GGR;0;21;21;11;10;run050
7873;GGG;GRG;0;2;2;2;0;run050
7874;GGG;GRR;2;15;17;11;6;run050
7875;GGG;RBB;0;1;1;1;0;run050
7876;GGG;RBR;1;4;5;5;0;run050
7877;GGG;RGG;1;7;8;6;2;run050
7878;GGG;RGR;0;3;3;2;1;run050
7879;GGG;RRG;0;2;2;2;0;run050
7880;GGG;RRR;0;1;1;1;0;run050
7881;GGR;BBB;0;1;1;1;0;run050
7882;GGR;BGG;0;2;2;2;0;run050
7883;GGR;BRB;0;1;1;1;0;run050
7884;GRG;BBB;0;3;3;2;1;run050
7885;GRG;BGB;0;3;3;3;0;run050
7886;GRG;BGG;0;1;1;1;0;run050
7887;GRG;BRB;0;5;5;5;0;run050
7888;GRG;BRR;0;1;1;0;1;run050
7889;GRG;GBB;0;3;3;1;2;run050
7890;GRG;GGB;0;14;14;3;11;run050
7891;GRG;GGG;0;10;10;2;8;run050
7892;GRG;GGR;0;2;2;1;1;run050
7893;GRG;GRR;0;1;1;0;1;run050
7894;GRG;RBR;1;2;3;0;3;run050
7895;GRG;RGG;0;2;2;0;2;run050
7896;GRG;RGR;0;1;1;0;1;run050
7897;GRR;BBB;0;3;3;1;2;run050
7898;GRR;BBR;0;2;2;0;2;run050
7899;GRR;BRB;1;8;9;7;2;run050
7900;GRR;BRR;1;6;7;2;5;run050
7901;GRR;GBB;0;1;1;0;1;run050
7902;GRR;GBG;0;1;1;1;0;run050
7903;GRR;GGR;1;9;10;1;9;run050
7904;GRR;RBR;0;1;1;1;0;run050
7905;GRR;RGG;1;3;4;2;2;run050
7906;GRR;RGR;0;1;1;1;0;run050
7907;GRR;RRR;0;1;1;0;1;run050
7908;RBB;BBB;0;1;1;1;0;run050
7909;RBB;GGG;0;3;3;2;1;run050
7910;RBG;GRR;0;1;1;1;0;run050
7911;RBG;RBR;0;1;1;1;0;run050
7912;RBG;RGR;0;1;1;0;1;run050
7913;RBR;BBB;0;3;3;0;3;run050
7914;RBR;BRB;0;1;1;0;1;run050
7915;RBR;BRR;0;2;2;2;0;run050
7916;RBR;GGG;0;1;1;1;0;run050
7917;RBR;GGR;1;2;3;2;1;run050
7918;RBR;GRG;0;1;1;1;0;run050
7919;RBR;GRR;1;15;16;10;6;run050
7920;RBR;RGG;0;4;4;0;4;run050
7921;RBR;RGR;0;1;1;0;1;run050
7922;RBR;RRR;0;3;3;1;2;run050
7923;RGG;BGG;0;1;1;1;0;run050
7924;RGG;RGR;0;1;1;0;1;run050
7925;RGR;BBB;0;9;9;9;0;run050
7926;RGR;BBR;0;1;1;1;0;run050
7927;RGR;BGB;1;8;9;5;4;run050
7928;RGR;BRB;0;3;3;2;1;run050
7929;RGR;BRR;0;3;3;1;2;run050
7930;RGR;GBG;0;1;1;0;1;run050
7931;RGR;GGB;0;3;3;3;0;run050
7932;RGR;GGG;0;2;2;2;0;run050
7933;RGR;GGR;0;8;8;7;1;run050
7934;RGR;GRR;1;7;8;2;6;run050
7935;RGR;RGG;0;6;6;3;3;run050
7936;RRG;BGB;0;1;1;1;0;run050
7937;RRG;BRB;0;1;1;0;1;run050
7938;RRG;GGG;0;1;1;1;0;run050
7939;RRG;GGR;0;1;1;1;0;run050
7940;RRG;GRG;0;1;1;1;0;run050
7941;RRG;GRR;0;3;3;1;2;run050
7942;RRG;RBR;0;4;4;4;0;run050
7943;RRG;RGG;0;1;1;1;0;run050
7944;RRG;RGR;6;37;43;42;1;run050
7945;RRR;BRR;0;1;1;0;1;run050
7946;RRR;GGB;0;1;1;0;1;run050
7947;RRR;GGG;1;5;6;5;1;run050
7948;RRR;GGR;0;2;2;0;2;run050
7949;RRR;GRR;0;1;1;0;1;run050
7950;RRR;RGR;0;1;1;1;0;run050
7951;BBB;GRR;0;1;1;0;1;run051
7952;BBG;BBB;1;9;10;2;8;run051
7953;BBG;BBR;0;2;2;0;2;run051
7954;BBG;BGB;0;1;1;1;0;run051
7955;BBG;BGG;0;1;1;1;0;run051
7956;BBG;BRB;0;2;2;0;2;run051
7957;BBG;BRR;0;1;1;0;1;run051
7958;BBG;GBB;1;1;2;0;2;run051
7959;BBG;GBG;1;6;7;4;3;run051
7960;BBG;GGB;0;18;18;1;17;run051
7961;BBG;GGG;1;29;30;11;19;run051
7962;BBG;GGR;0;2;2;1;1;run051
7963;BBG;GRG;0;1;1;1;0;run051
7964;BBG;GRR;0;3;3;0;3;run051
7965;BBG;RBR;0;2;2;0;2;run051
7966;BBG;RGR;0;2;2;2;0;run051
7967;BBG;RRG;1;2;3;1;2;run051
7968;BBG;RRR;0;1;1;1;0;run051
7969;BGG;BBB;0;1;1;0;1;run051
7970;BGG;BRB;0;1;1;1;0;run051
7971;BGG;GGG;0;1;1;1;0;run051
7972;BGG;RBB;0;1;1;0;1;run051
7973;BGG;RBG;1;0;1;0;1;run051
7974;BRB;BBB;0;1;1;0;1;run051
7975;BRB;GGB;1;0;1;0;1;run051
7976;BRB;GGG;0;2;2;1;1;run051
7977;BRB;RBB;1;0;1;1;0;run051
7978;BRR;BBB;0;1;1;0;1;run051
7979;BRR;BRB;0;1;1;0;1;run051
7980;BRR;GBB;1;0;1;1;0;run051
7981;GBB;BBB;1;16;17;6;11;run051
7982;GBB;BBG;0;2;2;2;0;run051
7983;GBB;BGB;0;1;1;0;1;run051
7984;GBB;BGG;0;3;3;1;2;run051
7985;GBB;BRB;0;9;9;9;0;run051
7986;GBB;BRR;0;2;2;0;2;run051
7987;GBB;GBG;1;1;2;2;0;run051
7988;GBB;GGB;2;59;61;4;57;run051
7989;GBB;GGG;4;95;99;18;81;run051
7990;GBB;GGR;0;1;1;1;0;run051
7991;GBB;GRG;0;1;1;1;0;run051
7992;GBB;GRR;1;8;9;1;8;run051
7993;GBB;RBB;0;2;2;1;1;run051
7994;GBB;RBG;0;1;1;1;0;run051
7995;GBB;RBR;1;1;2;1;1;run051
7996;GBB;RGG;0;2;2;0;2;run051
7997;GBB;RGR;0;1;1;0;1;run051
7998;GBB;RRG;0;3;3;3;0;run051
7999;GBG;BRB;0;1;1;1;0;run051
8000;GBG;BRR;0;3;3;1;2;run051
8001;GBG;GGB;0;1;1;0;1;run051
8002;GBG;GGR;0;3;3;2;1;run051
8003;GBG;RBR;0;1;1;0;1;run051
8004;GBG;RGR;1;1;2;0;2;run051
8005;GBG;RRR;0;1;1;0;1;run051
8006;GGB;BBB;1;8;9;0;9;run051
8007;GGB;BBG;0;1;1;1;0;run051
8008;GGB;BGB;0;1;1;0;1;run051
8009;GGB;BRB;3;5;8;5;3;run051
8010;GGB;BRR;0;1;1;1;0;run051
8011;GGB;GBG;0;2;2;2;0;run051
8012;GGB;GGG;4;37;41;10;31;run051
8013;GGB;GGR;0;9;9;9;0;run051
8014;GGB;GRR;1;4;5;5;0;run051
8015;GGB;RBB;0;2;2;2;0;run051
8016;GGB;RBG;0;2;2;2;0;run051
8017;GGB;RBR;0;2;2;0;2;run051
8018;GGB;RGG;0;1;1;0;1;run051
8019;GGB;RGR;1;2;3;1;2;run051
8020;GGB;RRG;1;3;4;2;2;run051
8021;GGB;RRR;0;3;3;3;0;run051
8022;GGG;BBB;4;22;26;16;10;run051
8023;GGG;BBG;0;2;2;0;2;run051
8024;GGG;BBR;0;3;3;2;1;run051
8025;GGG;BGB;0;2;2;0;2;run051
8026;GGG;BGG;0;3;3;0;3;run051
8027;GGG;BRB;0;3;3;2;1;run051
8028;GGG;BRR;0;3;3;2;1;run051
8029;GGG;GBB;0;1;1;0;1;run051
8030;GGG;GGB;1;3;4;0;4;run051
8031;GGG;GGR;0;21;21;0;21;run051
8032;GGG;GRG;0;2;2;1;1;run051
8033;GGG;GRR;2;15;17;14;3;run051
8034;GGG;RBB;0;1;1;1;0;run051
8035;GGG;RBR;1;4;5;5;0;run051
8036;GGG;RGG;1;7;8;6;2;run051
8037;GGG;RGR;0;3;3;2;1;run051
8038;GGG;RRG;0;2;2;1;1;run051
8039;GGG;RRR;0;1;1;1;0;run051
8040;GGR;BBB;0;1;1;1;0;run051
8041;GGR;BGG;0;2;2;2;0;run051
8042;GGR;BRB;0;1;1;0;1;run051
8043;GRG;BBB;0;3;3;0;3;run051
8044;GRG;BGB;0;3;3;3;0;run051
8045;GRG;BGG;0;1;1;0;1;run051
8046;GRG;BRB;0;5;5;4;1;run051
8047;GRG;BRR;0;1;1;1;0;run051
8048;GRG;GBB;0;3;3;3;0;run051
8049;GRG;GGB;0;14;14;13;1;run051
8050;GRG;GGG;0;10;10;1;9;run051
8051;GRG;GGR;0;2;2;0;2;run051
8052;GRG;GRR;0;1;1;0;1;run051
8053;GRG;RBR;1;2;3;3;0;run051
8054;GRG;RGG;0;2;2;1;1;run051
8055;GRG;RGR;0;1;1;1;0;run051
8056;GRR;BBB;0;3;3;1;2;run051
8057;GRR;BBR;0;2;2;1;1;run051
8058;GRR;BRB;1;8;9;3;6;run051
8059;GRR;BRR;1;6;7;6;1;run051
8060;GRR;GBB;0;1;1;0;1;run051
8061;GRR;GBG;0;1;1;1;0;run051
8062;GRR;GGR;1;9;10;8;2;run051
8063;GRR;RBR;0;1;1;0;1;run051
8064;GRR;RGG;1;3;4;3;1;run051
8065;GRR;RGR;0;1;1;1;0;run051
8066;GRR;RRR;0;1;1;0;1;run051
8067;RBB;BBB;0;1;1;0;1;run051
8068;RBB;GGG;0;3;3;1;2;run051
8069;RBG;GRR;0;1;1;1;0;run051
8070;RBG;RBR;0;1;1;1;0;run051
8071;RBG;RGR;0;1;1;0;1;run051
8072;RBR;BBB;0;3;3;0;3;run051
8073;RBR;BRB;0;1;1;1;0;run051
8074;RBR;BRR;0;2;2;0;2;run051
8075;RBR;GGG;0;1;1;1;0;run051
8076;RBR;GGR;1;2;3;2;1;run051
8077;RBR;GRG;0;1;1;1;0;run051
8078;RBR;GRR;1;15;16;4;12;run051
8079;RBR;RGG;0;4;4;1;3;run051
8080;RBR;RGR;0;1;1;1;0;run051
8081;RBR;RRR;0;3;3;0;3;run051
8082;RGG;BGG;0;1;1;0;1;run051
8083;RGG;RGR;0;1;1;1;0;run051
8084;RGR;BBB;0;9;9;0;9;run051
8085;RGR;BBR;0;1;1;1;0;run051
8086;RGR;BGB;1;8;9;1;8;run051
8087;RGR;BRB;0;3;3;0;3;run051
8088;RGR;BRR;0;3;3;3;0;run051
8089;RGR;GBG;0;1;1;1;0;run051
8090;RGR;GGB;0;3;3;1;2;run051
8091;RGR;GGG;0;2;2;0;2;run051
8092;RGR;GGR;0;8;8;5;3;run051
8093;RGR;GRR;1;7;8;2;6;run051
8094;RGR;RGG;0;6;6;0;6;run051
8095;RRG;BGB;0;1;1;0;1;run051
8096;RRG;BRB;0;1;1;0;1;run051
8097;RRG;GGG;0;1;1;0;1;run051
8098;RRG;GGR;0;1;1;0;1;run051
8099;RRG;GRG;0;1;1;0;1;run051
8100;RRG;GRR;0;3;3;1;2;run051
8101;RRG;RBR;0;4;4;3;1;run051
8102;RRG;RGG;0;1;1;1;0;run051
8103;RRG;RGR;6;37;43;22;21;run051
8104;RRR;BRR;0;1;1;0;1;run051
8105;RRR;GGB;0;1;1;0;1;run051
8106;RRR;GGG;1;5;6;5;1;run051
8107;RRR;GGR;0;2;2;1;1;run051
8108;RRR;GRR;0;1;1;0;1;run051
8109;RRR;RGR;0;1;1;0;1;run051
8110;BBB;GRR;0;1;1;0;1;run052
8111;BBG;BBB;1;9;10;1;9;run052
8112;BBG;BBR;0;2;2;2;0;run052
8113;BBG;BGB;0;1;1;0;1;run052
8114;BBG;BGG;0;1;1;1;0;run052
8115;BBG;BRB;0;2;2;0;2;run052
8116;BBG;BRR;0;1;1;0;1;run052
8117;BBG;GBB;1;1;2;1;1;run052
8118;BBG;GBG;1;6;7;6;1;run052
8119;BBG;GGB;0;18;18;2;16;run052
8120;BBG;GGG;1;29;30;16;14;run052
8121;BBG;GGR;0;2;2;0;2;run052
8122;BBG;GRG;0;1;1;1;0;run052
8123;BBG;GRR;0;3;3;0;3;run052
8124;BBG;RBR;0;2;2;1;1;run052
8125;BBG;RGR;0;2;2;1;1;run052
8126;BBG;RRG;1;2;3;3;0;run052
8127;BBG;RRR;0;1;1;1;0;run052
8128;BGG;BBB;0;1;1;1;0;run052
8129;BGG;BRB;0;1;1;0;1;run052
8130;BGG;GGG;0;1;1;1;0;run052
8131;BGG;RBB;0;1;1;0;1;run052
8132;BGG;RBG;1;0;1;0;1;run052
8133;BRB;BBB;0;1;1;1;0;run052
8134;BRB;GGB;1;0;1;0;1;run052
8135;BRB;GGG;0;2;2;1;1;run052
8136;BRB;RBB;1;0;1;1;0;run052
8137;BRR;BBB;0;1;1;0;1;run052
8138;BRR;BRB;0;1;1;0;1;run052
8139;BRR;GBB;1;0;1;1;0;run052
8140;GBB;BBB;1;16;17;4;13;run052
8141;GBB;BBG;0;2;2;2;0;run052
8142;GBB;BGB;0;1;1;1;0;run052
8143;GBB;BGG;0;3;3;2;1;run052
8144;GBB;BRB;0;9;9;0;9;run052
8145;GBB;BRR;0;2;2;2;0;run052
8146;GBB;GBG;1;1;2;1;1;run052
8147;GBB;GGB;2;59;61;48;13;run052
8148;GBB;GGG;4;95;99;96;3;run052
8149;GBB;GGR;0;1;1;1;0;run052
8150;GBB;GRG;0;1;1;1;0;run052
8151;GBB;GRR;1;8;9;4;5;run052
8152;GBB;RBB;0;2;2;2;0;run052
8153;GBB;RBG;0;1;1;1;0;run052
8154;GBB;RBR;1;1;2;2;0;run052
8155;GBB;RGG;0;2;2;1;1;run052
8156;GBB;RGR;0;1;1;1;0;run052
8157;GBB;RRG;0;3;3;2;1;run052
8158;GBG;BRB;0;1;1;1;0;run052
8159;GBG;BRR;0;3;3;2;1;run052
8160;GBG;GGB;0;1;1;0;1;run052
8161;GBG;GGR;0;3;3;3;0;run052
8162;GBG;RBR;0;1;1;0;1;run052
8163;GBG;RGR;1;1;2;1;1;run052
8164;GBG;RRR;0;1;1;1;0;run052
8165;GGB;BBB;1;8;9;7;2;run052
8166;GGB;BBG;0;1;1;0;1;run052
8167;GGB;BGB;0;1;1;0;1;run052
8168;GGB;BRB;3;5;8;5;3;run052
8169;GGB;BRR;0;1;1;1;0;run052
8170;GGB;GBG;0;2;2;0;2;run052
8171;GGB;GGG;4;37;41;1;40;run052
8172;GGB;GGR;0;9;9;8;1;run052
8173;GGB;GRR;1;4;5;2;3;run052
8174;GGB;RBB;0;2;2;0;2;run052
8175;GGB;RBG;0;2;2;0;2;run052
8176;GGB;RBR;0;2;2;1;1;run052
8177;GGB;RGG;0;1;1;1;0;run052
8178;GGB;RGR;1;2;3;0;3;run052
8179;GGB;RRG;1;3;4;4;0;run052
8180;GGB;RRR;0;3;3;2;1;run052
8181;GGG;BBB;4;22;26;1;25;run052
8182;GGG;BBG;0;2;2;2;0;run052
8183;GGG;BBR;0;3;3;0;3;run052
8184;GGG;BGB;0;2;2;0;2;run052
8185;GGG;BGG;0;3;3;3;0;run052
8186;GGG;BRB;0;3;3;0;3;run052
8187;GGG;BRR;0;3;3;0;3;run052
8188;GGG;GBB;0;1;1;0;1;run052
8189;GGG;GGB;1;3;4;2;2;run052
8190;GGG;GGR;0;21;21;6;15;run052
8191;GGG;GRG;0;2;2;1;1;run052
8192;GGG;GRR;2;15;17;1;16;run052
8193;GGG;RBB;0;1;1;0;1;run052
8194;GGG;RBR;1;4;5;4;1;run052
8195;GGG;RGG;1;7;8;7;1;run052
8196;GGG;RGR;0;3;3;1;2;run052
8197;GGG;RRG;0;2;2;0;2;run052
8198;GGG;RRR;0;1;1;1;0;run052
8199;GGR;BBB;0;1;1;1;0;run052
8200;GGR;BGG;0;2;2;1;1;run052
8201;GGR;BRB;0;1;1;1;0;run052
8202;GRG;BBB;0;3;3;3;0;run052
8203;GRG;BGB;0;3;3;2;1;run052
8204;GRG;BGG;0;1;1;0;1;run052
8205;GRG;BRB;0;5;5;3;2;run052
8206;GRG;BRR;0;1;1;1;0;run052
8207;GRG;GBB;0;3;3;3;0;run052
8208;GRG;GGB;0;14;14;6;8;run052
8209;GRG;GGG;0;10;10;4;6;run052
8210;GRG;GGR;0;2;2;2;0;run052
8211;GRG;GRR;0;1;1;1;0;run052
8212;GRG;RBR;1;2;3;1;2;run052
8213;GRG;RGG;0;2;2;1;1;run052
8214;GRG;RGR;0;1;1;1;0;run052
8215;GRR;BBB;0;3;3;0;3;run052
8216;GRR;BBR;0;2;2;2;0;run052
8217;GRR;BRB;1;8;9;0;9;run052
8218;GRR;BRR;1;6;7;6;1;run052
8219;GRR;GBB;0;1;1;1;0;run052
8220;GRR;GBG;0;1;1;1;0;run052
8221;GRR;GGR;1;9;10;10;0;run052
8222;GRR;RBR;0;1;1;1;0;run052
8223;GRR;RGG;1;3;4;3;1;run052
8224;GRR;RGR;0;1;1;1;0;run052
8225;GRR;RRR;0;1;1;1;0;run052
8226;RBB;BBB;0;1;1;1;0;run052
8227;RBB;GGG;0;3;3;1;2;run052
8228;RBG;GRR;0;1;1;1;0;run052
8229;RBG;RBR;0;1;1;1;0;run052
8230;RBG;RGR;0;1;1;0;1;run052
8231;RBR;BBB;0;3;3;1;2;run052
8232;RBR;BRB;0;1;1;0;1;run052
8233;RBR;BRR;0;2;2;2;0;run052
8234;RBR;GGG;0;1;1;0;1;run052
8235;RBR;GGR;1;2;3;0;3;run052
8236;RBR;GRG;0;1;1;1;0;run052
8237;RBR;GRR;1;15;16;9;7;run052
8238;RBR;RGG;0;4;4;4;0;run052
8239;RBR;RGR;0;1;1;0;1;run052
8240;RBR;RRR;0;3;3;3;0;run052
8241;RGG;BGG;0;1;1;0;1;run052
8242;RGG;RGR;0;1;1;1;0;run052
8243;RGR;BBB;0;9;9;2;7;run052
8244;RGR;BBR;0;1;1;1;0;run052
8245;RGR;BGB;1;8;9;8;1;run052
8246;RGR;BRB;0;3;3;1;2;run052
8247;RGR;BRR;0;3;3;3;0;run052
8248;RGR;GBG;0;1;1;0;1;run052
8249;RGR;GGB;0;3;3;1;2;run052
8250;RGR;GGG;0;2;2;1;1;run052
8251;RGR;GGR;0;8;8;1;7;run052
8252;RGR;GRR;1;7;8;1;7;run052
8253;RGR;RGG;0;6;6;0;6;run052
8254;RRG;BGB;0;1;1;0;1;run052
8255;RRG;BRB;0;1;1;1;0;run052
8256;RRG;GGG;0;1;1;0;1;run052
8257;RRG;GGR;0;1;1;1;0;run052
8258;RRG;GRG;0;1;1;1;0;run052
8259;RRG;GRR;0;3;3;2;1;run052
8260;RRG;RBR;0;4;4;1;3;run052
8261;RRG;RGG;0;1;1;0;1;run052
8262;RRG;RGR;6;37;43;0;43;run052
8263;RRR;BRR;0;1;1;0;1;run052
8264;RRR;GGB;0;1;1;0;1;run052
8265;RRR;GGG;1;5;6;3;3;run052
8266;RRR;GGR;0;2;2;0;2;run052
8267;RRR;GRR;0;1;1;1;0;run052
8268;RRR;RGR;0;1;1;0;1;run052
8269;BBB;GRR;0;1;1;1;0;run053
8270;BBG;BBB;1;9;10;7;3;run053
8271;BBG;BBR;0;2;2;2;0;run053
8272;BBG;BGB;0;1;1;1;0;run053
8273;BBG;BGG;0;1;1;0;1;run053
8274;BBG;BRB;0;2;2;0;2;run053
8275;BBG;BRR;0;1;1;1;0;run053
8276;BBG;GBB;1;1;2;0;2;run053
8277;BBG;GBG;1;6;7;0;7;run053
8278;BBG;GGB;0;18;18;0;18;run053
8279;BBG;GGG;1;29;30;21;9;run053
8280;BBG;GGR;0;2;2;1;1;run053
8281;BBG;GRG;0;1;1;0;1;run053
8282;BBG;GRR;0;3;3;2;1;run053
8283;BBG;RBR;0;2;2;1;1;run053
8284;BBG;RGR;0;2;2;2;0;run053
8285;BBG;RRG;1;2;3;2;1;run053
8286;BBG;RRR;0;1;1;1;0;run053
8287;BGG;BBB;0;1;1;1;0;run053
8288;BGG;BRB;0;1;1;0;1;run053
8289;BGG;GGG;0;1;1;0;1;run053
8290;BGG;RBB;0;1;1;1;0;run053
8291;BGG;RBG;1;0;1;0;1;run053
8292;BRB;BBB;0;1;1;1;0;run053
8293;BRB;GGB;1;0;1;0;1;run053
8294;BRB;GGG;0;2;2;0;2;run053
8295;BRB;RBB;1;0;1;0;1;run053
8296;BRR;BBB;0;1;1;1;0;run053
8297;BRR;BRB;0;1;1;0;1;run053
8298;BRR;GBB;1;0;1;1;0;run053
8299;GBB;BBB;1;16;17;12;5;run053
8300;GBB;BBG;0;2;2;1;1;run053
8301;GBB;BGB;0;1;1;0;1;run053
8302;GBB;BGG;0;3;3;3;0;run053
8303;GBB;BRB;0;9;9;6;3;run053
8304;GBB;BRR;0;2;2;2;0;run053
8305;GBB;GBG;1;1;2;2;0;run053
8306;GBB;GGB;2;59;61;40;21;run053
8307;GBB;GGG;4;95;99;81;18;run053
8308;GBB;GGR;0;1;1;0;1;run053
8309;GBB;GRG;0;1;1;1;0;run053
8310;GBB;GRR;1;8;9;5;4;run053
8311;GBB;RBB;0;2;2;1;1;run053
8312;GBB;RBG;0;1;1;0;1;run053
8313;GBB;RBR;1;1;2;0;2;run053
8314;GBB;RGG;0;2;2;0;2;run053
8315;GBB;RGR;0;1;1;0;1;run053
8316;GBB;RRG;0;3;3;3;0;run053
8317;GBG;BRB;0;1;1;0;1;run053
8318;GBG;BRR;0;3;3;3;0;run053
8319;GBG;GGB;0;1;1;0;1;run053
8320;GBG;GGR;0;3;3;1;2;run053
8321;GBG;RBR;0;1;1;1;0;run053
8322;GBG;RGR;1;1;2;1;1;run053
8323;GBG;RRR;0;1;1;0;1;run053
8324;GGB;BBB;1;8;9;8;1;run053
8325;GGB;BBG;0;1;1;1;0;run053
8326;GGB;BGB;0;1;1;0;1;run053
8327;GGB;BRB;3;5;8;8;0;run053
8328;GGB;BRR;0;1;1;1;0;run053
8329;GGB;GBG;0;2;2;2;0;run053
8330;GGB;GGG;4;37;41;2;39;run053
8331;GGB;GGR;0;9;9;3;6;run053
8332;GGB;GRR;1;4;5;1;4;run053
8333;GGB;RBB;0;2;2;0;2;run053
8334;GGB;RBG;0;2;2;2;0;run053
8335;GGB;RBR;0;2;2;0;2;run053
8336;GGB;RGG;0;1;1;0;1;run053
8337;GGB;RGR;1;2;3;2;1;run053
8338;GGB;RRG;1;3;4;0;4;run053
8339;GGB;RRR;0;3;3;2;1;run053
8340;GGG;BBB;4;22;26;23;3;run053
8341;GGG;BBG;0;2;2;2;0;run053
8342;GGG;BBR;0;3;3;3;0;run053
8343;GGG;BGB;0;2;2;0;2;run053
8344;GGG;BGG;0;3;3;2;1;run053
8345;GGG;BRB;0;3;3;2;1;run053
8346;GGG;BRR;0;3;3;3;0;run053
8347;GGG;GBB;0;1;1;0;1;run053
8348;GGG;GGB;1;3;4;1;3;run053
8349;GGG;GGR;0;21;21;8;13;run053
8350;GGG;GRG;0;2;2;1;1;run053
8351;GGG;GRR;2;15;17;11;6;run053
8352;GGG;RBB;0;1;1;0;1;run053
8353;GGG;RBR;1;4;5;2;3;run053
8354;GGG;RGG;1;7;8;6;2;run053
8355;GGG;RGR;0;3;3;2;1;run053
8356;GGG;RRG;0;2;2;1;1;run053
8357;GGG;RRR;0;1;1;1;0;run053
8358;GGR;BBB;0;1;1;1;0;run053
8359;GGR;BGG;0;2;2;1;1;run053
8360;GGR;BRB;0;1;1;1;0;run053
8361;GRG;BBB;0;3;3;2;1;run053
8362;GRG;BGB;0;3;3;0;3;run053
8363;GRG;BGG;0;1;1;0;1;run053
8364;GRG;BRB;0;5;5;1;4;run053
8365;GRG;BRR;0;1;1;0;1;run053
8366;GRG;GBB;0;3;3;2;1;run053
8367;GRG;GGB;0;14;14;2;12;run053
8368;GRG;GGG;0;10;10;4;6;run053
8369;GRG;GGR;0;2;2;2;0;run053
8370;GRG;GRR;0;1;1;1;0;run053
8371;GRG;RBR;1;2;3;2;1;run053
8372;GRG;RGG;0;2;2;2;0;run053
8373;GRG;RGR;0;1;1;1;0;run053
8374;GRR;BBB;0;3;3;2;1;run053
8375;GRR;BBR;0;2;2;2;0;run053
8376;GRR;BRB;1;8;9;7;2;run053
8377;GRR;BRR;1;6;7;2;5;run053
8378;GRR;GBB;0;1;1;1;0;run053
8379;GRR;GBG;0;1;1;0;1;run053
8380;GRR;GGR;1;9;10;2;8;run053
8381;GRR;RBR;0;1;1;0;1;run053
8382;GRR;RGG;1;3;4;0;4;run053
8383;GRR;RGR;0;1;1;0;1;run053
8384;GRR;RRR;0;1;1;0;1;run053
8385;RBB;BBB;0;1;1;1;0;run053
8386;RBB;GGG;0;3;3;0;3;run053
8387;RBG;GRR;0;1;1;0;1;run053
8388;RBG;RBR;0;1;1;1;0;run053
8389;RBG;RGR;0;1;1;1;0;run053
8390;RBR;BBB;0;3;3;2;1;run053
8391;RBR;BRB;0;1;1;1;0;run053
8392;RBR;BRR;0;2;2;1;1;run053
8393;RBR;GGG;0;1;1;1;0;run053
8394;RBR;GGR;1;2;3;1;2;run053
8395;RBR;GRG;0;1;1;0;1;run053
8396;RBR;GRR;1;15;16;13;3;run053
8397;RBR;RGG;0;4;4;2;2;run053
8398;RBR;RGR;0;1;1;1;0;run053
8399;RBR;RRR;0;3;3;2;1;run053
8400;RGG;BGG;0;1;1;0;1;run053
8401;RGG;RGR;0;1;1;0;1;run053
8402;RGR;BBB;0;9;9;4;5;run053
8403;RGR;BBR;0;1;1;1;0;run053
8404;RGR;BGB;1;8;9;7;2;run053
8405;RGR;BRB;0;3;3;1;2;run053
8406;RGR;BRR;0;3;3;0;3;run053
8407;RGR;GBG;0;1;1;1;0;run053
8408;RGR;GGB;0;3;3;2;1;run053
8409;RGR;GGG;0;2;2;0;2;run053
8410;RGR;GGR;0;8;8;7;1;run053
8411;RGR;GRR;1;7;8;8;0;run053
8412;RGR;RGG;0;6;6;6;0;run053
8413;RRG;BGB;0;1;1;0;1;run053
8414;RRG;BRB;0;1;1;1;0;run053
8415;RRG;GGG;0;1;1;0;1;run053
8416;RRG;GGR;0;1;1;1;0;run053
8417;RRG;GRG;0;1;1;1;0;run053
8418;RRG;GRR;0;3;3;3;0;run053
8419;RRG;RBR;0;4;4;1;3;run053
8420;RRG;RGG;0;1;1;1;0;run053
8421;RRG;RGR;6;37;43;40;3;run053
8422;RRR;BRR;0;1;1;1;0;run053
8423;RRR;GGB;0;1;1;0;1;run053
8424;RRR;GGG;1;5;6;4;2;run053
8425;RRR;GGR;0;2;2;0;2;run053
8426;RRR;GRR;0;1;1;0;1;run053
8427;RRR;RGR;0;1;1;1;0;run053
8428;BBB;GRR;0;1;1;1;0;run054
8429;BBG;BBB;1;9;10;6;4;run054
8430;BBG;BBR;0;2;2;1;1;run054
8431;BBG;BGB;0;1;1;1;0;run054
8432;BBG;BGG;0;1;1;0;1;run054
8433;BBG;BRB;0;2;2;0;2;run054
8434;BBG;BRR;0;1;1;1;0;run054
8435;BBG;GBB;1;1;2;1;1;run054
8436;BBG;GBG;1;6;7;7;0;run054
8437;BBG;GGB;0;18;18;11;7;run054
8438;BBG;GGG;1;29;30;3;27;run054
8439;BBG;GGR;0;2;2;2;0;run054
8440;BBG;GRG;0;1;1;1;0;run054
8441;BBG;GRR;0;3;3;1;2;run054
8442;BBG;RBR;0;2;2;0;2;run054
8443;BBG;RGR;0;2;2;2;0;run054
8444;BBG;RRG;1;2;3;2;1;run054
8445;BBG;RRR;0;1;1;1;0;run054
8446;BGG;BBB;0;1;1;0;1;run054
8447;BGG;BRB;0;1;1;0;1;run054
8448;BGG;GGG;0;1;1;1;0;run054
8449;BGG;RBB;0;1;1;0;1;run054
8450;BGG;RBG;1;0;1;0;1;run054
8451;BRB;BBB;0;1;1;0;1;run054
8452;BRB;GGB;1;0;1;1;0;run054
8453;BRB;GGG;0;2;2;2;0;run054
8454;BRB;RBB;1;0;1;0;1;run054
8455;BRR;BBB;0;1;1;1;0;run054
8456;BRR;BRB;0;1;1;1;0;run054
8457;BRR;GBB;1;0;1;0;1;run054
8458;GBB;BBB;1;16;17;13;4;run054
8459;GBB;BBG;0;2;2;1;1;run054
8460;GBB;BGB;0;1;1;1;0;run054
8461;GBB;BGG;0;3;3;0;3;run054
8462;GBB;BRB;0;9;9;9;0;run054
8463;GBB;BRR;0;2;2;2;0;run054
8464;GBB;GBG;1;1;2;1;1;run054
8465;GBB;GGB;2;59;61;53;8;run054
8466;GBB;GGG;4;95;99;60;39;run054
8467;GBB;GGR;0;1;1;1;0;run054
8468;GBB;GRG;0;1;1;1;0;run054
8469;GBB;GRR;1;8;9;5;4;run054
8470;GBB;RBB;0;2;2;0;2;run054
8471;GBB;RBG;0;1;1;0;1;run054
8472;GBB;RBR;1;1;2;2;0;run054
8473;GBB;RGG;0;2;2;2;0;run054
8474;GBB;RGR;0;1;1;1;0;run054
8475;GBB;RRG;0;3;3;3;0;run054
8476;GBG;BRB;0;1;1;1;0;run054
8477;GBG;BRR;0;3;3;1;2;run054
8478;GBG;GGB;0;1;1;0;1;run054
8479;GBG;GGR;0;3;3;1;2;run054
8480;GBG;RBR;0;1;1;0;1;run054
8481;GBG;RGR;1;1;2;1;1;run054
8482;GBG;RRR;0;1;1;0;1;run054
8483;GGB;BBB;1;8;9;6;3;run054
8484;GGB;BBG;0;1;1;0;1;run054
8485;GGB;BGB;0;1;1;1;0;run054
8486;GGB;BRB;3;5;8;1;7;run054
8487;GGB;BRR;0;1;1;0;1;run054
8488;GGB;GBG;0;2;2;2;0;run054
8489;GGB;GGG;4;37;41;5;36;run054
8490;GGB;GGR;0;9;9;3;6;run054
8491;GGB;GRR;1;4;5;0;5;run054
8492;GGB;RBB;0;2;2;2;0;run054
8493;GGB;RBG;0;2;2;1;1;run054
8494;GGB;RBR;0;2;2;0;2;run054
8495;GGB;RGG;0;1;1;1;0;run054
8496;GGB;RGR;1;2;3;1;2;run054
8497;GGB;RRG;1;3;4;3;1;run054
8498;GGB;RRR;0;3;3;0;3;run054
8499;GGG;BBB;4;22;26;11;15;run054
8500;GGG;BBG;0;2;2;1;1;run054
8501;GGG;BBR;0;3;3;3;0;run054
8502;GGG;BGB;0;2;2;2;0;run054
8503;GGG;BGG;0;3;3;1;2;run054
8504;GGG;BRB;0;3;3;0;3;run054
8505;GGG;BRR;0;3;3;1;2;run054
8506;GGG;GBB;0;1;1;0;1;run054
8507;GGG;GGB;1;3;4;2;2;run054
8508;GGG;GGR;0;21;21;8;13;run054
8509;GGG;GRG;0;2;2;2;0;run054
8510;GGG;GRR;2;15;17;15;2;run054
8511;GGG;RBB;0;1;1;1;0;run054
8512;GGG;RBR;1;4;5;5;0;run054
8513;GGG;RGG;1;7;8;3;5;run054
8514;GGG;RGR;0;3;3;3;0;run054
8515;GGG;RRG;0;2;2;0;2;run054
8516;GGG;RRR;0;1;1;0;1;run054
8517;GGR;BBB;0;1;1;1;0;run054
8518;GGR;BGG;0;2;2;2;0;run054
8519;GGR;BRB;0;1;1;1;0;run054
8520;GRG;BBB;0;3;3;1;2;run054
8521;GRG;BGB;0;3;3;1;2;run054
8522;GRG;BGG;0;1;1;1;0;run054
8523;GRG;BRB;0;5;5;4;1;run054
8524;GRG;BRR;0;1;1;1;0;run054
8525;GRG;GBB;0;3;3;3;0;run054
8526;GRG;GGB;0;14;14;5;9;run054
8527;GRG;GGG;0;10;10;7;3;run054
8528;GRG;GGR;0;2;2;1;1;run054
8529;GRG;GRR;0;1;1;0;1;run054
8530;GRG;RBR;1;2;3;0;3;run054
8531;GRG;RGG;0;2;2;0;2;run054
8532;GRG;RGR;0;1;1;1;0;run054
8533;GRR;BBB;0;3;3;3;0;run054
8534;GRR;BBR;0;2;2;2;0;run054
8535;GRR;BRB;1;8;9;1;8;run054
8536;GRR;BRR;1;6;7;5;2;run054
8537;GRR;GBB;0;1;1;0;1;run054
8538;GRR;GBG;0;1;1;1;0;run054
8539;GRR;GGR;1;9;10;7;3;run054
8540;GRR;RBR;0;1;1;0;1;run054
8541;GRR;RGG;1;3;4;4;0;run054
8542;GRR;RGR;0;1;1;1;0;run054
8543;GRR;RRR;0;1;1;0;1;run054
8544;RBB;BBB;0;1;1;0;1;run054
8545;RBB;GGG;0;3;3;3;0;run054
8546;RBG;GRR;0;1;1;1;0;run054
8547;RBG;RBR;0;1;1;0;1;run054
8548;RBG;RGR;0;1;1;1;0;run054
8549;RBR;BBB;0;3;3;2;1;run054
8550;RBR;BRB;0;1;1;0;1;run054
8551;RBR;BRR;0;2;2;0;2;run054
8552;RBR;GGG;0;1;1;0;1;run054
8553;RBR;GGR;1;2;3;0;3;run054
8554;RBR;GRG;0;1;1;0;1;run054
8555;RBR;GRR;1;15;16;13;3;run054
8556;RBR;RGG;0;4;4;1;3;run054
8557;RBR;RGR;0;1;1;1;0;run054
8558;RBR;RRR;0;3;3;0;3;run054
8559;RGG;BGG;0;1;1;0;1;run054
8560;RGG;RGR;0;1;1;0;1;run054
8561;RGR;BBB;0;9;9;1;8;run054
8562;RGR;BBR;0;1;1;0;1;run054
8563;RGR;BGB;1;8;9;1;8;run054
8564;RGR;BRB;0;3;3;1;2;run054
8565;RGR;BRR;0;3;3;3;0;run054
8566;RGR;GBG;0;1;1;1;0;run054
8567;RGR;GGB;0;3;3;3;0;run054
8568;RGR;GGG;0;2;2;1;1;run054
8569;RGR;GGR;0;8;8;1;7;run054
8570;RGR;GRR;1;7;8;0;8;run054
8571;RGR;RGG;0;6;6;6;0;run054
8572;RRG;BGB;0;1;1;1;0;run054
8573;RRG;BRB;0;1;1;1;0;run054
8574;RRG;GGG;0;1;1;1;0;run054
8575;RRG;GGR;0;1;1;1;0;run054
8576;RRG;GRG;0;1;1;1;0;run054
8577;RRG;GRR;0;3;3;3;0;run054
8578;RRG;RBR;0;4;4;3;1;run054
8579;RRG;RGG;0;1;1;0;1;run054
8580;RRG;RGR;6;37;43;2;41;run054
8581;RRR;BRR;0;1;1;1;0;run054
8582;RRR;GGB;0;1;1;0;1;run054
8583;RRR;GGG;1;5;6;3;3;run054
8584;RRR;GGR;0;2;2;0;2;run054
8585;RRR;GRR;0;1;1;1;0;run054
8586;RRR;RGR;0;1;1;0;1;run054
8587;BBB;GRR;0;1;1;1;0;run055
8588;BBG;BBB;1;9;10;9;1;run055
8589;BBG;BBR;0;2;2;2;0;run055
8590;BBG;BGB;0;1;1;0;1;run055
8591;BBG;BGG;0;1;1;0;1;run055
8592;BBG;BRB;0;2;2;1;1;run055
8593;BBG;BRR;0;1;1;0;1;run055
8594;BBG;GBB;1;1;2;1;1;run055
8595;BBG;GBG;1;6;7;5;2;run055
8596;BBG;GGB;0;18;18;1;17;run055
8597;BBG;GGG;1;29;30;6;24;run055
8598;BBG;GGR;0;2;2;1;1;run055
8599;BBG;GRG;0;1;1;0;1;run055
8600;BBG;GRR;0;3;3;1;2;run055
8601;BBG;RBR;0;2;2;1;1;run055
8602;BBG;RGR;0;2;2;1;1;run055
8603;BBG;RRG;1;2;3;1;2;run055
8604;BBG;RRR;0;1;1;1;0;run055
8605;BGG;BBB;0;1;1;1;0;run055
8606;BGG;BRB;0;1;1;1;0;run055
8607;BGG;GGG;0;1;1;0;1;run055
8608;BGG;RBB;0;1;1;0;1;run055
8609;BGG;RBG;1;0;1;1;0;run055
8610;BRB;BBB;0;1;1;1;0;run055
8611;BRB;GGB;1;0;1;1;0;run055
8612;BRB;GGG;0;2;2;0;2;run055
8613;BRB;RBB;1;0;1;1;0;run055
8614;BRR;BBB;0;1;1;0;1;run055
8615;BRR;BRB;0;1;1;0;1;run055
8616;BRR;GBB;1;0;1;1;0;run055
8617;GBB;BBB;1;16;17;12;5;run055
8618;GBB;BBG;0;2;2;1;1;run055
8619;GBB;BGB;0;1;1;1;0;run055
8620;GBB;BGG;0;3;3;1;2;run055
8621;GBB;BRB;0;9;9;1;8;run055
8622;GBB;BRR;0;2;2;1;1;run055
8623;GBB;GBG;1;1;2;1;1;run055
8624;GBB;GGB;2;59;61;53;8;run055
8625;GBB;GGG;4;95;99;96;3;run055
8626;GBB;GGR;0;1;1;1;0;run055
8627;GBB;GRG;0;1;1;1;0;run055
8628;GBB;GRR;1;8;9;9;0;run055
8629;GBB;RBB;0;2;2;2;0;run055
8630;GBB;RBG;0;1;1;1;0;run055
8631;GBB;RBR;1;1;2;1;1;run055
8632;GBB;RGG;0;2;2;2;0;run055
8633;GBB;RGR;0;1;1;0;1;run055
8634;GBB;RRG;0;3;3;2;1;run055
8635;GBG;BRB;0;1;1;1;0;run055
8636;GBG;BRR;0;3;3;0;3;run055
8637;GBG;GGB;0;1;1;0;1;run055
8638;GBG;GGR;0;3;3;0;3;run055
8639;GBG;RBR;0;1;1;1;0;run055
8640;GBG;RGR;1;1;2;1;1;run055
8641;GBG;RRR;0;1;1;1;0;run055
8642;GGB;BBB;1;8;9;7;2;run055
8643;GGB;BBG;0;1;1;0;1;run055
8644;GGB;BGB;0;1;1;1;0;run055
8645;GGB;BRB;3;5;8;8;0;run055
8646;GGB;BRR;0;1;1;0;1;run055
8647;GGB;GBG;0;2;2;0;2;run055
8648;GGB;GGG;4;37;41;18;23;run055
8649;GGB;GGR;0;9;9;1;8;run055
8650;GGB;GRR;1;4;5;3;2;run055
8651;GGB;RBB;0;2;2;0;2;run055
8652;GGB;RBG;0;2;2;0;2;run055
8653;GGB;RBR;0;2;2;1;1;run055
8654;GGB;RGG;0;1;1;0;1;run055
8655;GGB;RGR;1;2;3;3;0;run055
8656;GGB;RRG;1;3;4;3;1;run055
8657;GGB;RRR;0;3;3;3;0;run055
8658;GGG;BBB;4;22;26;6;20;run055
8659;GGG;BBG;0;2;2;2;0;run055
8660;GGG;BBR;0;3;3;1;2;run055
8661;GGG;BGB;0;2;2;2;0;run055
8662;GGG;BGG;0;3;3;0;3;run055
8663;GGG;BRB;0;3;3;3;0;run055
8664;GGG;BRR;0;3;3;0;3;run055
8665;GGG;GBB;0;1;1;0;1;run055
8666;GGG;GGB;1;3;4;4;0;run055
8667;GGG;GGR;0;21;21;7;14;run055
8668;GGG;GRG;0;2;2;1;1;run055
8669;GGG;GRR;2;15;17;5;12;run055
8670;GGG;RBB;0;1;1;1;0;run055
8671;GGG;RBR;1;4;5;2;3;run055
8672;GGG;RGG;1;7;8;5;3;run055
8673;GGG;RGR;0;3;3;1;2;run055
8674;GGG;RRG;0;2;2;1;1;run055
8675;GGG;RRR;0;1;1;0;1;run055
8676;GGR;BBB;0;1;1;0;1;run055
8677;GGR;BGG;0;2;2;1;1;run055
8678;GGR;BRB;0;1;1;0;1;run055
8679;GRG;BBB;0;3;3;3;0;run055
8680;GRG;BGB;0;3;3;3;0;run055
8681;GRG;BGG;0;1;1;1;0;run055
8682;GRG;BRB;0;5;5;0;5;run055
8683;GRG;BRR;0;1;1;0;1;run055
8684;GRG;GBB;0;3;3;0;3;run055
8685;GRG;GGB;0;14;14;14;0;run055
8686;GRG;GGG;0;10;10;0;10;run055
8687;GRG;GGR;0;2;2;0;2;run055
8688;GRG;GRR;0;1;1;1;0;run055
8689;GRG;RBR;1;2;3;1;2;run055
8690;GRG;RGG;0;2;2;2;0;run055
8691;GRG;RGR;0;1;1;0;1;run055
8692;GRR;BBB;0;3;3;2;1;run055
8693;GRR;BBR;0;2;2;2;0;run055
8694;GRR;BRB;1;8;9;4;5;run055
8695;GRR;BRR;1;6;7;6;1;run055
8696;GRR;GBB;0;1;1;0;1;run055
8697;GRR;GBG;0;1;1;1;0;run055
8698;GRR;GGR;1;9;10;1;9;run055
8699;GRR;RBR;0;1;1;0;1;run055
8700;GRR;RGG;1;3;4;0;4;run055
8701;GRR;RGR;0;1;1;0;1;run055
8702;GRR;RRR;0;1;1;1;0;run055
8703;RBB;BBB;0;1;1;1;0;run055
8704;RBB;GGG;0;3;3;2;1;run055
8705;RBG;GRR;0;1;1;0;1;run055
8706;RBG;RBR;0;1;1;1;0;run055
8707;RBG;RGR;0;1;1;0;1;run055
8708;RBR;BBB;0;3;3;2;1;run055
8709;RBR;BRB;0;1;1;1;0;run055
8710;RBR;BRR;0;2;2;1;1;run055
8711;RBR;GGG;0;1;1;0;1;run055
8712;RBR;GGR;1;2;3;2;1;run055
8713;RBR;GRG;0;1;1;1;0;run055
8714;RBR;GRR;1;15;16;9;7;run055
8715;RBR;RGG;0;4;4;1;3;run055
8716;RBR;RGR;0;1;1;1;0;run055
8717;RBR;RRR;0;3;3;1;2;run055
8718;RGG;BGG;0;1;1;1;0;run055
8719;RGG;RGR;0;1;1;0;1;run055
8720;RGR;BBB;0;9;9;7;2;run055
8721;RGR;BBR;0;1;1;0;1;run055
8722;RGR;BGB;1;8;9;9;0;run055
8723;RGR;BRB;0;3;3;0;3;run055
8724;RGR;BRR;0;3;3;0;3;run055
8725;RGR;GBG;0;1;1;1;0;run055
8726;RGR;GGB;0;3;3;2;1;run055
8727;RGR;GGG;0;2;2;0;2;run055
8728;RGR;GGR;0;8;8;7;1;run055
8729;RGR;GRR;1;7;8;6;2;run055
8730;RGR;RGG;0;6;6;2;4;run055
8731;RRG;BGB;0;1;1;0;1;run055
8732;RRG;BRB;0;1;1;1;0;run055
8733;RRG;GGG;0;1;1;0;1;run055
8734;RRG;GGR;0;1;1;0;1;run055
8735;RRG;GRG;0;1;1;0;1;run055
8736;RRG;GRR;0;3;3;2;1;run055
8737;RRG;RBR;0;4;4;1;3;run055
8738;RRG;RGG;0;1;1;1;0;run055
8739;RRG;RGR;6;37;43;12;31;run055
8740;RRR;BRR;0;1;1;0;1;run055
8741;RRR;GGB;0;1;1;0;1;run055
8742;RRR;GGG;1;5;6;6;0;run055
8743;RRR;GGR;0;2;2;1;1;run055
8744;RRR;GRR;0;1;1;0;1;run055
8745;RRR;RGR;0;1;1;0;1;run055
8746;BBB;GRR;0;1;1;0;1;run056
8747;BBG;BBB;1;9;10;2;8;run056
8748;BBG;BBR;0;2;2;2;0;run056
8749;BBG;BGB;0;1;1;1;0;run056
8750;BBG;BGG;0;1;1;1;0;run056
8751;BBG;BRB;0;2;2;2;0;run056
8752;BBG;BRR;0;1;1;1;0;run056
8753;BBG;GBB;1;1;2;0;2;run056
8754;BBG;GBG;1;6;7;6;1;run056
8755;BBG;GGB;0;18;18;6;12;run056
8756;BBG;GGG;1;29;30;21;9;run056
8757;BBG;GGR;0;2;2;2;0;run056
8758;BBG;GRG;0;1;1;1;0;run056
8759;BBG;GRR;0;3;3;1;2;run056
8760;BBG;RBR;0;2;2;2;0;run056
8761;BBG;RGR;0;2;2;2;0;run056
8762;BBG;RRG;1;2;3;3;0;run056
8763;BBG;RRR;0;1;1;1;0;run056
8764;BGG;BBB;0;1;1;1;0;run056
8765;BGG;BRB;0;1;1;1;0;run056
8766;BGG;GGG;0;1;1;0;1;run056
8767;BGG;RBB;0;1;1;1;0;run056
8768;BGG;RBG;1;0;1;0;1;run056
8769;BRB;BBB;0;1;1;1;0;run056
8770;BRB;GGB;1;0;1;1;0;run056
8771;BRB;GGG;0;2;2;0;2;run056
8772;BRB;RBB;1;0;1;0;1;run056
8773;BRR;BBB;0;1;1;0;1;run056
8774;BRR;BRB;0;1;1;0;1;run056
8775;BRR;GBB;1;0;1;0;1;run056
8776;GBB;BBB;1;16;17;17;0;run056
8777;GBB;BBG;0;2;2;2;0;run056
8778;GBB;BGB;0;1;1;0;1;run056
8779;GBB;BGG;0;3;3;3;0;run056
8780;GBB;BRB;0;9;9;1;8;run056
8781;GBB;BRR;0;2;2;1;1;run056
8782;GBB;GBG;1;1;2;1;1;run056
8783;GBB;GGB;2;59;61;38;23;run056
8784;GBB;GGG;4;95;99;19;80;run056
8785;GBB;GGR;0;1;1;0;1;run056
8786;GBB;GRG;0;1;1;0;1;run056
8787;GBB;GRR;1;8;9;6;3;run056
8788;GBB;RBB;0;2;2;0;2;run056
8789;GBB;RBG;0;1;1;1;0;run056
8790;GBB;RBR;1;1;2;1;1;run056
8791;GBB;RGG;0;2;2;1;1;run056
8792;GBB;RGR;0;1;1;0;1;run056
8793;GBB;RRG;0;3;3;0;3;run056
8794;GBG;BRB;0;1;1;0;1;run056
8795;GBG;BRR;0;3;3;1;2;run056
8796;GBG;GGB;0;1;1;1;0;run056
8797;GBG;GGR;0;3;3;0;3;run056
8798;GBG;RBR;0;1;1;1;0;run056
8799;GBG;RGR;1;1;2;0;2;run056
8800;GBG;RRR;0;1;1;0;1;run056
8801;GGB;BBB;1;8;9;6;3;run056
8802;GGB;BBG;0;1;1;1;0;run056
8803;GGB;BGB;0;1;1;1;0;run056
8804;GGB;BRB;3;5;8;3;5;run056
8805;GGB;BRR;0;1;1;0;1;run056
8806;GGB;GBG;0;2;2;1;1;run056
8807;GGB;GGG;4;37;41;15;26;run056
8808;GGB;GGR;0;9;9;3;6;run056
8809;GGB;GRR;1;4;5;1;4;run056
8810;GGB;RBB;0;2;2;2;0;run056
8811;GGB;RBG;0;2;2;1;1;run056
8812;GGB;RBR;0;2;2;0;2;run056
8813;GGB;RGG;0;1;1;1;0;run056
8814;GGB;RGR;1;2;3;1;2;run056
8815;GGB;RRG;1;3;4;4;0;run056
8816;GGB;RRR;0;3;3;0;3;run056
8817;GGG;BBB;4;22;26;21;5;run056
8818;GGG;BBG;0;2;2;1;1;run056
8819;GGG;BBR;0;3;3;0;3;run056
8820;GGG;BGB;0;2;2;1;1;run056
8821;GGG;BGG;0;3;3;0;3;run056
8822;GGG;BRB;0;3;3;3;0;run056
8823;GGG;BRR;0;3;3;3;0;run056
8824;GGG;GBB;0;1;1;0;1;run056
8825;GGG;GGB;1;3;4;0;4;run056
8826;GGG;GGR;0;21;21;14;7;run056
8827;GGG;GRG;0;2;2;2;0;run056
8828;GGG;GRR;2;15;17;16;1;run056
8829;GGG;RBB;0;1;1;1;0;run056
8830;GGG;RBR;1;4;5;2;3;run056
8831;GGG;RGG;1;7;8;7;1;run056
8832;GGG;RGR;0;3;3;2;1;run056
8833;GGG;RRG;0;2;2;1;1;run056
8834;GGG;RRR;0;1;1;1;0;run056
8835;GGR;BBB;0;1;1;0;1;run056
8836;GGR;BGG;0;2;2;2;0;run056
8837;GGR;BRB;0;1;1;1;0;run056
8838;GRG;BBB;0;3;3;0;3;run056
8839;GRG;BGB;0;3;3;1;2;run056
8840;GRG;BGG;0;1;1;1;0;run056
8841;GRG;BRB;0;5;5;5;0;run056
8842;GRG;BRR;0;1;1;1;0;run056
8843;GRG;GBB;0;3;3;1;2;run056
8844;GRG;GGB;0;14;14;7;7;run056
8845;GRG;GGG;0;10;10;0;10;run056
8846;GRG;GGR;0;2;2;2;0;run056
8847;GRG;GRR;0;1;1;0;1;run056
8848;GRG;RBR;1;2;3;0;3;run056
8849;GRG;RGG;0;2;2;2;0;run056
8850;GRG;RGR;0;1;1;0;1;run056
8851;GRR;BBB;0;3;3;0;3;run056
8852;GRR;BBR;0;2;2;0;2;run056
8853;GRR;BRB;1;8;9;5;4;run056
8854;GRR;BRR;1;6;7;4;3;run056
8855;GRR;GBB;0;1;1;0;1;run056
8856;GRR;GBG;0;1;1;0;1;run056
8857;GRR;GGR;1;9;10;8;2;run056
8858;GRR;RBR;0;1;1;1;0;run056
8859;GRR;RGG;1;3;4;2;2;run056
8860;GRR;RGR;0;1;1;1;0;run056
8861;GRR;RRR;0;1;1;1;0;run056
8862;RBB;BBB;0;1;1;0;1;run056
8863;RBB;GGG;0;3;3;3;0;run056
8864;RBG;GRR;0;1;1;1;0;run056
8865;RBG;RBR;0;1;1;0;1;run056
8866;RBG;RGR;0;1;1;0;1;run056
8867;RBR;BBB;0;3;3;2;1;run056
8868;RBR;BRB;0;1;1;1;0;run056
8869;RBR;BRR;0;2;2;2;0;run056
8870;RBR;GGG;0;1;1;1;0;run056
8871;RBR;GGR;1;2;3;1;2;run056
8872;RBR;GRG;0;1;1;1;0;run056
8873;RBR;GRR;1;15;16;11;5;run056
8874;RBR;RGG;0;4;4;3;1;run056
8875;RBR;RGR;0;1;1;0;1;run056
8876;RBR;RRR;0;3;3;3;0;run056
8877;RGG;BGG;0;1;1;0;1;run056
8878;RGG;RGR;0;1;1;1;0;run056
8879;RGR;BBB;0;9;9;9;0;run056
8880;RGR;BBR;0;1;1;0;1;run056
8881;RGR;BGB;1;8;9;0;9;run056
8882;RGR;BRB;0;3;3;1;2;run056
8883;RGR;BRR;0;3;3;0;3;run056
8884;RGR;GBG;0;1;1;1;0;run056
8885;RGR;GGB;0;3;3;1;2;run056
8886;RGR;GGG;0;2;2;2;0;run056
8887;RGR;GGR;0;8;8;3;5;run056
8888;RGR;GRR;1;7;8;7;1;run056
8889;RGR;RGG;0;6;6;4;2;run056
8890;RRG;BGB;0;1;1;1;0;run056
8891;RRG;BRB;0;1;1;0;1;run056
8892;RRG;GGG;0;1;1;0;1;run056
8893;RRG;GGR;0;1;1;0;1;run056
8894;RRG;GRG;0;1;1;1;0;run056
8895;RRG;GRR;0;3;3;3;0;run056
8896;RRG;RBR;0;4;4;4;0;run056
8897;RRG;RGG;0;1;1;0;1;run056
8898;RRG;RGR;6;37;43;13;30;run056
8899;RRR;BRR;0;1;1;1;0;run056
8900;RRR;GGB;0;1;1;1;0;run056
8901;RRR;GGG;1;5;6;6;0;run056
8902;RRR;GGR;0;2;2;0;2;run056
8903;RRR;GRR;0;1;1;1;0;run056
8904;RRR;RGR;0;1;1;1;0;run056
8905;BBB;GRR;0;1;1;1;0;run057
8906;BBG;BBB;1;9;10;0;10;run057
8907;BBG;BBR;0;2;2;2;0;run057
8908;BBG;BGB;0;1;1;1;0;run057
8909;BBG;BGG;0;1;1;1;0;run057
8910;BBG;BRB;0;2;2;2;0;run057
8911;BBG;BRR;0;1;1;0;1;run057
8912;BBG;GBB;1;1;2;0;2;run057
8913;BBG;GBG;1;6;7;7;0;run057
8914;BBG;GGB;0;18;18;8;10;run057
8915;BBG;GGG;1;29;30;17;13;run057
8916;BBG;GGR;0;2;2;1;1;run057
8917;BBG;GRG;0;1;1;0;1;run057
8918;BBG;GRR;0;3;3;2;1;run057
8919;BBG;RBR;0;2;2;1;1;run057
8920;BBG;RGR;0;2;2;2;0;run057
8921;BBG;RRG;1;2;3;2;1;run057
8922;BBG;RRR;0;1;1;1;0;run057
8923;BGG;BBB;0;1;1;1;0;run057
8924;BGG;BRB;0;1;1;0;1;run057
8925;BGG;GGG;0;1;1;0;1;run057
8926;BGG;RBB;0;1;1;1;0;run057
8927;BGG;RBG;1;0;1;0;1;run057
8928;BRB;BBB;0;1;1;0;1;run057
8929;BRB;GGB;1;0;1;1;0;run057
8930;BRB;GGG;0;2;2;1;1;run057
8931;BRB;RBB;1;0;1;1;0;run057
8932;BRR;BBB;0;1;1;0;1;run057
8933;BRR;BRB;0;1;1;1;0;run057
8934;BRR;GBB;1;0;1;1;0;run057
8935;GBB;BBB;1;16;17;12;5;run057
8936;GBB;BBG;0;2;2;2;0;run057
8937;GBB;BGB;0;1;1;0;1;run057
8938;GBB;BGG;0;3;3;3;0;run057
8939;GBB;BRB;0;9;9;9;0;run057
8940;GBB;BRR;0;2;2;2;0;run057
8941;GBB;GBG;1;1;2;2;0;run057
8942;GBB;GGB;2;59;61;55;6;run057
8943;GBB;GGG;4;95;99;24;75;run057
8944;GBB;GGR;0;1;1;1;0;run057
8945;GBB;GRG;0;1;1;1;0;run057
8946;GBB;GRR;1;8;9;2;7;run057
8947;GBB;RBB;0;2;2;1;1;run057
8948;GBB;RBG;0;1;1;1;0;run057
8949;GBB;RBR;1;1;2;1;1;run057
8950;GBB;RGG;0;2;2;1;1;run057
8951;GBB;RGR;0;1;1;0;1;run057
8952;GBB;RRG;0;3;3;3;0;run057
8953;GBG;BRB;0;1;1;1;0;run057
8954;GBG;BRR;0;3;3;1;2;run057
8955;GBG;GGB;0;1;1;0;1;run057
8956;GBG;GGR;0;3;3;0;3;run057
8957;GBG;RBR;0;1;1;0;1;run057
8958;GBG;RGR;1;1;2;2;0;run057
8959;GBG;RRR;0;1;1;1;0;run057
8960;GGB;BBB;1;8;9;0;9;run057
8961;GGB;BBG;0;1;1;0;1;run057
8962;GGB;BGB;0;1;1;1;0;run057
8963;GGB;BRB;3;5;8;5;3;run057
8964;GGB;BRR;0;1;1;1;0;run057
8965;GGB;GBG;0;2;2;0;2;run057
8966;GGB;GGG;4;37;41;32;9;run057
8967;GGB;GGR;0;9;9;7;2;run057
8968;GGB;GRR;1;4;5;3;2;run057
8969;GGB;RBB;0;2;2;1;1;run057
8970;GGB;RBG;0;2;2;1;1;run057
8971;GGB;RBR;0;2;2;1;1;run057
8972;GGB;RGG;0;1;1;0;1;run057
8973;GGB;RGR;1;2;3;3;0;run057
8974;GGB;RRG;1;3;4;0;4;run057
8975;GGB;RRR;0;3;3;2;1;run057
8976;GGG;BBB;4;22;26;25;1;run057
8977;GGG;BBG;0;2;2;2;0;run057
8978;GGG;BBR;0;3;3;3;0;run057
8979;GGG;BGB;0;2;2;1;1;run057
8980;GGG;BGG;0;3;3;2;1;run057
8981;GGG;BRB;0;3;3;0;3;run057
8982;GGG;BRR;0;3;3;2;1;run057
8983;GGG;GBB;0;1;1;1;0;run057
8984;GGG;GGB;1;3;4;3;1;run057
8985;GGG;GGR;0;21;21;1;20;run057
8986;GGG;GRG;0;2;2;2;0;run057
8987;GGG;GRR;2;15;17;3;14;run057
8988;GGG;RBB;0;1;1;0;1;run057
8989;GGG;RBR;1;4;5;0;5;run057
8990;GGG;RGG;1;7;8;4;4;run057
8991;GGG;RGR;0;3;3;0;3;run057
8992;GGG;RRG;0;2;2;2;0;run057
8993;GGG;RRR;0;1;1;0;1;run057
8994;GGR;BBB;0;1;1;1;0;run057
8995;GGR;BGG;0;2;2;0;2;run057
8996;GGR;BRB;0;1;1;1;0;run057
8997;GRG;BBB;0;3;3;1;2;run057
8998;GRG;BGB;0;3;3;1;2;run057
8999;GRG;BGG;0;1;1;0;1;run057
9000;GRG;BRB;0;5;5;4;1;run057
9001;GRG;BRR;0;1;1;0;1;run057
9002;GRG;GBB;0;3;3;2;1;run057
9003;GRG;GGB;0;14;14;10;4;run057
9004;GRG;GGG;0;10;10;9;1;run057
9005;GRG;GGR;0;2;2;0;2;run057
9006;GRG;GRR;0;1;1;0;1;run057
9007;GRG;RBR;1;2;3;0;3;run057
9008;GRG;RGG;0;2;2;2;0;run057
9009;GRG;RGR;0;1;1;0;1;run057
9010;GRR;BBB;0;3;3;2;1;run057
9011;GRR;BBR;0;2;2;1;1;run057
9012;GRR;BRB;1;8;9;7;2;run057
9013;GRR;BRR;1;6;7;1;6;run057
9014;GRR;GBB;0;1;1;0;1;run057
9015;GRR;GBG;0;1;1;0;1;run057
9016;GRR;GGR;1;9;10;1;9;run057
9017;GRR;RBR;0;1;1;0;1;run057
9018;GRR;RGG;1;3;4;0;4;run057
9019;GRR;RGR;0;1;1;0;1;run057
9020;GRR;RRR;0;1;1;1;0;run057
9021;RBB;BBB;0;1;1;0;1;run057
9022;RBB;GGG;0;3;3;0;3;run057
9023;RBG;GRR;0;1;1;0;1;run057
9024;RBG;RBR;0;1;1;0;1;run057
9025;RBG;RGR;0;1;1;1;0;run057
9026;RBR;BBB;0;3;3;3;0;run057
9027;RBR;BRB;0;1;1;1;0;run057
9028;RBR;BRR;0;2;2;1;1;run057
9029;RBR;GGG;0;1;1;0;1;run057
9030;RBR;GGR;1;2;3;0;3;run057
9031;RBR;GRG;0;1;1;0;1;run057
9032;RBR;GRR;1;15;16;5;11;run057
9033;RBR;RGG;0;4;4;2;2;run057
9034;RBR;RGR;0;1;1;1;0;run057
9035;RBR;RRR;0;3;3;0;3;run057
9036;RGG;BGG;0;1;1;1;0;run057
9037;RGG;RGR;0;1;1;1;0;run057
9038;RGR;BBB;0;9;9;7;2;run057
9039;RGR;BBR;0;1;1;1;0;run057
9040;RGR;BGB;1;8;9;5;4;run057
9041;RGR;BRB;0;3;3;0;3;run057
9042;RGR;BRR;0;3;3;1;2;run057
9043;RGR;GBG;0;1;1;0;1;run057
9044;RGR;GGB;0;3;3;3;0;run057
9045;RGR;GGG;0;2;2;2;0;run057
9046;RGR;GGR;0;8;8;1;7;run057
9047;RGR;GRR;1;7;8;8;0;run057
9048;RGR;RGG;0;6;6;0;6;run057
9049;RRG;BGB;0;1;1;0;1;run057
9050;RRG;BRB;0;1;1;1;0;run057
9051;RRG;GGG;0;1;1;1;0;run057
9052;RRG;GGR;0;1;1;1;0;run057
9053;RRG;GRG;0;1;1;1;0;run057
9054;RRG;GRR;0;3;3;3;0;run057
9055;RRG;RBR;0;4;4;1;3;run057
9056;RRG;RGG;0;1;1;1;0;run057
9057;RRG;RGR;6;37;43;42;1;run057
9058;RRR;BRR;0;1;1;0;1;run057
9059;RRR;GGB;0;1;1;1;0;run057
9060;RRR;GGG;1;5;6;0;6;run057
9061;RRR;GGR;0;2;2;0;2;run057
9062;RRR;GRR;0;1;1;1;0;run057
9063;RRR;RGR;0;1;1;1;0;run057
9064;BBB;GRR;0;1;1;0;1;run058
9065;BBG;BBB;1;9;10;5;5;run058
9066;BBG;BBR;0;2;2;1;1;run058
9067;BBG;BGB;0;1;1;1;0;run058
9068;BBG;BGG;0;1;1;0;1;run058
9069;BBG;BRB;0;2;2;0;2;run058
9070;BBG;BRR;0;1;1;0;1;run058
9071;BBG;GBB;1;1;2;2;0;run058
9072;BBG;GBG;1;6;7;0;7;run058
9073;BBG;GGB;0;18;18;16;2;run058
9074;BBG;GGG;1;29;30;25;5;run058
9075;BBG;GGR;0;2;2;2;0;run058
9076;BBG;GRG;0;1;1;1;0;run058
9077;BBG;GRR;0;3;3;1;2;run058
9078;BBG;RBR;0;2;2;2;0;run058
9079;BBG;RGR;0;2;2;2;0;run058
9080;BBG;RRG;1;2;3;2;1;run058
9081;BBG;RRR;0;1;1;0;1;run058
9082;BGG;BBB;0;1;1;0;1;run058
9083;BGG;BRB;0;1;1;1;0;run058
9084;BGG;GGG;0;1;1;0;1;run058
9085;BGG;RBB;0;1;1;0;1;run058
9086;BGG;RBG;1;0;1;0;1;run058
9087;BRB;BBB;0;1;1;0;1;run058
9088;BRB;GGB;1;0;1;0;1;run058
9089;BRB;GGG;0;2;2;0;2;run058
9090;BRB;RBB;1;0;1;0;1;run058
9091;BRR;BBB;0;1;1;0;1;run058
9092;BRR;BRB;0;1;1;1;0;run058
9093;BRR;GBB;1;0;1;1;0;run058
9094;GBB;BBB;1;16;17;14;3;run058
9095;GBB;BBG;0;2;2;0;2;run058
9096;GBB;BGB;0;1;1;0;1;run058
9097;GBB;BGG;0;3;3;0;3;run058
9098;GBB;BRB;0;9;9;7;2;run058
9099;GBB;BRR;0;2;2;0;2;run058
9100;GBB;GBG;1;1;2;2;0;run058
9101;GBB;GGB;2;59;61;51;10;run058
9102;GBB;GGG;4;95;99;91;8;run058
9103;GBB;GGR;0;1;1;1;0;run058
9104;GBB;GRG;0;1;1;0;1;run058
9105;GBB;GRR;1;8;9;1;8;run058
9106;GBB;RBB;0;2;2;1;1;run058
9107;GBB;RBG;0;1;1;1;0;run058
9108;GBB;RBR;1;1;2;0;2;run058
9109;GBB;RGG;0;2;2;0;2;run058
9110;GBB;RGR;0;1;1;1;0;run058
9111;GBB;RRG;0;3;3;3;0;run058
9112;GBG;BRB;0;1;1;1;0;run058
9113;GBG;BRR;0;3;3;3;0;run058
9114;GBG;GGB;0;1;1;0;1;run058
9115;GBG;GGR;0;3;3;2;1;run058
9116;GBG;RBR;0;1;1;0;1;run058
9117;GBG;RGR;1;1;2;1;1;run058
9118;GBG;RRR;0;1;1;0;1;run058
9119;GGB;BBB;1;8;9;6;3;run058
9120;GGB;BBG;0;1;1;0;1;run058
9121;GGB;BGB;0;1;1;1;0;run058
9122;GGB;BRB;3;5;8;1;7;run058
9123;GGB;BRR;0;1;1;0;1;run058
9124;GGB;GBG;0;2;2;1;1;run058
9125;GGB;GGG;4;37;41;27;14;run058
9126;GGB;GGR;0;9;9;6;3;run058
9127;GGB;GRR;1;4;5;3;2;run058
9128;GGB;RBB;0;2;2;0;2;run058
9129;GGB;RBG;0;2;2;1;1;run058
9130;GGB;RBR;0;2;2;0;2;run058
9131;GGB;RGG;0;1;1;0;1;run058
9132;GGB;RGR;1;2;3;3;0;run058
9133;GGB;RRG;1;3;4;0;4;run058
9134;GGB;RRR;0;3;3;2;1;run058
9135;GGG;BBB;4;22;26;11;15;run058
9136;GGG;BBG;0;2;2;2;0;run058
9137;GGG;BBR;0;3;3;0;3;run058
9138;GGG;BGB;0;2;2;2;0;run058
9139;GGG;BGG;0;3;3;2;1;run058
9140;GGG;BRB;0;3;3;3;0;run058
9141;GGG;BRR;0;3;3;1;2;run058
9142;GGG;GBB;0;1;1;1;0;run058
9143;GGG;GGB;1;3;4;0;4;run058
9144;GGG;GGR;0;21;21;0;21;run058
9145;GGG;GRG;0;2;2;1;1;run058
9146;GGG;GRR;2;15;17;11;6;run058
9147;GGG;RBB;0;1;1;0;1;run058
9148;GGG;RBR;1;4;5;5;0;run058
9149;GGG;RGG;1;7;8;0;8;run058
9150;GGG;RGR;0;3;3;3;0;run058
9151;GGG;RRG;0;2;2;2;0;run058
9152;GGG;RRR;0;1;1;1;0;run058
9153;GGR;BBB;0;1;1;0;1;run058
9154;GGR;BGG;0;2;2;1;1;run058
9155;GGR;BRB;0;1;1;0;1;run058
9156;GRG;BBB;0;3;3;1;2;run058
9157;GRG;BGB;0;3;3;3;0;run058
9158;GRG;BGG;0;1;1;0;1;run058
9159;GRG;BRB;0;5;5;4;1;run058
9160;GRG;BRR;0;1;1;0;1;run058
9161;GRG;GBB;0;3;3;1;2;run058
9162;GRG;GGB;0;14;14;14;0;run058
9163;GRG;GGG;0;10;10;9;1;run058
9164;GRG;GGR;0;2;2;1;1;run058
9165;GRG;GRR;0;1;1;0;1;run058
9166;GRG;RBR;1;2;3;2;1;run058
9167;GRG;RGG;0;2;2;2;0;run058
9168;GRG;RGR;0;1;1;1;0;run058
9169;GRR;BBB;0;3;3;1;2;run058
9170;GRR;BBR;0;2;2;2;0;run058
9171;GRR;BRB;1;8;9;7;2;run058
9172;GRR;BRR;1;6;7;1;6;run058
9173;GRR;GBB;0;1;1;1;0;run058
9174;GRR;GBG;0;1;1;0;1;run058
9175;GRR;GGR;1;9;10;3;7;run058
9176;GRR;RBR;0;1;1;0;1;run058
9177;GRR;RGG;1;3;4;4;0;run058
9178;GRR;RGR;0;1;1;0;1;run058
9179;GRR;RRR;0;1;1;1;0;run058
9180;RBB;BBB;0;1;1;0;1;run058
9181;RBB;GGG;0;3;3;2;1;run058
9182;RBG;GRR;0;1;1;1;0;run058
9183;RBG;RBR;0;1;1;0;1;run058
9184;RBG;RGR;0;1;1;0;1;run058
9185;RBR;BBB;0;3;3;0;3;run058
9186;RBR;BRB;0;1;1;1;0;run058
9187;RBR;BRR;0;2;2;2;0;run058
9188;RBR;GGG;0;1;1;1;0;run058
9189;RBR;GGR;1;2;3;0;3;run058
9190;RBR;GRG;0;1;1;1;0;run058
9191;RBR;GRR;1;15;16;16;0;run058
9192;RBR;RGG;0;4;4;0;4;run058
9193;RBR;RGR;0;1;1;0;1;run058
9194;RBR;RRR;0;3;3;3;0;run058
9195;RGG;BGG;0;1;1;0;1;run058
9196;RGG;RGR;0;1;1;0;1;run058
9197;RGR;BBB;0;9;9;5;4;run058
9198;RGR;BBR;0;1;1;0;1;run058
9199;RGR;BGB;1;8;9;7;2;run058
9200;RGR;BRB;0;3;3;0;3;run058
9201;RGR;BRR;0;3;3;1;2;run058
9202;RGR;GBG;0;1;1;1;0;run058
9203;RGR;GGB;0;3;3;2;1;run058
9204;RGR;GGG;0;2;2;0;2;run058
9205;RGR;GGR;0;8;8;2;6;run058
9206;RGR;GRR;1;7;8;0;8;run058
9207;RGR;RGG;0;6;6;0;6;run058
9208;RRG;BGB;0;1;1;1;0;run058
9209;RRG;BRB;0;1;1;1;0;run058
9210;RRG;GGG;0;1;1;0;1;run058
9211;RRG;GGR;0;1;1;1;0;run058
9212;RRG;GRG;0;1;1;1;0;run058
9213;RRG;GRR;0;3;3;3;0;run058
9214;RRG;RBR;0;4;4;4;0;run058
9215;RRG;RGG;0;1;1;1;0;run058
9216;RRG;RGR;6;37;43;31;12;run058
9217;RRR;BRR;0;1;1;1;0;run058
9218;RRR;GGB;0;1;1;1;0;run058
9219;RRR;GGG;1;5;6;1;5;run058
9220;RRR;GGR;0;2;2;1;1;run058
9221;RRR;GRR;0;1;1;1;0;run058
9222;RRR;RGR;0;1;1;0;1;run058
9223;BBB;GRR;0;1;1;0;1;run059
9224;BBG;BBB;1;9;10;8;2;run059
9225;BBG;BBR;0;2;2;0;2;run059
9226;BBG;BGB;0;1;1;0;1;run059
9227;BBG;BGG;0;1;1;0;1;run059
9228;BBG;BRB;0;2;2;0;2;run059
9229;BBG;BRR;0;1;1;0;1;run059
9230;BBG;GBB;1;1;2;1;1;run059
9231;BBG;GBG;1;6;7;4;3;run059
9232;BBG;GGB;0;18;18;10;8;run059
9233;BBG;GGG;1;29;30;12;18;run059
9234;BBG;GGR;0;2;2;1;1;run059
9235;BBG;GRG;0;1;1;0;1;run059
9236;BBG;GRR;0;3;3;3;0;run059
9237;BBG;RBR;0;2;2;2;0;run059
9238;BBG;RGR;0;2;2;1;1;run059
9239;BBG;RRG;1;2;3;1;2;run059
9240;BBG;RRR;0;1;1;1;0;run059
9241;BGG;BBB;0;1;1;1;0;run059
9242;BGG;BRB;0;1;1;1;0;run059
9243;BGG;GGG;0;1;1;0;1;run059
9244;BGG;RBB;0;1;1;1;0;run059
9245;BGG;RBG;1;0;1;1;0;run059
9246;BRB;BBB;0;1;1;0;1;run059
9247;BRB;GGB;1;0;1;0;1;run059
9248;BRB;GGG;0;2;2;1;1;run059
9249;BRB;RBB;1;0;1;1;0;run059
9250;BRR;BBB;0;1;1;0;1;run059
9251;BRR;BRB;0;1;1;0;1;run059
9252;BRR;GBB;1;0;1;1;0;run059
9253;GBB;BBB;1;16;17;6;11;run059
9254;GBB;BBG;0;2;2;2;0;run059
9255;GBB;BGB;0;1;1;1;0;run059
9256;GBB;BGG;0;3;3;3;0;run059
9257;GBB;BRB;0;9;9;8;1;run059
9258;GBB;BRR;0;2;2;2;0;run059
9259;GBB;GBG;1;1;2;0;2;run059
9260;GBB;GGB;2;59;61;21;40;run059
9261;GBB;GGG;4;95;99;3;96;run059
9262;GBB;GGR;0;1;1;0;1;run059
9263;GBB;GRG;0;1;1;1;0;run059
9264;GBB;GRR;1;8;9;9;0;run059
9265;GBB;RBB;0;2;2;1;1;run059
9266;GBB;RBG;0;1;1;1;0;run059
9267;GBB;RBR;1;1;2;2;0;run059
9268;GBB;RGG;0;2;2;2;0;run059
9269;GBB;RGR;0;1;1;1;0;run059
9270;GBB;RRG;0;3;3;3;0;run059
9271;GBG;BRB;0;1;1;1;0;run059
9272;GBG;BRR;0;3;3;3;0;run059
9273;GBG;GGB;0;1;1;1;0;run059
9274;GBG;GGR;0;3;3;0;3;run059
9275;GBG;RBR;0;1;1;0;1;run059
9276;GBG;RGR;1;1;2;2;0;run059
9277;GBG;RRR;0;1;1;0;1;run059
9278;GGB;BBB;1;8;9;3;6;run059
9279;GGB;BBG;0;1;1;1;0;run059
9280;GGB;BGB;0;1;1;0;1;run059
9281;GGB;BRB;3;5;8;5;3;run059
9282;GGB;BRR;0;1;1;1;0;run059
9283;GGB;GBG;0;2;2;2;0;run059
9284;GGB;GGG;4;37;41;8;33;run059
9285;GGB;GGR;0;9;9;2;7;run059
9286;GGB;GRR;1;4;5;5;0;run059
9287;GGB;RBB;0;2;2;2;0;run059
9288;GGB;RBG;0;2;2;1;1;run059
9289;GGB;RBR;0;2;2;2;0;run059
9290;GGB;RGG;0;1;1;0;1;run059
9291;GGB;RGR;1;2;3;3;0;run059
9292;GGB;RRG;1;3;4;1;3;run059
9293;GGB;RRR;0;3;3;2;1;run059
9294;GGG;BBB;4;22;26;10;16;run059
9295;GGG;BBG;0;2;2;0;2;run059
9296;GGG;BBR;0;3;3;2;1;run059
9297;GGG;BGB;0;2;2;0;2;run059
9298;GGG;BGG;0;3;3;2;1;run059
9299;GGG;BRB;0;3;3;0;3;run059
9300;GGG;BRR;0;3;3;1;2;run059
9301;GGG;GBB;0;1;1;1;0;run059
9302;GGG;GGB;1;3;4;2;2;run059
9303;GGG;GGR;0;21;21;11;10;run059
9304;GGG;GRG;0;2;2;1;1;run059
9305;GGG;GRR;2;15;17;13;4;run059
9306;GGG;RBB;0;1;1;0;1;run059
9307;GGG;RBR;1;4;5;3;2;run059
9308;GGG;RGG;1;7;8;6;2;run059
9309;GGG;RGR;0;3;3;0;3;run059
9310;GGG;RRG;0;2;2;1;1;run059
9311;GGG;RRR;0;1;1;1;0;run059
9312;GGR;BBB;0;1;1;0;1;run059
9313;GGR;BGG;0;2;2;2;0;run059
9314;GGR;BRB;0;1;1;1;0;run059
9315;GRG;BBB;0;3;3;3;0;run059
9316;GRG;BGB;0;3;3;3;0;run059
9317;GRG;BGG;0;1;1;1;0;run059
9318;GRG;BRB;0;5;5;4;1;run059
9319;GRG;BRR;0;1;1;1;0;run059
9320;GRG;GBB;0;3;3;3;0;run059
9321;GRG;GGB;0;14;14;2;12;run059
9322;GRG;GGG;0;10;10;5;5;run059
9323;GRG;GGR;0;2;2;1;1;run059
9324;GRG;GRR;0;1;1;0;1;run059
9325;GRG;RBR;1;2;3;1;2;run059
9326;GRG;RGG;0;2;2;1;1;run059
9327;GRG;RGR;0;1;1;1;0;run059
9328;GRR;BBB;0;3;3;2;1;run059
9329;GRR;BBR;0;2;2;2;0;run059
9330;GRR;BRB;1;8;9;0;9;run059
9331;GRR;BRR;1;6;7;2;5;run059
9332;GRR;GBB;0;1;1;1;0;run059
9333;GRR;GBG;0;1;1;0;1;run059
9334;GRR;GGR;1;9;10;7;3;run059
9335;GRR;RBR;0;1;1;0;1;run059
9336;GRR;RGG;1;3;4;0;4;run059
9337;GRR;RGR;0;1;1;1;0;run059
9338;GRR;RRR;0;1;1;0;1;run059
9339;RBB;BBB;0;1;1;1;0;run059
9340;RBB;GGG;0;3;3;3;0;run059
9341;RBG;GRR;0;1;1;0;1;run059
9342;RBG;RBR;0;1;1;0;1;run059
9343;RBG;RGR;0;1;1;0;1;run059
9344;RBR;BBB;0;3;3;2;1;run059
9345;RBR;BRB;0;1;1;0;1;run059
9346;RBR;BRR;0;2;2;2;0;run059
9347;RBR;GGG;0;1;1;0;1;run059
9348;RBR;GGR;1;2;3;2;1;run059
9349;RBR;GRG;0;1;1;0;1;run059
9350;RBR;GRR;1;15;16;10;6;run059
9351;RBR;RGG;0;4;4;4;0;run059
9352;RBR;RGR;0;1;1;1;0;run059
9353;RBR;RRR;0;3;3;2;1;run059
9354;RGG;BGG;0;1;1;0;1;run059
9355;RGG;RGR;0;1;1;1;0;run059
9356;RGR;BBB;0;9;9;0;9;run059
9357;RGR;BBR;0;1;1;0;1;run059
9358;RGR;BGB;1;8;9;7;2;run059
9359;RGR;BRB;0;3;3;3;0;run059
9360;RGR;BRR;0;3;3;1;2;run059
9361;RGR;GBG;0;1;1;1;0;run059
9362;RGR;GGB;0;3;3;0;3;run059
9363;RGR;GGG;0;2;2;0;2;run059
9364;RGR;GGR;0;8;8;2;6;run059
9365;RGR;GRR;1;7;8;1;7;run059
9366;RGR;RGG;0;6;6;0;6;run059
9367;RRG;BGB;0;1;1;0;1;run059
9368;RRG;BRB;0;1;1;0;1;run059
9369;RRG;GGG;0;1;1;1;0;run059
9370;RRG;GGR;0;1;1;1;0;run059
9371;RRG;GRG;0;1;1;0;1;run059
9372;RRG;GRR;0;3;3;0;3;run059
9373;RRG;RBR;0;4;4;4;0;run059
9374;RRG;RGG;0;1;1;0;1;run059
9375;RRG;RGR;6;37;43;15;28;run059
9376;RRR;BRR;0;1;1;1;0;run059
9377;RRR;GGB;0;1;1;0;1;run059
9378;RRR;GGG;1;5;6;3;3;run059
9379;RRR;GGR;0;2;2;1;1;run059
9380;RRR;GRR;0;1;1;1;0;run059
9381;RRR;RGR;0;1;1;1;0;run059
9382;BBB;GRR;0;1;1;0;1;run060
9383;BBG;BBB;1;9;10;1;9;run060
9384;BBG;BBR;0;2;2;0;2;run060
9385;BBG;BGB;0;1;1;1;0;run060
9386;BBG;BGG;0;1;1;1;0;run060
9387;BBG;BRB;0;2;2;2;0;run060
9388;BBG;BRR;0;1;1;1;0;run060
9389;BBG;GBB;1;1;2;1;1;run060
9390;BBG;GBG;1;6;7;5;2;run060
9391;BBG;GGB;0;18;18;18;0;run060
9392;BBG;GGG;1;29;30;24;6;run060
9393;BBG;GGR;0;2;2;0;2;run060
9394;BBG;GRG;0;1;1;0;1;run060
9395;BBG;GRR;0;3;3;3;0;run060
9396;BBG;RBR;0;2;2;2;0;run060
9397;BBG;RGR;0;2;2;2;0;run060
9398;BBG;RRG;1;2;3;0;3;run060
9399;BBG;RRR;0;1;1;1;0;run060
9400;BGG;BBB;0;1;1;1;0;run060
9401;BGG;BRB;0;1;1;1;0;run060
9402;BGG;GGG;0;1;1;1;0;run060
9403;BGG;RBB;0;1;1;1;0;run060
9404;BGG;RBG;1;0;1;0;1;run060
9405;BRB;BBB;0;1;1;1;0;run060
9406;BRB;GGB;1;0;1;1;0;run060
9407;BRB;GGG;0;2;2;2;0;run060
9408;BRB;RBB;1;0;1;0;1;run060
9409;BRR;BBB;0;1;1;1;0;run060
9410;BRR;BRB;0;1;1;0;1;run060
9411;BRR;GBB;1;0;1;0;1;run060
9412;GBB;BBB;1;16;17;4;13;run060
9413;GBB;BBG;0;2;2;2;0;run060
9414;GBB;BGB;0;1;1;0;1;run060
9415;GBB;BGG;0;3;3;1;2;run060
9416;GBB;BRB;0;9;9;9;0;run060
9417;GBB;BRR;0;2;2;1;1;run060
9418;GBB;GBG;1;1;2;0;2;run060
9419;GBB;GGB;2;59;61;13;48;run060
9420;GBB;GGG;4;95;99;41;58;run060
9421;GBB;GGR;0;1;1;0;1;run060
9422;GBB;GRG;0;1;1;0;1;run060
9423;GBB;GRR;1;8;9;5;4;run060
9424;GBB;RBB;0;2;2;2;0;run060
9425;GBB;RBG;0;1;1;0;1;run060
9426;GBB;RBR;1;1;2;1;1;run060
9427;GBB;RGG;0;2;2;0;2;run060
9428;GBB;RGR;0;1;1;0;1;run060
9429;GBB;RRG;0;3;3;3;0;run060
9430;GBG;BRB;0;1;1;0;1;run060
9431;GBG;BRR;0;3;3;3;0;run060
9432;GBG;GGB;0;1;1;0;1;run060
9433;GBG;GGR;0;3;3;2;1;run060
9434;GBG;RBR;0;1;1;1;0;run060
9435;GBG;RGR;1;1;2;0;2;run060
9436;GBG;RRR;0;1;1;0;1;run060
9437;GGB;BBB;1;8;9;4;5;run060
9438;GGB;BBG;0;1;1;0;1;run060
9439;GGB;BGB;0;1;1;0;1;run060
9440;GGB;BRB;3;5;8;6;2;run060
9441;GGB;BRR;0;1;1;0;1;run060
9442;GGB;GBG;0;2;2;1;1;run060
9443;GGB;GGG;4;37;41;6;35;run060
9444;GGB;GGR;0;9;9;1;8;run060
9445;GGB;GRR;1;4;5;2;3;run060
9446;GGB;RBB;0;2;2;0;2;run060
9447;GGB;RBG;0;2;2;2;0;run060
9448;GGB;RBR;0;2;2;0;2;run060
9449;GGB;RGG;0;1;1;1;0;run060
9450;GGB;RGR;1;2;3;1;2;run060
9451;GGB;RRG;1;3;4;3;1;run060
9452;GGB;RRR;0;3;3;0;3;run060
9453;GGG;BBB;4;22;26;21;5;run060
9454;GGG;BBG;0;2;2;0;2;run060
9455;GGG;BBR;0;3;3;1;2;run060
9456;GGG;BGB;0;2;2;0;2;run060
9457;GGG;BGG;0;3;3;2;1;run060
9458;GGG;BRB;0;3;3;1;2;run060
9459;GGG;BRR;0;3;3;2;1;run060
9460;GGG;GBB;0;1;1;1;0;run060
9461;GGG;GGB;1;3;4;1;3;run060
9462;GGG;GGR;0;21;21;9;12;run060
9463;GGG;GRG;0;2;2;2;0;run060
9464;GGG;GRR;2;15;17;16;1;run060
9465;GGG;RBB;0;1;1;0;1;run060
9466;GGG;RBR;1;4;5;5;0;run060
9467;GGG;RGG;1;7;8;6;2;run060
9468;GGG;RGR;0;3;3;3;0;run060
9469;GGG;RRG;0;2;2;2;0;run060
9470;GGG;RRR;0;1;1;0;1;run060
9471;GGR;BBB;0;1;1;0;1;run060
9472;GGR;BGG;0;2;2;1;1;run060
9473;GGR;BRB;0;1;1;1;0;run060
9474;GRG;BBB;0;3;3;1;2;run060
9475;GRG;BGB;0;3;3;2;1;run060
9476;GRG;BGG;0;1;1;0;1;run060
9477;GRG;BRB;0;5;5;1;4;run060
9478;GRG;BRR;0;1;1;0;1;run060
9479;GRG;GBB;0;3;3;3;0;run060
9480;GRG;GGB;0;14;14;5;9;run060
9481;GRG;GGG;0;10;10;1;9;run060
9482;GRG;GGR;0;2;2;0;2;run060
9483;GRG;GRR;0;1;1;0;1;run060
9484;GRG;RBR;1;2;3;3;0;run060
9485;GRG;RGG;0;2;2;0;2;run060
9486;GRG;RGR;0;1;1;1;0;run060
9487;GRR;BBB;0;3;3;0;3;run060
9488;GRR;BBR;0;2;2;1;1;run060
9489;GRR;BRB;1;8;9;4;5;run060
9490;GRR;BRR;1;6;7;0;7;run060
9491;GRR;GBB;0;1;1;1;0;run060
9492;GRR;GBG;0;1;1;1;0;run060
9493;GRR;GGR;1;9;10;2;8;run060
9494;GRR;RBR;0;1;1;1;0;run060
9495;GRR;RGG;1;3;4;1;3;run060
9496;GRR;RGR;0;1;1;1;0;run060
9497;GRR;RRR;0;1;1;0;1;run060
9498;RBB;BBB;0;1;1;0;1;run060
9499;RBB;GGG;0;3;3;2;1;run060
9500;RBG;GRR;0;1;1;1;0;run060
9501;RBG;RBR;0;1;1;1;0;run060
9502;RBG;RGR;0;1;1;0;1;run060
9503;RBR;BBB;0;3;3;2;1;run060
9504;RBR;BRB;0;1;1;1;0;run060
9505;RBR;BRR;0;2;2;0;2;run060
9506;RBR;GGG;0;1;1;1;0;run060
9507;RBR;GGR;1;2;3;2;1;run060
9508;RBR;GRG;0;1;1;1;0;run060
9509;RBR;GRR;1;15;16;10;6;run060
9510;RBR;RGG;0;4;4;1;3;run060
9511;RBR;RGR;0;1;1;0;1;run060
9512;RBR;RRR;0;3;3;2;1;run060
9513;RGG;BGG;0;1;1;1;0;run060
9514;RGG;RGR;0;1;1;0;1;run060
9515;RGR;BBB;0;9;9;8;1;run060
9516;RGR;BBR;0;1;1;1;0;run060
9517;RGR;BGB;1;8;9;3;6;run060
9518;RGR;BRB;0;3;3;1;2;run060
9519;RGR;BRR;0;3;3;2;1;run060
9520;RGR;GBG;0;1;1;1;0;run060
9521;RGR;GGB;0;3;3;3;0;run060
9522;RGR;GGG;0;2;2;1;1;run060
9523;RGR;GGR;0;8;8;1;7;run060
9524;RGR;GRR;1;7;8;2;6;run060
9525;RGR;RGG;0;6;6;2;4;run060
9526;RRG;BGB;0;1;1;1;0;run060
9527;RRG;BRB;0;1;1;0;1;run060
9528;RRG;GGG;0;1;1;0;1;run060
9529;RRG;GGR;0;1;1;0;1;run060
9530;RRG;GRG;0;1;1;1;0;run060
9531;RRG;GRR;0;3;3;0;3;run060
9532;RRG;RBR;0;4;4;2;2;run060
9533;RRG;RGG;0;1;1;0;1;run060
9534;RRG;RGR;6;37;43;23;20;run060
9535;RRR;BRR;0;1;1;1;0;run060
9536;RRR;GGB;0;1;1;0;1;run060
9537;RRR;GGG;1;5;6;0;6;run060
9538;RRR;GGR;0;2;2;2;0;run060
9539;RRR;GRR;0;1;1;0;1;run060
9540;RRR;RGR;0;1;1;0;1;run060
9541;BBB;GRR;0;1;1;1;0;run061
9542;BBG;BBB;1;9;10;6;4;run061
9543;BBG;BBR;0;2;2;2;0;run061
9544;BBG;BGB;0;1;1;1;0;run061
9545;BBG;BGG;0;1;1;1;0;run061
9546;BBG;BRB;0;2;2;0;2;run061
9547;BBG;BRR;0;1;1;1;0;run061
9548;BBG;GBB;1;1;2;1;1;run061
9549;BBG;GBG;1;6;7;2;5;run061
9550;BBG;GGB;0;18;18;0;18;run061
9551;BBG;GGG;1;29;30;3;27;run061
9552;BBG;GGR;0;2;2;0;2;run061
9553;BBG;GRG;0;1;1;1;0;run061
9554;BBG;GRR;0;3;3;2;1;run061
9555;BBG;RBR;0;2;2;1;1;run061
9556;BBG;RGR;0;2;2;2;0;run061
9557;BBG;RRG;1;2;3;3;0;run061
9558;BBG;RRR;0;1;1;1;0;run061
9559;BGG;BBB;0;1;1;0;1;run061
9560;BGG;BRB;0;1;1;0;1;run061
9561;BGG;GGG;0;1;1;1;0;run061
9562;BGG;RBB;0;1;1;1;0;run061
9563;BGG;RBG;1;0;1;1;0;run061
9564;BRB;BBB;0;1;1;1;0;run061
9565;BRB;GGB;1;0;1;0;1;run061
9566;BRB;GGG;0;2;2;0;2;run061
9567;BRB;RBB;1;0;1;1;0;run061
9568;BRR;BBB;0;1;1;1;0;run061
9569;BRR;BRB;0;1;1;0;1;run061
9570;BRR;GBB;1;0;1;0;1;run061
9571;GBB;BBB;1;16;17;2;15;run061
9572;GBB;BBG;0;2;2;2;0;run061
9573;GBB;BGB;0;1;1;1;0;run061
9574;GBB;BGG;0;3;3;1;2;run061
9575;GBB;BRB;0;9;9;2;7;run061
9576;GBB;BRR;0;2;2;0;2;run061
9577;GBB;GBG;1;1;2;1;1;run061
9578;GBB;GGB;2;59;61;10;51;run061
9579;GBB;GGG;4;95;99;62;37;run061
9580;GBB;GGR;0;1;1;0;1;run061
9581;GBB;GRG;0;1;1;0;1;run061
9582;GBB;GRR;1;8;9;1;8;run061
9583;GBB;RBB;0;2;2;1;1;run061
9584;GBB;RBG;0;1;1;0;1;run061
9585;GBB;RBR;1;1;2;1;1;run061
9586;GBB;RGG;0;2;2;1;1;run061
9587;GBB;RGR;0;1;1;1;0;run061
9588;GBB;RRG;0;3;3;1;2;run061
9589;GBG;BRB;0;1;1;0;1;run061
9590;GBG;BRR;0;3;3;1;2;run061
9591;GBG;GGB;0;1;1;0;1;run061
9592;GBG;GGR;0;3;3;0;3;run061
9593;GBG;RBR;0;1;1;1;0;run061
9594;GBG;RGR;1;1;2;1;1;run061
9595;GBG;RRR;0;1;1;0;1;run061
9596;GGB;BBB;1;8;9;8;1;run061
9597;GGB;BBG;0;1;1;0;1;run061
9598;GGB;BGB;0;1;1;0;1;run061
9599;GGB;BRB;3;5;8;3;5;run061
9600;GGB;BRR;0;1;1;1;0;run061
9601;GGB;GBG;0;2;2;2;0;run061
9602;GGB;GGG;4;37;41;13;28;run061
9603;GGB;GGR;0;9;9;0;9;run061
9604;GGB;GRR;1;4;5;0;5;run061
9605;GGB;RBB;0;2;2;2;0;run061
9606;GGB;RBG;0;2;2;0;2;run061
9607;GGB;RBR;0;2;2;0;2;run061
9608;GGB;RGG;0;1;1;0;1;run061
9609;GGB;RGR;1;2;3;3;0;run061
9610;GGB;RRG;1;3;4;0;4;run061
9611;GGB;RRR;0;3;3;1;2;run061
9612;GGG;BBB;4;22;26;25;1;run061
9613;GGG;BBG;0;2;2;0;2;run061
9614;GGG;BBR;0;3;3;1;2;run061
9615;GGG;BGB;0;2;2;0;2;run061
9616;GGG;BGG;0;3;3;2;1;run061
9617;GGG;BRB;0;3;3;2;1;run061
9618;GGG;BRR;0;3;3;0;3;run061
9619;GGG;GBB;0;1;1;1;0;run061
9620;GGG;GGB;1;3;4;1;3;run061
9621;GGG;GGR;0;21;21;20;1;run061
9622;GGG;GRG;0;2;2;2;0;run061
9623;GGG;GRR;2;15;17;10;7;run061
9624;GGG;RBB;0;1;1;0;1;run061
9625;GGG;RBR;1;4;5;5;0;run061
9626;GGG;RGG;1;7;8;5;3;run061
9627;GGG;RGR;0;3;3;3;0;run061
9628;GGG;RRG;0;2;2;0;2;run061
9629;GGG;RRR;0;1;1;1;0;run061
9630;GGR;BBB;0;1;1;0;1;run061
9631;GGR;BGG;0;2;2;1;1;run061
9632;GGR;BRB;0;1;1;0;1;run061
9633;GRG;BBB;0;3;3;1;2;run061
9634;GRG;BGB;0;3;3;3;0;run061
9635;GRG;BGG;0;1;1;1;0;run061
9636;GRG;BRB;0;5;5;0;5;run061
9637;GRG;BRR;0;1;1;1;0;run061
9638;GRG;GBB;0;3;3;3;0;run061
9639;GRG;GGB;0;14;14;3;11;run061
9640;GRG;GGG;0;10;10;4;6;run061
9641;GRG;GGR;0;2;2;2;0;run061
9642;GRG;GRR;0;1;1;1;0;run061
9643;GRG;RBR;1;2;3;0;3;run061
9644;GRG;RGG;0;2;2;2;0;run061
9645;GRG;RGR;0;1;1;1;0;run061
9646;GRR;BBB;0;3;3;3;0;run061
9647;GRR;BBR;0;2;2;2;0;run061
9648;GRR;BRB;1;8;9;7;2;run061
9649;GRR;BRR;1;6;7;3;4;run061
9650;GRR;GBB;0;1;1;0;1;run061
9651;GRR;GBG;0;1;1;0;1;run061
9652;GRR;GGR;1;9;10;7;3;run061
9653;GRR;RBR;0;1;1;1;0;run061
9654;GRR;RGG;1;3;4;1;3;run061
9655;GRR;RGR;0;1;1;1;0;run061
9656;GRR;RRR;0;1;1;0;1;run061
9657;RBB;BBB;0;1;1;0;1;run061
9658;RBB;GGG;0;3;3;1;2;run061
9659;RBG;GRR;0;1;1;1;0;run061
9660;RBG;RBR;0;1;1;1;0;run061
9661;RBG;RGR;0;1;1;0;1;run061
9662;RBR;BBB;0;3;3;0;3;run061
9663;RBR;BRB;0;1;1;1;0;run061
9664;RBR;BRR;0;2;2;1;1;run061
9665;RBR;GGG;0;1;1;1;0;run061
9666;RBR;GGR;1;2;3;2;1;run061
9667;RBR;GRG;0;1;1;1;0;run061
9668;RBR;GRR;1;15;16;12;4;run061
9669;RBR;RGG;0;4;4;1;3;run061
9670;RBR;RGR;0;1;1;0;1;run061
9671;RBR;RRR;0;3;3;3;0;run061
9672;RGG;BGG;0;1;1;0;1;run061
9673;RGG;RGR;0;1;1;1;0;run061
9674;RGR;BBB;0;9;9;3;6;run061
9675;RGR;BBR;0;1;1;0;1;run061
9676;RGR;BGB;1;8;9;4;5;run061
9677;RGR;BRB;0;3;3;3;0;run061
9678;RGR;BRR;0;3;3;0;3;run061
9679;RGR;GBG;0;1;1;0;1;run061
9680;RGR;GGB;0;3;3;2;1;run061
9681;RGR;GGG;0;2;2;2;0;run061
9682;RGR;GGR;0;8;8;5;3;run061
9683;RGR;GRR;1;7;8;0;8;run061
9684;RGR;RGG;0;6;6;1;5;run061
9685;RRG;BGB;0;1;1;0;1;run061
9686;RRG;BRB;0;1;1;0;1;run061
9687;RRG;GGG;0;1;1;1;0;run061
9688;RRG;GGR;0;1;1;1;0;run061
9689;RRG;GRG;0;1;1;1;0;run061
9690;RRG;GRR;0;3;3;0;3;run061
9691;RRG;RBR;0;4;4;4;0;run061
9692;RRG;RGG;0;1;1;0;1;run061
9693;RRG;RGR;6;37;43;26;17;run061
9694;RRR;BRR;0;1;1;0;1;run061
9695;RRR;GGB;0;1;1;1;0;run061
9696;RRR;GGG;1;5;6;2;4;run061
9697;RRR;GGR;0;2;2;0;2;run061
9698;RRR;GRR;0;1;1;0;1;run061
9699;RRR;RGR;0;1;1;1;0;run061
9700;BBB;GRR;0;1;1;1;0;run062
9701;BBG;BBB;1;9;10;5;5;run062
9702;BBG;BBR;0;2;2;2;0;run062
9703;BBG;BGB;0;1;1;0;1;run062
9704;BBG;BGG;0;1;1;0;1;run062
9705;BBG;BRB;0;2;2;0;2;run062
9706;BBG;BRR;0;1;1;1;0;run062
9707;BBG;GBB;1;1;2;0;2;run062
9708;BBG;GBG;1;6;7;4;3;run062
9709;BBG;GGB;0;18;18;14;4;run062
9710;BBG;GGG;1;29;30;19;11;run062
9711;BBG;GGR;0;2;2;0;2;run062
9712;BBG;GRG;0;1;1;0;1;run062
9713;BBG;GRR;0;3;3;0;3;run062
9714;BBG;RBR;0;2;2;0;2;run062
9715;BBG;RGR;0;2;2;1;1;run062
9716;BBG;RRG;1;2;3;2;1;run062
9717;BBG;RRR;0;1;1;0;1;run062
9718;BGG;BBB;0;1;1;0;1;run062
9719;BGG;BRB;0;1;1;1;0;run062
9720;BGG;GGG;0;1;1;1;0;run062
9721;BGG;RBB;0;1;1;0;1;run062
9722;BGG;RBG;1;0;1;1;0;run062
9723;BRB;BBB;0;1;1;0;1;run062
9724;BRB;GGB;1;0;1;1;0;run062
9725;BRB;GGG;0;2;2;0;2;run062
9726;BRB;RBB;1;0;1;0;1;run062
9727;BRR;BBB;0;1;1;0;1;run062
9728;BRR;BRB;0;1;1;0;1;run062
9729;BRR;GBB;1;0;1;0;1;run062
9730;GBB;BBB;1;16;17;13;4;run062
9731;GBB;BBG;0;2;2;0;2;run062
9732;GBB;BGB;0;1;1;1;0;run062
9733;GBB;BGG;0;3;3;0;3;run062
9734;GBB;BRB;0;9;9;9;0;run062
9735;GBB;BRR;0;2;2;2;0;run062
9736;GBB;GBG;1;1;2;0;2;run062
9737;GBB;GGB;2;59;61;54;7;run062
9738;GBB;GGG;4;95;99;2;97;run062
9739;GBB;GGR;0;1;1;1;0;run062
9740;GBB;GRG;0;1;1;1;0;run062
9741;GBB;GRR;1;8;9;3;6;run062
9742;GBB;RBB;0;2;2;1;1;run062
9743;GBB;RBG;0;1;1;0;1;run062
9744;GBB;RBR;1;1;2;1;1;run062
9745;GBB;RGG;0;2;2;1;1;run062
9746;GBB;RGR;0;1;1;1;0;run062
9747;GBB;RRG;0;3;3;2;1;run062
9748;GBG;BRB;0;1;1;0;1;run062
9749;GBG;BRR;0;3;3;2;1;run062
9750;GBG;GGB;0;1;1;0;1;run062
9751;GBG;GGR;0;3;3;0;3;run062
9752;GBG;RBR;0;1;1;1;0;run062
9753;GBG;RGR;1;1;2;1;1;run062
9754;GBG;RRR;0;1;1;0;1;run062
9755;GGB;BBB;1;8;9;7;2;run062
9756;GGB;BBG;0;1;1;0;1;run062
9757;GGB;BGB;0;1;1;0;1;run062
9758;GGB;BRB;3;5;8;7;1;run062
9759;GGB;BRR;0;1;1;1;0;run062
9760;GGB;GBG;0;2;2;2;0;run062
9761;GGB;GGG;4;37;41;2;39;run062
9762;GGB;GGR;0;9;9;3;6;run062
9763;GGB;GRR;1;4;5;5;0;run062
9764;GGB;RBB;0;2;2;1;1;run062
9765;GGB;RBG;0;2;2;1;1;run062
9766;GGB;RBR;0;2;2;2;0;run062
9767;GGB;RGG;0;1;1;0;1;run062
9768;GGB;RGR;1;2;3;3;0;run062
9769;GGB;RRG;1;3;4;2;2;run062
9770;GGB;RRR;0;3;3;0;3;run062
9771;GGG;BBB;4;22;26;20;6;run062
9772;GGG;BBG;0;2;2;1;1;run062
9773;GGG;BBR;0;3;3;1;2;run062
9774;GGG;BGB;0;2;2;1;1;run062
9775;GGG;BGG;0;3;3;2;1;run062
9776;GGG;BRB;0;3;3;2;1;run062
9777;GGG;BRR;0;3;3;2;1;run062
9778;GGG;GBB;0;1;1;1;0;run062
9779;GGG;GGB;1;3;4;0;4;run062
9780;GGG;GGR;0;21;21;19;2;run062
9781;GGG;GRG;0;2;2;1;1;run062
9782;GGG;GRR;2;15;17;17;0;run062
9783;GGG;RBB;0;1;1;1;0;run062
9784;GGG;RBR;1;4;5;5;0;run062
9785;GGG;RGG;1;7;8;4;4;run062
9786;GGG;RGR;0;3;3;3;0;run062
9787;GGG;RRG;0;2;2;0;2;run062
9788;GGG;RRR;0;1;1;0;1;run062
9789;GGR;BBB;0;1;1;0;1;run062
9790;GGR;BGG;0;2;2;0;2;run062
9791;GGR;BRB;0;1;1;0;1;run062
9792;GRG;BBB;0;3;3;0;3;run062
9793;GRG;BGB;0;3;3;3;0;run062
9794;GRG;BGG;0;1;1;0;1;run062
9795;GRG;BRB;0;5;5;5;0;run062
9796;GRG;BRR;0;1;1;0;1;run062
9797;GRG;GBB;0;3;3;1;2;run062
9798;GRG;GGB;0;14;14;0;14;run062
9799;GRG;GGG;0;10;10;0;10;run062
9800;GRG;GGR;0;2;2;2;0;run062
9801;GRG;GRR;0;1;1;1;0;run062
9802;GRG;RBR;1;2;3;0;3;run062
9803;GRG;RGG;0;2;2;2;0;run062
9804;GRG;RGR;0;1;1;0;1;run062
9805;GRR;BBB;0;3;3;3;0;run062
9806;GRR;BBR;0;2;2;0;2;run062
9807;GRR;BRB;1;8;9;9;0;run062
9808;GRR;BRR;1;6;7;3;4;run062
9809;GRR;GBB;0;1;1;1;0;run062
9810;GRR;GBG;0;1;1;1;0;run062
9811;GRR;GGR;1;9;10;4;6;run062
9812;GRR;RBR;0;1;1;0;1;run062
9813;GRR;RGG;1;3;4;3;1;run062
9814;GRR;RGR;0;1;1;1;0;run062
9815;GRR;RRR;0;1;1;1;0;run062
9816;RBB;BBB;0;1;1;0;1;run062
9817;RBB;GGG;0;3;3;1;2;run062
9818;RBG;GRR;0;1;1;0;1;run062
9819;RBG;RBR;0;1;1;0;1;run062
9820;RBG;RGR;0;1;1;0;1;run062
9821;RBR;BBB;0;3;3;0;3;run062
9822;RBR;BRB;0;1;1;0;1;run062
9823;RBR;BRR;0;2;2;1;1;run062
9824;RBR;GGG;0;1;1;1;0;run062
9825;RBR;GGR;1;2;3;0;3;run062
9826;RBR;GRG;0;1;1;1;0;run062
9827;RBR;GRR;1;15;16;11;5;run062
9828;RBR;RGG;0;4;4;1;3;run062
9829;RBR;RGR;0;1;1;0;1;run062
9830;RBR;RRR;0;3;3;3;0;run062
9831;RGG;BGG;0;1;1;0;1;run062
9832;RGG;RGR;0;1;1;1;0;run062
9833;RGR;BBB;0;9;9;0;9;run062
9834;RGR;BBR;0;1;1;0;1;run062
9835;RGR;BGB;1;8;9;0;9;run062
9836;RGR;BRB;0;3;3;0;3;run062
9837;RGR;BRR;0;3;3;3;0;run062
9838;RGR;GBG;0;1;1;0;1;run062
9839;RGR;GGB;0;3;3;2;1;run062
9840;RGR;GGG;0;2;2;2;0;run062
9841;RGR;GGR;0;8;8;4;4;run062
9842;RGR;GRR;1;7;8;2;6;run062
9843;RGR;RGG;0;6;6;2;4;run062
9844;RRG;BGB;0;1;1;0;1;run062
9845;RRG;BRB;0;1;1;1;0;run062
9846;RRG;GGG;0;1;1;1;0;run062
9847;RRG;GGR;0;1;1;0;1;run062
9848;RRG;GRG;0;1;1;1;0;run062
9849;RRG;GRR;0;3;3;3;0;run062
9850;RRG;RBR;0;4;4;0;4;run062
9851;RRG;RGG;0;1;1;1;0;run062
9852;RRG;RGR;6;37;43;27;16;run062
9853;RRR;BRR;0;1;1;1;0;run062
9854;RRR;GGB;0;1;1;0;1;run062
9855;RRR;GGG;1;5;6;1;5;run062
9856;RRR;GGR;0;2;2;1;1;run062
9857;RRR;GRR;0;1;1;0;1;run062
9858;RRR;RGR;0;1;1;0;1;run062
9859;BBB;GRR;0;1;1;0;1;run063
9860;BBG;BBB;1;9;10;9;1;run063
9861;BBG;BBR;0;2;2;0;2;run063
9862;BBG;BGB;0;1;1;0;1;run063
9863;BBG;BGG;0;1;1;0;1;run063
9864;BBG;BRB;0;2;2;0;2;run063
9865;BBG;BRR;0;1;1;0;1;run063
9866;BBG;GBB;1;1;2;0;2;run063
9867;BBG;GBG;1;6;7;3;4;run063
9868;BBG;GGB;0;18;18;1;17;run063
9869;BBG;GGG;1;29;30;20;10;run063
9870;BBG;GGR;0;2;2;1;1;run063
9871;BBG;GRG;0;1;1;1;0;run063
9872;BBG;GRR;0;3;3;1;2;run063
9873;BBG;RBR;0;2;2;1;1;run063
9874;BBG;RGR;0;2;2;0;2;run063
9875;BBG;RRG;1;2;3;2;1;run063
9876;BBG;RRR;0;1;1;0;1;run063
9877;BGG;BBB;0;1;1;1;0;run063
9878;BGG;BRB;0;1;1;0;1;run063
9879;BGG;GGG;0;1;1;1;0;run063
9880;BGG;RBB;0;1;1;1;0;run063
9881;BGG;RBG;1;0;1;0;1;run063
9882;BRB;BBB;0;1;1;1;0;run063
9883;BRB;GGB;1;0;1;0;1;run063
9884;BRB;GGG;0;2;2;1;1;run063
9885;BRB;RBB;1;0;1;0;1;run063
9886;BRR;BBB;0;1;1;0;1;run063
9887;BRR;BRB;0;1;1;1;0;run063
9888;BRR;GBB;1;0;1;1;0;run063
9889;GBB;BBB;1;16;17;2;15;run063
9890;GBB;BBG;0;2;2;1;1;run063
9891;GBB;BGB;0;1;1;1;0;run063
9892;GBB;BGG;0;3;3;2;1;run063
9893;GBB;BRB;0;9;9;4;5;run063
9894;GBB;BRR;0;2;2;1;1;run063
9895;GBB;GBG;1;1;2;0;2;run063
9896;GBB;GGB;2;59;61;19;42;run063
9897;GBB;GGG;4;95;99;54;45;run063
9898;GBB;GGR;0;1;1;0;1;run063
9899;GBB;GRG;0;1;1;1;0;run063
9900;GBB;GRR;1;8;9;2;7;run063
9901;GBB;RBB;0;2;2;1;1;run063
9902;GBB;RBG;0;1;1;1;0;run063
9903;GBB;RBR;1;1;2;0;2;run063
9904;GBB;RGG;0;2;2;2;0;run063
9905;GBB;RGR;0;1;1;0;1;run063
9906;GBB;RRG;0;3;3;2;1;run063
9907;GBG;BRB;0;1;1;0;1;run063
9908;GBG;BRR;0;3;3;1;2;run063
9909;GBG;GGB;0;1;1;1;0;run063
9910;GBG;GGR;0;3;3;3;0;run063
9911;GBG;RBR;0;1;1;0;1;run063
9912;GBG;RGR;1;1;2;0;2;run063
9913;GBG;RRR;0;1;1;1;0;run063
9914;GGB;BBB;1;8;9;4;5;run063
9915;GGB;BBG;0;1;1;0;1;run063
9916;GGB;BGB;0;1;1;0;1;run063
9917;GGB;BRB;3;5;8;4;4;run063
9918;GGB;BRR;0;1;1;0;1;run063
9919;GGB;GBG;0;2;2;2;0;run063
9920;GGB;GGG;4;37;41;14;27;run063
9921;GGB;GGR;0;9;9;5;4;run063
9922;GGB;GRR;1;4;5;2;3;run063
9923;GGB;RBB;0;2;2;1;1;run063
9924;GGB;RBG;0;2;2;0;2;run063
9925;GGB;RBR;0;2;2;2;0;run063
9926;GGB;RGG;0;1;1;0;1;run063
9927;GGB;RGR;1;2;3;3;0;run063
9928;GGB;RRG;1;3;4;0;4;run063
9929;GGB;RRR;0;3;3;0;3;run063
9930;GGG;BBB;4;22;26;20;6;run063
9931;GGG;BBG;0;2;2;0;2;run063
9932;GGG;BBR;0;3;3;3;0;run063
9933;GGG;BGB;0;2;2;1;1;run063
9934;GGG;BGG;0;3;3;2;1;run063
9935;GGG;BRB;0;3;3;1;2;run063
9936;GGG;BRR;0;3;3;1;2;run063
9937;GGG;GBB;0;1;1;0;1;run063
9938;GGG;GGB;1;3;4;3;1;run063
9939;GGG;GGR;0;21;21;3;18;run063
9940;GGG;GRG;0;2;2;0;2;run063
9941;GGG;GRR;2;15;17;7;10;run063
9942;GGG;RBB;0;1;1;1;0;run063
9943;GGG;RBR;1;4;5;2;3;run063
9944;GGG;RGG;1;7;8;2;6;run063
9945;GGG;RGR;0;3;3;2;1;run063
9946;GGG;RRG;0;2;2;1;1;run063
9947;GGG;RRR;0;1;1;0;1;run063
9948;GGR;BBB;0;1;1;0;1;run063
9949;GGR;BGG;0;2;2;1;1;run063
9950;GGR;BRB;0;1;1;0;1;run063
9951;GRG;BBB;0;3;3;2;1;run063
9952;GRG;BGB;0;3;3;2;1;run063
9953;GRG;BGG;0;1;1;0;1;run063
9954;GRG;BRB;0;5;5;0;5;run063
9955;GRG;BRR;0;1;1;0;1;run063
9956;GRG;GBB;0;3;3;0;3;run063
9957;GRG;GGB;0;14;14;6;8;run063
9958;GRG;GGG;0;10;10;5;5;run063
9959;GRG;GGR;0;2;2;2;0;run063
9960;GRG;GRR;0;1;1;0;1;run063
9961;GRG;RBR;1;2;3;0;3;run063
9962;GRG;RGG;0;2;2;0;2;run063
9963;GRG;RGR;0;1;1;1;0;run063
9964;GRR;BBB;0;3;3;3;0;run063
9965;GRR;BBR;0;2;2;0;2;run063
9966;GRR;BRB;1;8;9;6;3;run063
9967;GRR;BRR;1;6;7;4;3;run063
9968;GRR;GBB;0;1;1;1;0;run063
9969;GRR;GBG;0;1;1;0;1;run063
9970;GRR;GGR;1;9;10;1;9;run063
9971;GRR;RBR;0;1;1;0;1;run063
9972;GRR;RGG;1;3;4;4;0;run063
9973;GRR;RGR;0;1;1;0;1;run063
9974;GRR;RRR;0;1;1;1;0;run063
9975;RBB;BBB;0;1;1;1;0;run063
9976;RBB;GGG;0;3;3;3;0;run063
9977;RBG;GRR;0;1;1;0;1;run063
9978;RBG;RBR;0;1;1;1;0;run063
9979;RBG;RGR;0;1;1;0;1;run063
9980;RBR;BBB;0;3;3;2;1;run063
9981;RBR;BRB;0;1;1;1;0;run063
9982;RBR;BRR;0;2;2;0;2;run063
9983;RBR;GGG;0;1;1;0;1;run063
9984;RBR;GGR;1;2;3;0;3;run063
9985;RBR;GRG;0;1;1;0;1;run063
9986;RBR;GRR;1;15;16;15;1;run063
9987;RBR;RGG;0;4;4;1;3;run063
9988;RBR;RGR;0;1;1;0;1;run063
9989;RBR;RRR;0;3;3;2;1;run063
9990;RGG;BGG;0;1;1;1;0;run063
9991;RGG;RGR;0;1;1;0;1;run063
9992;RGR;BBB;0;9;9;8;1;run063
9993;RGR;BBR;0;1;1;1;0;run063
9994;RGR;BGB;1;8;9;0;9;run063
9995;RGR;BRB;0;3;3;2;1;run063
9996;RGR;BRR;0;3;3;1;2;run063
9997;RGR;GBG;0;1;1;0;1;run063
9998;RGR;GGB;0;3;3;1;2;run063
9999;RGR;GGG;0;2;2;1;1;run063
10000;RGR;GGR;0;8;8;5;3;run063
10001;RGR;GRR;1;7;8;5;3;run063
10002;RGR;RGG;0;6;6;2;4;run063
10003;RRG;BGB;0;1;1;0;1;run063
10004;RRG;BRB;0;1;1;0;1;run063
10005;RRG;GGG;0;1;1;1;0;run063
10006;RRG;GGR;0;1;1;1;0;run063
10007;RRG;GRG;0;1;1;1;0;run063
10008;RRG;GRR;0;3;3;1;2;run063
10009;RRG;RBR;0;4;4;4;0;run063
10010;RRG;RGG;0;1;1;1;0;run063
10011;RRG;RGR;6;37;43;26;17;run063
10012;RRR;BRR;0;1;1;0;1;run063
10013;RRR;GGB;0;1;1;1;0;run063
10014;RRR;GGG;1;5;6;4;2;run063
10015;RRR;GGR;0;2;2;0;2;run063
10016;RRR;GRR;0;1;1;1;0;run063
10017;RRR;RGR;0;1;1;1;0;run063
10018;BBB;GRR;0;1;1;1;0;run064
10019;BBG;BBB;1;9;10;3;7;run064
10020;BBG;BBR;0;2;2;2;0;run064
10021;BBG;BGB;0;1;1;0;1;run064
10022;BBG;BGG;0;1;1;0;1;run064
10023;BBG;BRB;0;2;2;0;2;run064
10024;BBG;BRR;0;1;1;1;0;run064
10025;BBG;GBB;1;1;2;0;2;run064
10026;BBG;GBG;1;6;7;5;2;run064
10027;BBG;GGB;0;18;18;16;2;run064
10028;BBG;GGG;1;29;30;24;6;run064
10029;BBG;GGR;0;2;2;2;0;run064
10030;BBG;GRG;0;1;1;1;0;run064
10031;BBG;GRR;0;3;3;1;2;run064
10032;BBG;RBR;0;2;2;1;1;run064
10033;BBG;RGR;0;2;2;2;0;run064
10034;BBG;RRG;1;2;3;0;3;run064
10035;BBG;RRR;0;1;1;0;1;run064
10036;BGG;BBB;0;1;1;1;0;run064
10037;BGG;BRB;0;1;1;0;1;run064
10038;BGG;GGG;0;1;1;1;0;run064
10039;BGG;RBB;0;1;1;1;0;run064
10040;BGG;RBG;1;0;1;0;1;run064
10041;BRB;BBB;0;1;1;0;1;run064
10042;BRB;GGB;1;0;1;0;1;run064
10043;BRB;GGG;0;2;2;1;1;run064
10044;BRB;RBB;1;0;1;1;0;run064
10045;BRR;BBB;0;1;1;1;0;run064
10046;BRR;BRB;0;1;1;0;1;run064
10047;BRR;GBB;1;0;1;1;0;run064
10048;GBB;BBB;1;16;17;10;7;run064
10049;GBB;BBG;0;2;2;1;1;run064
10050;GBB;BGB;0;1;1;1;0;run064
10051;GBB;BGG;0;3;3;2;1;run064
10052;GBB;BRB;0;9;9;0;9;run064
10053;GBB;BRR;0;2;2;1;1;run064
10054;GBB;GBG;1;1;2;0;2;run064
10055;GBB;GGB;2;59;61;26;35;run064
10056;GBB;GGG;4;95;99;9;90;run064
10057;GBB;GGR;0;1;1;0;1;run064
10058;GBB;GRG;0;1;1;1;0;run064
10059;GBB;GRR;1;8;9;3;6;run064
10060;GBB;RBB;0;2;2;0;2;run064
10061;GBB;RBG;0;1;1;0;1;run064
10062;GBB;RBR;1;1;2;1;1;run064
10063;GBB;RGG;0;2;2;1;1;run064
10064;GBB;RGR;0;1;1;1;0;run064
10065;GBB;RRG;0;3;3;2;1;run064
10066;GBG;BRB;0;1;1;0;1;run064
10067;GBG;BRR;0;3;3;0;3;run064
10068;GBG;GGB;0;1;1;0;1;run064
10069;GBG;GGR;0;3;3;3;0;run064
10070;GBG;RBR;0;1;1;0;1;run064
10071;GBG;RGR;1;1;2;2;0;run064
10072;GBG;RRR;0;1;1;1;0;run064
10073;GGB;BBB;1;8;9;0;9;run064
10074;GGB;BBG;0;1;1;0;1;run064
10075;GGB;BGB;0;1;1;1;0;run064
10076;GGB;BRB;3;5;8;6;2;run064
10077;GGB;BRR;0;1;1;1;0;run064
10078;GGB;GBG;0;2;2;1;1;run064
10079;GGB;GGG;4;37;41;0;41;run064
10080;GGB;GGR;0;9;9;0;9;run064
10081;GGB;GRR;1;4;5;5;0;run064
10082;GGB;RBB;0;2;2;0;2;run064
10083;GGB;RBG;0;2;2;0;2;run064
10084;GGB;RBR;0;2;2;2;0;run064
10085;GGB;RGG;0;1;1;0;1;run064
10086;GGB;RGR;1;2;3;0;3;run064
10087;GGB;RRG;1;3;4;1;3;run064
10088;GGB;RRR;0;3;3;3;0;run064
10089;GGG;BBB;4;22;26;26;0;run064
10090;GGG;BBG;0;2;2;0;2;run064
10091;GGG;BBR;0;3;3;2;1;run064
10092;GGG;BGB;0;2;2;1;1;run064
10093;GGG;BGG;0;3;3;2;1;run064
10094;GGG;BRB;0;3;3;0;3;run064
10095;GGG;BRR;0;3;3;2;1;run064
10096;GGG;GBB;0;1;1;0;1;run064
10097;GGG;GGB;1;3;4;4;0;run064
10098;GGG;GGR;0;21;21;15;6;run064
10099;GGG;GRG;0;2;2;2;0;run064
10100;GGG;GRR;2;15;17;14;3;run064
10101;GGG;RBB;0;1;1;1;0;run064
10102;GGG;RBR;1;4;5;5;0;run064
10103;GGG;RGG;1;7;8;8;0;run064
10104;GGG;RGR;0;3;3;0;3;run064
10105;GGG;RRG;0;2;2;1;1;run064
10106;GGG;RRR;0;1;1;0;1;run064
10107;GGR;BBB;0;1;1;0;1;run064
10108;GGR;BGG;0;2;2;1;1;run064
10109;GGR;BRB;0;1;1;0;1;run064
10110;GRG;BBB;0;3;3;2;1;run064
10111;GRG;BGB;0;3;3;1;2;run064
10112;GRG;BGG;0;1;1;0;1;run064
10113;GRG;BRB;0;5;5;2;3;run064
10114;GRG;BRR;0;1;1;1;0;run064
10115;GRG;GBB;0;3;3;1;2;run064
10116;GRG;GGB;0;14;14;14;0;run064
10117;GRG;GGG;0;10;10;2;8;run064
10118;GRG;GGR;0;2;2;1;1;run064
10119;GRG;GRR;0;1;1;0;1;run064
10120;GRG;RBR;1;2;3;0;3;run064
10121;GRG;RGG;0;2;2;1;1;run064
10122;GRG;RGR;0;1;1;0;1;run064
10123;GRR;BBB;0;3;3;0;3;run064
10124;GRR;BBR;0;2;2;0;2;run064
10125;GRR;BRB;1;8;9;6;3;run064
10126;GRR;BRR;1;6;7;5;2;run064
10127;GRR;GBB;0;1;1;0;1;run064
10128;GRR;GBG;0;1;1;1;0;run064
10129;GRR;GGR;1;9;10;0;10;run064
10130;GRR;RBR;0;1;1;1;0;run064
10131;GRR;RGG;1;3;4;0;4;run064
10132;GRR;RGR;0;1;1;0;1;run064
10133;GRR;RRR;0;1;1;0;1;run064
10134;RBB;BBB;0;1;1;0;1;run064
10135;RBB;GGG;0;3;3;3;0;run064
10136;RBG;GRR;0;1;1;1;0;run064
10137;RBG;RBR;0;1;1;0;1;run064
10138;RBG;RGR;0;1;1;0;1;run064
10139;RBR;BBB;0;3;3;0;3;run064
10140;RBR;BRB;0;1;1;1;0;run064
10141;RBR;BRR;0;2;2;0;2;run064
10142;RBR;GGG;0;1;1;0;1;run064
10143;RBR;GGR;1;2;3;3;0;run064
10144;RBR;GRG;0;1;1;1;0;run064
10145;RBR;GRR;1;15;16;15;1;run064
10146;RBR;RGG;0;4;4;1;3;run064
10147;RBR;RGR;0;1;1;0;1;run064
10148;RBR;RRR;0;3;3;2;1;run064
10149;RGG;BGG;0;1;1;1;0;run064
10150;RGG;RGR;0;1;1;1;0;run064
10151;RGR;BBB;0;9;9;7;2;run064
10152;RGR;BBR;0;1;1;0;1;run064
10153;RGR;BGB;1;8;9;5;4;run064
10154;RGR;BRB;0;3;3;2;1;run064
10155;RGR;BRR;0;3;3;1;2;run064
10156;RGR;GBG;0;1;1;1;0;run064
10157;RGR;GGB;0;3;3;1;2;run064
10158;RGR;GGG;0;2;2;2;0;run064
10159;RGR;GGR;0;8;8;5;3;run064
10160;RGR;GRR;1;7;8;4;4;run064
10161;RGR;RGG;0;6;6;3;3;run064
10162;RRG;BGB;0;1;1;1;0;run064
10163;RRG;BRB;0;1;1;0;1;run064
10164;RRG;GGG;0;1;1;1;0;run064
10165;RRG;GGR;0;1;1;0;1;run064
10166;RRG;GRG;0;1;1;1;0;run064
10167;RRG;GRR;0;3;3;3;0;run064
10168;RRG;RBR;0;4;4;3;1;run064
10169;RRG;RGG;0;1;1;1;0;run064
10170;RRG;RGR;6;37;43;34;9;run064
10171;RRR;BRR;0;1;1;0;1;run064
10172;RRR;GGB;0;1;1;1;0;run064
10173;RRR;GGG;1;5;6;0;6;run064
10174;RRR;GGR;0;2;2;1;1;run064
10175;RRR;GRR;0;1;1;0;1;run064
10176;RRR;RGR;0;1;1;0;1;run064
10177;BBB;GRR;0;1;1;1;0;run065
10178;BBG;BBB;1;9;10;2;8;run065
10179;BBG;BBR;0;2;2;2;0;run065
10180;BBG;BGB;0;1;1;1;0;run065
10181;BBG;BGG;0;1;1;1;0;run065
10182;BBG;BRB;0;2;2;2;0;run065
10183;BBG;BRR;0;1;1;1;0;run065
10184;BBG;GBB;1;1;2;1;1;run065
10185;BBG;GBG;1;6;7;3;4;run065
10186;BBG;GGB;0;18;18;8;10;run065
10187;BBG;GGG;1;29;30;16;14;run065
10188;BBG;GGR;0;2;2;0;2;run065
10189;BBG;GRG;0;1;1;0;1;run065
10190;BBG;GRR;0;3;3;2;1;run065
10191;BBG;RBR;0;2;2;2;0;run065
10192;BBG;RGR;0;2;2;0;2;run065
10193;BBG;RRG;1;2;3;1;2;run065
10194;BBG;RRR;0;1;1;0;1;run065
10195;BGG;BBB;0;1;1;0;1;run065
10196;BGG;BRB;0;1;1;0;1;run065
10197;BGG;GGG;0;1;1;1;0;run065
10198;BGG;RBB;0;1;1;1;0;run065
10199;BGG;RBG;1;0;1;1;0;run065
10200;BRB;BBB;0;1;1;0;1;run065
10201;BRB;GGB;1;0;1;1;0;run065
10202;BRB;GGG;0;2;2;1;1;run065
10203;BRB;RBB;1;0;1;1;0;run065
10204;BRR;BBB;0;1;1;0;1;run065
10205;BRR;BRB;0;1;1;0;1;run065
10206;BRR;GBB;1;0;1;1;0;run065
10207;GBB;BBB;1;16;17;1;16;run065
10208;GBB;BBG;0;2;2;0;2;run065
10209;GBB;BGB;0;1;1;0;1;run065
10210;GBB;BGG;0;3;3;3;0;run065
10211;GBB;BRB;0;9;9;0;9;run065
10212;GBB;BRR;0;2;2;1;1;run065
10213;GBB;GBG;1;1;2;1;1;run065
10214;GBB;GGB;2;59;61;7;54;run065
10215;GBB;GGG;4;95;99;79;20;run065
10216;GBB;GGR;0;1;1;1;0;run065
10217;GBB;GRG;0;1;1;0;1;run065
10218;GBB;GRR;1;8;9;1;8;run065
10219;GBB;RBB;0;2;2;2;0;run065
10220;GBB;RBG;0;1;1;0;1;run065
10221;GBB;RBR;1;1;2;2;0;run065
10222;GBB;RGG;0;2;2;0;2;run065
10223;GBB;RGR;0;1;1;1;0;run065
10224;GBB;RRG;0;3;3;1;2;run065
10225;GBG;BRB;0;1;1;0;1;run065
10226;GBG;BRR;0;3;3;1;2;run065
10227;GBG;GGB;0;1;1;1;0;run065
10228;GBG;GGR;0;3;3;1;2;run065
10229;GBG;RBR;0;1;1;1;0;run065
10230;GBG;RGR;1;1;2;1;1;run065
10231;GBG;RRR;0;1;1;1;0;run065
10232;GGB;BBB;1;8;9;5;4;run065
10233;GGB;BBG;0;1;1;0;1;run065
10234;GGB;BGB;0;1;1;1;0;run065
10235;GGB;BRB;3;5;8;1;7;run065
10236;GGB;BRR;0;1;1;1;0;run065
10237;GGB;GBG;0;2;2;1;1;run065
10238;GGB;GGG;4;37;41;12;29;run065
10239;GGB;GGR;0;9;9;3;6;run065
10240;GGB;GRR;1;4;5;5;0;run065
10241;GGB;RBB;0;2;2;0;2;run065
10242;GGB;RBG;0;2;2;1;1;run065
10243;GGB;RBR;0;2;2;0;2;run065
10244;GGB;RGG;0;1;1;1;0;run065
10245;GGB;RGR;1;2;3;0;3;run065
10246;GGB;RRG;1;3;4;2;2;run065
10247;GGB;RRR;0;3;3;3;0;run065
10248;GGG;BBB;4;22;26;3;23;run065
10249;GGG;BBG;0;2;2;0;2;run065
10250;GGG;BBR;0;3;3;1;2;run065
10251;GGG;BGB;0;2;2;1;1;run065
10252;GGG;BGG;0;3;3;3;0;run065
10253;GGG;BRB;0;3;3;1;2;run065
10254;GGG;BRR;0;3;3;1;2;run065
10255;GGG;GBB;0;1;1;1;0;run065
10256;GGG;GGB;1;3;4;0;4;run065
10257;GGG;GGR;0;21;21;12;9;run065
10258;GGG;GRG;0;2;2;2;0;run065
10259;GGG;GRR;2;15;17;16;1;run065
10260;GGG;RBB;0;1;1;0;1;run065
10261;GGG;RBR;1;4;5;5;0;run065
10262;GGG;RGG;1;7;8;3;5;run065
10263;GGG;RGR;0;3;3;3;0;run065
10264;GGG;RRG;0;2;2;2;0;run065
10265;GGG;RRR;0;1;1;1;0;run065
10266;GGR;BBB;0;1;1;0;1;run065
10267;GGR;BGG;0;2;2;1;1;run065
10268;GGR;BRB;0;1;1;0;1;run065
10269;GRG;BBB;0;3;3;0;3;run065
10270;GRG;BGB;0;3;3;2;1;run065
10271;GRG;BGG;0;1;1;0;1;run065
10272;GRG;BRB;0;5;5;3;2;run065
10273;GRG;BRR;0;1;1;0;1;run065
10274;GRG;GBB;0;3;3;3;0;run065
10275;GRG;GGB;0;14;14;4;10;run065
10276;GRG;GGG;0;10;10;1;9;run065
10277;GRG;GGR;0;2;2;0;2;run065
10278;GRG;GRR;0;1;1;0;1;run065
10279;GRG;RBR;1;2;3;0;3;run065
10280;GRG;RGG;0;2;2;0;2;run065
10281;GRG;RGR;0;1;1;1;0;run065
10282;GRR;BBB;0;3;3;1;2;run065
10283;GRR;BBR;0;2;2;2;0;run065
10284;GRR;BRB;1;8;9;6;3;run065
10285;GRR;BRR;1;6;7;2;5;run065
10286;GRR;GBB;0;1;1;1;0;run065
10287;GRR;GBG;0;1;1;0;1;run065
10288;GRR;GGR;1;9;10;6;4;run065
10289;GRR;RBR;0;1;1;0;1;run065
10290;GRR;RGG;1;3;4;4;0;run065
10291;GRR;RGR;0;1;1;1;0;run065
10292;GRR;RRR;0;1;1;1;0;run065
10293;RBB;BBB;0;1;1;1;0;run065
10294;RBB;GGG;0;3;3;1;2;run065
10295;RBG;GRR;0;1;1;0;1;run065
10296;RBG;RBR;0;1;1;0;1;run065
10297;RBG;RGR;0;1;1;0;1;run065
10298;RBR;BBB;0;3;3;1;2;run065
10299;RBR;BRB;0;1;1;1;0;run065
10300;RBR;BRR;0;2;2;0;2;run065
10301;RBR;GGG;0;1;1;1;0;run065
10302;RBR;GGR;1;2;3;0;3;run065
10303;RBR;GRG;0;1;1;0;1;run065
10304;RBR;GRR;1;15;16;9;7;run065
10305;RBR;RGG;0;4;4;0;4;run065
10306;RBR;RGR;0;1;1;0;1;run065
10307;RBR;RRR;0;3;3;0;3;run065
10308;RGG;BGG;0;1;1;0;1;run065
10309;RGG;RGR;0;1;1;0;1;run065
10310;RGR;BBB;0;9;9;6;3;run065
10311;RGR;BBR;0;1;1;1;0;run065
10312;RGR;BGB;1;8;9;3;6;run065
10313;RGR;BRB;0;3;3;2;1;run065
10314;RGR;BRR;0;3;3;2;1;run065
10315;RGR;GBG;0;1;1;0;1;run065
10316;RGR;GGB;0;3;3;3;0;run065
10317;RGR;GGG;0;2;2;1;1;run065
10318;RGR;GGR;0;8;8;2;6;run065
10319;RGR;GRR;1;7;8;1;7;run065
10320;RGR;RGG;0;6;6;2;4;run065
10321;RRG;BGB;0;1;1;0;1;run065
10322;RRG;BRB;0;1;1;1;0;run065
10323;RRG;GGG;0;1;1;1;0;run065
10324;RRG;GGR;0;1;1;0;1;run065
10325;RRG;GRG;0;1;1;1;0;run065
10326;RRG;GRR;0;3;3;1;2;run065
10327;RRG;RBR;0;4;4;0;4;run065
10328;RRG;RGG;0;1;1;1;0;run065
10329;RRG;RGR;6;37;43;31;12;run065
10330;RRR;BRR;0;1;1;1;0;run065
10331;RRR;GGB;0;1;1;0;1;run065
10332;RRR;GGG;1;5;6;2;4;run065
10333;RRR;GGR;0;2;2;0;2;run065
10334;RRR;GRR;0;1;1;0;1;run065
10335;RRR;RGR;0;1;1;0;1;run065
10336;BBB;GRR;0;1;1;0;1;run066
10337;BBG;BBB;1;9;10;6;4;run066
10338;BBG;BBR;0;2;2;0;2;run066
10339;BBG;BGB;0;1;1;1;0;run066
10340;BBG;BGG;0;1;1;1;0;run066
10341;BBG;BRB;0;2;2;1;1;run066
10342;BBG;BRR;0;1;1;0;1;run066
10343;BBG;GBB;1;1;2;2;0;run066
10344;BBG;GBG;1;6;7;6;1;run066
10345;BBG;GGB;0;18;18;15;3;run066
10346;BBG;GGG;1;29;30;9;21;run066
10347;BBG;GGR;0;2;2;0;2;run066
10348;BBG;GRG;0;1;1;1;0;run066
10349;BBG;GRR;0;3;3;2;1;run066
10350;BBG;RBR;0;2;2;1;1;run066
10351;BBG;RGR;0;2;2;2;0;run066
10352;BBG;RRG;1;2;3;3;0;run066
10353;BBG;RRR;0;1;1;1;0;run066
10354;BGG;BBB;0;1;1;0;1;run066
10355;BGG;BRB;0;1;1;1;0;run066
10356;BGG;GGG;0;1;1;1;0;run066
10357;BGG;RBB;0;1;1;0;1;run066
10358;BGG;RBG;1;0;1;0;1;run066
10359;BRB;BBB;0;1;1;0;1;run066
10360;BRB;GGB;1;0;1;0;1;run066
10361;BRB;GGG;0;2;2;1;1;run066
10362;BRB;RBB;1;0;1;1;0;run066
10363;BRR;BBB;0;1;1;1;0;run066
10364;BRR;BRB;0;1;1;1;0;run066
10365;BRR;GBB;1;0;1;1;0;run066
10366;GBB;BBB;1;16;17;4;13;run066
10367;GBB;BBG;0;2;2;1;1;run066
10368;GBB;BGB;0;1;1;0;1;run066
10369;GBB;BGG;0;3;3;3;0;run066
10370;GBB;BRB;0;9;9;4;5;run066
10371;GBB;BRR;0;2;2;2;0;run066
10372;GBB;GBG;1;1;2;1;1;run066
10373;GBB;GGB;2;59;61;12;49;run066
10374;GBB;GGG;4;95;99;11;88;run066
10375;GBB;GGR;0;1;1;0;1;run066
10376;GBB;GRG;0;1;1;0;1;run066
10377;GBB;GRR;1;8;9;7;2;run066
10378;GBB;RBB;0;2;2;0;2;run066
10379;GBB;RBG;0;1;1;0;1;run066
10380;GBB;RBR;1;1;2;0;2;run066
10381;GBB;RGG;0;2;2;2;0;run066
10382;GBB;RGR;0;1;1;0;1;run066
10383;GBB;RRG;0;3;3;3;0;run066
10384;GBG;BRB;0;1;1;0;1;run066
10385;GBG;BRR;0;3;3;0;3;run066
10386;GBG;GGB;0;1;1;0;1;run066
10387;GBG;GGR;0;3;3;1;2;run066
10388;GBG;RBR;0;1;1;0;1;run066
10389;GBG;RGR;1;1;2;2;0;run066
10390;GBG;RRR;0;1;1;0;1;run066
10391;GGB;BBB;1;8;9;5;4;run066
10392;GGB;BBG;0;1;1;0;1;run066
10393;GGB;BGB;0;1;1;0;1;run066
10394;GGB;BRB;3;5;8;8;0;run066
10395;GGB;BRR;0;1;1;0;1;run066
10396;GGB;GBG;0;2;2;1;1;run066
10397;GGB;GGG;4;37;41;26;15;run066
10398;GGB;GGR;0;9;9;6;3;run066
10399;GGB;GRR;1;4;5;3;2;run066
10400;GGB;RBB;0;2;2;2;0;run066
10401;GGB;RBG;0;2;2;1;1;run066
10402;GGB;RBR;0;2;2;1;1;run066
10403;GGB;RGG;0;1;1;0;1;run066
10404;GGB;RGR;1;2;3;1;2;run066
10405;GGB;RRG;1;3;4;1;3;run066
10406;GGB;RRR;0;3;3;2;1;run066
10407;GGG;BBB;4;22;26;22;4;run066
10408;GGG;BBG;0;2;2;0;2;run066
10409;GGG;BBR;0;3;3;0;3;run066
10410;GGG;BGB;0;2;2;2;0;run066
10411;GGG;BGG;0;3;3;2;1;run066
10412;GGG;BRB;0;3;3;3;0;run066
10413;GGG;BRR;0;3;3;2;1;run066
10414;GGG;GBB;0;1;1;1;0;run066
10415;GGG;GGB;1;3;4;4;0;run066
10416;GGG;GGR;0;21;21;4;17;run066
10417;GGG;GRG;0;2;2;2;0;run066
10418;GGG;GRR;2;15;17;0;17;run066
10419;GGG;RBB;0;1;1;1;0;run066
10420;GGG;RBR;1;4;5;2;3;run066
10421;GGG;RGG;1;7;8;6;2;run066
10422;GGG;RGR;0;3;3;0;3;run066
10423;GGG;RRG;0;2;2;2;0;run066
10424;GGG;RRR;0;1;1;1;0;run066
10425;GGR;BBB;0;1;1;1;0;run066
10426;GGR;BGG;0;2;2;2;0;run066
10427;GGR;BRB;0;1;1;1;0;run066
10428;GRG;BBB;0;3;3;1;2;run066
10429;GRG;BGB;0;3;3;2;1;run066
10430;GRG;BGG;0;1;1;1;0;run066
10431;GRG;BRB;0;5;5;0;5;run066
10432;GRG;BRR;0;1;1;1;0;run066
10433;GRG;GBB;0;3;3;3;0;run066
10434;GRG;GGB;0;14;14;7;7;run066
10435;GRG;GGG;0;10;10;6;4;run066
10436;GRG;GGR;0;2;2;2;0;run066
10437;GRG;GRR;0;1;1;1;0;run066
10438;GRG;RBR;1;2;3;0;3;run066
10439;GRG;RGG;0;2;2;2;0;run066
10440;GRG;RGR;0;1;1;0;1;run066
10441;GRR;BBB;0;3;3;1;2;run066
10442;GRR;BBR;0;2;2;1;1;run066
10443;GRR;BRB;1;8;9;6;3;run066
10444;GRR;BRR;1;6;7;1;6;run066
10445;GRR;GBB;0;1;1;0;1;run066
10446;GRR;GBG;0;1;1;0;1;run066
10447;GRR;GGR;1;9;10;10;0;run066
10448;GRR;RBR;0;1;1;1;0;run066
10449;GRR;RGG;1;3;4;2;2;run066
10450;GRR;RGR;0;1;1;0;1;run066
10451;GRR;RRR;0;1;1;1;0;run066
10452;RBB;BBB;0;1;1;1;0;run066
10453;RBB;GGG;0;3;3;0;3;run066
10454;RBG;GRR;0;1;1;0;1;run066
10455;RBG;RBR;0;1;1;1;0;run066
10456;RBG;RGR;0;1;1;1;0;run066
10457;RBR;BBB;0;3;3;3;0;run066
10458;RBR;BRB;0;1;1;0;1;run066
10459;RBR;BRR;0;2;2;2;0;run066
10460;RBR;GGG;0;1;1;1;0;run066
10461;RBR;GGR;1;2;3;3;0;run066
10462;RBR;GRG;0;1;1;1;0;run066
10463;RBR;GRR;1;15;16;4;12;run066
10464;RBR;RGG;0;4;4;1;3;run066
10465;RBR;RGR;0;1;1;1;0;run066
10466;RBR;RRR;0;3;3;1;2;run066
10467;RGG;BGG;0;1;1;0;1;run066
10468;RGG;RGR;0;1;1;1;0;run066
10469;RGR;BBB;0;9;9;7;2;run066
10470;RGR;BBR;0;1;1;0;1;run066
10471;RGR;BGB;1;8;9;2;7;run066
10472;RGR;BRB;0;3;3;3;0;run066
10473;RGR;BRR;0;3;3;3;0;run066
10474;RGR;GBG;0;1;1;1;0;run066
10475;RGR;GGB;0;3;3;1;2;run066
10476;RGR;GGG;0;2;2;0;2;run066
10477;RGR;GGR;0;8;8;8;0;run066
10478;RGR;GRR;1;7;8;0;8;run066
10479;RGR;RGG;0;6;6;6;0;run066
10480;RRG;BGB;0;1;1;1;0;run066
10481;RRG;BRB;0;1;1;0;1;run066
10482;RRG;GGG;0;1;1;1;0;run066
10483;RRG;GGR;0;1;1;1;0;run066
10484;RRG;GRG;0;1;1;0;1;run066
10485;RRG;GRR;0;3;3;0;3;run066
10486;RRG;RBR;0;4;4;0;4;run066
10487;RRG;RGG;0;1;1;1;0;run066
10488;RRG;RGR;6;37;43;1;42;run066
10489;RRR;BRR;0;1;1;1;0;run066
10490;RRR;GGB;0;1;1;0;1;run066
10491;RRR;GGG;1;5;6;1;5;run066
10492;RRR;GGR;0;2;2;0;2;run066
10493;RRR;GRR;0;1;1;1;0;run066
10494;RRR;RGR;0;1;1;0;1;run066
10495;BBB;GRR;0;1;1;0;1;run067
10496;BBG;BBB;1;9;10;10;0;run067
10497;BBG;BBR;0;2;2;0;2;run067
10498;BBG;BGB;0;1;1;1;0;run067
10499;BBG;BGG;0;1;1;0;1;run067
10500;BBG;BRB;0;2;2;0;2;run067
10501;BBG;BRR;0;1;1;0;1;run067
10502;BBG;GBB;1;1;2;1;1;run067
10503;BBG;GBG;1;6;7;0;7;run067
10504;BBG;GGB;0;18;18;12;6;run067
10505;BBG;GGG;1;29;30;19;11;run067
10506;BBG;GGR;0;2;2;0;2;run067
10507;BBG;GRG;0;1;1;1;0;run067
10508;BBG;GRR;0;3;3;0;3;run067
10509;BBG;RBR;0;2;2;1;1;run067
10510;BBG;RGR;0;2;2;2;0;run067
10511;BBG;RRG;1;2;3;3;0;run067
10512;BBG;RRR;0;1;1;0;1;run067
10513;BGG;BBB;0;1;1;1;0;run067
10514;BGG;BRB;0;1;1;0;1;run067
10515;BGG;GGG;0;1;1;1;0;run067
10516;BGG;RBB;0;1;1;1;0;run067
10517;BGG;RBG;1;0;1;1;0;run067
10518;BRB;BBB;0;1;1;0;1;run067
10519;BRB;GGB;1;0;1;1;0;run067
10520;BRB;GGG;0;2;2;2;0;run067
10521;BRB;RBB;1;0;1;1;0;run067
10522;BRR;BBB;0;1;1;0;1;run067
10523;BRR;BRB;0;1;1;0;1;run067
10524;BRR;GBB;1;0;1;0;1;run067
10525;GBB;BBB;1;16;17;6;11;run067
10526;GBB;BBG;0;2;2;2;0;run067
10527;GBB;BGB;0;1;1;0;1;run067
10528;GBB;BGG;0;3;3;3;0;run067
10529;GBB;BRB;0;9;9;8;1;run067
10530;GBB;BRR;0;2;2;2;0;run067
10531;GBB;GBG;1;1;2;0;2;run067
10532;GBB;GGB;2;59;61;58;3;run067
10533;GBB;GGG;4;95;99;18;81;run067
10534;GBB;GGR;0;1;1;1;0;run067
10535;GBB;GRG;0;1;1;1;0;run067
10536;GBB;GRR;1;8;9;2;7;run067
10537;GBB;RBB;0;2;2;0;2;run067
10538;GBB;RBG;0;1;1;1;0;run067
10539;GBB;RBR;1;1;2;2;0;run067
10540;GBB;RGG;0;2;2;2;0;run067
10541;GBB;RGR;0;1;1;1;0;run067
10542;GBB;RRG;0;3;3;2;1;run067
10543;GBG;BRB;0;1;1;1;0;run067
10544;GBG;BRR;0;3;3;2;1;run067
10545;GBG;GGB;0;1;1;1;0;run067
10546;GBG;GGR;0;3;3;0;3;run067
10547;GBG;RBR;0;1;1;1;0;run067
10548;GBG;RGR;1;1;2;0;2;run067
10549;GBG;RRR;0;1;1;0;1;run067
10550;GGB;BBB;1;8;9;3;6;run067
10551;GGB;BBG;0;1;1;0;1;run067
10552;GGB;BGB;0;1;1;1;0;run067
10553;GGB;BRB;3;5;8;0;8;run067
10554;GGB;BRR;0;1;1;1;0;run067
10555;GGB;GBG;0;2;2;0;2;run067
10556;GGB;GGG;4;37;41;9;32;run067
10557;GGB;GGR;0;9;9;2;7;run067
10558;GGB;GRR;1;4;5;2;3;run067
10559;GGB;RBB;0;2;2;1;1;run067
10560;GGB;RBG;0;2;2;0;2;run067
10561;GGB;RBR;0;2;2;2;0;run067
10562;GGB;RGG;0;1;1;0;1;run067
10563;GGB;RGR;1;2;3;1;2;run067
10564;GGB;RRG;1;3;4;2;2;run067
10565;GGB;RRR;0;3;3;3;0;run067
10566;GGG;BBB;4;22;26;11;15;run067
10567;GGG;BBG;0;2;2;2;0;run067
10568;GGG;BBR;0;3;3;0;3;run067
10569;GGG;BGB;0;2;2;0;2;run067
10570;GGG;BGG;0;3;3;3;0;run067
10571;GGG;BRB;0;3;3;2;1;run067
10572;GGG;BRR;0;3;3;1;2;run067
10573;GGG;GBB;0;1;1;1;0;run067
10574;GGG;GGB;1;3;4;0;4;run067
10575;GGG;GGR;0;21;21;3;18;run067
10576;GGG;GRG;0;2;2;1;1;run067
10577;GGG;GRR;2;15;17;10;7;run067
10578;GGG;RBB;0;1;1;0;1;run067
10579;GGG;RBR;1;4;5;5;0;run067
10580;GGG;RGG;1;7;8;3;5;run067
10581;GGG;RGR;0;3;3;1;2;run067
10582;GGG;RRG;0;2;2;1;1;run067
10583;GGG;RRR;0;1;1;0;1;run067
10584;GGR;BBB;0;1;1;0;1;run067
10585;GGR;BGG;0;2;2;2;0;run067
10586;GGR;BRB;0;1;1;1;0;run067
10587;GRG;BBB;0;3;3;2;1;run067
10588;GRG;BGB;0;3;3;0;3;run067
10589;GRG;BGG;0;1;1;1;0;run067
10590;GRG;BRB;0;5;5;1;4;run067
10591;GRG;BRR;0;1;1;0;1;run067
10592;GRG;GBB;0;3;3;1;2;run067
10593;GRG;GGB;0;14;14;3;11;run067
10594;GRG;GGG;0;10;10;10;0;run067
10595;GRG;GGR;0;2;2;2;0;run067
10596;GRG;GRR;0;1;1;0;1;run067
10597;GRG;RBR;1;2;3;2;1;run067
10598;GRG;RGG;0;2;2;2;0;run067
10599;GRG;RGR;0;1;1;1;0;run067
10600;GRR;BBB;0;3;3;1;2;run067
10601;GRR;BBR;0;2;2;2;0;run067
10602;GRR;BRB;1;8;9;9;0;run067
10603;GRR;BRR;1;6;7;6;1;run067
10604;GRR;GBB;0;1;1;0;1;run067
10605;GRR;GBG;0;1;1;1;0;run067
10606;GRR;GGR;1;9;10;7;3;run067
10607;GRR;RBR;0;1;1;1;0;run067
10608;GRR;RGG;1;3;4;2;2;run067
10609;GRR;RGR;0;1;1;0;1;run067
10610;GRR;RRR;0;1;1;0;1;run067
10611;RBB;BBB;0;1;1;0;1;run067
10612;RBB;GGG;0;3;3;1;2;run067
10613;RBG;GRR;0;1;1;1;0;run067
10614;RBG;RBR;0;1;1;1;0;run067
10615;RBG;RGR;0;1;1;1;0;run067
10616;RBR;BBB;0;3;3;3;0;run067
10617;RBR;BRB;0;1;1;0;1;run067
10618;RBR;BRR;0;2;2;1;1;run067
10619;RBR;GGG;0;1;1;0;1;run067
10620;RBR;GGR;1;2;3;3;0;run067
10621;RBR;GRG;0;1;1;0;1;run067
10622;RBR;GRR;1;15;16;1;15;run067
10623;RBR;RGG;0;4;4;4;0;run067
10624;RBR;RGR;0;1;1;0;1;run067
10625;RBR;RRR;0;3;3;1;2;run067
10626;RGG;BGG;0;1;1;0;1;run067
10627;RGG;RGR;0;1;1;1;0;run067
10628;RGR;BBB;0;9;9;5;4;run067
10629;RGR;BBR;0;1;1;0;1;run067
10630;RGR;BGB;1;8;9;3;6;run067
10631;RGR;BRB;0;3;3;0;3;run067
10632;RGR;BRR;0;3;3;0;3;run067
10633;RGR;GBG;0;1;1;1;0;run067
10634;RGR;GGB;0;3;3;1;2;run067
10635;RGR;GGG;0;2;2;0;2;run067
10636;RGR;GGR;0;8;8;4;4;run067
10637;RGR;GRR;1;7;8;1;7;run067
10638;RGR;RGG;0;6;6;6;0;run067
10639;RRG;BGB;0;1;1;0;1;run067
10640;RRG;BRB;0;1;1;0;1;run067
10641;RRG;GGG;0;1;1;0;1;run067
10642;RRG;GGR;0;1;1;0;1;run067
10643;RRG;GRG;0;1;1;0;1;run067
10644;RRG;GRR;0;3;3;0;3;run067
10645;RRG;RBR;0;4;4;0;4;run067
10646;RRG;RGG;0;1;1;0;1;run067
10647;RRG;RGR;6;37;43;34;9;run067
10648;RRR;BRR;0;1;1;0;1;run067
10649;RRR;GGB;0;1;1;0;1;run067
10650;RRR;GGG;1;5;6;6;0;run067
10651;RRR;GGR;0;2;2;1;1;run067
10652;RRR;GRR;0;1;1;1;0;run067
10653;RRR;RGR;0;1;1;0;1;run067
10654;BBB;GRR;0;1;1;1;0;run068
10655;BBG;BBB;1;9;10;4;6;run068
10656;BBG;BBR;0;2;2;0;2;run068
10657;BBG;BGB;0;1;1;0;1;run068
10658;BBG;BGG;0;1;1;0;1;run068
10659;BBG;BRB;0;2;2;1;1;run068
10660;BBG;BRR;0;1;1;1;0;run068
10661;BBG;GBB;1;1;2;1;1;run068
10662;BBG;GBG;1;6;7;0;7;run068
10663;BBG;GGB;0;18;18;14;4;run068
10664;BBG;GGG;1;29;30;1;29;run068
10665;BBG;GGR;0;2;2;2;0;run068
10666;BBG;GRG;0;1;1;1;0;run068
10667;BBG;GRR;0;3;3;0;3;run068
10668;BBG;RBR;0;2;2;1;1;run068
10669;BBG;RGR;0;2;2;0;2;run068
10670;BBG;RRG;1;2;3;1;2;run068
10671;BBG;RRR;0;1;1;0;1;run068
10672;BGG;BBB;0;1;1;0;1;run068
10673;BGG;BRB;0;1;1;0;1;run068
10674;BGG;GGG;0;1;1;1;0;run068
10675;BGG;RBB;0;1;1;0;1;run068
10676;BGG;RBG;1;0;1;1;0;run068
10677;BRB;BBB;0;1;1;1;0;run068
10678;BRB;GGB;1;0;1;1;0;run068
10679;BRB;GGG;0;2;2;1;1;run068
10680;BRB;RBB;1;0;1;1;0;run068
10681;BRR;BBB;0;1;1;1;0;run068
10682;BRR;BRB;0;1;1;0;1;run068
10683;BRR;GBB;1;0;1;1;0;run068
10684;GBB;BBB;1;16;17;13;4;run068
10685;GBB;BBG;0;2;2;0;2;run068
10686;GBB;BGB;0;1;1;1;0;run068
10687;GBB;BGG;0;3;3;3;0;run068
10688;GBB;BRB;0;9;9;1;8;run068
10689;GBB;BRR;0;2;2;2;0;run068
10690;GBB;GBG;1;1;2;2;0;run068
10691;GBB;GGB;2;59;61;28;33;run068
10692;GBB;GGG;4;95;99;27;72;run068
10693;GBB;GGR;0;1;1;1;0;run068
10694;GBB;GRG;0;1;1;1;0;run068
10695;GBB;GRR;1;8;9;0;9;run068
10696;GBB;RBB;0;2;2;1;1;run068
10697;GBB;RBG;0;1;1;0;1;run068
10698;GBB;RBR;1;1;2;2;0;run068
10699;GBB;RGG;0;2;2;1;1;run068
10700;GBB;RGR;0;1;1;1;0;run068
10701;GBB;RRG;0;3;3;0;3;run068
10702;GBG;BRB;0;1;1;0;1;run068
10703;GBG;BRR;0;3;3;2;1;run068
10704;GBG;GGB;0;1;1;1;0;run068
10705;GBG;GGR;0;3;3;1;2;run068
10706;GBG;RBR;0;1;1;1;0;run068
10707;GBG;RGR;1;1;2;2;0;run068
10708;GBG;RRR;0;1;1;1;0;run068
10709;GGB;BBB;1;8;9;4;5;run068
10710;GGB;BBG;0;1;1;1;0;run068
10711;GGB;BGB;0;1;1;1;0;run068
10712;GGB;BRB;3;5;8;1;7;run068
10713;GGB;BRR;0;1;1;0;1;run068
10714;GGB;GBG;0;2;2;2;0;run068
10715;GGB;GGG;4;37;41;11;30;run068
10716;GGB;GGR;0;9;9;3;6;run068
10717;GGB;GRR;1;4;5;1;4;run068
10718;GGB;RBB;0;2;2;1;1;run068
10719;GGB;RBG;0;2;2;1;1;run068
10720;GGB;RBR;0;2;2;2;0;run068
10721;GGB;RGG;0;1;1;1;0;run068
10722;GGB;RGR;1;2;3;3;0;run068
10723;GGB;RRG;1;3;4;1;3;run068
10724;GGB;RRR;0;3;3;2;1;run068
10725;GGG;BBB;4;22;26;26;0;run068
10726;GGG;BBG;0;2;2;1;1;run068
10727;GGG;BBR;0;3;3;2;1;run068
10728;GGG;BGB;0;2;2;2;0;run068
10729;GGG;BGG;0;3;3;3;0;run068
10730;GGG;BRB;0;3;3;2;1;run068
10731;GGG;BRR;0;3;3;3;0;run068
10732;GGG;GBB;0;1;1;1;0;run068
10733;GGG;GGB;1;3;4;4;0;run068
10734;GGG;GGR;0;21;21;0;21;run068
10735;GGG;GRG;0;2;2;2;0;run068
10736;GGG;GRR;2;15;17;1;16;run068
10737;GGG;RBB;0;1;1;1;0;run068
10738;GGG;RBR;1;4;5;1;4;run068
10739;GGG;RGG;1;7;8;8;0;run068
10740;GGG;RGR;0;3;3;3;0;run068
10741;GGG;RRG;0;2;2;2;0;run068
10742;GGG;RRR;0;1;1;1;0;run068
10743;GGR;BBB;0;1;1;0;1;run068
10744;GGR;BGG;0;2;2;0;2;run068
10745;GGR;BRB;0;1;1;0;1;run068
10746;GRG;BBB;0;3;3;2;1;run068
10747;GRG;BGB;0;3;3;0;3;run068
10748;GRG;BGG;0;1;1;0;1;run068
10749;GRG;BRB;0;5;5;0;5;run068
10750;GRG;BRR;0;1;1;0;1;run068
10751;GRG;GBB;0;3;3;2;1;run068
10752;GRG;GGB;0;14;14;8;6;run068
10753;GRG;GGG;0;10;10;5;5;run068
10754;GRG;GGR;0;2;2;2;0;run068
10755;GRG;GRR;0;1;1;0;1;run068
10756;GRG;RBR;1;2;3;3;0;run068
10757;GRG;RGG;0;2;2;1;1;run068
10758;GRG;RGR;0;1;1;0;1;run068
10759;GRR;BBB;0;3;3;1;2;run068
10760;GRR;BBR;0;2;2;2;0;run068
10761;GRR;BRB;1;8;9;0;9;run068
10762;GRR;BRR;1;6;7;1;6;run068
10763;GRR;GBB;0;1;1;1;0;run068
10764;GRR;GBG;0;1;1;1;0;run068
10765;GRR;GGR;1;9;10;5;5;run068
10766;GRR;RBR;0;1;1;0;1;run068
10767;GRR;RGG;1;3;4;0;4;run068
10768;GRR;RGR;0;1;1;0;1;run068
10769;GRR;RRR;0;1;1;0;1;run068
10770;RBB;BBB;0;1;1;1;0;run068
10771;RBB;GGG;0;3;3;3;0;run068
10772;RBG;GRR;0;1;1;0;1;run068
10773;RBG;RBR;0;1;1;1;0;run068
10774;RBG;RGR;0;1;1;0;1;run068
10775;RBR;BBB;0;3;3;1;2;run068
10776;RBR;BRB;0;1;1;1;0;run068
10777;RBR;BRR;0;2;2;1;1;run068
10778;RBR;GGG;0;1;1;0;1;run068
10779;RBR;GGR;1;2;3;1;2;run068
10780;RBR;GRG;0;1;1;1;0;run068
10781;RBR;GRR;1;15;16;4;12;run068
10782;RBR;RGG;0;4;4;0;4;run068
10783;RBR;RGR;0;1;1;0;1;run068
10784;RBR;RRR;0;3;3;2;1;run068
10785;RGG;BGG;0;1;1;1;0;run068
10786;RGG;RGR;0;1;1;1;0;run068
10787;RGR;BBB;0;9;9;8;1;run068
10788;RGR;BBR;0;1;1;1;0;run068
10789;RGR;BGB;1;8;9;3;6;run068
10790;RGR;BRB;0;3;3;2;1;run068
10791;RGR;BRR;0;3;3;2;1;run068
10792;RGR;GBG;0;1;1;1;0;run068
10793;RGR;GGB;0;3;3;2;1;run068
10794;RGR;GGG;0;2;2;2;0;run068
10795;RGR;GGR;0;8;8;5;3;run068
10796;RGR;GRR;1;7;8;3;5;run068
10797;RGR;RGG;0;6;6;4;2;run068
10798;RRG;BGB;0;1;1;1;0;run068
10799;RRG;BRB;0;1;1;0;1;run068
10800;RRG;GGG;0;1;1;0;1;run068
10801;RRG;GGR;0;1;1;1;0;run068
10802;RRG;GRG;0;1;1;1;0;run068
10803;RRG;GRR;0;3;3;2;1;run068
10804;RRG;RBR;0;4;4;3;1;run068
10805;RRG;RGG;0;1;1;1;0;run068
10806;RRG;RGR;6;37;43;2;41;run068
10807;RRR;BRR;0;1;1;1;0;run068
10808;RRR;GGB;0;1;1;1;0;run068
10809;RRR;GGG;1;5;6;6;0;run068
10810;RRR;GGR;0;2;2;2;0;run068
10811;RRR;GRR;0;1;1;0;1;run068
10812;RRR;RGR;0;1;1;0;1;run068
10813;BBB;GRR;0;1;1;1;0;run069
10814;BBG;BBB;1;9;10;0;10;run069
10815;BBG;BBR;0;2;2;2;0;run069
10816;BBG;BGB;0;1;1;1;0;run069
10817;BBG;BGG;0;1;1;1;0;run069
10818;BBG;BRB;0;2;2;0;2;run069
10819;BBG;BRR;0;1;1;0;1;run069
10820;BBG;GBB;1;1;2;2;0;run069
10821;BBG;GBG;1;6;7;6;1;run069
10822;BBG;GGB;0;18;18;5;13;run069
10823;BBG;GGG;1;29;30;28;2;run069
10824;BBG;GGR;0;2;2;2;0;run069
10825;BBG;GRG;0;1;1;1;0;run069
10826;BBG;GRR;0;3;3;1;2;run069
10827;BBG;RBR;0;2;2;2;0;run069
10828;BBG;RGR;0;2;2;1;1;run069
10829;BBG;RRG;1;2;3;2;1;run069
10830;BBG;RRR;0;1;1;1;0;run069
10831;BGG;BBB;0;1;1;1;0;run069
10832;BGG;BRB;0;1;1;0;1;run069
10833;BGG;GGG;0;1;1;0;1;run069
10834;BGG;RBB;0;1;1;1;0;run069
10835;BGG;RBG;1;0;1;0;1;run069
10836;BRB;BBB;0;1;1;0;1;run069
10837;BRB;GGB;1;0;1;0;1;run069
10838;BRB;GGG;0;2;2;0;2;run069
10839;BRB;RBB;1;0;1;1;0;run069
10840;BRR;BBB;0;1;1;1;0;run069
10841;BRR;BRB;0;1;1;1;0;run069
10842;BRR;GBB;1;0;1;1;0;run069
10843;GBB;BBB;1;16;17;4;13;run069
10844;GBB;BBG;0;2;2;2;0;run069
10845;GBB;BGB;0;1;1;1;0;run069
10846;GBB;BGG;0;3;3;0;3;run069
10847;GBB;BRB;0;9;9;2;7;run069
10848;GBB;BRR;0;2;2;1;1;run069
10849;GBB;GBG;1;1;2;1;1;run069
10850;GBB;GGB;2;59;61;3;58;run069
10851;GBB;GGG;4;95;99;63;36;run069
10852;GBB;GGR;0;1;1;1;0;run069
10853;GBB;GRG;0;1;1;0;1;run069
10854;GBB;GRR;1;8;9;0;9;run069
10855;GBB;RBB;0;2;2;2;0;run069
10856;GBB;RBG;0;1;1;0;1;run069
10857;GBB;RBR;1;1;2;0;2;run069
10858;GBB;RGG;0;2;2;0;2;run069
10859;GBB;RGR;0;1;1;1;0;run069
10860;GBB;RRG;0;3;3;0;3;run069
10861;GBG;BRB;0;1;1;1;0;run069
10862;GBG;BRR;0;3;3;0;3;run069
10863;GBG;GGB;0;1;1;0;1;run069
10864;GBG;GGR;0;3;3;0;3;run069
10865;GBG;RBR;0;1;1;0;1;run069
10866;GBG;RGR;1;1;2;2;0;run069
10867;GBG;RRR;0;1;1;0;1;run069
10868;GGB;BBB;1;8;9;8;1;run069
10869;GGB;BBG;0;1;1;1;0;run069
10870;GGB;BGB;0;1;1;0;1;run069
10871;GGB;BRB;3;5;8;2;6;run069
10872;GGB;BRR;0;1;1;0;1;run069
10873;GGB;GBG;0;2;2;0;2;run069
10874;GGB;GGG;4;37;41;4;37;run069
10875;GGB;GGR;0;9;9;5;4;run069
10876;GGB;GRR;1;4;5;3;2;run069
10877;GGB;RBB;0;2;2;0;2;run069
10878;GGB;RBG;0;2;2;2;0;run069
10879;GGB;RBR;0;2;2;0;2;run069
10880;GGB;RGG;0;1;1;0;1;run069
10881;GGB;RGR;1;2;3;1;2;run069
10882;GGB;RRG;1;3;4;0;4;run069
10883;GGB;RRR;0;3;3;2;1;run069
10884;GGG;BBB;4;22;26;12;14;run069
10885;GGG;BBG;0;2;2;2;0;run069
10886;GGG;BBR;0;3;3;3;0;run069
10887;GGG;BGB;0;2;2;1;1;run069
10888;GGG;BGG;0;3;3;1;2;run069
10889;GGG;BRB;0;3;3;1;2;run069
10890;GGG;BRR;0;3;3;0;3;run069
10891;GGG;GBB;0;1;1;0;1;run069
10892;GGG;GGB;1;3;4;1;3;run069
10893;GGG;GGR;0;21;21;4;17;run069
10894;GGG;GRG;0;2;2;1;1;run069
10895;GGG;GRR;2;15;17;0;17;run069
10896;GGG;RBB;0;1;1;0;1;run069
10897;GGG;RBR;1;4;5;2;3;run069
10898;GGG;RGG;1;7;8;7;1;run069
10899;GGG;RGR;0;3;3;0;3;run069
10900;GGG;RRG;0;2;2;2;0;run069
10901;GGG;RRR;0;1;1;1;0;run069
10902;GGR;BBB;0;1;1;0;1;run069
10903;GGR;BGG;0;2;2;2;0;run069
10904;GGR;BRB;0;1;1;0;1;run069
10905;GRG;BBB;0;3;3;2;1;run069
10906;GRG;BGB;0;3;3;3;0;run069
10907;GRG;BGG;0;1;1;0;1;run069
10908;GRG;BRB;0;5;5;2;3;run069
10909;GRG;BRR;0;1;1;1;0;run069
10910;GRG;GBB;0;3;3;1;2;run069
10911;GRG;GGB;0;14;14;1;13;run069
10912;GRG;GGG;0;10;10;2;8;run069
10913;GRG;GGR;0;2;2;1;1;run069
10914;GRG;GRR;0;1;1;1;0;run069
10915;GRG;RBR;1;2;3;1;2;run069
10916;GRG;RGG;0;2;2;1;1;run069
10917;GRG;RGR;0;1;1;1;0;run069
10918;GRR;BBB;0;3;3;3;0;run069
10919;GRR;BBR;0;2;2;2;0;run069
10920;GRR;BRB;1;8;9;2;7;run069
10921;GRR;BRR;1;6;7;3;4;run069
10922;GRR;GBB;0;1;1;1;0;run069
10923;GRR;GBG;0;1;1;0;1;run069
10924;GRR;GGR;1;9;10;4;6;run069
10925;GRR;RBR;0;1;1;0;1;run069
10926;GRR;RGG;1;3;4;4;0;run069
10927;GRR;RGR;0;1;1;1;0;run069
10928;GRR;RRR;0;1;1;1;0;run069
10929;RBB;BBB;0;1;1;0;1;run069
10930;RBB;GGG;0;3;3;2;1;run069
10931;RBG;GRR;0;1;1;0;1;run069
10932;RBG;RBR;0;1;1;0;1;run069
10933;RBG;RGR;0;1;1;1;0;run069
10934;RBR;BBB;0;3;3;3;0;run069
10935;RBR;BRB;0;1;1;1;0;run069
10936;RBR;BRR;0;2;2;0;2;run069
10937;RBR;GGG;0;1;1;0;1;run069
10938;RBR;GGR;1;2;3;0;3;run069
10939;RBR;GRG;0;1;1;1;0;run069
10940;RBR;GRR;1;15;16;0;16;run069
10941;RBR;RGG;0;4;4;0;4;run069
10942;RBR;RGR;0;1;1;0;1;run069
10943;RBR;RRR;0;3;3;3;0;run069
10944;RGG;BGG;0;1;1;1;0;run069
10945;RGG;RGR;0;1;1;1;0;run069
10946;RGR;BBB;0;9;9;7;2;run069
10947;RGR;BBR;0;1;1;0;1;run069
10948;RGR;BGB;1;8;9;5;4;run069
10949;RGR;BRB;0;3;3;3;0;run069
10950;RGR;BRR;0;3;3;2;1;run069
10951;RGR;GBG;0;1;1;1;0;run069
10952;RGR;GGB;0;3;3;3;0;run069
10953;RGR;GGG;0;2;2;1;1;run069
10954;RGR;GGR;0;8;8;2;6;run069
10955;RGR;GRR;1;7;8;4;4;run069
10956;RGR;RGG;0;6;6;4;2;run069
10957;RRG;BGB;0;1;1;1;0;run069
10958;RRG;BRB;0;1;1;0;1;run069
10959;RRG;GGG;0;1;1;1;0;run069
10960;RRG;GGR;0;1;1;1;0;run069
10961;RRG;GRG;0;1;1;0;1;run069
10962;RRG;GRR;0;3;3;2;1;run069
10963;RRG;RBR;0;4;4;1;3;run069
10964;RRG;RGG;0;1;1;1;0;run069
10965;RRG;RGR;6;37;43;23;20;run069
10966;RRR;BRR;0;1;1;1;0;run069
10967;RRR;GGB;0;1;1;0;1;run069
10968;RRR;GGG;1;5;6;6;0;run069
10969;RRR;GGR;0;2;2;0;2;run069
10970;RRR;GRR;0;1;1;1;0;run069
10971;RRR;RGR;0;1;1;0;1;run069
10972;BBB;GRR;0;1;1;0;1;run070
10973;BBG;BBB;1;9;10;5;5;run070
10974;BBG;BBR;0;2;2;0;2;run070
10975;BBG;BGB;0;1;1;1;0;run070
10976;BBG;BGG;0;1;1;0;1;run070
10977;BBG;BRB;0;2;2;2;0;run070
10978;BBG;BRR;0;1;1;1;0;run070
10979;BBG;GBB;1;1;2;2;0;run070
10980;BBG;GBG;1;6;7;5;2;run070
10981;BBG;GGB;0;18;18;14;4;run070
10982;BBG;GGG;1;29;30;6;24;run070
10983;BBG;GGR;0;2;2;0;2;run070
10984;BBG;GRG;0;1;1;1;0;run070
10985;BBG;GRR;0;3;3;3;0;run070
10986;BBG;RBR;0;2;2;0;2;run070
10987;BBG;RGR;0;2;2;2;0;run070
10988;BBG;RRG;1;2;3;0;3;run070
10989;BBG;RRR;0;1;1;1;0;run070
10990;BGG;BBB;0;1;1;1;0;run070
10991;BGG;BRB;0;1;1;1;0;run070
10992;BGG;GGG;0;1;1;0;1;run070
10993;BGG;RBB;0;1;1;1;0;run070
10994;BGG;RBG;1;0;1;0;1;run070
10995;BRB;BBB;0;1;1;1;0;run070
10996;BRB;GGB;1;0;1;0;1;run070
10997;BRB;GGG;0;2;2;1;1;run070
10998;BRB;RBB;1;0;1;1;0;run070
10999;BRR;BBB;0;1;1;0;1;run070
11000;BRR;BRB;0;1;1;0;1;run070
11001;BRR;GBB;1;0;1;0;1;run070
11002;GBB;BBB;1;16;17;2;15;run070
11003;GBB;BBG;0;2;2;2;0;run070
11004;GBB;BGB;0;1;1;1;0;run070
11005;GBB;BGG;0;3;3;0;3;run070
11006;GBB;BRB;0;9;9;2;7;run070
11007;GBB;BRR;0;2;2;2;0;run070
11008;GBB;GBG;1;1;2;0;2;run070
11009;GBB;GGB;2;59;61;6;55;run070
11010;GBB;GGG;4;95;99;99;0;run070
11011;GBB;GGR;0;1;1;0;1;run070
11012;GBB;GRG;0;1;1;1;0;run070
11013;GBB;GRR;1;8;9;9;0;run070
11014;GBB;RBB;0;2;2;0;2;run070
11015;GBB;RBG;0;1;1;1;0;run070
11016;GBB;RBR;1;1;2;0;2;run070
11017;GBB;RGG;0;2;2;2;0;run070
11018;GBB;RGR;0;1;1;1;0;run070
11019;GBB;RRG;0;3;3;2;1;run070
11020;GBG;BRB;0;1;1;1;0;run070
11021;GBG;BRR;0;3;3;0;3;run070
11022;GBG;GGB;0;1;1;1;0;run070
11023;GBG;GGR;0;3;3;0;3;run070
11024;GBG;RBR;0;1;1;0;1;run070
11025;GBG;RGR;1;1;2;0;2;run070
11026;GBG;RRR;0;1;1;0;1;run070
11027;GGB;BBB;1;8;9;2;7;run070
11028;GGB;BBG;0;1;1;1;0;run070
11029;GGB;BGB;0;1;1;0;1;run070
11030;GGB;BRB;3;5;8;0;8;run070
11031;GGB;BRR;0;1;1;1;0;run070
11032;GGB;GBG;0;2;2;0;2;run070
11033;GGB;GGG;4;37;41;5;36;run070
11034;GGB;GGR;0;9;9;1;8;run070
11035;GGB;GRR;1;4;5;5;0;run070
11036;GGB;RBB;0;2;2;2;0;run070
11037;GGB;RBG;0;2;2;1;1;run070
11038;GGB;RBR;0;2;2;0;2;run070
11039;GGB;RGG;0;1;1;0;1;run070
11040;GGB;RGR;1;2;3;2;1;run070
11041;GGB;RRG;1;3;4;0;4;run070
11042;GGB;RRR;0;3;3;1;2;run070
11043;GGG;BBB;4;22;26;1;25;run070
11044;GGG;BBG;0;2;2;2;0;run070
11045;GGG;BBR;0;3;3;0;3;run070
11046;GGG;BGB;0;2;2;0;2;run070
11047;GGG;BGG;0;3;3;0;3;run070
11048;GGG;BRB;0;3;3;2;1;run070
11049;GGG;BRR;0;3;3;2;1;run070
11050;GGG;GBB;0;1;1;0;1;run070
11051;GGG;GGB;1;3;4;0;4;run070
11052;GGG;GGR;0;21;21;8;13;run070
11053;GGG;GRG;0;2;2;1;1;run070
11054;GGG;GRR;2;15;17;17;0;run070
11055;GGG;RBB;0;1;1;1;0;run070
11056;GGG;RBR;1;4;5;3;2;run070
11057;GGG;RGG;1;7;8;5;3;run070
11058;GGG;RGR;0;3;3;2;1;run070
11059;GGG;RRG;0;2;2;1;1;run070
11060;GGG;RRR;0;1;1;1;0;run070
11061;GGR;BBB;0;1;1;1;0;run070
11062;GGR;BGG;0;2;2;0;2;run070
11063;GGR;BRB;0;1;1;1;0;run070
11064;GRG;BBB;0;3;3;1;2;run070
11065;GRG;BGB;0;3;3;1;2;run070
11066;GRG;BGG;0;1;1;0;1;run070
11067;GRG;BRB;0;5;5;5;0;run070
11068;GRG;BRR;0;1;1;1;0;run070
11069;GRG;GBB;0;3;3;2;1;run070
11070;GRG;GGB;0;14;14;11;3;run070
11071;GRG;GGG;0;10;10;8;2;run070
11072;GRG;GGR;0;2;2;0;2;run070
11073;GRG;GRR;0;1;1;0;1;run070
11074;GRG;RBR;1;2;3;2;1;run070
11075;GRG;RGG;0;2;2;1;1;run070
11076;GRG;RGR;0;1;1;1;0;run070
11077;GRR;BBB;0;3;3;1;2;run070
11078;GRR;BBR;0;2;2;2;0;run070
11079;GRR;BRB;1;8;9;0;9;run070
11080;GRR;BRR;1;6;7;0;7;run070
11081;GRR;GBB;0;1;1;0;1;run070
11082;GRR;GBG;0;1;1;1;0;run070
11083;GRR;GGR;1;9;10;9;1;run070
11084;GRR;RBR;0;1;1;0;1;run070
11085;GRR;RGG;1;3;4;2;2;run070
11086;GRR;RGR;0;1;1;1;0;run070
11087;GRR;RRR;0;1;1;0;1;run070
11088;RBB;BBB;0;1;1;1;0;run070
11089;RBB;GGG;0;3;3;3;0;run070
11090;RBG;GRR;0;1;1;0;1;run070
11091;RBG;RBR;0;1;1;1;0;run070
11092;RBG;RGR;0;1;1;1;0;run070
11093;RBR;BBB;0;3;3;1;2;run070
11094;RBR;BRB;0;1;1;1;0;run070
11095;RBR;BRR;0;2;2;2;0;run070
11096;RBR;GGG;0;1;1;0;1;run070
11097;RBR;GGR;1;2;3;2;1;run070
11098;RBR;GRG;0;1;1;1;0;run070
11099;RBR;GRR;1;15;16;6;10;run070
11100;RBR;RGG;0;4;4;2;2;run070
11101;RBR;RGR;0;1;1;1;0;run070
11102;RBR;RRR;0;3;3;0;3;run070
11103;RGG;BGG;0;1;1;0;1;run070
11104;RGG;RGR;0;1;1;1;0;run070
11105;RGR;BBB;0;9;9;9;0;run070
11106;RGR;BBR;0;1;1;1;0;run070
11107;RGR;BGB;1;8;9;7;2;run070
11108;RGR;BRB;0;3;3;2;1;run070
11109;RGR;BRR;0;3;3;2;1;run070
11110;RGR;GBG;0;1;1;1;0;run070
11111;RGR;GGB;0;3;3;2;1;run070
11112;RGR;GGG;0;2;2;1;1;run070
11113;RGR;GGR;0;8;8;1;7;run070
11114;RGR;GRR;1;7;8;0;8;run070
11115;RGR;RGG;0;6;6;4;2;run070
11116;RRG;BGB;0;1;1;0;1;run070
11117;RRG;BRB;0;1;1;0;1;run070
11118;RRG;GGG;0;1;1;0;1;run070
11119;RRG;GGR;0;1;1;0;1;run070
11120;RRG;GRG;0;1;1;1;0;run070
11121;RRG;GRR;0;3;3;0;3;run070
11122;RRG;RBR;0;4;4;4;0;run070
11123;RRG;RGG;0;1;1;0;1;run070
11124;RRG;RGR;6;37;43;32;11;run070
11125;RRR;BRR;0;1;1;0;1;run070
11126;RRR;GGB;0;1;1;0;1;run070
11127;RRR;GGG;1;5;6;3;3;run070
11128;RRR;GGR;0;2;2;0;2;run070
11129;RRR;GRR;0;1;1;1;0;run070
11130;RRR;RGR;0;1;1;0;1;run070
11131;BBB;GRR;0;1;1;0;1;run071
11132;BBG;BBB;1;9;10;0;10;run071
11133;BBG;BBR;0;2;2;2;0;run071
11134;BBG;BGB;0;1;1;1;0;run071
11135;BBG;BGG;0;1;1;1;0;run071
11136;BBG;BRB;0;2;2;1;1;run071
11137;BBG;BRR;0;1;1;1;0;run071
11138;BBG;GBB;1;1;2;0;2;run071
11139;BBG;GBG;1;6;7;4;3;run071
11140;BBG;GGB;0;18;18;2;16;run071
11141;BBG;GGG;1;29;30;17;13;run071
11142;BBG;GGR;0;2;2;2;0;run071
11143;BBG;GRG;0;1;1;1;0;run071
11144;BBG;GRR;0;3;3;0;3;run071
11145;BBG;RBR;0;2;2;0;2;run071
11146;BBG;RGR;0;2;2;0;2;run071
11147;BBG;RRG;1;2;3;2;1;run071
11148;BBG;RRR;0;1;1;0;1;run071
11149;BGG;BBB;0;1;1;1;0;run071
11150;BGG;BRB;0;1;1;1;0;run071
11151;BGG;GGG;0;1;1;0;1;run071
11152;BGG;RBB;0;1;1;0;1;run071
11153;BGG;RBG;1;0;1;0;1;run071
11154;BRB;BBB;0;1;1;1;0;run071
11155;BRB;GGB;1;0;1;0;1;run071
11156;BRB;GGG;0;2;2;2;0;run071
11157;BRB;RBB;1;0;1;1;0;run071
11158;BRR;BBB;0;1;1;1;0;run071
11159;BRR;BRB;0;1;1;1;0;run071
11160;BRR;GBB;1;0;1;0;1;run071
11161;GBB;BBB;1;16;17;12;5;run071
11162;GBB;BBG;0;2;2;1;1;run071
11163;GBB;BGB;0;1;1;0;1;run071
11164;GBB;BGG;0;3;3;2;1;run071
11165;GBB;BRB;0;9;9;1;8;run071
11166;GBB;BRR;0;2;2;1;1;run071
11167;GBB;GBG;1;1;2;0;2;run071
11168;GBB;GGB;2;59;61;6;55;run071
11169;GBB;GGG;4;95;99;52;47;run071
11170;GBB;GGR;0;1;1;0;1;run071
11171;GBB;GRG;0;1;1;0;1;run071
11172;GBB;GRR;1;8;9;7;2;run071
11173;GBB;RBB;0;2;2;2;0;run071
11174;GBB;RBG;0;1;1;1;0;run071
11175;GBB;RBR;1;1;2;1;1;run071
11176;GBB;RGG;0;2;2;0;2;run071
11177;GBB;RGR;0;1;1;1;0;run071
11178;GBB;RRG;0;3;3;2;1;run071
11179;GBG;BRB;0;1;1;1;0;run071
11180;GBG;BRR;0;3;3;1;2;run071
11181;GBG;GGB;0;1;1;1;0;run071
11182;GBG;GGR;0;3;3;3;0;run071
11183;GBG;RBR;0;1;1;1;0;run071
11184;GBG;RGR;1;1;2;0;2;run071
11185;GBG;RRR;0;1;1;0;1;run071
11186;GGB;BBB;1;8;9;5;4;run071
11187;GGB;BBG;0;1;1;1;0;run071
11188;GGB;BGB;0;1;1;0;1;run071
11189;GGB;BRB;3;5;8;6;2;run071
11190;GGB;BRR;0;1;1;1;0;run071
11191;GGB;GBG;0;2;2;1;1;run071
11192;GGB;GGG;4;37;41;23;18;run071
11193;GGB;GGR;0;9;9;1;8;run071
11194;GGB;GRR;1;4;5;2;3;run071
11195;GGB;RBB;0;2;2;0;2;run071
11196;GGB;RBG;0;2;2;2;0;run071
11197;GGB;RBR;0;2;2;2;0;run071
11198;GGB;RGG;0;1;1;1;0;run071
11199;GGB;RGR;1;2;3;2;1;run071
11200;GGB;RRG;1;3;4;4;0;run071
11201;GGB;RRR;0;3;3;1;2;run071
11202;GGG;BBB;4;22;26;1;25;run071
11203;GGG;BBG;0;2;2;1;1;run071
11204;GGG;BBR;0;3;3;2;1;run071
11205;GGG;BGB;0;2;2;1;1;run071
11206;GGG;BGG;0;3;3;2;1;run071
11207;GGG;BRB;0;3;3;1;2;run071
11208;GGG;BRR;0;3;3;2;1;run071
11209;GGG;GBB;0;1;1;1;0;run071
11210;GGG;GGB;1;3;4;3;1;run071
11211;GGG;GGR;0;21;21;0;21;run071
11212;GGG;GRG;0;2;2;1;1;run071
11213;GGG;GRR;2;15;17;4;13;run071
11214;GGG;RBB;0;1;1;0;1;run071
11215;GGG;RBR;1;4;5;2;3;run071
11216;GGG;RGG;1;7;8;4;4;run071
11217;GGG;RGR;0;3;3;2;1;run071
11218;GGG;RRG;0;2;2;1;1;run071
11219;GGG;RRR;0;1;1;0;1;run071
11220;GGR;BBB;0;1;1;1;0;run071
11221;GGR;BGG;0;2;2;1;1;run071
11222;GGR;BRB;0;1;1;1;0;run071
11223;GRG;BBB;0;3;3;1;2;run071
11224;GRG;BGB;0;3;3;0;3;run071
11225;GRG;BGG;0;1;1;0;1;run071
11226;GRG;BRB;0;5;5;5;0;run071
11227;GRG;BRR;0;1;1;0;1;run071
11228;GRG;GBB;0;3;3;2;1;run071
11229;GRG;GGB;0;14;14;1;13;run071
11230;GRG;GGG;0;10;10;2;8;run071
11231;GRG;GGR;0;2;2;0;2;run071
11232;GRG;GRR;0;1;1;0;1;run071
11233;GRG;RBR;1;2;3;2;1;run071
11234;GRG;RGG;0;2;2;0;2;run071
11235;GRG;RGR;0;1;1;0;1;run071
11236;GRR;BBB;0;3;3;1;2;run071
11237;GRR;BBR;0;2;2;2;0;run071
11238;GRR;BRB;1;8;9;9;0;run071
11239;GRR;BRR;1;6;7;7;0;run071
11240;GRR;GBB;0;1;1;0;1;run071
11241;GRR;GBG;0;1;1;0;1;run071
11242;GRR;GGR;1;9;10;7;3;run071
11243;GRR;RBR;0;1;1;1;0;run071
11244;GRR;RGG;1;3;4;1;3;run071
11245;GRR;RGR;0;1;1;1;0;run071
11246;GRR;RRR;0;1;1;1;0;run071
11247;RBB;BBB;0;1;1;1;0;run071
11248;RBB;GGG;0;3;3;2;1;run071
11249;RBG;GRR;0;1;1;0;1;run071
11250;RBG;RBR;0;1;1;1;0;run071
11251;RBG;RGR;0;1;1;1;0;run071
11252;RBR;BBB;0;3;3;0;3;run071
11253;RBR;BRB;0;1;1;1;0;run071
11254;RBR;BRR;0;2;2;2;0;run071
11255;RBR;GGG;0;1;1;0;1;run071
11256;RBR;GGR;1;2;3;2;1;run071
11257;RBR;GRG;0;1;1;1;0;run071
11258;RBR;GRR;1;15;16;11;5;run071
11259;RBR;RGG;0;4;4;0;4;run071
11260;RBR;RGR;0;1;1;1;0;run071
11261;RBR;RRR;0;3;3;0;3;run071
11262;RGG;BGG;0;1;1;0;1;run071
11263;RGG;RGR;0;1;1;0;1;run071
11264;RGR;BBB;0;9;9;6;3;run071
11265;RGR;BBR;0;1;1;0;1;run071
11266;RGR;BGB;1;8;9;3;6;run071
11267;RGR;BRB;0;3;3;1;2;run071
11268;RGR;BRR;0;3;3;1;2;run071
11269;RGR;GBG;0;1;1;0;1;run071
11270;RGR;GGB;0;3;3;3;0;run071
11271;RGR;GGG;0;2;2;1;1;run071
11272;RGR;GGR;0;8;8;1;7;run071
11273;RGR;GRR;1;7;8;0;8;run071
11274;RGR;RGG;0;6;6;0;6;run071
11275;RRG;BGB;0;1;1;1;0;run071
11276;RRG;BRB;0;1;1;0;1;run071
11277;RRG;GGG;0;1;1;1;0;run071
11278;RRG;GGR;0;1;1;0;1;run071
11279;RRG;GRG;0;1;1;1;0;run071
11280;RRG;GRR;0;3;3;0;3;run071
11281;RRG;RBR;0;4;4;3;1;run071
11282;RRG;RGG;0;1;1;1;0;run071
11283;RRG;RGR;6;37;43;9;34;run071
11284;RRR;BRR;0;1;1;1;0;run071
11285;RRR;GGB;0;1;1;1;0;run071
11286;RRR;GGG;1;5;6;3;3;run071
11287;RRR;GGR;0;2;2;2;0;run071
11288;RRR;GRR;0;1;1;0;1;run071
11289;RRR;RGR;0;1;1;1;0;run071
11290;BBB;GRR;0;1;1;0;1;run072
11291;BBG;BBB;1;9;10;2;8;run072
11292;BBG;BBR;0;2;2;2;0;run072
11293;BBG;BGB;0;1;1;0;1;run072
11294;BBG;BGG;0;1;1;1;0;run072
11295;BBG;BRB;0;2;2;0;2;run072
11296;BBG;BRR;0;1;1;1;0;run072
11297;BBG;GBB;1;1;2;2;0;run072
11298;BBG;GBG;1;6;7;3;4;run072
11299;BBG;GGB;0;18;18;15;3;run072
11300;BBG;GGG;1;29;30;4;26;run072
11301;BBG;GGR;0;2;2;0;2;run072
11302;BBG;GRG;0;1;1;1;0;run072
11303;BBG;GRR;0;3;3;3;0;run072
11304;BBG;RBR;0;2;2;0;2;run072
11305;BBG;RGR;0;2;2;1;1;run072
11306;BBG;RRG;1;2;3;3;0;run072
11307;BBG;RRR;0;1;1;1;0;run072
11308;BGG;BBB;0;1;1;0;1;run072
11309;BGG;BRB;0;1;1;0;1;run072
11310;BGG;GGG;0;1;1;0;1;run072
11311;BGG;RBB;0;1;1;1;0;run072
11312;BGG;RBG;1;0;1;0;1;run072
11313;BRB;BBB;0;1;1;1;0;run072
11314;BRB;GGB;1;0;1;1;0;run072
11315;BRB;GGG;0;2;2;1;1;run072
11316;BRB;RBB;1;0;1;0;1;run072
11317;BRR;BBB;0;1;1;1;0;run072
11318;BRR;BRB;0;1;1;1;0;run072
11319;BRR;GBB;1;0;1;0;1;run072
11320;GBB;BBB;1;16;17;7;10;run072
11321;GBB;BBG;0;2;2;0;2;run072
11322;GBB;BGB;0;1;1;0;1;run072
11323;GBB;BGG;0;3;3;2;1;run072
11324;GBB;BRB;0;9;9;2;7;run072
11325;GBB;BRR;0;2;2;1;1;run072
11326;GBB;GBG;1;1;2;1;1;run072
11327;GBB;GGB;2;59;61;7;54;run072
11328;GBB;GGG;4;95;99;92;7;run072
11329;GBB;GGR;0;1;1;0;1;run072
11330;GBB;GRG;0;1;1;1;0;run072
11331;GBB;GRR;1;8;9;5;4;run072
11332;GBB;RBB;0;2;2;1;1;run072
11333;GBB;RBG;0;1;1;1;0;run072
11334;GBB;RBR;1;1;2;1;1;run072
11335;GBB;RGG;0;2;2;2;0;run072
11336;GBB;RGR;0;1;1;1;0;run072
11337;GBB;RRG;0;3;3;2;1;run072
11338;GBG;BRB;0;1;1;1;0;run072
11339;GBG;BRR;0;3;3;2;1;run072
11340;GBG;GGB;0;1;1;1;0;run072
11341;GBG;GGR;0;3;3;3;0;run072
11342;GBG;RBR;0;1;1;0;1;run072
11343;GBG;RGR;1;1;2;0;2;run072
11344;GBG;RRR;0;1;1;0;1;run072
11345;GGB;BBB;1;8;9;5;4;run072
11346;GGB;BBG;0;1;1;1;0;run072
11347;GGB;BGB;0;1;1;1;0;run072
11348;GGB;BRB;3;5;8;1;7;run072
11349;GGB;BRR;0;1;1;1;0;run072
11350;GGB;GBG;0;2;2;0;2;run072
11351;GGB;GGG;4;37;41;37;4;run072
11352;GGB;GGR;0;9;9;0;9;run072
11353;GGB;GRR;1;4;5;1;4;run072
11354;GGB;RBB;0;2;2;0;2;run072
11355;GGB;RBG;0;2;2;0;2;run072
11356;GGB;RBR;0;2;2;2;0;run072
11357;GGB;RGG;0;1;1;1;0;run072
11358;GGB;RGR;1;2;3;2;1;run072
11359;GGB;RRG;1;3;4;0;4;run072
11360;GGB;RRR;0;3;3;0;3;run072
11361;GGG;BBB;4;22;26;4;22;run072
11362;GGG;BBG;0;2;2;1;1;run072
11363;GGG;BBR;0;3;3;3;0;run072
11364;GGG;BGB;0;2;2;1;1;run072
11365;GGG;BGG;0;3;3;1;2;run072
11366;GGG;BRB;0;3;3;3;0;run072
11367;GGG;BRR;0;3;3;2;1;run072
11368;GGG;GBB;0;1;1;0;1;run072
11369;GGG;GGB;1;3;4;3;1;run072
11370;GGG;GGR;0;21;21;8;13;run072
11371;GGG;GRG;0;2;2;1;1;run072
11372;GGG;GRR;2;15;17;8;9;run072
11373;GGG;RBB;0;1;1;1;0;run072
11374;GGG;RBR;1;4;5;0;5;run072
11375;GGG;RGG;1;7;8;2;6;run072
11376;GGG;RGR;0;3;3;1;2;run072
11377;GGG;RRG;0;2;2;2;0;run072
11378;GGG;RRR;0;1;1;1;0;run072
11379;GGR;BBB;0;1;1;0;1;run072
11380;GGR;BGG;0;2;2;2;0;run072
11381;GGR;BRB;0;1;1;1;0;run072
11382;GRG;BBB;0;3;3;1;2;run072
11383;GRG;BGB;0;3;3;3;0;run072
11384;GRG;BGG;0;1;1;1;0;run072
11385;GRG;BRB;0;5;5;3;2;run072
11386;GRG;BRR;0;1;1;0;1;run072
11387;GRG;GBB;0;3;3;3;0;run072
11388;GRG;GGB;0;14;14;4;10;run072
11389;GRG;GGG;0;10;10;0;10;run072
11390;GRG;GGR;0;2;2;2;0;run072
11391;GRG;GRR;0;1;1;1;0;run072
11392;GRG;RBR;1;2;3;1;2;run072
11393;GRG;RGG;0;2;2;2;0;run072
11394;GRG;RGR;0;1;1;1;0;run072
11395;GRR;BBB;0;3;3;2;1;run072
11396;GRR;BBR;0;2;2;2;0;run072
11397;GRR;BRB;1;8;9;1;8;run072
11398;GRR;BRR;1;6;7;2;5;run072
11399;GRR;GBB;0;1;1;1;0;run072
11400;GRR;GBG;0;1;1;1;0;run072
11401;GRR;GGR;1;9;10;4;6;run072
11402;GRR;RBR;0;1;1;0;1;run072
11403;GRR;RGG;1;3;4;4;0;run072
11404;GRR;RGR;0;1;1;0;1;run072
11405;GRR;RRR;0;1;1;0;1;run072
11406;RBB;BBB;0;1;1;0;1;run072
11407;RBB;GGG;0;3;3;0;3;run072
11408;RBG;GRR;0;1;1;0;1;run072
11409;RBG;RBR;0;1;1;1;0;run072
11410;RBG;RGR;0;1;1;1;0;run072
11411;RBR;BBB;0;3;3;1;2;run072
11412;RBR;BRB;0;1;1;0;1;run072
11413;RBR;BRR;0;2;2;0;2;run072
11414;RBR;GGG;0;1;1;0;1;run072
11415;RBR;GGR;1;2;3;2;1;run072
11416;RBR;GRG;0;1;1;1;0;run072
11417;RBR;GRR;1;15;16;15;1;run072
11418;RBR;RGG;0;4;4;0;4;run072
11419;RBR;RGR;0;1;1;0;1;run072
11420;RBR;RRR;0;3;3;0;3;run072
11421;RGG;BGG;0;1;1;0;1;run072
11422;RGG;RGR;0;1;1;1;0;run072
11423;RGR;BBB;0;9;9;2;7;run072
11424;RGR;BBR;0;1;1;1;0;run072
11425;RGR;BGB;1;8;9;6;3;run072
11426;RGR;BRB;0;3;3;0;3;run072
11427;RGR;BRR;0;3;3;3;0;run072
11428;RGR;GBG;0;1;1;1;0;run072
11429;RGR;GGB;0;3;3;0;3;run072
11430;RGR;GGG;0;2;2;1;1;run072
11431;RGR;GGR;0;8;8;7;1;run072
11432;RGR;GRR;1;7;8;6;2;run072
11433;RGR;RGG;0;6;6;1;5;run072
11434;RRG;BGB;0;1;1;1;0;run072
11435;RRG;BRB;0;1;1;1;0;run072
11436;RRG;GGG;0;1;1;0;1;run072
11437;RRG;GGR;0;1;1;1;0;run072
11438;RRG;GRG;0;1;1;0;1;run072
11439;RRG;GRR;0;3;3;1;2;run072
11440;RRG;RBR;0;4;4;2;2;run072
11441;RRG;RGG;0;1;1;0;1;run072
11442;RRG;RGR;6;37;43;10;33;run072
11443;RRR;BRR;0;1;1;1;0;run072
11444;RRR;GGB;0;1;1;0;1;run072
11445;RRR;GGG;1;5;6;3;3;run072
11446;RRR;GGR;0;2;2;2;0;run072
11447;RRR;GRR;0;1;1;1;0;run072
11448;RRR;RGR;0;1;1;1;0;run072
11449;BBB;GRR;0;1;1;0;1;run073
11450;BBG;BBB;1;9;10;6;4;run073
11451;BBG;BBR;0;2;2;0;2;run073
11452;BBG;BGB;0;1;1;0;1;run073
11453;BBG;BGG;0;1;1;0;1;run073
11454;BBG;BRB;0;2;2;2;0;run073
11455;BBG;BRR;0;1;1;0;1;run073
11456;BBG;GBB;1;1;2;2;0;run073
11457;BBG;GBG;1;6;7;6;1;run073
11458;BBG;GGB;0;18;18;16;2;run073
11459;BBG;GGG;1;29;30;21;9;run073
11460;BBG;GGR;0;2;2;2;0;run073
11461;BBG;GRG;0;1;1;0;1;run073
11462;BBG;GRR;0;3;3;3;0;run073
11463;BBG;RBR;0;2;2;0;2;run073
11464;BBG;RGR;0;2;2;0;2;run073
11465;BBG;RRG;1;2;3;2;1;run073
11466;BBG;RRR;0;1;1;0;1;run073
11467;BGG;BBB;0;1;1;0;1;run073
11468;BGG;BRB;0;1;1;1;0;run073
11469;BGG;GGG;0;1;1;0;1;run073
11470;BGG;RBB;0;1;1;0;1;run073
11471;BGG;RBG;1;0;1;1;0;run073
11472;BRB;BBB;0;1;1;1;0;run073
11473;BRB;GGB;1;0;1;0;1;run073
11474;BRB;GGG;0;2;2;1;1;run073
11475;BRB;RBB;1;0;1;0;1;run073
11476;BRR;BBB;0;1;1;0;1;run073
11477;BRR;BRB;0;1;1;0;1;run073
11478;BRR;GBB;1;0;1;0;1;run073
11479;GBB;BBB;1;16;17;11;6;run073
11480;GBB;BBG;0;2;2;1;1;run073
11481;GBB;BGB;0;1;1;0;1;run073
11482;GBB;BGG;0;3;3;2;1;run073
11483;GBB;BRB;0;9;9;8;1;run073
11484;GBB;BRR;0;2;2;0;2;run073
11485;GBB;GBG;1;1;2;1;1;run073
11486;GBB;GGB;2;59;61;28;33;run073
11487;GBB;GGG;4;95;99;52;47;run073
11488;GBB;GGR;0;1;1;0;1;run073
11489;GBB;GRG;0;1;1;0;1;run073
11490;GBB;GRR;1;8;9;4;5;run073
11491;GBB;RBB;0;2;2;2;0;run073
11492;GBB;RBG;0;1;1;0;1;run073
11493;GBB;RBR;1;1;2;1;1;run073
11494;GBB;RGG;0;2;2;0;2;run073
11495;GBB;RGR;0;1;1;0;1;run073
11496;GBB;RRG;0;3;3;2;1;run073
11497;GBG;BRB;0;1;1;1;0;run073
11498;GBG;BRR;0;3;3;3;0;run073
11499;GBG;GGB;0;1;1;0;1;run073
11500;GBG;GGR;0;3;3;0;3;run073
11501;GBG;RBR;0;1;1;0;1;run073
11502;GBG;RGR;1;1;2;2;0;run073
11503;GBG;RRR;0;1;1;0;1;run073
11504;GGB;BBB;1;8;9;7;2;run073
11505;GGB;BBG;0;1;1;1;0;run073
11506;GGB;BGB;0;1;1;0;1;run073
11507;GGB;BRB;3;5;8;6;2;run073
11508;GGB;BRR;0;1;1;0;1;run073
11509;GGB;GBG;0;2;2;1;1;run073
11510;GGB;GGG;4;37;41;27;14;run073
11511;GGB;GGR;0;9;9;2;7;run073
11512;GGB;GRR;1;4;5;1;4;run073
11513;GGB;RBB;0;2;2;1;1;run073
11514;GGB;RBG;0;2;2;1;1;run073
11515;GGB;RBR;0;2;2;1;1;run073
11516;GGB;RGG;0;1;1;0;1;run073
11517;GGB;RGR;1;2;3;3;0;run073
11518;GGB;RRG;1;3;4;2;2;run073
11519;GGB;RRR;0;3;3;3;0;run073
11520;GGG;BBB;4;22;26;15;11;run073
11521;GGG;BBG;0;2;2;0;2;run073
11522;GGG;BBR;0;3;3;3;0;run073
11523;GGG;BGB;0;2;2;0;2;run073
11524;GGG;BGG;0;3;3;1;2;run073
11525;GGG;BRB;0;3;3;0;3;run073
11526;GGG;BRR;0;3;3;1;2;run073
11527;GGG;GBB;0;1;1;1;0;run073
11528;GGG;GGB;1;3;4;4;0;run073
11529;GGG;GGR;0;21;21;8;13;run073
11530;GGG;GRG;0;2;2;2;0;run073
11531;GGG;GRR;2;15;17;7;10;run073
11532;GGG;RBB;0;1;1;0;1;run073
11533;GGG;RBR;1;4;5;2;3;run073
11534;GGG;RGG;1;7;8;3;5;run073
11535;GGG;RGR;0;3;3;0;3;run073
11536;GGG;RRG;0;2;2;2;0;run073
11537;GGG;RRR;0;1;1;1;0;run073
11538;GGR;BBB;0;1;1;0;1;run073
11539;GGR;BGG;0;2;2;0;2;run073
11540;GGR;BRB;0;1;1;0;1;run073
11541;GRG;BBB;0;3;3;3;0;run073
11542;GRG;BGB;0;3;3;2;1;run073
11543;GRG;BGG;0;1;1;1;0;run073
11544;GRG;BRB;0;5;5;2;3;run073
11545;GRG;BRR;0;1;1;1;0;run073
11546;GRG;GBB;0;3;3;0;3;run073
11547;GRG;GGB;0;14;14;13;1;run073
11548;GRG;GGG;0;10;10;2;8;run073
11549;GRG;GGR;0;2;2;1;1;run073
11550;GRG;GRR;0;1;1;1;0;run073
11551;GRG;RBR;1;2;3;2;1;run073
11552;GRG;RGG;0;2;2;2;0;run073
11553;GRG;RGR;0;1;1;0;1;run073
11554;GRR;BBB;0;3;3;0;3;run073
11555;GRR;BBR;0;2;2;0;2;run073
11556;GRR;BRB;1;8;9;8;1;run073
11557;GRR;BRR;1;6;7;0;7;run073
11558;GRR;GBB;0;1;1;0;1;run073
11559;GRR;GBG;0;1;1;1;0;run073
11560;GRR;GGR;1;9;10;3;7;run073
11561;GRR;RBR;0;1;1;1;0;run073
11562;GRR;RGG;1;3;4;1;3;run073
11563;GRR;RGR;0;1;1;1;0;run073
11564;GRR;RRR;0;1;1;0;1;run073
11565;RBB;BBB;0;1;1;0;1;run073
11566;RBB;GGG;0;3;3;2;1;run073
11567;RBG;GRR;0;1;1;0;1;run073
11568;RBG;RBR;0;1;1;1;0;run073
11569;RBG;RGR;0;1;1;0;1;run073
11570;RBR;BBB;0;3;3;0;3;run073
11571;RBR;BRB;0;1;1;0;1;run073
11572;RBR;BRR;0;2;2;2;0;run073
11573;RBR;GGG;0;1;1;0;1;run073
11574;RBR;GGR;1;2;3;0;3;run073
11575;RBR;GRG;0;1;1;1;0;run073
11576;RBR;GRR;1;15;16;13;3;run073
11577;RBR;RGG;0;4;4;3;1;run073
11578;RBR;RGR;0;1;1;0;1;run073
11579;RBR;RRR;0;3;3;0;3;run073
11580;RGG;BGG;0;1;1;1;0;run073
11581;RGG;RGR;0;1;1;1;0;run073
11582;RGR;BBB;0;9;9;0;9;run073
11583;RGR;BBR;0;1;1;0;1;run073
11584;RGR;BGB;1;8;9;8;1;run073
11585;RGR;BRB;0;3;3;2;1;run073
11586;RGR;BRR;0;3;3;2;1;run073
11587;RGR;GBG;0;1;1;0;1;run073
11588;RGR;GGB;0;3;3;3;0;run073
11589;RGR;GGG;0;2;2;2;0;run073
11590;RGR;GGR;0;8;8;2;6;run073
11591;RGR;GRR;1;7;8;6;2;run073
11592;RGR;RGG;0;6;6;5;1;run073
11593;RRG;BGB;0;1;1;1;0;run073
11594;RRG;BRB;0;1;1;1;0;run073
11595;RRG;GGG;0;1;1;0;1;run073
11596;RRG;GGR;0;1;1;1;0;run073
11597;RRG;GRG;0;1;1;0;1;run073
11598;RRG;GRR;0;3;3;1;2;run073
11599;RRG;RBR;0;4;4;2;2;run073
11600;RRG;RGG;0;1;1;0;1;run073
11601;RRG;RGR;6;37;43;41;2;run073
11602;RRR;BRR;0;1;1;0;1;run073
11603;RRR;GGB;0;1;1;0;1;run073
11604;RRR;GGG;1;5;6;4;2;run073
11605;RRR;GGR;0;2;2;2;0;run073
11606;RRR;GRR;0;1;1;1;0;run073
11607;RRR;RGR;0;1;1;1;0;run073
11608;BBB;GRR;0;1;1;1;0;run074
11609;BBG;BBB;1;9;10;1;9;run074
11610;BBG;BBR;0;2;2;2;0;run074
11611;BBG;BGB;0;1;1;1;0;run074
11612;BBG;BGG;0;1;1;1;0;run074
11613;BBG;BRB;0;2;2;2;0;run074
11614;BBG;BRR;0;1;1;0;1;run074
11615;BBG;GBB;1;1;2;1;1;run074
11616;BBG;GBG;1;6;7;6;1;run074
11617;BBG;GGB;0;18;18;13;5;run074
11618;BBG;GGG;1;29;30;6;24;run074
11619;BBG;GGR;0;2;2;2;0;run074
11620;BBG;GRG;0;1;1;1;0;run074
11621;BBG;GRR;0;3;3;2;1;run074
11622;BBG;RBR;0;2;2;1;1;run074
11623;BBG;RGR;0;2;2;1;1;run074
11624;BBG;RRG;1;2;3;0;3;run074
11625;BBG;RRR;0;1;1;1;0;run074
11626;BGG;BBB;0;1;1;0;1;run074
11627;BGG;BRB;0;1;1;1;0;run074
11628;BGG;GGG;0;1;1;0;1;run074
11629;BGG;RBB;0;1;1;1;0;run074
11630;BGG;RBG;1;0;1;0;1;run074
11631;BRB;BBB;0;1;1;0;1;run074
11632;BRB;GGB;1;0;1;1;0;run074
11633;BRB;GGG;0;2;2;1;1;run074
11634;BRB;RBB;1;0;1;1;0;run074
11635;BRR;BBB;0;1;1;1;0;run074
11636;BRR;BRB;0;1;1;1;0;run074
11637;BRR;GBB;1;0;1;0;1;run074
11638;GBB;BBB;1;16;17;4;13;run074
11639;GBB;BBG;0;2;2;1;1;run074
11640;GBB;BGB;0;1;1;0;1;run074
11641;GBB;BGG;0;3;3;2;1;run074
11642;GBB;BRB;0;9;9;3;6;run074
11643;GBB;BRR;0;2;2;2;0;run074
11644;GBB;GBG;1;1;2;2;0;run074
11645;GBB;GGB;2;59;61;58;3;run074
11646;GBB;GGG;4;95;99;26;73;run074
11647;GBB;GGR;0;1;1;1;0;run074
11648;GBB;GRG;0;1;1;0;1;run074
11649;GBB;GRR;1;8;9;0;9;run074
11650;GBB;RBB;0;2;2;0;2;run074
11651;GBB;RBG;0;1;1;0;1;run074
11652;GBB;RBR;1;1;2;0;2;run074
11653;GBB;RGG;0;2;2;0;2;run074
11654;GBB;RGR;0;1;1;1;0;run074
11655;GBB;RRG;0;3;3;3;0;run074
11656;GBG;BRB;0;1;1;0;1;run074
11657;GBG;BRR;0;3;3;2;1;run074
11658;GBG;GGB;0;1;1;0;1;run074
11659;GBG;GGR;0;3;3;0;3;run074
11660;GBG;RBR;0;1;1;0;1;run074
11661;GBG;RGR;1;1;2;0;2;run074
11662;GBG;RRR;0;1;1;1;0;run074
11663;GGB;BBB;1;8;9;9;0;run074
11664;GGB;BBG;0;1;1;1;0;run074
11665;GGB;BGB;0;1;1;1;0;run074
11666;GGB;BRB;3;5;8;6;2;run074
11667;GGB;BRR;0;1;1;1;0;run074
11668;GGB;GBG;0;2;2;1;1;run074
11669;GGB;GGG;4;37;41;27;14;run074
11670;GGB;GGR;0;9;9;1;8;run074
11671;GGB;GRR;1;4;5;3;2;run074
11672;GGB;RBB;0;2;2;0;2;run074
11673;GGB;RBG;0;2;2;1;1;run074
11674;GGB;RBR;0;2;2;1;1;run074
11675;GGB;RGG;0;1;1;0;1;run074
11676;GGB;RGR;1;2;3;3;0;run074
11677;GGB;RRG;1;3;4;0;4;run074
11678;GGB;RRR;0;3;3;0;3;run074
11679;GGG;BBB;4;22;26;22;4;run074
11680;GGG;BBG;0;2;2;2;0;run074
11681;GGG;BBR;0;3;3;2;1;run074
11682;GGG;BGB;0;2;2;1;1;run074
11683;GGG;BGG;0;3;3;3;0;run074
11684;GGG;BRB;0;3;3;0;3;run074
11685;GGG;BRR;0;3;3;2;1;run074
11686;GGG;GBB;0;1;1;0;1;run074
11687;GGG;GGB;1;3;4;2;2;run074
11688;GGG;GGR;0;21;21;12;9;run074
11689;GGG;GRG;0;2;2;0;2;run074
11690;GGG;GRR;2;15;17;13;4;run074
11691;GGG;RBB;0;1;1;1;0;run074
11692;GGG;RBR;1;4;5;3;2;run074
11693;GGG;RGG;1;7;8;1;7;run074
11694;GGG;RGR;0;3;3;0;3;run074
11695;GGG;RRG;0;2;2;0;2;run074
11696;GGG;RRR;0;1;1;0;1;run074
11697;GGR;BBB;0;1;1;1;0;run074
11698;GGR;BGG;0;2;2;2;0;run074
11699;GGR;BRB;0;1;1;0;1;run074
11700;GRG;BBB;0;3;3;3;0;run074
11701;GRG;BGB;0;3;3;1;2;run074
11702;GRG;BGG;0;1;1;1;0;run074
11703;GRG;BRB;0;5;5;2;3;run074
11704;GRG;BRR;0;1;1;0;1;run074
11705;GRG;GBB;0;3;3;2;1;run074
11706;GRG;GGB;0;14;14;1;13;run074
11707;GRG;GGG;0;10;10;7;3;run074
11708;GRG;GGR;0;2;2;0;2;run074
11709;GRG;GRR;0;1;1;1;0;run074
11710;GRG;RBR;1;2;3;0;3;run074
11711;GRG;RGG;0;2;2;1;1;run074
11712;GRG;RGR;0;1;1;0;1;run074
11713;GRR;BBB;0;3;3;2;1;run074
11714;GRR;BBR;0;2;2;0;2;run074
11715;GRR;BRB;1;8;9;6;3;run074
11716;GRR;BRR;1;6;7;7;0;run074
11717;GRR;GBB;0;1;1;0;1;run074
11718;GRR;GBG;0;1;1;0;1;run074
11719;GRR;GGR;1;9;10;4;6;run074
11720;GRR;RBR;0;1;1;0;1;run074
11721;GRR;RGG;1;3;4;3;1;run074
11722;GRR;RGR;0;1;1;1;0;run074
11723;GRR;RRR;0;1;1;1;0;run074
11724;RBB;BBB;0;1;1;0;1;run074
11725;RBB;GGG;0;3;3;2;1;run074
11726;RBG;GRR;0;1;1;0;1;run074
11727;RBG;RBR;0;1;1;0;1;run074
11728;RBG;RGR;0;1;1;1;0;run074
11729;RBR;BBB;0;3;3;1;2;run074
11730;RBR;BRB;0;1;1;1;0;run074
11731;RBR;BRR;0;2;2;0;2;run074
11732;RBR;GGG;0;1;1;0;1;run074
11733;RBR;GGR;1;2;3;3;0;run074
11734;RBR;GRG;0;1;1;0;1;run074
11735;RBR;GRR;1;15;16;13;3;run074
11736;RBR;RGG;0;4;4;1;3;run074
11737;RBR;RGR;0;1;1;1;0;run074
11738;RBR;RRR;0;3;3;2;1;run074
11739;RGG;BGG;0;1;1;0;1;run074
11740;RGG;RGR;0;1;1;0;1;run074
11741;RGR;BBB;0;9;9;7;2;run074
11742;RGR;BBR;0;1;1;0;1;run074
11743;RGR;BGB;1;8;9;3;6;run074
11744;RGR;BRB;0;3;3;2;1;run074
11745;RGR;BRR;0;3;3;3;0;run074
11746;RGR;GBG;0;1;1;0;1;run074
11747;RGR;GGB;0;3;3;0;3;run074
11748;RGR;GGG;0;2;2;1;1;run074
11749;RGR;GGR;0;8;8;0;8;run074
11750;RGR;GRR;1;7;8;8;0;run074
11751;RGR;RGG;0;6;6;0;6;run074
11752;RRG;BGB;0;1;1;0;1;run074
11753;RRG;BRB;0;1;1;0;1;run074
11754;RRG;GGG;0;1;1;0;1;run074
11755;RRG;GGR;0;1;1;1;0;run074
11756;RRG;GRG;0;1;1;0;1;run074
11757;RRG;GRR;0;3;3;0;3;run074
11758;RRG;RBR;0;4;4;1;3;run074
11759;RRG;RGG;0;1;1;1;0;run074
11760;RRG;RGR;6;37;43;17;26;run074
11761;RRR;BRR;0;1;1;0;1;run074
11762;RRR;GGB;0;1;1;1;0;run074
11763;RRR;GGG;1;5;6;2;4;run074
11764;RRR;GGR;0;2;2;1;1;run074
11765;RRR;GRR;0;1;1;0;1;run074
11766;RRR;RGR;0;1;1;1;0;run074
11767;BBB;GRR;0;1;1;1;0;run075
11768;BBG;BBB;1;9;10;7;3;run075
11769;BBG;BBR;0;2;2;0;2;run075
11770;BBG;BGB;0;1;1;0;1;run075
11771;BBG;BGG;0;1;1;0;1;run075
11772;BBG;BRB;0;2;2;2;0;run075
11773;BBG;BRR;0;1;1;0;1;run075
11774;BBG;GBB;1;1;2;1;1;run075
11775;BBG;GBG;1;6;7;0;7;run075
11776;BBG;GGB;0;18;18;15;3;run075
11777;BBG;GGG;1;29;30;23;7;run075
11778;BBG;GGR;0;2;2;0;2;run075
11779;BBG;GRG;0;1;1;0;1;run075
11780;BBG;GRR;0;3;3;2;1;run075
11781;BBG;RBR;0;2;2;2;0;run075
11782;BBG;RGR;0;2;2;2;0;run075
11783;BBG;RRG;1;2;3;2;1;run075
11784;BBG;RRR;0;1;1;1;0;run075
11785;BGG;BBB;0;1;1;1;0;run075
11786;BGG;BRB;0;1;1;1;0;run075
11787;BGG;GGG;0;1;1;1;0;run075
11788;BGG;RBB;0;1;1;1;0;run075
11789;BGG;RBG;1;0;1;1;0;run075
11790;BRB;BBB;0;1;1;1;0;run075
11791;BRB;GGB;1;0;1;1;0;run075
11792;BRB;GGG;0;2;2;0;2;run075
11793;BRB;RBB;1;0;1;0;1;run075
11794;BRR;BBB;0;1;1;0;1;run075
11795;BRR;BRB;0;1;1;1;0;run075
11796;BRR;GBB;1;0;1;0;1;run075
11797;GBB;BBB;1;16;17;11;6;run075
11798;GBB;BBG;0;2;2;2;0;run075
11799;GBB;BGB;0;1;1;0;1;run075
11800;GBB;BGG;0;3;3;1;2;run075
11801;GBB;BRB;0;9;9;1;8;run075
11802;GBB;BRR;0;2;2;0;2;run075
11803;GBB;GBG;1;1;2;2;0;run075
11804;GBB;GGB;2;59;61;19;42;run075
11805;GBB;GGG;4;95;99;47;52;run075
11806;GBB;GGR;0;1;1;0;1;run075
11807;GBB;GRG;0;1;1;1;0;run075
11808;GBB;GRR;1;8;9;4;5;run075
11809;GBB;RBB;0;2;2;1;1;run075
11810;GBB;RBG;0;1;1;0;1;run075
11811;GBB;RBR;1;1;2;1;1;run075
11812;GBB;RGG;0;2;2;0;2;run075
11813;GBB;RGR;0;1;1;1;0;run075
11814;GBB;RRG;0;3;3;0;3;run075
11815;GBG;BRB;0;1;1;0;1;run075
11816;GBG;BRR;0;3;3;1;2;run075
11817;GBG;GGB;0;1;1;1;0;run075
11818;GBG;GGR;0;3;3;3;0;run075
11819;GBG;RBR;0;1;1;1;0;run075
11820;GBG;RGR;1;1;2;1;1;run075
11821;GBG;RRR;0;1;1;1;0;run075
11822;GGB;BBB;1;8;9;5;4;run075
11823;GGB;BBG;0;1;1;0;1;run075
11824;GGB;BGB;0;1;1;0;1;run075
11825;GGB;BRB;3;5;8;7;1;run075
11826;GGB;BRR;0;1;1;1;0;run075
11827;GGB;GBG;0;2;2;0;2;run075
11828;GGB;GGG;4;37;41;31;10;run075
11829;GGB;GGR;0;9;9;1;8;run075
11830;GGB;GRR;1;4;5;5;0;run075
11831;GGB;RBB;0;2;2;0;2;run075
11832;GGB;RBG;0;2;2;2;0;run075
11833;GGB;RBR;0;2;2;1;1;run075
11834;GGB;RGG;0;1;1;1;0;run075
11835;GGB;RGR;1;2;3;1;2;run075
11836;GGB;RRG;1;3;4;3;1;run075
11837;GGB;RRR;0;3;3;3;0;run075
11838;GGG;BBB;4;22;26;18;8;run075
11839;GGG;BBG;0;2;2;2;0;run075
11840;GGG;BBR;0;3;3;1;2;run075
11841;GGG;BGB;0;2;2;0;2;run075
11842;GGG;BGG;0;3;3;0;3;run075
11843;GGG;BRB;0;3;3;0;3;run075
11844;GGG;BRR;0;3;3;1;2;run075
11845;GGG;GBB;0;1;1;1;0;run075
11846;GGG;GGB;1;3;4;4;0;run075
11847;GGG;GGR;0;21;21;15;6;run075
11848;GGG;GRG;0;2;2;2;0;run075
11849;GGG;GRR;2;15;17;13;4;run075
11850;GGG;RBB;0;1;1;1;0;run075
11851;GGG;RBR;1;4;5;1;4;run075
11852;GGG;RGG;1;7;8;1;7;run075
11853;GGG;RGR;0;3;3;0;3;run075
11854;GGG;RRG;0;2;2;1;1;run075
11855;GGG;RRR;0;1;1;1;0;run075
11856;GGR;BBB;0;1;1;0;1;run075
11857;GGR;BGG;0;2;2;0;2;run075
11858;GGR;BRB;0;1;1;0;1;run075
11859;GRG;BBB;0;3;3;1;2;run075
11860;GRG;BGB;0;3;3;2;1;run075
11861;GRG;BGG;0;1;1;1;0;run075
11862;GRG;BRB;0;5;5;5;0;run075
11863;GRG;BRR;0;1;1;0;1;run075
11864;GRG;GBB;0;3;3;3;0;run075
11865;GRG;GGB;0;14;14;12;2;run075
11866;GRG;GGG;0;10;10;0;10;run075
11867;GRG;GGR;0;2;2;0;2;run075
11868;GRG;GRR;0;1;1;0;1;run075
11869;GRG;RBR;1;2;3;2;1;run075
11870;GRG;RGG;0;2;2;0;2;run075
11871;GRG;RGR;0;1;1;0;1;run075
11872;GRR;BBB;0;3;3;0;3;run075
11873;GRR;BBR;0;2;2;0;2;run075
11874;GRR;BRB;1;8;9;0;9;run075
11875;GRR;BRR;1;6;7;3;4;run075
11876;GRR;GBB;0;1;1;1;0;run075
11877;GRR;GBG;0;1;1;1;0;run075
11878;GRR;GGR;1;9;10;0;10;run075
11879;GRR;RBR;0;1;1;0;1;run075
11880;GRR;RGG;1;3;4;2;2;run075
11881;GRR;RGR;0;1;1;1;0;run075
11882;GRR;RRR;0;1;1;0;1;run075
11883;RBB;BBB;0;1;1;1;0;run075
11884;RBB;GGG;0;3;3;3;0;run075
11885;RBG;GRR;0;1;1;0;1;run075
11886;RBG;RBR;0;1;1;1;0;run075
11887;RBG;RGR;0;1;1;0;1;run075
11888;RBR;BBB;0;3;3;1;2;run075
11889;RBR;BRB;0;1;1;1;0;run075
11890;RBR;BRR;0;2;2;2;0;run075
11891;RBR;GGG;0;1;1;1;0;run075
11892;RBR;GGR;1;2;3;3;0;run075
11893;RBR;GRG;0;1;1;0;1;run075
11894;RBR;GRR;1;15;16;13;3;run075
11895;RBR;RGG;0;4;4;3;1;run075
11896;RBR;RGR;0;1;1;0;1;run075
11897;RBR;RRR;0;3;3;0;3;run075
11898;RGG;BGG;0;1;1;0;1;run075
11899;RGG;RGR;0;1;1;0;1;run075
11900;RGR;BBB;0;9;9;5;4;run075
11901;RGR;BBR;0;1;1;1;0;run075
11902;RGR;BGB;1;8;9;5;4;run075
11903;RGR;BRB;0;3;3;0;3;run075
11904;RGR;BRR;0;3;3;3;0;run075
11905;RGR;GBG;0;1;1;1;0;run075
11906;RGR;GGB;0;3;3;3;0;run075
11907;RGR;GGG;0;2;2;2;0;run075
11908;RGR;GGR;0;8;8;2;6;run075
11909;RGR;GRR;1;7;8;8;0;run075
11910;RGR;RGG;0;6;6;0;6;run075
11911;RRG;BGB;0;1;1;0;1;run075
11912;RRG;BRB;0;1;1;0;1;run075
11913;RRG;GGG;0;1;1;0;1;run075
11914;RRG;GGR;0;1;1;0;1;run075
11915;RRG;GRG;0;1;1;1;0;run075
11916;RRG;GRR;0;3;3;2;1;run075
11917;RRG;RBR;0;4;4;1;3;run075
11918;RRG;RGG;0;1;1;0;1;run075
11919;RRG;RGR;6;37;43;16;27;run075
11920;RRR;BRR;0;1;1;0;1;run075
11921;RRR;GGB;0;1;1;1;0;run075
11922;RRR;GGG;1;5;6;4;2;run075
11923;RRR;GGR;0;2;2;2;0;run075
11924;RRR;GRR;0;1;1;1;0;run075
11925;RRR;RGR;0;1;1;0;1;run075
11926;BBB;GRR;0;1;1;0;1;run076
11927;BBG;BBB;1;9;10;0;10;run076
11928;BBG;BBR;0;2;2;0;2;run076
11929;BBG;BGB;0;1;1;1;0;run076
11930;BBG;BGG;0;1;1;1;0;run076
11931;BBG;BRB;0;2;2;1;1;run076
11932;BBG;BRR;0;1;1;1;0;run076
11933;BBG;GBB;1;1;2;2;0;run076
11934;BBG;GBG;1;6;7;6;1;run076
11935;BBG;GGB;0;18;18;11;7;run076
11936;BBG;GGG;1;29;30;20;10;run076
11937;BBG;GGR;0;2;2;1;1;run076
11938;BBG;GRG;0;1;1;1;0;run076
11939;BBG;GRR;0;3;3;3;0;run076
11940;BBG;RBR;0;2;2;1;1;run076
11941;BBG;RGR;0;2;2;1;1;run076
11942;BBG;RRG;1;2;3;0;3;run076
11943;BBG;RRR;0;1;1;1;0;run076
11944;BGG;BBB;0;1;1;1;0;run076
11945;BGG;BRB;0;1;1;1;0;run076
11946;BGG;GGG;0;1;1;0;1;run076
11947;BGG;RBB;0;1;1;0;1;run076
11948;BGG;RBG;1;0;1;1;0;run076
11949;BRB;BBB;0;1;1;0;1;run076
11950;BRB;GGB;1;0;1;0;1;run076
11951;BRB;GGG;0;2;2;0;2;run076
11952;BRB;RBB;1;0;1;0;1;run076
11953;BRR;BBB;0;1;1;1;0;run076
11954;BRR;BRB;0;1;1;1;0;run076
11955;BRR;GBB;1;0;1;1;0;run076
11956;GBB;BBB;1;16;17;16;1;run076
11957;GBB;BBG;0;2;2;2;0;run076
11958;GBB;BGB;0;1;1;1;0;run076
11959;GBB;BGG;0;3;3;1;2;run076
11960;GBB;BRB;0;9;9;6;3;run076
11961;GBB;BRR;0;2;2;2;0;run076
11962;GBB;GBG;1;1;2;2;0;run076
11963;GBB;GGB;2;59;61;0;61;run076
11964;GBB;GGG;4;95;99;69;30;run076
11965;GBB;GGR;0;1;1;1;0;run076
11966;GBB;GRG;0;1;1;1;0;run076
11967;GBB;GRR;1;8;9;0;9;run076
11968;GBB;RBB;0;2;2;0;2;run076
11969;GBB;RBG;0;1;1;1;0;run076
11970;GBB;RBR;1;1;2;2;0;run076
11971;GBB;RGG;0;2;2;2;0;run076
11972;GBB;RGR;0;1;1;1;0;run076
11973;GBB;RRG;0;3;3;1;2;run076
11974;GBG;BRB;0;1;1;1;0;run076
11975;GBG;BRR;0;3;3;0;3;run076
11976;GBG;GGB;0;1;1;1;0;run076
11977;GBG;GGR;0;3;3;3;0;run076
11978;GBG;RBR;0;1;1;0;1;run076
11979;GBG;RGR;1;1;2;1;1;run076
11980;GBG;RRR;0;1;1;1;0;run076
11981;GGB;BBB;1;8;9;7;2;run076
11982;GGB;BBG;0;1;1;0;1;run076
11983;GGB;BGB;0;1;1;1;0;run076
11984;GGB;BRB;3;5;8;4;4;run076
11985;GGB;BRR;0;1;1;0;1;run076
11986;GGB;GBG;0;2;2;1;1;run076
11987;GGB;GGG;4;37;41;26;15;run076
11988;GGB;GGR;0;9;9;2;7;run076
11989;GGB;GRR;1;4;5;0;5;run076
11990;GGB;RBB;0;2;2;0;2;run076
11991;GGB;RBG;0;2;2;1;1;run076
11992;GGB;RBR;0;2;2;0;2;run076
11993;GGB;RGG;0;1;1;1;0;run076
11994;GGB;RGR;1;2;3;0;3;run076
11995;GGB;RRG;1;3;4;0;4;run076
11996;GGB;RRR;0;3;3;2;1;run076
11997;GGG;BBB;4;22;26;12;14;run076
11998;GGG;BBG;0;2;2;1;1;run076
11999;GGG;BBR;0;3;3;1;2;run076
12000;GGG;BGB;0;2;2;2;0;run076
12001;GGG;BGG;0;3;3;0;3;run076
12002;GGG;BRB;0;3;3;2;1;run076
12003;GGG;BRR;0;3;3;2;1;run076
12004;GGG;GBB;0;1;1;0;1;run076
12005;GGG;GGB;1;3;4;0;4;run076
12006;GGG;GGR;0;21;21;11;10;run076
12007;GGG;GRG;0;2;2;0;2;run076
12008;GGG;GRR;2;15;17;2;15;run076
12009;GGG;RBB;0;1;1;1;0;run076
12010;GGG;RBR;1;4;5;2;3;run076
12011;GGG;RGG;1;7;8;6;2;run076
12012;GGG;RGR;0;3;3;3;0;run076
12013;GGG;RRG;0;2;2;2;0;run076
12014;GGG;RRR;0;1;1;0;1;run076
12015;GGR;BBB;0;1;1;0;1;run076
12016;GGR;BGG;0;2;2;1;1;run076
12017;GGR;BRB;0;1;1;1;0;run076
12018;GRG;BBB;0;3;3;0;3;run076
12019;GRG;BGB;0;3;3;0;3;run076
12020;GRG;BGG;0;1;1;1;0;run076
12021;GRG;BRB;0;5;5;3;2;run076
12022;GRG;BRR;0;1;1;1;0;run076
12023;GRG;GBB;0;3;3;2;1;run076
12024;GRG;GGB;0;14;14;3;11;run076
12025;GRG;GGG;0;10;10;2;8;run076
12026;GRG;GGR;0;2;2;0;2;run076
12027;GRG;GRR;0;1;1;0;1;run076
12028;GRG;RBR;1;2;3;2;1;run076
12029;GRG;RGG;0;2;2;1;1;run076
12030;GRG;RGR;0;1;1;0;1;run076
12031;GRR;BBB;0;3;3;3;0;run076
12032;GRR;BBR;0;2;2;0;2;run076
12033;GRR;BRB;1;8;9;9;0;run076
12034;GRR;BRR;1;6;7;2;5;run076
12035;GRR;GBB;0;1;1;1;0;run076
12036;GRR;GBG;0;1;1;1;0;run076
12037;GRR;GGR;1;9;10;6;4;run076
12038;GRR;RBR;0;1;1;1;0;run076
12039;GRR;RGG;1;3;4;2;2;run076
12040;GRR;RGR;0;1;1;0;1;run076
12041;GRR;RRR;0;1;1;1;0;run076
12042;RBB;BBB;0;1;1;0;1;run076
12043;RBB;GGG;0;3;3;3;0;run076
12044;RBG;GRR;0;1;1;0;1;run076
12045;RBG;RBR;0;1;1;1;0;run076
12046;RBG;RGR;0;1;1;0;1;run076
12047;RBR;BBB;0;3;3;1;2;run076
12048;RBR;BRB;0;1;1;0;1;run076
12049;RBR;BRR;0;2;2;2;0;run076
12050;RBR;GGG;0;1;1;0;1;run076
12051;RBR;GGR;1;2;3;2;1;run076
12052;RBR;GRG;0;1;1;0;1;run076
12053;RBR;GRR;1;15;16;15;1;run076
12054;RBR;RGG;0;4;4;0;4;run076
12055;RBR;RGR;0;1;1;1;0;run076
12056;RBR;RRR;0;3;3;1;2;run076
12057;RGG;BGG;0;1;1;0;1;run076
12058;RGG;RGR;0;1;1;1;0;run076
12059;RGR;BBB;0;9;9;4;5;run076
12060;RGR;BBR;0;1;1;1;0;run076
12061;RGR;BGB;1;8;9;2;7;run076
12062;RGR;BRB;0;3;3;0;3;run076
12063;RGR;BRR;0;3;3;3;0;run076
12064;RGR;GBG;0;1;1;1;0;run076
12065;RGR;GGB;0;3;3;0;3;run076
12066;RGR;GGG;0;2;2;0;2;run076
12067;RGR;GGR;0;8;8;0;8;run076
12068;RGR;GRR;1;7;8;6;2;run076
12069;RGR;RGG;0;6;6;0;6;run076
12070;RRG;BGB;0;1;1;1;0;run076
12071;RRG;BRB;0;1;1;1;0;run076
12072;RRG;GGG;0;1;1;0;1;run076
12073;RRG;GGR;0;1;1;0;1;run076
12074;RRG;GRG;0;1;1;0;1;run076
12075;RRG;GRR;0;3;3;3;0;run076
12076;RRG;RBR;0;4;4;4;0;run076
12077;RRG;RGG;0;1;1;1;0;run076
12078;RRG;RGR;6;37;43;8;35;run076
12079;RRR;BRR;0;1;1;1;0;run076
12080;RRR;GGB;0;1;1;0;1;run076
12081;RRR;GGG;1;5;6;1;5;run076
12082;RRR;GGR;0;2;2;0;2;run076
12083;RRR;GRR;0;1;1;1;0;run076
12084;RRR;RGR;0;1;1;1;0;run076
12085;BBB;GRR;0;1;1;1;0;run077
12086;BBG;BBB;1;9;10;4;6;run077
12087;BBG;BBR;0;2;2;0;2;run077
12088;BBG;BGB;0;1;1;0;1;run077
12089;BBG;BGG;0;1;1;0;1;run077
12090;BBG;BRB;0;2;2;1;1;run077
12091;BBG;BRR;0;1;1;1;0;run077
12092;BBG;GBB;1;1;2;1;1;run077
12093;BBG;GBG;1;6;7;2;5;run077
12094;BBG;GGB;0;18;18;1;17;run077
12095;BBG;GGG;1;29;30;15;15;run077
12096;BBG;GGR;0;2;2;1;1;run077
12097;BBG;GRG;0;1;1;0;1;run077
12098;BBG;GRR;0;3;3;3;0;run077
12099;BBG;RBR;0;2;2;0;2;run077
12100;BBG;RGR;0;2;2;0;2;run077
12101;BBG;RRG;1;2;3;2;1;run077
12102;BBG;RRR;0;1;1;0;1;run077
12103;BGG;BBB;0;1;1;0;1;run077
12104;BGG;BRB;0;1;1;0;1;run077
12105;BGG;GGG;0;1;1;0;1;run077
12106;BGG;RBB;0;1;1;1;0;run077
12107;BGG;RBG;1;0;1;1;0;run077
12108;BRB;BBB;0;1;1;0;1;run077
12109;BRB;GGB;1;0;1;0;1;run077
12110;BRB;GGG;0;2;2;2;0;run077
12111;BRB;RBB;1;0;1;1;0;run077
12112;BRR;BBB;0;1;1;0;1;run077
12113;BRR;BRB;0;1;1;1;0;run077
12114;BRR;GBB;1;0;1;0;1;run077
12115;GBB;BBB;1;16;17;4;13;run077
12116;GBB;BBG;0;2;2;0;2;run077
12117;GBB;BGB;0;1;1;0;1;run077
12118;GBB;BGG;0;3;3;0;3;run077
12119;GBB;BRB;0;9;9;3;6;run077
12120;GBB;BRR;0;2;2;2;0;run077
12121;GBB;GBG;1;1;2;2;0;run077
12122;GBB;GGB;2;59;61;7;54;run077
12123;GBB;GGG;4;95;99;39;60;run077
12124;GBB;GGR;0;1;1;1;0;run077
12125;GBB;GRG;0;1;1;0;1;run077
12126;GBB;GRR;1;8;9;0;9;run077
12127;GBB;RBB;0;2;2;2;0;run077
12128;GBB;RBG;0;1;1;1;0;run077
12129;GBB;RBR;1;1;2;0;2;run077
12130;GBB;RGG;0;2;2;0;2;run077
12131;GBB;RGR;0;1;1;1;0;run077
12132;GBB;RRG;0;3;3;1;2;run077
12133;GBG;BRB;0;1;1;1;0;run077
12134;GBG;BRR;0;3;3;2;1;run077
12135;GBG;GGB;0;1;1;1;0;run077
12136;GBG;GGR;0;3;3;3;0;run077
12137;GBG;RBR;0;1;1;1;0;run077
12138;GBG;RGR;1;1;2;0;2;run077
12139;GBG;RRR;0;1;1;0;1;run077
12140;GGB;BBB;1;8;9;5;4;run077
12141;GGB;BBG;0;1;1;0;1;run077
12142;GGB;BGB;0;1;1;0;1;run077
12143;GGB;BRB;3;5;8;6;2;run077
12144;GGB;BRR;0;1;1;1;0;run077
12145;GGB;GBG;0;2;2;2;0;run077
12146;GGB;GGG;4;37;41;14;27;run077
12147;GGB;GGR;0;9;9;6;3;run077
12148;GGB;GRR;1;4;5;5;0;run077
12149;GGB;RBB;0;2;2;2;0;run077
12150;GGB;RBG;0;2;2;2;0;run077
12151;GGB;RBR;0;2;2;1;1;run077
12152;GGB;RGG;0;1;1;0;1;run077
12153;GGB;RGR;1;2;3;1;2;run077
12154;GGB;RRG;1;3;4;2;2;run077
12155;GGB;RRR;0;3;3;2;1;run077
12156;GGG;BBB;4;22;26;24;2;run077
12157;GGG;BBG;0;2;2;1;1;run077
12158;GGG;BBR;0;3;3;1;2;run077
12159;GGG;BGB;0;2;2;0;2;run077
12160;GGG;BGG;0;3;3;1;2;run077
12161;GGG;BRB;0;3;3;0;3;run077
12162;GGG;BRR;0;3;3;3;0;run077
12163;GGG;GBB;0;1;1;0;1;run077
12164;GGG;GGB;1;3;4;1;3;run077
12165;GGG;GGR;0;21;21;8;13;run077
12166;GGG;GRG;0;2;2;2;0;run077
12167;GGG;GRR;2;15;17;3;14;run077
12168;GGG;RBB;0;1;1;1;0;run077
12169;GGG;RBR;1;4;5;0;5;run077
12170;GGG;RGG;1;7;8;6;2;run077
12171;GGG;RGR;0;3;3;0;3;run077
12172;GGG;RRG;0;2;2;2;0;run077
12173;GGG;RRR;0;1;1;1;0;run077
12174;GGR;BBB;0;1;1;0;1;run077
12175;GGR;BGG;0;2;2;0;2;run077
12176;GGR;BRB;0;1;1;1;0;run077
12177;GRG;BBB;0;3;3;0;3;run077
12178;GRG;BGB;0;3;3;2;1;run077
12179;GRG;BGG;0;1;1;0;1;run077
12180;GRG;BRB;0;5;5;1;4;run077
12181;GRG;BRR;0;1;1;1;0;run077
12182;GRG;GBB;0;3;3;0;3;run077
12183;GRG;GGB;0;14;14;0;14;run077
12184;GRG;GGG;0;10;10;10;0;run077
12185;GRG;GGR;0;2;2;1;1;run077
12186;GRG;GRR;0;1;1;0;1;run077
12187;GRG;RBR;1;2;3;1;2;run077
12188;GRG;RGG;0;2;2;2;0;run077
12189;GRG;RGR;0;1;1;1;0;run077
12190;GRR;BBB;0;3;3;2;1;run077
12191;GRR;BBR;0;2;2;2;0;run077
12192;GRR;BRB;1;8;9;8;1;run077
12193;GRR;BRR;1;6;7;2;5;run077
12194;GRR;GBB;0;1;1;1;0;run077
12195;GRR;GBG;0;1;1;0;1;run077
12196;GRR;GGR;1;9;10;8;2;run077
12197;GRR;RBR;0;1;1;1;0;run077
12198;GRR;RGG;1;3;4;0;4;run077
12199;GRR;RGR;0;1;1;0;1;run077
12200;GRR;RRR;0;1;1;0;1;run077
12201;RBB;BBB;0;1;1;1;0;run077
12202;RBB;GGG;0;3;3;2;1;run077
12203;RBG;GRR;0;1;1;1;0;run077
12204;RBG;RBR;0;1;1;0;1;run077
12205;RBG;RGR;0;1;1;1;0;run077
12206;RBR;BBB;0;3;3;1;2;run077
12207;RBR;BRB;0;1;1;0;1;run077
12208;RBR;BRR;0;2;2;1;1;run077
12209;RBR;GGG;0;1;1;0;1;run077
12210;RBR;GGR;1;2;3;3;0;run077
12211;RBR;GRG;0;1;1;0;1;run077
12212;RBR;GRR;1;15;16;1;15;run077
12213;RBR;RGG;0;4;4;4;0;run077
12214;RBR;RGR;0;1;1;1;0;run077
12215;RBR;RRR;0;3;3;2;1;run077
12216;RGG;BGG;0;1;1;0;1;run077
12217;RGG;RGR;0;1;1;0;1;run077
12218;RGR;BBB;0;9;9;2;7;run077
12219;RGR;BBR;0;1;1;1;0;run077
12220;RGR;BGB;1;8;9;9;0;run077
12221;RGR;BRB;0;3;3;3;0;run077
12222;RGR;BRR;0;3;3;1;2;run077
12223;RGR;GBG;0;1;1;0;1;run077
12224;RGR;GGB;0;3;3;1;2;run077
12225;RGR;GGG;0;2;2;0;2;run077
12226;RGR;GGR;0;8;8;4;4;run077
12227;RGR;GRR;1;7;8;8;0;run077
12228;RGR;RGG;0;6;6;3;3;run077
12229;RRG;BGB;0;1;1;0;1;run077
12230;RRG;BRB;0;1;1;0;1;run077
12231;RRG;GGG;0;1;1;0;1;run077
12232;RRG;GGR;0;1;1;0;1;run077
12233;RRG;GRG;0;1;1;0;1;run077
12234;RRG;GRR;0;3;3;2;1;run077
12235;RRG;RBR;0;4;4;4;0;run077
12236;RRG;RGG;0;1;1;1;0;run077
12237;RRG;RGR;6;37;43;9;34;run077
12238;RRR;BRR;0;1;1;1;0;run077
12239;RRR;GGB;0;1;1;1;0;run077
12240;RRR;GGG;1;5;6;6;0;run077
12241;RRR;GGR;0;2;2;0;2;run077
12242;RRR;GRR;0;1;1;1;0;run077
12243;RRR;RGR;0;1;1;1;0;run077
12244;BBB;GRR;0;1;1;0;1;run078
12245;BBG;BBB;1;9;10;3;7;run078
12246;BBG;BBR;0;2;2;2;0;run078
12247;BBG;BGB;0;1;1;1;0;run078
12248;BBG;BGG;0;1;1;1;0;run078
12249;BBG;BRB;0;2;2;1;1;run078
12250;BBG;BRR;0;1;1;1;0;run078
12251;BBG;GBB;1;1;2;0;2;run078
12252;BBG;GBG;1;6;7;0;7;run078
12253;BBG;GGB;0;18;18;2;16;run078
12254;BBG;GGG;1;29;30;26;4;run078
12255;BBG;GGR;0;2;2;1;1;run078
12256;BBG;GRG;0;1;1;1;0;run078
12257;BBG;GRR;0;3;3;1;2;run078
12258;BBG;RBR;0;2;2;1;1;run078
12259;BBG;RGR;0;2;2;2;0;run078
12260;BBG;RRG;1;2;3;0;3;run078
12261;BBG;RRR;0;1;1;1;0;run078
12262;BGG;BBB;0;1;1;0;1;run078
12263;BGG;BRB;0;1;1;1;0;run078
12264;BGG;GGG;0;1;1;0;1;run078
12265;BGG;RBB;0;1;1;0;1;run078
12266;BGG;RBG;1;0;1;0;1;run078
12267;BRB;BBB;0;1;1;1;0;run078
12268;BRB;GGB;1;0;1;1;0;run078
12269;BRB;GGG;0;2;2;2;0;run078
12270;BRB;RBB;1;0;1;1;0;run078
12271;BRR;BBB;0;1;1;1;0;run078
12272;BRR;BRB;0;1;1;1;0;run078
12273;BRR;GBB;1;0;1;1;0;run078
12274;GBB;BBB;1;16;17;5;12;run078
12275;GBB;BBG;0;2;2;0;2;run078
12276;GBB;BGB;0;1;1;0;1;run078
12277;GBB;BGG;0;3;3;1;2;run078
12278;GBB;BRB;0;9;9;2;7;run078
12279;GBB;BRR;0;2;2;1;1;run078
12280;GBB;GBG;1;1;2;0;2;run078
12281;GBB;GGB;2;59;61;46;15;run078
12282;GBB;GGG;4;95;99;0;99;run078
12283;GBB;GGR;0;1;1;1;0;run078
12284;GBB;GRG;0;1;1;1;0;run078
12285;GBB;GRR;1;8;9;4;5;run078
12286;GBB;RBB;0;2;2;0;2;run078
12287;GBB;RBG;0;1;1;1;0;run078
12288;GBB;RBR;1;1;2;1;1;run078
12289;GBB;RGG;0;2;2;1;1;run078
12290;GBB;RGR;0;1;1;1;0;run078
12291;GBB;RRG;0;3;3;2;1;run078
12292;GBG;BRB;0;1;1;0;1;run078
12293;GBG;BRR;0;3;3;3;0;run078
12294;GBG;GGB;0;1;1;0;1;run078
12295;GBG;GGR;0;3;3;3;0;run078
12296;GBG;RBR;0;1;1;1;0;run078
12297;GBG;RGR;1;1;2;2;0;run078
12298;GBG;RRR;0;1;1;1;0;run078
12299;GGB;BBB;1;8;9;3;6;run078
12300;GGB;BBG;0;1;1;0;1;run078
12301;GGB;BGB;0;1;1;0;1;run078
12302;GGB;BRB;3;5;8;4;4;run078
12303;GGB;BRR;0;1;1;0;1;run078
12304;GGB;GBG;0;2;2;1;1;run078
12305;GGB;GGG;4;37;41;11;30;run078
12306;GGB;GGR;0;9;9;8;1;run078
12307;GGB;GRR;1;4;5;1;4;run078
12308;GGB;RBB;0;2;2;0;2;run078
12309;GGB;RBG;0;2;2;0;2;run078
12310;GGB;RBR;0;2;2;0;2;run078
12311;GGB;RGG;0;1;1;1;0;run078
12312;GGB;RGR;1;2;3;3;0;run078
12313;GGB;RRG;1;3;4;4;0;run078
12314;GGB;RRR;0;3;3;0;3;run078
12315;GGG;BBB;4;22;26;20;6;run078
12316;GGG;BBG;0;2;2;2;0;run078
12317;GGG;BBR;0;3;3;0;3;run078
12318;GGG;BGB;0;2;2;1;1;run078
12319;GGG;BGG;0;3;3;1;2;run078
12320;GGG;BRB;0;3;3;1;2;run078
12321;GGG;BRR;0;3;3;0;3;run078
12322;GGG;GBB;0;1;1;0;1;run078
12323;GGG;GGB;1;3;4;0;4;run078
12324;GGG;GGR;0;21;21;21;0;run078
12325;GGG;GRG;0;2;2;0;2;run078
12326;GGG;GRR;2;15;17;5;12;run078
12327;GGG;RBB;0;1;1;1;0;run078
12328;GGG;RBR;1;4;5;1;4;run078
12329;GGG;RGG;1;7;8;8;0;run078
12330;GGG;RGR;0;3;3;1;2;run078
12331;GGG;RRG;0;2;2;1;1;run078
12332;GGG;RRR;0;1;1;1;0;run078
12333;GGR;BBB;0;1;1;1;0;run078
12334;GGR;BGG;0;2;2;0;2;run078
12335;GGR;BRB;0;1;1;0;1;run078
12336;GRG;BBB;0;3;3;3;0;run078
12337;GRG;BGB;0;3;3;1;2;run078
12338;GRG;BGG;0;1;1;0;1;run078
12339;GRG;BRB;0;5;5;4;1;run078
12340;GRG;BRR;0;1;1;1;0;run078
12341;GRG;GBB;0;3;3;0;3;run078
12342;GRG;GGB;0;14;14;2;12;run078
12343;GRG;GGG;0;10;10;0;10;run078
12344;GRG;GGR;0;2;2;2;0;run078
12345;GRG;GRR;0;1;1;0;1;run078
12346;GRG;RBR;1;2;3;3;0;run078
12347;GRG;RGG;0;2;2;2;0;run078
12348;GRG;RGR;0;1;1;0;1;run078
12349;GRR;BBB;0;3;3;3;0;run078
12350;GRR;BBR;0;2;2;2;0;run078
12351;GRR;BRB;1;8;9;7;2;run078
12352;GRR;BRR;1;6;7;4;3;run078
12353;GRR;GBB;0;1;1;0;1;run078
12354;GRR;GBG;0;1;1;1;0;run078
12355;GRR;GGR;1;9;10;4;6;run078
12356;GRR;RBR;0;1;1;1;0;run078
12357;GRR;RGG;1;3;4;0;4;run078
12358;GRR;RGR;0;1;1;1;0;run078
12359;GRR;RRR;0;1;1;0;1;run078
12360;RBB;BBB;0;1;1;0;1;run078
12361;RBB;GGG;0;3;3;3;0;run078
12362;RBG;GRR;0;1;1;1;0;run078
12363;RBG;RBR;0;1;1;0;1;run078
12364;RBG;RGR;0;1;1;1;0;run078
12365;RBR;BBB;0;3;3;2;1;run078
12366;RBR;BRB;0;1;1;1;0;run078
12367;RBR;BRR;0;2;2;2;0;run078
12368;RBR;GGG;0;1;1;0;1;run078
12369;RBR;GGR;1;2;3;3;0;run078
12370;RBR;GRG;0;1;1;1;0;run078
12371;RBR;GRR;1;15;16;8;8;run078
12372;RBR;RGG;0;4;4;3;1;run078
12373;RBR;RGR;0;1;1;0;1;run078
12374;RBR;RRR;0;3;3;0;3;run078
12375;RGG;BGG;0;1;1;1;0;run078
12376;RGG;RGR;0;1;1;0;1;run078
12377;RGR;BBB;0;9;9;5;4;run078
12378;RGR;BBR;0;1;1;1;0;run078
12379;RGR;BGB;1;8;9;2;7;run078
12380;RGR;BRB;0;3;3;0;3;run078
12381;RGR;BRR;0;3;3;0;3;run078
12382;RGR;GBG;0;1;1;0;1;run078
12383;RGR;GGB;0;3;3;3;0;run078
12384;RGR;GGG;0;2;2;1;1;run078
12385;RGR;GGR;0;8;8;7;1;run078
12386;RGR;GRR;1;7;8;2;6;run078
12387;RGR;RGG;0;6;6;3;3;run078
12388;RRG;BGB;0;1;1;1;0;run078
12389;RRG;BRB;0;1;1;1;0;run078
12390;RRG;GGG;0;1;1;1;0;run078
12391;RRG;GGR;0;1;1;0;1;run078
12392;RRG;GRG;0;1;1;0;1;run078
12393;RRG;GRR;0;3;3;0;3;run078
12394;RRG;RBR;0;4;4;3;1;run078
12395;RRG;RGG;0;1;1;1;0;run078
12396;RRG;RGR;6;37;43;11;32;run078
12397;RRR;BRR;0;1;1;0;1;run078
12398;RRR;GGB;0;1;1;0;1;run078
12399;RRR;GGG;1;5;6;5;1;run078
12400;RRR;GGR;0;2;2;2;0;run078
12401;RRR;GRR;0;1;1;1;0;run078
12402;RRR;RGR;0;1;1;0;1;run078
12403;BBB;GRR;0;1;1;1;0;run079
12404;BBG;BBB;1;9;10;2;8;run079
12405;BBG;BBR;0;2;2;2;0;run079
12406;BBG;BGB;0;1;1;1;0;run079
12407;BBG;BGG;0;1;1;1;0;run079
12408;BBG;BRB;0;2;2;2;0;run079
12409;BBG;BRR;0;1;1;0;1;run079
12410;BBG;GBB;1;1;2;1;1;run079
12411;BBG;GBG;1;6;7;0;7;run079
12412;BBG;GGB;0;18;18;13;5;run079
12413;BBG;GGG;1;29;30;9;21;run079
12414;BBG;GGR;0;2;2;0;2;run079
12415;BBG;GRG;0;1;1;0;1;run079
12416;BBG;GRR;0;3;3;1;2;run079
12417;BBG;RBR;0;2;2;1;1;run079
12418;BBG;RGR;0;2;2;0;2;run079
12419;BBG;RRG;1;2;3;3;0;run079
12420;BBG;RRR;0;1;1;0;1;run079
12421;BGG;BBB;0;1;1;0;1;run079
12422;BGG;BRB;0;1;1;1;0;run079
12423;BGG;GGG;0;1;1;1;0;run079
12424;BGG;RBB;0;1;1;0;1;run079
12425;BGG;RBG;1;0;1;0;1;run079
12426;BRB;BBB;0;1;1;0;1;run079
12427;BRB;GGB;1;0;1;0;1;run079
12428;BRB;GGG;0;2;2;1;1;run079
12429;BRB;RBB;1;0;1;0;1;run079
12430;BRR;BBB;0;1;1;0;1;run079
12431;BRR;BRB;0;1;1;1;0;run079
12432;BRR;GBB;1;0;1;0;1;run079
12433;GBB;BBB;1;16;17;5;12;run079
12434;GBB;BBG;0;2;2;0;2;run079
12435;GBB;BGB;0;1;1;0;1;run079
12436;GBB;BGG;0;3;3;1;2;run079
12437;GBB;BRB;0;9;9;3;6;run079
12438;GBB;BRR;0;2;2;2;0;run079
12439;GBB;GBG;1;1;2;0;2;run079
12440;GBB;GGB;2;59;61;5;56;run079
12441;GBB;GGG;4;95;99;55;44;run079
12442;GBB;GGR;0;1;1;0;1;run079
12443;GBB;GRG;0;1;1;0;1;run079
12444;GBB;GRR;1;8;9;8;1;run079
12445;GBB;RBB;0;2;2;0;2;run079
12446;GBB;RBG;0;1;1;1;0;run079
12447;GBB;RBR;1;1;2;1;1;run079
12448;GBB;RGG;0;2;2;1;1;run079
12449;GBB;RGR;0;1;1;1;0;run079
12450;GBB;RRG;0;3;3;2;1;run079
12451;GBG;BRB;0;1;1;0;1;run079
12452;GBG;BRR;0;3;3;1;2;run079
12453;GBG;GGB;0;1;1;0;1;run079
12454;GBG;GGR;0;3;3;3;0;run079
12455;GBG;RBR;0;1;1;1;0;run079
12456;GBG;RGR;1;1;2;0;2;run079
12457;GBG;RRR;0;1;1;1;0;run079
12458;GGB;BBB;1;8;9;9;0;run079
12459;GGB;BBG;0;1;1;1;0;run079
12460;GGB;BGB;0;1;1;0;1;run079
12461;GGB;BRB;3;5;8;7;1;run079
12462;GGB;BRR;0;1;1;0;1;run079
12463;GGB;GBG;0;2;2;2;0;run079
12464;GGB;GGG;4;37;41;35;6;run079
12465;GGB;GGR;0;9;9;8;1;run079
12466;GGB;GRR;1;4;5;2;3;run079
12467;GGB;RBB;0;2;2;2;0;run079
12468;GGB;RBG;0;2;2;0;2;run079
12469;GGB;RBR;0;2;2;1;1;run079
12470;GGB;RGG;0;1;1;0;1;run079
12471;GGB;RGR;1;2;3;2;1;run079
12472;GGB;RRG;1;3;4;2;2;run079
12473;GGB;RRR;0;3;3;0;3;run079
12474;GGG;BBB;4;22;26;26;0;run079
12475;GGG;BBG;0;2;2;1;1;run079
12476;GGG;BBR;0;3;3;1;2;run079
12477;GGG;BGB;0;2;2;0;2;run079
12478;GGG;BGG;0;3;3;2;1;run079
12479;GGG;BRB;0;3;3;3;0;run079
12480;GGG;BRR;0;3;3;0;3;run079
12481;GGG;GBB;0;1;1;1;0;run079
12482;GGG;GGB;1;3;4;2;2;run079
12483;GGG;GGR;0;21;21;12;9;run079
12484;GGG;GRG;0;2;2;0;2;run079
12485;GGG;GRR;2;15;17;7;10;run079
12486;GGG;RBB;0;1;1;1;0;run079
12487;GGG;RBR;1;4;5;4;1;run079
12488;GGG;RGG;1;7;8;0;8;run079
12489;GGG;RGR;0;3;3;3;0;run079
12490;GGG;RRG;0;2;2;0;2;run079
12491;GGG;RRR;0;1;1;0;1;run079
12492;GGR;BBB;0;1;1;0;1;run079
12493;GGR;BGG;0;2;2;0;2;run079
12494;GGR;BRB;0;1;1;1;0;run079
12495;GRG;BBB;0;3;3;0;3;run079
12496;GRG;BGB;0;3;3;1;2;run079
12497;GRG;BGG;0;1;1;1;0;run079
12498;GRG;BRB;0;5;5;0;5;run079
12499;GRG;BRR;0;1;1;0;1;run079
12500;GRG;GBB;0;3;3;3;0;run079
12501;GRG;GGB;0;14;14;6;8;run079
12502;GRG;GGG;0;10;10;10;0;run079
12503;GRG;GGR;0;2;2;1;1;run079
12504;GRG;GRR;0;1;1;0;1;run079
12505;GRG;RBR;1;2;3;3;0;run079
12506;GRG;RGG;0;2;2;0;2;run079
12507;GRG;RGR;0;1;1;1;0;run079
12508;GRR;BBB;0;3;3;2;1;run079
12509;GRR;BBR;0;2;2;2;0;run079
12510;GRR;BRB;1;8;9;9;0;run079
12511;GRR;BRR;1;6;7;4;3;run079
12512;GRR;GBB;0;1;1;1;0;run079
12513;GRR;GBG;0;1;1;1;0;run079
12514;GRR;GGR;1;9;10;8;2;run079
12515;GRR;RBR;0;1;1;1;0;run079
12516;GRR;RGG;1;3;4;3;1;run079
12517;GRR;RGR;0;1;1;0;1;run079
12518;GRR;RRR;0;1;1;1;0;run079
12519;RBB;BBB;0;1;1;1;0;run079
12520;RBB;GGG;0;3;3;0;3;run079
12521;RBG;GRR;0;1;1;1;0;run079
12522;RBG;RBR;0;1;1;0;1;run079
12523;RBG;RGR;0;1;1;1;0;run079
12524;RBR;BBB;0;3;3;0;3;run079
12525;RBR;BRB;0;1;1;1;0;run079
12526;RBR;BRR;0;2;2;1;1;run079
12527;RBR;GGG;0;1;1;1;0;run079
12528;RBR;GGR;1;2;3;2;1;run079
12529;RBR;GRG;0;1;1;1;0;run079
12530;RBR;GRR;1;15;16;6;10;run079
12531;RBR;RGG;0;4;4;2;2;run079
12532;RBR;RGR;0;1;1;1;0;run079
12533;RBR;RRR;0;3;3;1;2;run079
12534;RGG;BGG;0;1;1;0;1;run079
12535;RGG;RGR;0;1;1;1;0;run079
12536;RGR;BBB;0;9;9;6;3;run079
12537;RGR;BBR;0;1;1;1;0;run079
12538;RGR;BGB;1;8;9;0;9;run079
12539;RGR;BRB;0;3;3;2;1;run079
12540;RGR;BRR;0;3;3;2;1;run079
12541;RGR;GBG;0;1;1;1;0;run079
12542;RGR;GGB;0;3;3;3;0;run079
12543;RGR;GGG;0;2;2;0;2;run079
12544;RGR;GGR;0;8;8;4;4;run079
12545;RGR;GRR;1;7;8;8;0;run079
12546;RGR;RGG;0;6;6;1;5;run079
12547;RRG;BGB;0;1;1;1;0;run079
12548;RRG;BRB;0;1;1;0;1;run079
12549;RRG;GGG;0;1;1;0;1;run079
12550;RRG;GGR;0;1;1;0;1;run079
12551;RRG;GRG;0;1;1;1;0;run079
12552;RRG;GRR;0;3;3;1;2;run079
12553;RRG;RBR;0;4;4;2;2;run079
12554;RRG;RGG;0;1;1;1;0;run079
12555;RRG;RGR;6;37;43;20;23;run079
12556;RRR;BRR;0;1;1;1;0;run079
12557;RRR;GGB;0;1;1;1;0;run079
12558;RRR;GGG;1;5;6;4;2;run079
12559;RRR;GGR;0;2;2;2;0;run079
12560;RRR;GRR;0;1;1;1;0;run079
12561;RRR;RGR;0;1;1;1;0;run079
12562;BBB;GRR;0;1;1;0;1;run080
12563;BBG;BBB;1;9;10;10;0;run080
12564;BBG;BBR;0;2;2;2;0;run080
12565;BBG;BGB;0;1;1;0;1;run080
12566;BBG;BGG;0;1;1;0;1;run080
12567;BBG;BRB;0;2;2;1;1;run080
12568;BBG;BRR;0;1;1;1;0;run080
12569;BBG;GBB;1;1;2;1;1;run080
12570;BBG;GBG;1;6;7;3;4;run080
12571;BBG;GGB;0;18;18;2;16;run080
12572;BBG;GGG;1;29;30;14;16;run080
12573;BBG;GGR;0;2;2;2;0;run080
12574;BBG;GRG;0;1;1;0;1;run080
12575;BBG;GRR;0;3;3;2;1;run080
12576;BBG;RBR;0;2;2;2;0;run080
12577;BBG;RGR;0;2;2;1;1;run080
12578;BBG;RRG;1;2;3;3;0;run080
12579;BBG;RRR;0;1;1;0;1;run080
12580;BGG;BBB;0;1;1;0;1;run080
12581;BGG;BRB;0;1;1;0;1;run080
12582;BGG;GGG;0;1;1;0;1;run080
12583;BGG;RBB;0;1;1;1;0;run080
12584;BGG;RBG;1;0;1;1;0;run080
12585;BRB;BBB;0;1;1;0;1;run080
12586;BRB;GGB;1;0;1;1;0;run080
12587;BRB;GGG;0;2;2;2;0;run080
12588;BRB;RBB;1;0;1;0;1;run080
12589;BRR;BBB;0;1;1;0;1;run080
12590;BRR;BRB;0;1;1;1;0;run080
12591;BRR;GBB;1;0;1;0;1;run080
12592;GBB;BBB;1;16;17;1;16;run080
12593;GBB;BBG;0;2;2;1;1;run080
12594;GBB;BGB;0;1;1;1;0;run080
12595;GBB;BGG;0;3;3;3;0;run080
12596;GBB;BRB;0;9;9;6;3;run080
12597;GBB;BRR;0;2;2;1;1;run080
12598;GBB;GBG;1;1;2;1;1;run080
12599;GBB;GGB;2;59;61;32;29;run080
12600;GBB;GGG;4;95;99;74;25;run080
12601;GBB;GGR;0;1;1;0;1;run080
12602;GBB;GRG;0;1;1;0;1;run080
12603;GBB;GRR;1;8;9;0;9;run080
12604;GBB;RBB;0;2;2;0;2;run080
12605;GBB;RBG;0;1;1;0;1;run080
12606;GBB;RBR;1;1;2;2;0;run080
12607;GBB;RGG;0;2;2;0;2;run080
12608;GBB;RGR;0;1;1;0;1;run080
12609;GBB;RRG;0;3;3;1;2;run080
12610;GBG;BRB;0;1;1;0;1;run080
12611;GBG;BRR;0;3;3;1;2;run080
12612;GBG;GGB;0;1;1;0;1;run080
12613;GBG;GGR;0;3;3;0;3;run080
12614;GBG;RBR;0;1;1;0;1;run080
12615;GBG;RGR;1;1;2;1;1;run080
12616;GBG;RRR;0;1;1;0;1;run080
12617;GGB;BBB;1;8;9;8;1;run080
12618;GGB;BBG;0;1;1;1;0;run080
12619;GGB;BGB;0;1;1;1;0;run080
12620;GGB;BRB;3;5;8;8;0;run080
12621;GGB;BRR;0;1;1;0;1;run080
12622;GGB;GBG;0;2;2;0;2;run080
12623;GGB;GGG;4;37;41;37;4;run080
12624;GGB;GGR;0;9;9;2;7;run080
12625;GGB;GRR;1;4;5;5;0;run080
12626;GGB;RBB;0;2;2;1;1;run080
12627;GGB;RBG;0;2;2;1;1;run080
12628;GGB;RBR;0;2;2;2;0;run080
12629;GGB;RGG;0;1;1;1;0;run080
12630;GGB;RGR;1;2;3;3;0;run080
12631;GGB;RRG;1;3;4;0;4;run080
12632;GGB;RRR;0;3;3;2;1;run080
12633;GGG;BBB;4;22;26;20;6;run080
12634;GGG;BBG;0;2;2;1;1;run080
12635;GGG;BBR;0;3;3;0;3;run080
12636;GGG;BGB;0;2;2;0;2;run080
12637;GGG;BGG;0;3;3;2;1;run080
12638;GGG;BRB;0;3;3;1;2;run080
12639;GGG;BRR;0;3;3;0;3;run080
12640;GGG;GBB;0;1;1;0;1;run080
12641;GGG;GGB;1;3;4;0;4;run080
12642;GGG;GGR;0;21;21;4;17;run080
12643;GGG;GRG;0;2;2;0;2;run080
12644;GGG;GRR;2;15;17;2;15;run080
12645;GGG;RBB;0;1;1;0;1;run080
12646;GGG;RBR;1;4;5;2;3;run080
12647;GGG;RGG;1;7;8;5;3;run080
12648;GGG;RGR;0;3;3;3;0;run080
12649;GGG;RRG;0;2;2;0;2;run080
12650;GGG;RRR;0;1;1;0;1;run080
12651;GGR;BBB;0;1;1;1;0;run080
12652;GGR;BGG;0;2;2;0;2;run080
12653;GGR;BRB;0;1;1;1;0;run080
12654;GRG;BBB;0;3;3;3;0;run080
12655;GRG;BGB;0;3;3;0;3;run080
12656;GRG;BGG;0;1;1;0;1;run080
12657;GRG;BRB;0;5;5;5;0;run080
12658;GRG;BRR;0;1;1;1;0;run080
12659;GRG;GBB;0;3;3;2;1;run080
12660;GRG;GGB;0;14;14;0;14;run080
12661;GRG;GGG;0;10;10;0;10;run080
12662;GRG;GGR;0;2;2;0;2;run080
12663;GRG;GRR;0;1;1;0;1;run080
12664;GRG;RBR;1;2;3;3;0;run080
12665;GRG;RGG;0;2;2;2;0;run080
12666;GRG;RGR;0;1;1;1;0;run080
12667;GRR;BBB;0;3;3;3;0;run080
12668;GRR;BBR;0;2;2;1;1;run080
12669;GRR;BRB;1;8;9;4;5;run080
12670;GRR;BRR;1;6;7;4;3;run080
12671;GRR;GBB;0;1;1;1;0;run080
12672;GRR;GBG;0;1;1;0;1;run080
12673;GRR;GGR;1;9;10;4;6;run080
12674;GRR;RBR;0;1;1;1;0;run080
12675;GRR;RGG;1;3;4;3;1;run080
12676;GRR;RGR;0;1;1;0;1;run080
12677;GRR;RRR;0;1;1;1;0;run080
12678;RBB;BBB;0;1;1;0;1;run080
12679;RBB;GGG;0;3;3;1;2;run080
12680;RBG;GRR;0;1;1;1;0;run080
12681;RBG;RBR;0;1;1;1;0;run080
12682;RBG;RGR;0;1;1;1;0;run080
12683;RBR;BBB;0;3;3;3;0;run080
12684;RBR;BRB;0;1;1;0;1;run080
12685;RBR;BRR;0;2;2;2;0;run080
12686;RBR;GGG;0;1;1;1;0;run080
12687;RBR;GGR;1;2;3;1;2;run080
12688;RBR;GRG;0;1;1;1;0;run080
12689;RBR;GRR;1;15;16;8;8;run080
12690;RBR;RGG;0;4;4;1;3;run080
12691;RBR;RGR;0;1;1;0;1;run080
12692;RBR;RRR;0;3;3;0;3;run080
12693;RGG;BGG;0;1;1;1;0;run080
12694;RGG;RGR;0;1;1;0;1;run080
12695;RGR;BBB;0;9;9;9;0;run080
12696;RGR;BBR;0;1;1;1;0;run080
12697;RGR;BGB;1;8;9;3;6;run080
12698;RGR;BRB;0;3;3;1;2;run080
12699;RGR;BRR;0;3;3;1;2;run080
12700;RGR;GBG;0;1;1;1;0;run080
12701;RGR;GGB;0;3;3;3;0;run080
12702;RGR;GGG;0;2;2;2;0;run080
12703;RGR;GGR;0;8;8;2;6;run080
12704;RGR;GRR;1;7;8;2;6;run080
12705;RGR;RGG;0;6;6;0;6;run080
12706;RRG;BGB;0;1;1;0;1;run080
12707;RRG;BRB;0;1;1;1;0;run080
12708;RRG;GGG;0;1;1;0;1;run080
12709;RRG;GGR;0;1;1;0;1;run080
12710;RRG;GRG;0;1;1;1;0;run080
12711;RRG;GRR;0;3;3;2;1;run080
12712;RRG;RBR;0;4;4;1;3;run080
12713;RRG;RGG;0;1;1;1;0;run080
12714;RRG;RGR;6;37;43;6;37;run080
12715;RRR;BRR;0;1;1;0;1;run080
12716;RRR;GGB;0;1;1;1;0;run080
12717;RRR;GGG;1;5;6;4;2;run080
12718;RRR;GGR;0;2;2;2;0;run080
12719;RRR;GRR;0;1;1;0;1;run080
12720;RRR;RGR;0;1;1;1;0;run080
12721;BBB;GRR;0;1;1;1;0;run081
12722;BBG;BBB;1;9;10;2;8;run081
12723;BBG;BBR;0;2;2;0;2;run081
12724;BBG;BGB;0;1;1;0;1;run081
12725;BBG;BGG;0;1;1;1;0;run081
12726;BBG;BRB;0;2;2;0;2;run081
12727;BBG;BRR;0;1;1;1;0;run081
12728;BBG;GBB;1;1;2;0;2;run081
12729;BBG;GBG;1;6;7;1;6;run081
12730;BBG;GGB;0;18;18;8;10;run081
12731;BBG;GGG;1;29;30;21;9;run081
12732;BBG;GGR;0;2;2;0;2;run081
12733;BBG;GRG;0;1;1;0;1;run081
12734;BBG;GRR;0;3;3;0;3;run081
12735;BBG;RBR;0;2;2;1;1;run081
12736;BBG;RGR;0;2;2;2;0;run081
12737;BBG;RRG;1;2;3;0;3;run081
12738;BBG;RRR;0;1;1;1;0;run081
12739;BGG;BBB;0;1;1;0;1;run081
12740;BGG;BRB;0;1;1;0;1;run081
12741;BGG;GGG;0;1;1;0;1;run081
12742;BGG;RBB;0;1;1;1;0;run081
12743;BGG;RBG;1;0;1;0;1;run081
12744;BRB;BBB;0;1;1;1;0;run081
12745;BRB;GGB;1;0;1;1;0;run081
12746;BRB;GGG;0;2;2;0;2;run081
12747;BRB;RBB;1;0;1;0;1;run081
12748;BRR;BBB;0;1;1;1;0;run081
12749;BRR;BRB;0;1;1;0;1;run081
12750;BRR;GBB;1;0;1;1;0;run081
12751;GBB;BBB;1;16;17;3;14;run081
12752;GBB;BBG;0;2;2;2;0;run081
12753;GBB;BGB;0;1;1;0;1;run081
12754;GBB;BGG;0;3;3;1;2;run081
12755;GBB;BRB;0;9;9;5;4;run081
12756;GBB;BRR;0;2;2;2;0;run081
12757;GBB;GBG;1;1;2;1;1;run081
12758;GBB;GGB;2;59;61;27;34;run081
12759;GBB;GGG;4;95;99;9;90;run081
12760;GBB;GGR;0;1;1;1;0;run081
12761;GBB;GRG;0;1;1;0;1;run081
12762;GBB;GRR;1;8;9;1;8;run081
12763;GBB;RBB;0;2;2;0;2;run081
12764;GBB;RBG;0;1;1;0;1;run081
12765;GBB;RBR;1;1;2;0;2;run081
12766;GBB;RGG;0;2;2;0;2;run081
12767;GBB;RGR;0;1;1;0;1;run081
12768;GBB;RRG;0;3;3;2;1;run081
12769;GBG;BRB;0;1;1;1;0;run081
12770;GBG;BRR;0;3;3;1;2;run081
12771;GBG;GGB;0;1;1;1;0;run081
12772;GBG;GGR;0;3;3;3;0;run081
12773;GBG;RBR;0;1;1;0;1;run081
12774;GBG;RGR;1;1;2;1;1;run081
12775;GBG;RRR;0;1;1;0;1;run081
12776;GGB;BBB;1;8;9;1;8;run081
12777;GGB;BBG;0;1;1;0;1;run081
12778;GGB;BGB;0;1;1;1;0;run081
12779;GGB;BRB;3;5;8;1;7;run081
12780;GGB;BRR;0;1;1;1;0;run081
12781;GGB;GBG;0;2;2;1;1;run081
12782;GGB;GGG;4;37;41;2;39;run081
12783;GGB;GGR;0;9;9;7;2;run081
12784;GGB;GRR;1;4;5;5;0;run081
12785;GGB;RBB;0;2;2;0;2;run081
12786;GGB;RBG;0;2;2;2;0;run081
12787;GGB;RBR;0;2;2;1;1;run081
12788;GGB;RGG;0;1;1;0;1;run081
12789;GGB;RGR;1;2;3;0;3;run081
12790;GGB;RRG;1;3;4;1;3;run081
12791;GGB;RRR;0;3;3;0;3;run081
12792;GGG;BBB;4;22;26;21;5;run081
12793;GGG;BBG;0;2;2;1;1;run081
12794;GGG;BBR;0;3;3;0;3;run081
12795;GGG;BGB;0;2;2;1;1;run081
12796;GGG;BGG;0;3;3;3;0;run081
12797;GGG;BRB;0;3;3;0;3;run081
12798;GGG;BRR;0;3;3;2;1;run081
12799;GGG;GBB;0;1;1;0;1;run081
12800;GGG;GGB;1;3;4;2;2;run081
12801;GGG;GGR;0;21;21;16;5;run081
12802;GGG;GRG;0;2;2;2;0;run081
12803;GGG;GRR;2;15;17;1;16;run081
12804;GGG;RBB;0;1;1;0;1;run081
12805;GGG;RBR;1;4;5;5;0;run081
12806;GGG;RGG;1;7;8;5;3;run081
12807;GGG;RGR;0;3;3;2;1;run081
12808;GGG;RRG;0;2;2;1;1;run081
12809;GGG;RRR;0;1;1;0;1;run081
12810;GGR;BBB;0;1;1;1;0;run081
12811;GGR;BGG;0;2;2;2;0;run081
12812;GGR;BRB;0;1;1;0;1;run081
12813;GRG;BBB;0;3;3;0;3;run081
12814;GRG;BGB;0;3;3;2;1;run081
12815;GRG;BGG;0;1;1;1;0;run081
12816;GRG;BRB;0;5;5;4;1;run081
12817;GRG;BRR;0;1;1;1;0;run081
12818;GRG;GBB;0;3;3;2;1;run081
12819;GRG;GGB;0;14;14;8;6;run081
12820;GRG;GGG;0;10;10;8;2;run081
12821;GRG;GGR;0;2;2;0;2;run081
12822;GRG;GRR;0;1;1;1;0;run081
12823;GRG;RBR;1;2;3;3;0;run081
12824;GRG;RGG;0;2;2;2;0;run081
12825;GRG;RGR;0;1;1;1;0;run081
12826;GRR;BBB;0;3;3;0;3;run081
12827;GRR;BBR;0;2;2;2;0;run081
12828;GRR;BRB;1;8;9;8;1;run081
12829;GRR;BRR;1;6;7;5;2;run081
12830;GRR;GBB;0;1;1;1;0;run081
12831;GRR;GBG;0;1;1;0;1;run081
12832;GRR;GGR;1;9;10;2;8;run081
12833;GRR;RBR;0;1;1;1;0;run081
12834;GRR;RGG;1;3;4;1;3;run081
12835;GRR;RGR;0;1;1;0;1;run081
12836;GRR;RRR;0;1;1;1;0;run081
12837;RBB;BBB;0;1;1;0;1;run081
12838;RBB;GGG;0;3;3;0;3;run081
12839;RBG;GRR;0;1;1;1;0;run081
12840;RBG;RBR;0;1;1;1;0;run081
12841;RBG;RGR;0;1;1;1;0;run081
12842;RBR;BBB;0;3;3;3;0;run081
12843;RBR;BRB;0;1;1;1;0;run081
12844;RBR;BRR;0;2;2;0;2;run081
12845;RBR;GGG;0;1;1;0;1;run081
12846;RBR;GGR;1;2;3;1;2;run081
12847;RBR;GRG;0;1;1;1;0;run081
12848;RBR;GRR;1;15;16;9;7;run081
12849;RBR;RGG;0;4;4;0;4;run081
12850;RBR;RGR;0;1;1;1;0;run081
12851;RBR;RRR;0;3;3;1;2;run081
12852;RGG;BGG;0;1;1;0;1;run081
12853;RGG;RGR;0;1;1;0;1;run081
12854;RGR;BBB;0;9;9;1;8;run081
12855;RGR;BBR;0;1;1;0;1;run081
12856;RGR;BGB;1;8;9;5;4;run081
12857;RGR;BRB;0;3;3;1;2;run081
12858;RGR;BRR;0;3;3;3;0;run081
12859;RGR;GBG;0;1;1;0;1;run081
12860;RGR;GGB;0;3;3;2;1;run081
12861;RGR;GGG;0;2;2;1;1;run081
12862;RGR;GGR;0;8;8;8;0;run081
12863;RGR;GRR;1;7;8;3;5;run081
12864;RGR;RGG;0;6;6;5;1;run081
12865;RRG;BGB;0;1;1;1;0;run081
12866;RRG;BRB;0;1;1;0;1;run081
12867;RRG;GGG;0;1;1;1;0;run081
12868;RRG;GGR;0;1;1;0;1;run081
12869;RRG;GRG;0;1;1;0;1;run081
12870;RRG;GRR;0;3;3;1;2;run081
12871;RRG;RBR;0;4;4;4;0;run081
12872;RRG;RGG;0;1;1;1;0;run081
12873;RRG;RGR;6;37;43;18;25;run081
12874;RRR;BRR;0;1;1;0;1;run081
12875;RRR;GGB;0;1;1;0;1;run081
12876;RRR;GGG;1;5;6;1;5;run081
12877;RRR;GGR;0;2;2;0;2;run081
12878;RRR;GRR;0;1;1;0;1;run081
12879;RRR;RGR;0;1;1;0;1;run081
12880;BBB;GRR;0;1;1;1;0;run082
12881;BBG;BBB;1;9;10;0;10;run082
12882;BBG;BBR;0;2;2;2;0;run082
12883;BBG;BGB;0;1;1;0;1;run082
12884;BBG;BGG;0;1;1;0;1;run082
12885;BBG;BRB;0;2;2;1;1;run082
12886;BBG;BRR;0;1;1;1;0;run082
12887;BBG;GBB;1;1;2;0;2;run082
12888;BBG;GBG;1;6;7;0;7;run082
12889;BBG;GGB;0;18;18;10;8;run082
12890;BBG;GGG;1;29;30;30;0;run082
12891;BBG;GGR;0;2;2;1;1;run082
12892;BBG;GRG;0;1;1;0;1;run082
12893;BBG;GRR;0;3;3;3;0;run082
12894;BBG;RBR;0;2;2;2;0;run082
12895;BBG;RGR;0;2;2;1;1;run082
12896;BBG;RRG;1;2;3;3;0;run082
12897;BBG;RRR;0;1;1;0;1;run082
12898;BGG;BBB;0;1;1;0;1;run082
12899;BGG;BRB;0;1;1;0;1;run082
12900;BGG;GGG;0;1;1;0;1;run082
12901;BGG;RBB;0;1;1;1;0;run082
12902;BGG;RBG;1;0;1;1;0;run082
12903;BRB;BBB;0;1;1;1;0;run082
12904;BRB;GGB;1;0;1;0;1;run082
12905;BRB;GGG;0;2;2;1;1;run082
12906;BRB;RBB;1;0;1;1;0;run082
12907;BRR;BBB;0;1;1;1;0;run082
12908;BRR;BRB;0;1;1;0;1;run082
12909;BRR;GBB;1;0;1;0;1;run082
12910;GBB;BBB;1;16;17;14;3;run082
12911;GBB;BBG;0;2;2;1;1;run082
12912;GBB;BGB;0;1;1;1;0;run082
12913;GBB;BGG;0;3;3;3;0;run082
12914;GBB;BRB;0;9;9;2;7;run082
12915;GBB;BRR;0;2;2;1;1;run082
12916;GBB;GBG;1;1;2;0;2;run082
12917;GBB;GGB;2;59;61;50;11;run082
12918;GBB;GGG;4;95;99;13;86;run082
12919;GBB;GGR;0;1;1;1;0;run082
12920;GBB;GRG;0;1;1;0;1;run082
12921;GBB;GRR;1;8;9;0;9;run082
12922;GBB;RBB;0;2;2;0;2;run082
12923;GBB;RBG;0;1;1;1;0;run082
12924;GBB;RBR;1;1;2;1;1;run082
12925;GBB;RGG;0;2;2;1;1;run082
12926;GBB;RGR;0;1;1;0;1;run082
12927;GBB;RRG;0;3;3;2;1;run082
12928;GBG;BRB;0;1;1;0;1;run082
12929;GBG;BRR;0;3;3;3;0;run082
12930;GBG;GGB;0;1;1;1;0;run082
12931;GBG;GGR;0;3;3;0;3;run082
12932;GBG;RBR;0;1;1;1;0;run082
12933;GBG;RGR;1;1;2;1;1;run082
12934;GBG;RRR;0;1;1;0;1;run082
12935;GGB;BBB;1;8;9;9;0;run082
12936;GGB;BBG;0;1;1;0;1;run082
12937;GGB;BGB;0;1;1;1;0;run082
12938;GGB;BRB;3;5;8;3;5;run082
12939;GGB;BRR;0;1;1;1;0;run082
12940;GGB;GBG;0;2;2;2;0;run082
12941;GGB;GGG;4;37;41;5;36;run082
12942;GGB;GGR;0;9;9;7;2;run082
12943;GGB;GRR;1;4;5;3;2;run082
12944;GGB;RBB;0;2;2;1;1;run082
12945;GGB;RBG;0;2;2;0;2;run082
12946;GGB;RBR;0;2;2;0;2;run082
12947;GGB;RGG;0;1;1;1;0;run082
12948;GGB;RGR;1;2;3;3;0;run082
12949;GGB;RRG;1;3;4;2;2;run082
12950;GGB;RRR;0;3;3;2;1;run082
12951;GGG;BBB;4;22;26;20;6;run082
12952;GGG;BBG;0;2;2;2;0;run082
12953;GGG;BBR;0;3;3;1;2;run082
12954;GGG;BGB;0;2;2;0;2;run082
12955;GGG;BGG;0;3;3;2;1;run082
12956;GGG;BRB;0;3;3;1;2;run082
12957;GGG;BRR;0;3;3;0;3;run082
12958;GGG;GBB;0;1;1;1;0;run082
12959;GGG;GGB;1;3;4;0;4;run082
12960;GGG;GGR;0;21;21;4;17;run082
12961;GGG;GRG;0;2;2;1;1;run082
12962;GGG;GRR;2;15;17;13;4;run082
12963;GGG;RBB;0;1;1;1;0;run082
12964;GGG;RBR;1;4;5;4;1;run082
12965;GGG;RGG;1;7;8;4;4;run082
12966;GGG;RGR;0;3;3;1;2;run082
12967;GGG;RRG;0;2;2;1;1;run082
12968;GGG;RRR;0;1;1;0;1;run082
12969;GGR;BBB;0;1;1;1;0;run082
12970;GGR;BGG;0;2;2;1;1;run082
12971;GGR;BRB;0;1;1;1;0;run082
12972;GRG;BBB;0;3;3;0;3;run082
12973;GRG;BGB;0;3;3;2;1;run082
12974;GRG;BGG;0;1;1;0;1;run082
12975;GRG;BRB;0;5;5;4;1;run082
12976;GRG;BRR;0;1;1;0;1;run082
12977;GRG;GBB;0;3;3;1;2;run082
12978;GRG;GGB;0;14;14;4;10;run082
12979;GRG;GGG;0;10;10;5;5;run082
12980;GRG;GGR;0;2;2;1;1;run082
12981;GRG;GRR;0;1;1;1;0;run082
12982;GRG;RBR;1;2;3;3;0;run082
12983;GRG;RGG;0;2;2;1;1;run082
12984;GRG;RGR;0;1;1;0;1;run082
12985;GRR;BBB;0;3;3;1;2;run082
12986;GRR;BBR;0;2;2;2;0;run082
12987;GRR;BRB;1;8;9;4;5;run082
12988;GRR;BRR;1;6;7;6;1;run082
12989;GRR;GBB;0;1;1;0;1;run082
12990;GRR;GBG;0;1;1;0;1;run082
12991;GRR;GGR;1;9;10;6;4;run082
12992;GRR;RBR;0;1;1;0;1;run082
12993;GRR;RGG;1;3;4;1;3;run082
12994;GRR;RGR;0;1;1;0;1;run082
12995;GRR;RRR;0;1;1;0;1;run082
12996;RBB;BBB;0;1;1;0;1;run082
12997;RBB;GGG;0;3;3;2;1;run082
12998;RBG;GRR;0;1;1;0;1;run082
12999;RBG;RBR;0;1;1;0;1;run082
13000;RBG;RGR;0;1;1;1;0;run082
13001;RBR;BBB;0;3;3;2;1;run082
13002;RBR;BRB;0;1;1;0;1;run082
13003;RBR;BRR;0;2;2;1;1;run082
13004;RBR;GGG;0;1;1;0;1;run082
13005;RBR;GGR;1;2;3;3;0;run082
13006;RBR;GRG;0;1;1;1;0;run082
13007;RBR;GRR;1;15;16;0;16;run082
13008;RBR;RGG;0;4;4;1;3;run082
13009;RBR;RGR;0;1;1;1;0;run082
13010;RBR;RRR;0;3;3;3;0;run082
13011;RGG;BGG;0;1;1;0;1;run082
13012;RGG;RGR;0;1;1;1;0;run082
13013;RGR;BBB;0;9;9;7;2;run082
13014;RGR;BBR;0;1;1;0;1;run082
13015;RGR;BGB;1;8;9;2;7;run082
13016;RGR;BRB;0;3;3;3;0;run082
13017;RGR;BRR;0;3;3;0;3;run082
13018;RGR;GBG;0;1;1;1;0;run082
13019;RGR;GGB;0;3;3;2;1;run082
13020;RGR;GGG;0;2;2;0;2;run082
13021;RGR;GGR;0;8;8;3;5;run082
13022;RGR;GRR;1;7;8;1;7;run082
13023;RGR;RGG;0;6;6;3;3;run082
13024;RRG;BGB;0;1;1;1;0;run082
13025;RRG;BRB;0;1;1;0;1;run082
13026;RRG;GGG;0;1;1;1;0;run082
13027;RRG;GGR;0;1;1;1;0;run082
13028;RRG;GRG;0;1;1;0;1;run082
13029;RRG;GRR;0;3;3;2;1;run082
13030;RRG;RBR;0;4;4;3;1;run082
13031;RRG;RGG;0;1;1;1;0;run082
13032;RRG;RGR;6;37;43;0;43;run082
13033;RRR;BRR;0;1;1;1;0;run082
13034;RRR;GGB;0;1;1;1;0;run082
13035;RRR;GGG;1;5;6;4;2;run082
13036;RRR;GGR;0;2;2;0;2;run082
13037;RRR;GRR;0;1;1;1;0;run082
13038;RRR;RGR;0;1;1;0;1;run082
13039;BBB;GRR;0;1;1;0;1;run083
13040;BBG;BBB;1;9;10;9;1;run083
13041;BBG;BBR;0;2;2;1;1;run083
13042;BBG;BGB;0;1;1;0;1;run083
13043;BBG;BGG;0;1;1;1;0;run083
13044;BBG;BRB;0;2;2;0;2;run083
13045;BBG;BRR;0;1;1;1;0;run083
13046;BBG;GBB;1;1;2;2;0;run083
13047;BBG;GBG;1;6;7;5;2;run083
13048;BBG;GGB;0;18;18;3;15;run083
13049;BBG;GGG;1;29;30;1;29;run083
13050;BBG;GGR;0;2;2;0;2;run083
13051;BBG;GRG;0;1;1;0;1;run083
13052;BBG;GRR;0;3;3;1;2;run083
13053;BBG;RBR;0;2;2;1;1;run083
13054;BBG;RGR;0;2;2;1;1;run083
13055;BBG;RRG;1;2;3;1;2;run083
13056;BBG;RRR;0;1;1;0;1;run083
13057;BGG;BBB;0;1;1;1;0;run083
13058;BGG;BRB;0;1;1;0;1;run083
13059;BGG;GGG;0;1;1;0;1;run083
13060;BGG;RBB;0;1;1;1;0;run083
13061;BGG;RBG;1;0;1;0;1;run083
13062;BRB;BBB;0;1;1;1;0;run083
13063;BRB;GGB;1;0;1;0;1;run083
13064;BRB;GGG;0;2;2;2;0;run083
13065;BRB;RBB;1;0;1;0;1;run083
13066;BRR;BBB;0;1;1;1;0;run083
13067;BRR;BRB;0;1;1;0;1;run083
13068;BRR;GBB;1;0;1;1;0;run083
13069;GBB;BBB;1;16;17;15;2;run083
13070;GBB;BBG;0;2;2;1;1;run083
13071;GBB;BGB;0;1;1;1;0;run083
13072;GBB;BGG;0;3;3;3;0;run083
13073;GBB;BRB;0;9;9;3;6;run083
13074;GBB;BRR;0;2;2;2;0;run083
13075;GBB;GBG;1;1;2;0;2;run083
13076;GBB;GGB;2;59;61;25;36;run083
13077;GBB;GGG;4;95;99;59;40;run083
13078;GBB;GGR;0;1;1;1;0;run083
13079;GBB;GRG;0;1;1;0;1;run083
13080;GBB;GRR;1;8;9;2;7;run083
13081;GBB;RBB;0;2;2;0;2;run083
13082;GBB;RBG;0;1;1;0;1;run083
13083;GBB;RBR;1;1;2;0;2;run083
13084;GBB;RGG;0;2;2;0;2;run083
13085;GBB;RGR;0;1;1;0;1;run083
13086;GBB;RRG;0;3;3;3;0;run083
13087;GBG;BRB;0;1;1;0;1;run083
13088;GBG;BRR;0;3;3;0;3;run083
13089;GBG;GGB;0;1;1;1;0;run083
13090;GBG;GGR;0;3;3;1;2;run083
13091;GBG;RBR;0;1;1;0;1;run083
13092;GBG;RGR;1;1;2;1;1;run083
13093;GBG;RRR;0;1;1;0;1;run083
13094;GGB;BBB;1;8;9;8;1;run083
13095;GGB;BBG;0;1;1;0;1;run083
13096;GGB;BGB;0;1;1;0;1;run083
13097;GGB;BRB;3;5;8;6;2;run083
13098;GGB;BRR;0;1;1;0;1;run083
13099;GGB;GBG;0;2;2;1;1;run083
13100;GGB;GGG;4;37;41;11;30;run083
13101;GGB;GGR;0;9;9;9;0;run083
13102;GGB;GRR;1;4;5;2;3;run083
13103;GGB;RBB;0;2;2;1;1;run083
13104;GGB;RBG;0;2;2;1;1;run083
13105;GGB;RBR;0;2;2;0;2;run083
13106;GGB;RGG;0;1;1;0;1;run083
13107;GGB;RGR;1;2;3;1;2;run083
13108;GGB;RRG;1;3;4;1;3;run083
13109;GGB;RRR;0;3;3;1;2;run083
13110;GGG;BBB;4;22;26;23;3;run083
13111;GGG;BBG;0;2;2;2;0;run083
13112;GGG;BBR;0;3;3;3;0;run083
13113;GGG;BGB;0;2;2;0;2;run083
13114;GGG;BGG;0;3;3;1;2;run083
13115;GGG;BRB;0;3;3;3;0;run083
13116;GGG;BRR;0;3;3;1;2;run083
13117;GGG;GBB;0;1;1;0;1;run083
13118;GGG;GGB;1;3;4;2;2;run083
13119;GGG;GGR;0;21;21;21;0;run083
13120;GGG;GRG;0;2;2;0;2;run083
13121;GGG;GRR;2;15;17;0;17;run083
13122;GGG;RBB;0;1;1;0;1;run083
13123;GGG;RBR;1;4;5;2;3;run083
13124;GGG;RGG;1;7;8;0;8;run083
13125;GGG;RGR;0;3;3;2;1;run083
13126;GGG;RRG;0;2;2;2;0;run083
13127;GGG;RRR;0;1;1;0;1;run083
13128;GGR;BBB;0;1;1;1;0;run083
13129;GGR;BGG;0;2;2;2;0;run083
13130;GGR;BRB;0;1;1;1;0;run083
13131;GRG;BBB;0;3;3;3;0;run083
13132;GRG;BGB;0;3;3;0;3;run083
13133;GRG;BGG;0;1;1;0;1;run083
13134;GRG;BRB;0;5;5;4;1;run083
13135;GRG;BRR;0;1;1;0;1;run083
13136;GRG;GBB;0;3;3;1;2;run083
13137;GRG;GGB;0;14;14;0;14;run083
13138;GRG;GGG;0;10;10;3;7;run083
13139;GRG;GGR;0;2;2;2;0;run083
13140;GRG;GRR;0;1;1;1;0;run083
13141;GRG;RBR;1;2;3;3;0;run083
13142;GRG;RGG;0;2;2;1;1;run083
13143;GRG;RGR;0;1;1;1;0;run083
13144;GRR;BBB;0;3;3;1;2;run083
13145;GRR;BBR;0;2;2;1;1;run083
13146;GRR;BRB;1;8;9;8;1;run083
13147;GRR;BRR;1;6;7;0;7;run083
13148;GRR;GBB;0;1;1;0;1;run083
13149;GRR;GBG;0;1;1;1;0;run083
13150;GRR;GGR;1;9;10;1;9;run083
13151;GRR;RBR;0;1;1;0;1;run083
13152;GRR;RGG;1;3;4;0;4;run083
13153;GRR;RGR;0;1;1;0;1;run083
13154;GRR;RRR;0;1;1;1;0;run083
13155;RBB;BBB;0;1;1;1;0;run083
13156;RBB;GGG;0;3;3;2;1;run083
13157;RBG;GRR;0;1;1;0;1;run083
13158;RBG;RBR;0;1;1;1;0;run083
13159;RBG;RGR;0;1;1;1;0;run083
13160;RBR;BBB;0;3;3;1;2;run083
13161;RBR;BRB;0;1;1;0;1;run083
13162;RBR;BRR;0;2;2;1;1;run083
13163;RBR;GGG;0;1;1;0;1;run083
13164;RBR;GGR;1;2;3;1;2;run083
13165;RBR;GRG;0;1;1;0;1;run083
13166;RBR;GRR;1;15;16;11;5;run083
13167;RBR;RGG;0;4;4;3;1;run083
13168;RBR;RGR;0;1;1;1;0;run083
13169;RBR;RRR;0;3;3;0;3;run083
13170;RGG;BGG;0;1;1;1;0;run083
13171;RGG;RGR;0;1;1;0;1;run083
13172;RGR;BBB;0;9;9;1;8;run083
13173;RGR;BBR;0;1;1;0;1;run083
13174;RGR;BGB;1;8;9;4;5;run083
13175;RGR;BRB;0;3;3;2;1;run083
13176;RGR;BRR;0;3;3;3;0;run083
13177;RGR;GBG;0;1;1;1;0;run083
13178;RGR;GGB;0;3;3;0;3;run083
13179;RGR;GGG;0;2;2;1;1;run083
13180;RGR;GGR;0;8;8;6;2;run083
13181;RGR;GRR;1;7;8;1;7;run083
13182;RGR;RGG;0;6;6;6;0;run083
13183;RRG;BGB;0;1;1;0;1;run083
13184;RRG;BRB;0;1;1;1;0;run083
13185;RRG;GGG;0;1;1;1;0;run083
13186;RRG;GGR;0;1;1;1;0;run083
13187;RRG;GRG;0;1;1;0;1;run083
13188;RRG;GRR;0;3;3;0;3;run083
13189;RRG;RBR;0;4;4;1;3;run083
13190;RRG;RGG;0;1;1;1;0;run083
13191;RRG;RGR;6;37;43;11;32;run083
13192;RRR;BRR;0;1;1;0;1;run083
13193;RRR;GGB;0;1;1;0;1;run083
13194;RRR;GGG;1;5;6;4;2;run083
13195;RRR;GGR;0;2;2;1;1;run083
13196;RRR;GRR;0;1;1;0;1;run083
13197;RRR;RGR;0;1;1;0;1;run083
13198;BBB;GRR;0;1;1;1;0;run084
13199;BBG;BBB;1;9;10;2;8;run084
13200;BBG;BBR;0;2;2;1;1;run084
13201;BBG;BGB;0;1;1;0;1;run084
13202;BBG;BGG;0;1;1;1;0;run084
13203;BBG;BRB;0;2;2;1;1;run084
13204;BBG;BRR;0;1;1;1;0;run084
13205;BBG;GBB;1;1;2;0;2;run084
13206;BBG;GBG;1;6;7;6;1;run084
13207;BBG;GGB;0;18;18;7;11;run084
13208;BBG;GGG;1;29;30;4;26;run084
13209;BBG;GGR;0;2;2;0;2;run084
13210;BBG;GRG;0;1;1;1;0;run084
13211;BBG;GRR;0;3;3;0;3;run084
13212;BBG;RBR;0;2;2;1;1;run084
13213;BBG;RGR;0;2;2;0;2;run084
13214;BBG;RRG;1;2;3;2;1;run084
13215;BBG;RRR;0;1;1;0;1;run084
13216;BGG;BBB;0;1;1;0;1;run084
13217;BGG;BRB;0;1;1;0;1;run084
13218;BGG;GGG;0;1;1;0;1;run084
13219;BGG;RBB;0;1;1;0;1;run084
13220;BGG;RBG;1;0;1;0;1;run084
13221;BRB;BBB;0;1;1;1;0;run084
13222;BRB;GGB;1;0;1;1;0;run084
13223;BRB;GGG;0;2;2;0;2;run084
13224;BRB;RBB;1;0;1;0;1;run084
13225;BRR;BBB;0;1;1;0;1;run084
13226;BRR;BRB;0;1;1;0;1;run084
13227;BRR;GBB;1;0;1;1;0;run084
13228;GBB;BBB;1;16;17;9;8;run084
13229;GBB;BBG;0;2;2;2;0;run084
13230;GBB;BGB;0;1;1;1;0;run084
13231;GBB;BGG;0;3;3;0;3;run084
13232;GBB;BRB;0;9;9;7;2;run084
13233;GBB;BRR;0;2;2;0;2;run084
13234;GBB;GBG;1;1;2;2;0;run084
13235;GBB;GGB;2;59;61;47;14;run084
13236;GBB;GGG;4;95;99;74;25;run084
13237;GBB;GGR;0;1;1;0;1;run084
13238;GBB;GRG;0;1;1;1;0;run084
13239;GBB;GRR;1;8;9;6;3;run084
13240;GBB;RBB;0;2;2;2;0;run084
13241;GBB;RBG;0;1;1;0;1;run084
13242;GBB;RBR;1;1;2;2;0;run084
13243;GBB;RGG;0;2;2;2;0;run084
13244;GBB;RGR;0;1;1;0;1;run084
13245;GBB;RRG;0;3;3;2;1;run084
13246;GBG;BRB;0;1;1;1;0;run084
13247;GBG;BRR;0;3;3;3;0;run084
13248;GBG;GGB;0;1;1;1;0;run084
13249;GBG;GGR;0;3;3;0;3;run084
13250;GBG;RBR;0;1;1;1;0;run084
13251;GBG;RGR;1;1;2;0;2;run084
13252;GBG;RRR;0;1;1;0;1;run084
13253;GGB;BBB;1;8;9;6;3;run084
13254;GGB;BBG;0;1;1;0;1;run084
13255;GGB;BGB;0;1;1;1;0;run084
13256;GGB;BRB;3;5;8;8;0;run084
13257;GGB;BRR;0;1;1;0;1;run084
13258;GGB;GBG;0;2;2;2;0;run084
13259;GGB;GGG;4;37;41;4;37;run084
13260;GGB;GGR;0;9;9;7;2;run084
13261;GGB;GRR;1;4;5;3;2;run084
13262;GGB;RBB;0;2;2;1;1;run084
13263;GGB;RBG;0;2;2;2;0;run084
13264;GGB;RBR;0;2;2;2;0;run084
13265;GGB;RGG;0;1;1;1;0;run084
13266;GGB;RGR;1;2;3;0;3;run084
13267;GGB;RRG;1;3;4;3;1;run084
13268;GGB;RRR;0;3;3;3;0;run084
13269;GGG;BBB;4;22;26;9;17;run084
13270;GGG;BBG;0;2;2;0;2;run084
13271;GGG;BBR;0;3;3;1;2;run084
13272;GGG;BGB;0;2;2;2;0;run084
13273;GGG;BGG;0;3;3;2;1;run084
13274;GGG;BRB;0;3;3;1;2;run084
13275;GGG;BRR;0;3;3;0;3;run084
13276;GGG;GBB;0;1;1;1;0;run084
13277;GGG;GGB;1;3;4;1;3;run084
13278;GGG;GGR;0;21;21;10;11;run084
13279;GGG;GRG;0;2;2;1;1;run084
13280;GGG;GRR;2;15;17;4;13;run084
13281;GGG;RBB;0;1;1;1;0;run084
13282;GGG;RBR;1;4;5;5;0;run084
13283;GGG;RGG;1;7;8;7;1;run084
13284;GGG;RGR;0;3;3;3;0;run084
13285;GGG;RRG;0;2;2;2;0;run084
13286;GGG;RRR;0;1;1;0;1;run084
13287;GGR;BBB;0;1;1;1;0;run084
13288;GGR;BGG;0;2;2;2;0;run084
13289;GGR;BRB;0;1;1;1;0;run084
13290;GRG;BBB;0;3;3;1;2;run084
13291;GRG;BGB;0;3;3;0;3;run084
13292;GRG;BGG;0;1;1;0;1;run084
13293;GRG;BRB;0;5;5;2;3;run084
13294;GRG;BRR;0;1;1;0;1;run084
13295;GRG;GBB;0;3;3;2;1;run084
13296;GRG;GGB;0;14;14;6;8;run084
13297;GRG;GGG;0;10;10;0;10;run084
13298;GRG;GGR;0;2;2;2;0;run084
13299;GRG;GRR;0;1;1;1;0;run084
13300;GRG;RBR;1;2;3;3;0;run084
13301;GRG;RGG;0;2;2;2;0;run084
13302;GRG;RGR;0;1;1;0;1;run084
13303;GRR;BBB;0;3;3;3;0;run084
13304;GRR;BBR;0;2;2;0;2;run084
13305;GRR;BRB;1;8;9;0;9;run084
13306;GRR;BRR;1;6;7;3;4;run084
13307;GRR;GBB;0;1;1;1;0;run084
13308;GRR;GBG;0;1;1;1;0;run084
13309;GRR;GGR;1;9;10;9;1;run084
13310;GRR;RBR;0;1;1;1;0;run084
13311;GRR;RGG;1;3;4;2;2;run084
13312;GRR;RGR;0;1;1;0;1;run084
13313;GRR;RRR;0;1;1;0;1;run084
13314;RBB;BBB;0;1;1;0;1;run084
13315;RBB;GGG;0;3;3;0;3;run084
13316;RBG;GRR;0;1;1;1;0;run084
13317;RBG;RBR;0;1;1;0;1;run084
13318;RBG;RGR;0;1;1;0;1;run084
13319;RBR;BBB;0;3;3;1;2;run084
13320;RBR;BRB;0;1;1;1;0;run084
13321;RBR;BRR;0;2;2;2;0;run084
13322;RBR;GGG;0;1;1;1;0;run084
13323;RBR;GGR;1;2;3;0;3;run084
13324;RBR;GRG;0;1;1;1;0;run084
13325;RBR;GRR;1;15;16;6;10;run084
13326;RBR;RGG;0;4;4;3;1;run084
13327;RBR;RGR;0;1;1;1;0;run084
13328;RBR;RRR;0;3;3;1;2;run084
13329;RGG;BGG;0;1;1;1;0;run084
13330;RGG;RGR;0;1;1;0;1;run084
13331;RGR;BBB;0;9;9;0;9;run084
13332;RGR;BBR;0;1;1;0;1;run084
13333;RGR;BGB;1;8;9;4;5;run084
13334;RGR;BRB;0;3;3;1;2;run084
13335;RGR;BRR;0;3;3;1;2;run084
13336;RGR;GBG;0;1;1;0;1;run084
13337;RGR;GGB;0;3;3;1;2;run084
13338;RGR;GGG;0;2;2;0;2;run084
13339;RGR;GGR;0;8;8;7;1;run084
13340;RGR;GRR;1;7;8;2;6;run084
13341;RGR;RGG;0;6;6;3;3;run084
13342;RRG;BGB;0;1;1;1;0;run084
13343;RRG;BRB;0;1;1;1;0;run084
13344;RRG;GGG;0;1;1;0;1;run084
13345;RRG;GGR;0;1;1;1;0;run084
13346;RRG;GRG;0;1;1;0;1;run084
13347;RRG;GRR;0;3;3;3;0;run084
13348;RRG;RBR;0;4;4;3;1;run084
13349;RRG;RGG;0;1;1;0;1;run084
13350;RRG;RGR;6;37;43;1;42;run084
13351;RRR;BRR;0;1;1;0;1;run084
13352;RRR;GGB;0;1;1;0;1;run084
13353;RRR;GGG;1;5;6;5;1;run084
13354;RRR;GGR;0;2;2;2;0;run084
13355;RRR;GRR;0;1;1;1;0;run084
13356;RRR;RGR;0;1;1;0;1;run084
13357;BBB;GRR;0;1;1;0;1;run085
13358;BBG;BBB;1;9;10;2;8;run085
13359;BBG;BBR;0;2;2;2;0;run085
13360;BBG;BGB;0;1;1;1;0;run085
13361;BBG;BGG;0;1;1;1;0;run085
13362;BBG;BRB;0;2;2;2;0;run085
13363;BBG;BRR;0;1;1;0;1;run085
13364;BBG;GBB;1;1;2;2;0;run085
13365;BBG;GBG;1;6;7;2;5;run085
13366;BBG;GGB;0;18;18;4;14;run085
13367;BBG;GGG;1;29;30;20;10;run085
13368;BBG;GGR;0;2;2;2;0;run085
13369;BBG;GRG;0;1;1;1;0;run085
13370;BBG;GRR;0;3;3;3;0;run085
13371;BBG;RBR;0;2;2;1;1;run085
13372;BBG;RGR;0;2;2;2;0;run085
13373;BBG;RRG;1;2;3;2;1;run085
13374;BBG;RRR;0;1;1;1;0;run085
13375;BGG;BBB;0;1;1;1;0;run085
13376;BGG;BRB;0;1;1;1;0;run085
13377;BGG;GGG;0;1;1;0;1;run085
13378;BGG;RBB;0;1;1;1;0;run085
13379;BGG;RBG;1;0;1;1;0;run085
13380;BRB;BBB;0;1;1;0;1;run085
13381;BRB;GGB;1;0;1;1;0;run085
13382;BRB;GGG;0;2;2;0;2;run085
13383;BRB;RBB;1;0;1;0;1;run085
13384;BRR;BBB;0;1;1;1;0;run085
13385;BRR;BRB;0;1;1;0;1;run085
13386;BRR;GBB;1;0;1;1;0;run085
13387;GBB;BBB;1;16;17;16;1;run085
13388;GBB;BBG;0;2;2;2;0;run085
13389;GBB;BGB;0;1;1;0;1;run085
13390;GBB;BGG;0;3;3;2;1;run085
13391;GBB;BRB;0;9;9;7;2;run085
13392;GBB;BRR;0;2;2;0;2;run085
13393;GBB;GBG;1;1;2;0;2;run085
13394;GBB;GGB;2;59;61;13;48;run085
13395;GBB;GGG;4;95;99;3;96;run085
13396;GBB;GGR;0;1;1;0;1;run085
13397;GBB;GRG;0;1;1;0;1;run085
13398;GBB;GRR;1;8;9;6;3;run085
13399;GBB;RBB;0;2;2;2;0;run085
13400;GBB;RBG;0;1;1;0;1;run085
13401;GBB;RBR;1;1;2;1;1;run085
13402;GBB;RGG;0;2;2;2;0;run085
13403;GBB;RGR;0;1;1;1;0;run085
13404;GBB;RRG;0;3;3;0;3;run085
13405;GBG;BRB;0;1;1;0;1;run085
13406;GBG;BRR;0;3;3;2;1;run085
13407;GBG;GGB;0;1;1;1;0;run085
13408;GBG;GGR;0;3;3;3;0;run085
13409;GBG;RBR;0;1;1;1;0;run085
13410;GBG;RGR;1;1;2;0;2;run085
13411;GBG;RRR;0;1;1;1;0;run085
13412;GGB;BBB;1;8;9;5;4;run085
13413;GGB;BBG;0;1;1;1;0;run085
13414;GGB;BGB;0;1;1;1;0;run085
13415;GGB;BRB;3;5;8;3;5;run085
13416;GGB;BRR;0;1;1;1;0;run085
13417;GGB;GBG;0;2;2;1;1;run085
13418;GGB;GGG;4;37;41;23;18;run085
13419;GGB;GGR;0;9;9;8;1;run085
13420;GGB;GRR;1;4;5;5;0;run085
13421;GGB;RBB;0;2;2;2;0;run085
13422;GGB;RBG;0;2;2;0;2;run085
13423;GGB;RBR;0;2;2;2;0;run085
13424;GGB;RGG;0;1;1;0;1;run085
13425;GGB;RGR;1;2;3;3;0;run085
13426;GGB;RRG;1;3;4;4;0;run085
13427;GGB;RRR;0;3;3;2;1;run085
13428;GGG;BBB;4;22;26;16;10;run085
13429;GGG;BBG;0;2;2;2;0;run085
13430;GGG;BBR;0;3;3;3;0;run085
13431;GGG;BGB;0;2;2;2;0;run085
13432;GGG;BGG;0;3;3;1;2;run085
13433;GGG;BRB;0;3;3;1;2;run085
13434;GGG;BRR;0;3;3;3;0;run085
13435;GGG;GBB;0;1;1;0;1;run085
13436;GGG;GGB;1;3;4;3;1;run085
13437;GGG;GGR;0;21;21;14;7;run085
13438;GGG;GRG;0;2;2;2;0;run085
13439;GGG;GRR;2;15;17;8;9;run085
13440;GGG;RBB;0;1;1;1;0;run085
13441;GGG;RBR;1;4;5;1;4;run085
13442;GGG;RGG;1;7;8;6;2;run085
13443;GGG;RGR;0;3;3;1;2;run085
13444;GGG;RRG;0;2;2;0;2;run085
13445;GGG;RRR;0;1;1;1;0;run085
13446;GGR;BBB;0;1;1;1;0;run085
13447;GGR;BGG;0;2;2;2;0;run085
13448;GGR;BRB;0;1;1;1;0;run085
13449;GRG;BBB;0;3;3;2;1;run085
13450;GRG;BGB;0;3;3;0;3;run085
13451;GRG;BGG;0;1;1;0;1;run085
13452;GRG;BRB;0;5;5;0;5;run085
13453;GRG;BRR;0;1;1;0;1;run085
13454;GRG;GBB;0;3;3;1;2;run085
13455;GRG;GGB;0;14;14;0;14;run085
13456;GRG;GGG;0;10;10;3;7;run085
13457;GRG;GGR;0;2;2;0;2;run085
13458;GRG;GRR;0;1;1;1;0;run085
13459;GRG;RBR;1;2;3;0;3;run085
13460;GRG;RGG;0;2;2;1;1;run085
13461;GRG;RGR;0;1;1;1;0;run085
13462;GRR;BBB;0;3;3;1;2;run085
13463;GRR;BBR;0;2;2;2;0;run085
13464;GRR;BRB;1;8;9;6;3;run085
13465;GRR;BRR;1;6;7;1;6;run085
13466;GRR;GBB;0;1;1;0;1;run085
13467;GRR;GBG;0;1;1;0;1;run085
13468;GRR;GGR;1;9;10;9;1;run085
13469;GRR;RBR;0;1;1;0;1;run085
13470;GRR;RGG;1;3;4;2;2;run085
13471;GRR;RGR;0;1;1;0;1;run085
13472;GRR;RRR;0;1;1;0;1;run085
13473;RBB;BBB;0;1;1;1;0;run085
13474;RBB;GGG;0;3;3;3;0;run085
13475;RBG;GRR;0;1;1;0;1;run085
13476;RBG;RBR;0;1;1;1;0;run085
13477;RBG;RGR;0;1;1;0;1;run085
13478;RBR;BBB;0;3;3;3;0;run085
13479;RBR;BRB;0;1;1;1;0;run085
13480;RBR;BRR;0;2;2;1;1;run085
13481;RBR;GGG;0;1;1;1;0;run085
13482;RBR;GGR;1;2;3;3;0;run085
13483;RBR;GRG;0;1;1;0;1;run085
13484;RBR;GRR;1;15;16;8;8;run085
13485;RBR;RGG;0;4;4;0;4;run085
13486;RBR;RGR;0;1;1;0;1;run085
13487;RBR;RRR;0;3;3;2;1;run085
13488;RGG;BGG;0;1;1;1;0;run085
13489;RGG;RGR;0;1;1;1;0;run085
13490;RGR;BBB;0;9;9;8;1;run085
13491;RGR;BBR;0;1;1;0;1;run085
13492;RGR;BGB;1;8;9;9;0;run085
13493;RGR;BRB;0;3;3;0;3;run085
13494;RGR;BRR;0;3;3;3;0;run085
13495;RGR;GBG;0;1;1;1;0;run085
13496;RGR;GGB;0;3;3;0;3;run085
13497;RGR;GGG;0;2;2;1;1;run085
13498;RGR;GGR;0;8;8;3;5;run085
13499;RGR;GRR;1;7;8;6;2;run085
13500;RGR;RGG;0;6;6;4;2;run085
13501;RRG;BGB;0;1;1;0;1;run085
13502;RRG;BRB;0;1;1;1;0;run085
13503;RRG;GGG;0;1;1;0;1;run085
13504;RRG;GGR;0;1;1;0;1;run085
13505;RRG;GRG;0;1;1;1;0;run085
13506;RRG;GRR;0;3;3;0;3;run085
13507;RRG;RBR;0;4;4;4;0;run085
13508;RRG;RGG;0;1;1;1;0;run085
13509;RRG;RGR;6;37;43;15;28;run085
13510;RRR;BRR;0;1;1;1;0;run085
13511;RRR;GGB;0;1;1;0;1;run085
13512;RRR;GGG;1;5;6;2;4;run085
13513;RRR;GGR;0;2;2;1;1;run085
13514;RRR;GRR;0;1;1;0;1;run085
13515;RRR;RGR;0;1;1;1;0;run085
13516;BBB;GRR;0;1;1;0;1;run086
13517;BBG;BBB;1;9;10;0;10;run086
13518;BBG;BBR;0;2;2;0;2;run086
13519;BBG;BGB;0;1;1;1;0;run086
13520;BBG;BGG;0;1;1;0;1;run086
13521;BBG;BRB;0;2;2;1;1;run086
13522;BBG;BRR;0;1;1;0;1;run086
13523;BBG;GBB;1;1;2;0;2;run086
13524;BBG;GBG;1;6;7;4;3;run086
13525;BBG;GGB;0;18;18;1;17;run086
13526;BBG;GGG;1;29;30;5;25;run086
13527;BBG;GGR;0;2;2;1;1;run086
13528;BBG;GRG;0;1;1;1;0;run086
13529;BBG;GRR;0;3;3;0;3;run086
13530;BBG;RBR;0;2;2;1;1;run086
13531;BBG;RGR;0;2;2;1;1;run086
13532;BBG;RRG;1;2;3;0;3;run086
13533;BBG;RRR;0;1;1;0;1;run086
13534;BGG;BBB;0;1;1;0;1;run086
13535;BGG;BRB;0;1;1;0;1;run086
13536;BGG;GGG;0;1;1;1;0;run086
13537;BGG;RBB;0;1;1;0;1;run086
13538;BGG;RBG;1;0;1;0;1;run086
13539;BRB;BBB;0;1;1;1;0;run086
13540;BRB;GGB;1;0;1;1;0;run086
13541;BRB;GGG;0;2;2;0;2;run086
13542;BRB;RBB;1;0;1;0;1;run086
13543;BRR;BBB;0;1;1;0;1;run086
13544;BRR;BRB;0;1;1;0;1;run086
13545;BRR;GBB;1;0;1;0;1;run086
13546;GBB;BBB;1;16;17;15;2;run086
13547;GBB;BBG;0;2;2;0;2;run086
13548;GBB;BGB;0;1;1;0;1;run086
13549;GBB;BGG;0;3;3;3;0;run086
13550;GBB;BRB;0;9;9;9;0;run086
13551;GBB;BRR;0;2;2;1;1;run086
13552;GBB;GBG;1;1;2;0;2;run086
13553;GBB;GGB;2;59;61;13;48;run086
13554;GBB;GGG;4;95;99;0;99;run086
13555;GBB;GGR;0;1;1;1;0;run086
13556;GBB;GRG;0;1;1;1;0;run086
13557;GBB;GRR;1;8;9;9;0;run086
13558;GBB;RBB;0;2;2;1;1;run086
13559;GBB;RBG;0;1;1;1;0;run086
13560;GBB;RBR;1;1;2;0;2;run086
13561;GBB;RGG;0;2;2;1;1;run086
13562;GBB;RGR;0;1;1;1;0;run086
13563;GBB;RRG;0;3;3;3;0;run086
13564;GBG;BRB;0;1;1;1;0;run086
13565;GBG;BRR;0;3;3;2;1;run086
13566;GBG;GGB;0;1;1;1;0;run086
13567;GBG;GGR;0;3;3;3;0;run086
13568;GBG;RBR;0;1;1;1;0;run086
13569;GBG;RGR;1;1;2;2;0;run086
13570;GBG;RRR;0;1;1;1;0;run086
13571;GGB;BBB;1;8;9;6;3;run086
13572;GGB;BBG;0;1;1;1;0;run086
13573;GGB;BGB;0;1;1;1;0;run086
13574;GGB;BRB;3;5;8;1;7;run086
13575;GGB;BRR;0;1;1;1;0;run086
13576;GGB;GBG;0;2;2;2;0;run086
13577;GGB;GGG;4;37;41;16;25;run086
13578;GGB;GGR;0;9;9;1;8;run086
13579;GGB;GRR;1;4;5;2;3;run086
13580;GGB;RBB;0;2;2;2;0;run086
13581;GGB;RBG;0;2;2;0;2;run086
13582;GGB;RBR;0;2;2;2;0;run086
13583;GGB;RGG;0;1;1;0;1;run086
13584;GGB;RGR;1;2;3;1;2;run086
13585;GGB;RRG;1;3;4;2;2;run086
13586;GGB;RRR;0;3;3;1;2;run086
13587;GGG;BBB;4;22;26;2;24;run086
13588;GGG;BBG;0;2;2;1;1;run086
13589;GGG;BBR;0;3;3;2;1;run086
13590;GGG;BGB;0;2;2;0;2;run086
13591;GGG;BGG;0;3;3;1;2;run086
13592;GGG;BRB;0;3;3;3;0;run086
13593;GGG;BRR;0;3;3;1;2;run086
13594;GGG;GBB;0;1;1;1;0;run086
13595;GGG;GGB;1;3;4;0;4;run086
13596;GGG;GGR;0;21;21;13;8;run086
13597;GGG;GRG;0;2;2;0;2;run086
13598;GGG;GRR;2;15;17;7;10;run086
13599;GGG;RBB;0;1;1;0;1;run086
13600;GGG;RBR;1;4;5;3;2;run086
13601;GGG;RGG;1;7;8;7;1;run086
13602;GGG;RGR;0;3;3;0;3;run086
13603;GGG;RRG;0;2;2;0;2;run086
13604;GGG;RRR;0;1;1;0;1;run086
13605;GGR;BBB;0;1;1;0;1;run086
13606;GGR;BGG;0;2;2;0;2;run086
13607;GGR;BRB;0;1;1;1;0;run086
13608;GRG;BBB;0;3;3;1;2;run086
13609;GRG;BGB;0;3;3;0;3;run086
13610;GRG;BGG;0;1;1;1;0;run086
13611;GRG;BRB;0;5;5;5;0;run086
13612;GRG;BRR;0;1;1;0;1;run086
13613;GRG;GBB;0;3;3;1;2;run086
13614;GRG;GGB;0;14;14;5;9;run086
13615;GRG;GGG;0;10;10;0;10;run086
13616;GRG;GGR;0;2;2;1;1;run086
13617;GRG;GRR;0;1;1;1;0;run086
13618;GRG;RBR;1;2;3;2;1;run086
13619;GRG;RGG;0;2;2;0;2;run086
13620;GRG;RGR;0;1;1;0;1;run086
13621;GRR;BBB;0;3;3;1;2;run086
13622;GRR;BBR;0;2;2;0;2;run086
13623;GRR;BRB;1;8;9;7;2;run086
13624;GRR;BRR;1;6;7;3;4;run086
13625;GRR;GBB;0;1;1;1;0;run086
13626;GRR;GBG;0;1;1;1;0;run086
13627;GRR;GGR;1;9;10;1;9;run086
13628;GRR;RBR;0;1;1;1;0;run086
13629;GRR;RGG;1;3;4;1;3;run086
13630;GRR;RGR;0;1;1;0;1;run086
13631;GRR;RRR;0;1;1;1;0;run086
13632;RBB;BBB;0;1;1;0;1;run086
13633;RBB;GGG;0;3;3;3;0;run086
13634;RBG;GRR;0;1;1;1;0;run086
13635;RBG;RBR;0;1;1;1;0;run086
13636;RBG;RGR;0;1;1;0;1;run086
13637;RBR;BBB;0;3;3;2;1;run086
13638;RBR;BRB;0;1;1;1;0;run086
13639;RBR;BRR;0;2;2;2;0;run086
13640;RBR;GGG;0;1;1;0;1;run086
13641;RBR;GGR;1;2;3;3;0;run086
13642;RBR;GRG;0;1;1;0;1;run086
13643;RBR;GRR;1;15;16;6;10;run086
13644;RBR;RGG;0;4;4;2;2;run086
13645;RBR;RGR;0;1;1;1;0;run086
13646;RBR;RRR;0;3;3;1;2;run086
13647;RGG;BGG;0;1;1;0;1;run086
13648;RGG;RGR;0;1;1;1;0;run086
13649;RGR;BBB;0;9;9;7;2;run086
13650;RGR;BBR;0;1;1;1;0;run086
13651;RGR;BGB;1;8;9;5;4;run086
13652;RGR;BRB;0;3;3;2;1;run086
13653;RGR;BRR;0;3;3;3;0;run086
13654;RGR;GBG;0;1;1;1;0;run086
13655;RGR;GGB;0;3;3;2;1;run086
13656;RGR;GGG;0;2;2;1;1;run086
13657;RGR;GGR;0;8;8;0;8;run086
13658;RGR;GRR;1;7;8;0;8;run086
13659;RGR;RGG;0;6;6;2;4;run086
13660;RRG;BGB;0;1;1;0;1;run086
13661;RRG;BRB;0;1;1;0;1;run086
13662;RRG;GGG;0;1;1;0;1;run086
13663;RRG;GGR;0;1;1;1;0;run086
13664;RRG;GRG;0;1;1;1;0;run086
13665;RRG;GRR;0;3;3;0;3;run086
13666;RRG;RBR;0;4;4;2;2;run086
13667;RRG;RGG;0;1;1;0;1;run086
13668;RRG;RGR;6;37;43;4;39;run086
13669;RRR;BRR;0;1;1;0;1;run086
13670;RRR;GGB;0;1;1;1;0;run086
13671;RRR;GGG;1;5;6;2;4;run086
13672;RRR;GGR;0;2;2;1;1;run086
13673;RRR;GRR;0;1;1;1;0;run086
13674;RRR;RGR;0;1;1;0;1;run086
13675;BBB;GRR;0;1;1;1;0;run087
13676;BBG;BBB;1;9;10;9;1;run087
13677;BBG;BBR;0;2;2;2;0;run087
13678;BBG;BGB;0;1;1;1;0;run087
13679;BBG;BGG;0;1;1;0;1;run087
13680;BBG;BRB;0;2;2;2;0;run087
13681;BBG;BRR;0;1;1;0;1;run087
13682;BBG;GBB;1;1;2;1;1;run087
13683;BBG;GBG;1;6;7;7;0;run087
13684;BBG;GGB;0;18;18;5;13;run087
13685;BBG;GGG;1;29;30;27;3;run087
13686;BBG;GGR;0;2;2;1;1;run087
13687;BBG;GRG;0;1;1;0;1;run087
13688;BBG;GRR;0;3;3;2;1;run087
13689;BBG;RBR;0;2;2;1;1;run087
13690;BBG;RGR;0;2;2;2;0;run087
13691;BBG;RRG;1;2;3;0;3;run087
13692;BBG;RRR;0;1;1;0;1;run087
13693;BGG;BBB;0;1;1;1;0;run087
13694;BGG;BRB;0;1;1;0;1;run087
13695;BGG;GGG;0;1;1;0;1;run087
13696;BGG;RBB;0;1;1;1;0;run087
13697;BGG;RBG;1;0;1;0;1;run087
13698;BRB;BBB;0;1;1;0;1;run087
13699;BRB;GGB;1;0;1;1;0;run087
13700;BRB;GGG;0;2;2;0;2;run087
13701;BRB;RBB;1;0;1;1;0;run087
13702;BRR;BBB;0;1;1;1;0;run087
13703;BRR;BRB;0;1;1;1;0;run087
13704;BRR;GBB;1;0;1;1;0;run087
13705;GBB;BBB;1;16;17;5;12;run087
13706;GBB;BBG;0;2;2;2;0;run087
13707;GBB;BGB;0;1;1;1;0;run087
13708;GBB;BGG;0;3;3;1;2;run087
13709;GBB;BRB;0;9;9;3;6;run087
13710;GBB;BRR;0;2;2;2;0;run087
13711;GBB;GBG;1;1;2;1;1;run087
13712;GBB;GGB;2;59;61;24;37;run087
13713;GBB;GGG;4;95;99;56;43;run087
13714;GBB;GGR;0;1;1;0;1;run087
13715;GBB;GRG;0;1;1;1;0;run087
13716;GBB;GRR;1;8;9;4;5;run087
13717;GBB;RBB;0;2;2;0;2;run087
13718;GBB;RBG;0;1;1;0;1;run087
13719;GBB;RBR;1;1;2;1;1;run087
13720;GBB;RGG;0;2;2;2;0;run087
13721;GBB;RGR;0;1;1;1;0;run087
13722;GBB;RRG;0;3;3;2;1;run087
13723;GBG;BRB;0;1;1;1;0;run087
13724;GBG;BRR;0;3;3;1;2;run087
13725;GBG;GGB;0;1;1;0;1;run087
13726;GBG;GGR;0;3;3;1;2;run087
13727;GBG;RBR;0;1;1;1;0;run087
13728;GBG;RGR;1;1;2;2;0;run087
13729;GBG;RRR;0;1;1;0;1;run087
13730;GGB;BBB;1;8;9;2;7;run087
13731;GGB;BBG;0;1;1;0;1;run087
13732;GGB;BGB;0;1;1;1;0;run087
13733;GGB;BRB;3;5;8;8;0;run087
13734;GGB;BRR;0;1;1;0;1;run087
13735;GGB;GBG;0;2;2;0;2;run087
13736;GGB;GGG;4;37;41;31;10;run087
13737;GGB;GGR;0;9;9;5;4;run087
13738;GGB;GRR;1;4;5;1;4;run087
13739;GGB;RBB;0;2;2;1;1;run087
13740;GGB;RBG;0;2;2;0;2;run087
13741;GGB;RBR;0;2;2;2;0;run087
13742;GGB;RGG;0;1;1;1;0;run087
13743;GGB;RGR;1;2;3;1;2;run087
13744;GGB;RRG;1;3;4;3;1;run087
13745;GGB;RRR;0;3;3;1;2;run087
13746;GGG;BBB;4;22;26;24;2;run087
13747;GGG;BBG;0;2;2;1;1;run087
13748;GGG;BBR;0;3;3;3;0;run087
13749;GGG;BGB;0;2;2;0;2;run087
13750;GGG;BGG;0;3;3;2;1;run087
13751;GGG;BRB;0;3;3;3;0;run087
13752;GGG;BRR;0;3;3;1;2;run087
13753;GGG;GBB;0;1;1;1;0;run087
13754;GGG;GGB;1;3;4;0;4;run087
13755;GGG;GGR;0;21;21;4;17;run087
13756;GGG;GRG;0;2;2;1;1;run087
13757;GGG;GRR;2;15;17;2;15;run087
13758;GGG;RBB;0;1;1;1;0;run087
13759;GGG;RBR;1;4;5;4;1;run087
13760;GGG;RGG;1;7;8;1;7;run087
13761;GGG;RGR;0;3;3;0;3;run087
13762;GGG;RRG;0;2;2;2;0;run087
13763;GGG;RRR;0;1;1;1;0;run087
13764;GGR;BBB;0;1;1;0;1;run087
13765;GGR;BGG;0;2;2;1;1;run087
13766;GGR;BRB;0;1;1;0;1;run087
13767;GRG;BBB;0;3;3;1;2;run087
13768;GRG;BGB;0;3;3;2;1;run087
13769;GRG;BGG;0;1;1;1;0;run087
13770;GRG;BRB;0;5;5;3;2;run087
13771;GRG;BRR;0;1;1;1;0;run087
13772;GRG;GBB;0;3;3;1;2;run087
13773;GRG;GGB;0;14;14;2;12;run087
13774;GRG;GGG;0;10;10;9;1;run087
13775;GRG;GGR;0;2;2;2;0;run087
13776;GRG;GRR;0;1;1;0;1;run087
13777;GRG;RBR;1;2;3;1;2;run087
13778;GRG;RGG;0;2;2;1;1;run087
13779;GRG;RGR;0;1;1;1;0;run087
13780;GRR;BBB;0;3;3;0;3;run087
13781;GRR;BBR;0;2;2;2;0;run087
13782;GRR;BRB;1;8;9;2;7;run087
13783;GRR;BRR;1;6;7;6;1;run087
13784;GRR;GBB;0;1;1;0;1;run087
13785;GRR;GBG;0;1;1;1;0;run087
13786;GRR;GGR;1;9;10;7;3;run087
13787;GRR;RBR;0;1;1;1;0;run087
13788;GRR;RGG;1;3;4;2;2;run087
13789;GRR;RGR;0;1;1;0;1;run087
13790;GRR;RRR;0;1;1;1;0;run087
13791;RBB;BBB;0;1;1;0;1;run087
13792;RBB;GGG;0;3;3;2;1;run087
13793;RBG;GRR;0;1;1;1;0;run087
13794;RBG;RBR;0;1;1;1;0;run087
13795;RBG;RGR;0;1;1;1;0;run087
13796;RBR;BBB;0;3;3;2;1;run087
13797;RBR;BRB;0;1;1;1;0;run087
13798;RBR;BRR;0;2;2;2;0;run087
13799;RBR;GGG;0;1;1;1;0;run087
13800;RBR;GGR;1;2;3;2;1;run087
13801;RBR;GRG;0;1;1;0;1;run087
13802;RBR;GRR;1;15;16;1;15;run087
13803;RBR;RGG;0;4;4;2;2;run087
13804;RBR;RGR;0;1;1;0;1;run087
13805;RBR;RRR;0;3;3;1;2;run087
13806;RGG;BGG;0;1;1;0;1;run087
13807;RGG;RGR;0;1;1;1;0;run087
13808;RGR;BBB;0;9;9;8;1;run087
13809;RGR;BBR;0;1;1;0;1;run087
13810;RGR;BGB;1;8;9;9;0;run087
13811;RGR;BRB;0;3;3;3;0;run087
13812;RGR;BRR;0;3;3;1;2;run087
13813;RGR;GBG;0;1;1;0;1;run087
13814;RGR;GGB;0;3;3;3;0;run087
13815;RGR;GGG;0;2;2;0;2;run087
13816;RGR;GGR;0;8;8;1;7;run087
13817;RGR;GRR;1;7;8;5;3;run087
13818;RGR;RGG;0;6;6;3;3;run087
13819;RRG;BGB;0;1;1;1;0;run087
13820;RRG;BRB;0;1;1;0;1;run087
13821;RRG;GGG;0;1;1;0;1;run087
13822;RRG;GGR;0;1;1;0;1;run087
13823;RRG;GRG;0;1;1;1;0;run087
13824;RRG;GRR;0;3;3;2;1;run087
13825;RRG;RBR;0;4;4;0;4;run087
13826;RRG;RGG;0;1;1;1;0;run087
13827;RRG;RGR;6;37;43;8;35;run087
13828;RRR;BRR;0;1;1;0;1;run087
13829;RRR;GGB;0;1;1;1;0;run087
13830;RRR;GGG;1;5;6;2;4;run087
13831;RRR;GGR;0;2;2;0;2;run087
13832;RRR;GRR;0;1;1;1;0;run087
13833;RRR;RGR;0;1;1;0;1;run087
13834;BBB;GRR;0;1;1;0;1;run088
13835;BBG;BBB;1;9;10;5;5;run088
13836;BBG;BBR;0;2;2;2;0;run088
13837;BBG;BGB;0;1;1;0;1;run088
13838;BBG;BGG;0;1;1;1;0;run088
13839;BBG;BRB;0;2;2;0;2;run088
13840;BBG;BRR;0;1;1;0;1;run088
13841;BBG;GBB;1;1;2;0;2;run088
13842;BBG;GBG;1;6;7;7;0;run088
13843;BBG;GGB;0;18;18;1;17;run088
13844;BBG;GGG;1;29;30;14;16;run088
13845;BBG;GGR;0;2;2;0;2;run088
13846;BBG;GRG;0;1;1;0;1;run088
13847;BBG;GRR;0;3;3;3;0;run088
13848;BBG;RBR;0;2;2;1;1;run088
13849;BBG;RGR;0;2;2;1;1;run088
13850;BBG;RRG;1;2;3;2;1;run088
13851;BBG;RRR;0;1;1;0;1;run088
13852;BGG;BBB;0;1;1;0;1;run088
13853;BGG;BRB;0;1;1;0;1;run088
13854;BGG;GGG;0;1;1;0;1;run088
13855;BGG;RBB;0;1;1;0;1;run088
13856;BGG;RBG;1;0;1;0;1;run088
13857;BRB;BBB;0;1;1;1;0;run088
13858;BRB;GGB;1;0;1;1;0;run088
13859;BRB;GGG;0;2;2;1;1;run088
13860;BRB;RBB;1;0;1;1;0;run088
13861;BRR;BBB;0;1;1;0;1;run088
13862;BRR;BRB;0;1;1;1;0;run088
13863;BRR;GBB;1;0;1;1;0;run088
13864;GBB;BBB;1;16;17;9;8;run088
13865;GBB;BBG;0;2;2;0;2;run088
13866;GBB;BGB;0;1;1;1;0;run088
13867;GBB;BGG;0;3;3;2;1;run088
13868;GBB;BRB;0;9;9;6;3;run088
13869;GBB;BRR;0;2;2;2;0;run088
13870;GBB;GBG;1;1;2;2;0;run088
13871;GBB;GGB;2;59;61;54;7;run088
13872;GBB;GGG;4;95;99;81;18;run088
13873;GBB;GGR;0;1;1;1;0;run088
13874;GBB;GRG;0;1;1;1;0;run088
13875;GBB;GRR;1;8;9;1;8;run088
13876;GBB;RBB;0;2;2;0;2;run088
13877;GBB;RBG;0;1;1;1;0;run088
13878;GBB;RBR;1;1;2;2;0;run088
13879;GBB;RGG;0;2;2;2;0;run088
13880;GBB;RGR;0;1;1;1;0;run088
13881;GBB;RRG;0;3;3;3;0;run088
13882;GBG;BRB;0;1;1;0;1;run088
13883;GBG;BRR;0;3;3;3;0;run088
13884;GBG;GGB;0;1;1;1;0;run088
13885;GBG;GGR;0;3;3;3;0;run088
13886;GBG;RBR;0;1;1;1;0;run088
13887;GBG;RGR;1;1;2;2;0;run088
13888;GBG;RRR;0;1;1;1;0;run088
13889;GGB;BBB;1;8;9;7;2;run088
13890;GGB;BBG;0;1;1;0;1;run088
13891;GGB;BGB;0;1;1;1;0;run088
13892;GGB;BRB;3;5;8;8;0;run088
13893;GGB;BRR;0;1;1;1;0;run088
13894;GGB;GBG;0;2;2;0;2;run088
13895;GGB;GGG;4;37;41;28;13;run088
13896;GGB;GGR;0;9;9;0;9;run088
13897;GGB;GRR;1;4;5;0;5;run088
13898;GGB;RBB;0;2;2;2;0;run088
13899;GGB;RBG;0;2;2;0;2;run088
13900;GGB;RBR;0;2;2;2;0;run088
13901;GGB;RGG;0;1;1;1;0;run088
13902;GGB;RGR;1;2;3;3;0;run088
13903;GGB;RRG;1;3;4;2;2;run088
13904;GGB;RRR;0;3;3;2;1;run088
13905;GGG;BBB;4;22;26;15;11;run088
13906;GGG;BBG;0;2;2;1;1;run088
13907;GGG;BBR;0;3;3;1;2;run088
13908;GGG;BGB;0;2;2;1;1;run088
13909;GGG;BGG;0;3;3;3;0;run088
13910;GGG;BRB;0;3;3;3;0;run088
13911;GGG;BRR;0;3;3;2;1;run088
13912;GGG;GBB;0;1;1;0;1;run088
13913;GGG;GGB;1;3;4;1;3;run088
13914;GGG;GGR;0;21;21;11;10;run088
13915;GGG;GRG;0;2;2;2;0;run088
13916;GGG;GRR;2;15;17;2;15;run088
13917;GGG;RBB;0;1;1;1;0;run088
13918;GGG;RBR;1;4;5;5;0;run088
13919;GGG;RGG;1;7;8;4;4;run088
13920;GGG;RGR;0;3;3;2;1;run088
13921;GGG;RRG;0;2;2;2;0;run088
13922;GGG;RRR;0;1;1;0;1;run088
13923;GGR;BBB;0;1;1;1;0;run088
13924;GGR;BGG;0;2;2;2;0;run088
13925;GGR;BRB;0;1;1;0;1;run088
13926;GRG;BBB;0;3;3;0;3;run088
13927;GRG;BGB;0;3;3;2;1;run088
13928;GRG;BGG;0;1;1;0;1;run088
13929;GRG;BRB;0;5;5;2;3;run088
13930;GRG;BRR;0;1;1;1;0;run088
13931;GRG;GBB;0;3;3;3;0;run088
13932;GRG;GGB;0;14;14;7;7;run088
13933;GRG;GGG;0;10;10;5;5;run088
13934;GRG;GGR;0;2;2;1;1;run088
13935;GRG;GRR;0;1;1;1;0;run088
13936;GRG;RBR;1;2;3;3;0;run088
13937;GRG;RGG;0;2;2;2;0;run088
13938;GRG;RGR;0;1;1;1;0;run088
13939;GRR;BBB;0;3;3;1;2;run088
13940;GRR;BBR;0;2;2;2;0;run088
13941;GRR;BRB;1;8;9;2;7;run088
13942;GRR;BRR;1;6;7;1;6;run088
13943;GRR;GBB;0;1;1;0;1;run088
13944;GRR;GBG;0;1;1;0;1;run088
13945;GRR;GGR;1;9;10;7;3;run088
13946;GRR;RBR;0;1;1;1;0;run088
13947;GRR;RGG;1;3;4;0;4;run088
13948;GRR;RGR;0;1;1;0;1;run088
13949;GRR;RRR;0;1;1;0;1;run088
13950;RBB;BBB;0;1;1;0;1;run088
13951;RBB;GGG;0;3;3;0;3;run088
13952;RBG;GRR;0;1;1;0;1;run088
13953;RBG;RBR;0;1;1;1;0;run088
13954;RBG;RGR;0;1;1;0;1;run088
13955;RBR;BBB;0;3;3;2;1;run088
13956;RBR;BRB;0;1;1;0;1;run088
13957;RBR;BRR;0;2;2;0;2;run088
13958;RBR;GGG;0;1;1;1;0;run088
13959;RBR;GGR;1;2;3;3;0;run088
13960;RBR;GRG;0;1;1;1;0;run088
13961;RBR;GRR;1;15;16;8;8;run088
13962;RBR;RGG;0;4;4;0;4;run088
13963;RBR;RGR;0;1;1;1;0;run088
13964;RBR;RRR;0;3;3;3;0;run088
13965;RGG;BGG;0;1;1;0;1;run088
13966;RGG;RGR;0;1;1;0;1;run088
13967;RGR;BBB;0;9;9;1;8;run088
13968;RGR;BBR;0;1;1;0;1;run088
13969;RGR;BGB;1;8;9;5;4;run088
13970;RGR;BRB;0;3;3;1;2;run088
13971;RGR;BRR;0;3;3;3;0;run088
13972;RGR;GBG;0;1;1;0;1;run088
13973;RGR;GGB;0;3;3;3;0;run088
13974;RGR;GGG;0;2;2;2;0;run088
13975;RGR;GGR;0;8;8;3;5;run088
13976;RGR;GRR;1;7;8;8;0;run088
13977;RGR;RGG;0;6;6;4;2;run088
13978;RRG;BGB;0;1;1;1;0;run088
13979;RRG;BRB;0;1;1;0;1;run088
13980;RRG;GGG;0;1;1;1;0;run088
13981;RRG;GGR;0;1;1;1;0;run088
13982;RRG;GRG;0;1;1;1;0;run088
13983;RRG;GRR;0;3;3;2;1;run088
13984;RRG;RBR;0;4;4;0;4;run088
13985;RRG;RGG;0;1;1;1;0;run088
13986;RRG;RGR;6;37;43;18;25;run088
13987;RRR;BRR;0;1;1;1;0;run088
13988;RRR;GGB;0;1;1;0;1;run088
13989;RRR;GGG;1;5;6;2;4;run088
13990;RRR;GGR;0;2;2;1;1;run088
13991;RRR;GRR;0;1;1;1;0;run088
13992;RRR;RGR;0;1;1;0;1;run088
13993;BBB;GRR;0;1;1;0;1;run089
13994;BBG;BBB;1;9;10;6;4;run089
13995;BBG;BBR;0;2;2;2;0;run089
13996;BBG;BGB;0;1;1;0;1;run089
13997;BBG;BGG;0;1;1;0;1;run089
13998;BBG;BRB;0;2;2;1;1;run089
13999;BBG;BRR;0;1;1;1;0;run089
14000;BBG;GBB;1;1;2;1;1;run089
14001;BBG;GBG;1;6;7;3;4;run089
14002;BBG;GGB;0;18;18;17;1;run089
14003;BBG;GGG;1;29;30;29;1;run089
14004;BBG;GGR;0;2;2;2;0;run089
14005;BBG;GRG;0;1;1;1;0;run089
14006;BBG;GRR;0;3;3;2;1;run089
14007;BBG;RBR;0;2;2;2;0;run089
14008;BBG;RGR;0;2;2;0;2;run089
14009;BBG;RRG;1;2;3;2;1;run089
14010;BBG;RRR;0;1;1;0;1;run089
14011;BGG;BBB;0;1;1;1;0;run089
14012;BGG;BRB;0;1;1;1;0;run089
14013;BGG;GGG;0;1;1;1;0;run089
14014;BGG;RBB;0;1;1;0;1;run089
14015;BGG;RBG;1;0;1;1;0;run089
14016;BRB;BBB;0;1;1;0;1;run089
14017;BRB;GGB;1;0;1;0;1;run089
14018;BRB;GGG;0;2;2;2;0;run089
14019;BRB;RBB;1;0;1;1;0;run089
14020;BRR;BBB;0;1;1;0;1;run089
14021;BRR;BRB;0;1;1;1;0;run089
14022;BRR;GBB;1;0;1;0;1;run089
14023;GBB;BBB;1;16;17;15;2;run089
14024;GBB;BBG;0;2;2;0;2;run089
14025;GBB;BGB;0;1;1;1;0;run089
14026;GBB;BGG;0;3;3;2;1;run089
14027;GBB;BRB;0;9;9;6;3;run089
14028;GBB;BRR;0;2;2;0;2;run089
14029;GBB;GBG;1;1;2;2;0;run089
14030;GBB;GGB;2;59;61;48;13;run089
14031;GBB;GGG;4;95;99;68;31;run089
14032;GBB;GGR;0;1;1;1;0;run089
14033;GBB;GRG;0;1;1;0;1;run089
14034;GBB;GRR;1;8;9;8;1;run089
14035;GBB;RBB;0;2;2;1;1;run089
14036;GBB;RBG;0;1;1;1;0;run089
14037;GBB;RBR;1;1;2;1;1;run089
14038;GBB;RGG;0;2;2;2;0;run089
14039;GBB;RGR;0;1;1;1;0;run089
14040;GBB;RRG;0;3;3;1;2;run089
14041;GBG;BRB;0;1;1;0;1;run089
14042;GBG;BRR;0;3;3;3;0;run089
14043;GBG;GGB;0;1;1;0;1;run089
14044;GBG;GGR;0;3;3;3;0;run089
14045;GBG;RBR;0;1;1;0;1;run089
14046;GBG;RGR;1;1;2;0;2;run089
14047;GBG;RRR;0;1;1;0;1;run089
14048;GGB;BBB;1;8;9;8;1;run089
14049;GGB;BBG;0;1;1;1;0;run089
14050;GGB;BGB;0;1;1;1;0;run089
14051;GGB;BRB;3;5;8;1;7;run089
14052;GGB;BRR;0;1;1;0;1;run089
14053;GGB;GBG;0;2;2;0;2;run089
14054;GGB;GGG;4;37;41;9;32;run089
14055;GGB;GGR;0;9;9;5;4;run089
14056;GGB;GRR;1;4;5;3;2;run089
14057;GGB;RBB;0;2;2;1;1;run089
14058;GGB;RBG;0;2;2;0;2;run089
14059;GGB;RBR;0;2;2;2;0;run089
14060;GGB;RGG;0;1;1;0;1;run089
14061;GGB;RGR;1;2;3;1;2;run089
14062;GGB;RRG;1;3;4;0;4;run089
14063;GGB;RRR;0;3;3;1;2;run089
14064;GGG;BBB;4;22;26;16;10;run089
14065;GGG;BBG;0;2;2;1;1;run089
14066;GGG;BBR;0;3;3;0;3;run089
14067;GGG;BGB;0;2;2;0;2;run089
14068;GGG;BGG;0;3;3;0;3;run089
14069;GGG;BRB;0;3;3;2;1;run089
14070;GGG;BRR;0;3;3;3;0;run089
14071;GGG;GBB;0;1;1;0;1;run089
14072;GGG;GGB;1;3;4;4;0;run089
14073;GGG;GGR;0;21;21;6;15;run089
14074;GGG;GRG;0;2;2;2;0;run089
14075;GGG;GRR;2;15;17;8;9;run089
14076;GGG;RBB;0;1;1;0;1;run089
14077;GGG;RBR;1;4;5;1;4;run089
14078;GGG;RGG;1;7;8;0;8;run089
14079;GGG;RGR;0;3;3;1;2;run089
14080;GGG;RRG;0;2;2;0;2;run089
14081;GGG;RRR;0;1;1;0;1;run089
14082;GGR;BBB;0;1;1;0;1;run089
14083;GGR;BGG;0;2;2;2;0;run089
14084;GGR;BRB;0;1;1;1;0;run089
14085;GRG;BBB;0;3;3;0;3;run089
14086;GRG;BGB;0;3;3;1;2;run089
14087;GRG;BGG;0;1;1;0;1;run089
14088;GRG;BRB;0;5;5;2;3;run089
14089;GRG;BRR;0;1;1;0;1;run089
14090;GRG;GBB;0;3;3;2;1;run089
14091;GRG;GGB;0;14;14;2;12;run089
14092;GRG;GGG;0;10;10;1;9;run089
14093;GRG;GGR;0;2;2;1;1;run089
14094;GRG;GRR;0;1;1;0;1;run089
14095;GRG;RBR;1;2;3;0;3;run089
14096;GRG;RGG;0;2;2;0;2;run089
14097;GRG;RGR;0;1;1;1;0;run089
14098;GRR;BBB;0;3;3;2;1;run089
14099;GRR;BBR;0;2;2;1;1;run089
14100;GRR;BRB;1;8;9;8;1;run089
14101;GRR;BRR;1;6;7;5;2;run089
14102;GRR;GBB;0;1;1;0;1;run089
14103;GRR;GBG;0;1;1;0;1;run089
14104;GRR;GGR;1;9;10;7;3;run089
14105;GRR;RBR;0;1;1;0;1;run089
14106;GRR;RGG;1;3;4;0;4;run089
14107;GRR;RGR;0;1;1;0;1;run089
14108;GRR;RRR;0;1;1;0;1;run089
14109;RBB;BBB;0;1;1;0;1;run089
14110;RBB;GGG;0;3;3;0;3;run089
14111;RBG;GRR;0;1;1;1;0;run089
14112;RBG;RBR;0;1;1;1;0;run089
14113;RBG;RGR;0;1;1;1;0;run089
14114;RBR;BBB;0;3;3;0;3;run089
14115;RBR;BRB;0;1;1;0;1;run089
14116;RBR;BRR;0;2;2;0;2;run089
14117;RBR;GGG;0;1;1;1;0;run089
14118;RBR;GGR;1;2;3;2;1;run089
14119;RBR;GRG;0;1;1;1;0;run089
14120;RBR;GRR;1;15;16;2;14;run089
14121;RBR;RGG;0;4;4;3;1;run089
14122;RBR;RGR;0;1;1;0;1;run089
14123;RBR;RRR;0;3;3;2;1;run089
14124;RGG;BGG;0;1;1;1;0;run089
14125;RGG;RGR;0;1;1;1;0;run089
14126;RGR;BBB;0;9;9;4;5;run089
14127;RGR;BBR;0;1;1;0;1;run089
14128;RGR;BGB;1;8;9;0;9;run089
14129;RGR;BRB;0;3;3;0;3;run089
14130;RGR;BRR;0;3;3;0;3;run089
14131;RGR;GBG;0;1;1;1;0;run089
14132;RGR;GGB;0;3;3;3;0;run089
14133;RGR;GGG;0;2;2;0;2;run089
14134;RGR;GGR;0;8;8;2;6;run089
14135;RGR;GRR;1;7;8;6;2;run089
14136;RGR;RGG;0;6;6;1;5;run089
14137;RRG;BGB;0;1;1;1;0;run089
14138;RRG;BRB;0;1;1;1;0;run089
14139;RRG;GGG;0;1;1;1;0;run089
14140;RRG;GGR;0;1;1;1;0;run089
14141;RRG;GRG;0;1;1;0;1;run089
14142;RRG;GRR;0;3;3;0;3;run089
14143;RRG;RBR;0;4;4;1;3;run089
14144;RRG;RGG;0;1;1;1;0;run089
14145;RRG;RGR;6;37;43;29;14;run089
14146;RRR;BRR;0;1;1;0;1;run089
14147;RRR;GGB;0;1;1;1;0;run089
14148;RRR;GGG;1;5;6;4;2;run089
14149;RRR;GGR;0;2;2;1;1;run089
14150;RRR;GRR;0;1;1;0;1;run089
14151;RRR;RGR;0;1;1;1;0;run089
14152;BBB;GRR;0;1;1;1;0;run090
14153;BBG;BBB;1;9;10;3;7;run090
14154;BBG;BBR;0;2;2;1;1;run090
14155;BBG;BGB;0;1;1;1;0;run090
14156;BBG;BGG;0;1;1;0;1;run090
14157;BBG;BRB;0;2;2;0;2;run090
14158;BBG;BRR;0;1;1;0;1;run090
14159;BBG;GBB;1;1;2;0;2;run090
14160;BBG;GBG;1;6;7;1;6;run090
14161;BBG;GGB;0;18;18;4;14;run090
14162;BBG;GGG;1;29;30;10;20;run090
14163;BBG;GGR;0;2;2;1;1;run090
14164;BBG;GRG;0;1;1;0;1;run090
14165;BBG;GRR;0;3;3;3;0;run090
14166;BBG;RBR;0;2;2;2;0;run090
14167;BBG;RGR;0;2;2;0;2;run090
14168;BBG;RRG;1;2;3;3;0;run090
14169;BBG;RRR;0;1;1;0;1;run090
14170;BGG;BBB;0;1;1;0;1;run090
14171;BGG;BRB;0;1;1;0;1;run090
14172;BGG;GGG;0;1;1;0;1;run090
14173;BGG;RBB;0;1;1;0;1;run090
14174;BGG;RBG;1;0;1;0;1;run090
14175;BRB;BBB;0;1;1;1;0;run090
14176;BRB;GGB;1;0;1;1;0;run090
14177;BRB;GGG;0;2;2;2;0;run090
14178;BRB;RBB;1;0;1;0;1;run090
14179;BRR;BBB;0;1;1;1;0;run090
14180;BRR;BRB;0;1;1;0;1;run090
14181;BRR;GBB;1;0;1;1;0;run090
14182;GBB;BBB;1;16;17;13;4;run090
14183;GBB;BBG;0;2;2;2;0;run090
14184;GBB;BGB;0;1;1;0;1;run090
14185;GBB;BGG;0;3;3;2;1;run090
14186;GBB;BRB;0;9;9;9;0;run090
14187;GBB;BRR;0;2;2;1;1;run090
14188;GBB;GBG;1;1;2;1;1;run090
14189;GBB;GGB;2;59;61;7;54;run090
14190;GBB;GGG;4;95;99;91;8;run090
14191;GBB;GGR;0;1;1;1;0;run090
14192;GBB;GRG;0;1;1;1;0;run090
14193;GBB;GRR;1;8;9;4;5;run090
14194;GBB;RBB;0;2;2;0;2;run090
14195;GBB;RBG;0;1;1;1;0;run090
14196;GBB;RBR;1;1;2;0;2;run090
14197;GBB;RGG;0;2;2;1;1;run090
14198;GBB;RGR;0;1;1;1;0;run090
14199;GBB;RRG;0;3;3;1;2;run090
14200;GBG;BRB;0;1;1;0;1;run090
14201;GBG;BRR;0;3;3;3;0;run090
14202;GBG;GGB;0;1;1;0;1;run090
14203;GBG;GGR;0;3;3;2;1;run090
14204;GBG;RBR;0;1;1;1;0;run090
14205;GBG;RGR;1;1;2;1;1;run090
14206;GBG;RRR;0;1;1;0;1;run090
14207;GGB;BBB;1;8;9;7;2;run090
14208;GGB;BBG;0;1;1;1;0;run090
14209;GGB;BGB;0;1;1;1;0;run090
14210;GGB;BRB;3;5;8;6;2;run090
14211;GGB;BRR;0;1;1;1;0;run090
14212;GGB;GBG;0;2;2;1;1;run090
14213;GGB;GGG;4;37;41;24;17;run090
14214;GGB;GGR;0;9;9;9;0;run090
14215;GGB;GRR;1;4;5;5;0;run090
14216;GGB;RBB;0;2;2;0;2;run090
14217;GGB;RBG;0;2;2;1;1;run090
14218;GGB;RBR;0;2;2;1;1;run090
14219;GGB;RGG;0;1;1;1;0;run090
14220;GGB;RGR;1;2;3;3;0;run090
14221;GGB;RRG;1;3;4;0;4;run090
14222;GGB;RRR;0;3;3;0;3;run090
14223;GGG;BBB;4;22;26;0;26;run090
14224;GGG;BBG;0;2;2;1;1;run090
14225;GGG;BBR;0;3;3;0;3;run090
14226;GGG;BGB;0;2;2;2;0;run090
14227;GGG;BGG;0;3;3;3;0;run090
14228;GGG;BRB;0;3;3;1;2;run090
14229;GGG;BRR;0;3;3;0;3;run090
14230;GGG;GBB;0;1;1;1;0;run090
14231;GGG;GGB;1;3;4;3;1;run090
14232;GGG;GGR;0;21;21;6;15;run090
14233;GGG;GRG;0;2;2;2;0;run090
14234;GGG;GRR;2;15;17;0;17;run090
14235;GGG;RBB;0;1;1;1;0;run090
14236;GGG;RBR;1;4;5;3;2;run090
14237;GGG;RGG;1;7;8;4;4;run090
14238;GGG;RGR;0;3;3;2;1;run090
14239;GGG;RRG;0;2;2;1;1;run090
14240;GGG;RRR;0;1;1;0;1;run090
14241;GGR;BBB;0;1;1;1;0;run090
14242;GGR;BGG;0;2;2;0;2;run090
14243;GGR;BRB;0;1;1;1;0;run090
14244;GRG;BBB;0;3;3;0;3;run090
14245;GRG;BGB;0;3;3;3;0;run090
14246;GRG;BGG;0;1;1;0;1;run090
14247;GRG;BRB;0;5;5;1;4;run090
14248;GRG;BRR;0;1;1;1;0;run090
14249;GRG;GBB;0;3;3;3;0;run090
14250;GRG;GGB;0;14;14;8;6;run090
14251;GRG;GGG;0;10;10;2;8;run090
14252;GRG;GGR;0;2;2;0;2;run090
14253;GRG;GRR;0;1;1;0;1;run090
14254;GRG;RBR;1;2;3;2;1;run090
14255;GRG;RGG;0;2;2;0;2;run090
14256;GRG;RGR;0;1;1;1;0;run090
14257;GRR;BBB;0;3;3;1;2;run090
14258;GRR;BBR;0;2;2;0;2;run090
14259;GRR;BRB;1;8;9;2;7;run090
14260;GRR;BRR;1;6;7;3;4;run090
14261;GRR;GBB;0;1;1;0;1;run090
14262;GRR;GBG;0;1;1;1;0;run090
14263;GRR;GGR;1;9;10;8;2;run090
14264;GRR;RBR;0;1;1;1;0;run090
14265;GRR;RGG;1;3;4;4;0;run090
14266;GRR;RGR;0;1;1;0;1;run090
14267;GRR;RRR;0;1;1;0;1;run090
14268;RBB;BBB;0;1;1;0;1;run090
14269;RBB;GGG;0;3;3;0;3;run090
14270;RBG;GRR;0;1;1;0;1;run090
14271;RBG;RBR;0;1;1;1;0;run090
14272;RBG;RGR;0;1;1;0;1;run090
14273;RBR;BBB;0;3;3;1;2;run090
14274;RBR;BRB;0;1;1;1;0;run090
14275;RBR;BRR;0;2;2;0;2;run090
14276;RBR;GGG;0;1;1;1;0;run090
14277;RBR;GGR;1;2;3;2;1;run090
14278;RBR;GRG;0;1;1;1;0;run090
14279;RBR;GRR;1;15;16;3;13;run090
14280;RBR;RGG;0;4;4;4;0;run090
14281;RBR;RGR;0;1;1;1;0;run090
14282;RBR;RRR;0;3;3;1;2;run090
14283;RGG;BGG;0;1;1;0;1;run090
14284;RGG;RGR;0;1;1;0;1;run090
14285;RGR;BBB;0;9;9;9;0;run090
14286;RGR;BBR;0;1;1;1;0;run090
14287;RGR;BGB;1;8;9;3;6;run090
14288;RGR;BRB;0;3;3;2;1;run090
14289;RGR;BRR;0;3;3;1;2;run090
14290;RGR;GBG;0;1;1;1;0;run090
14291;RGR;GGB;0;3;3;2;1;run090
14292;RGR;GGG;0;2;2;2;0;run090
14293;RGR;GGR;0;8;8;5;3;run090
14294;RGR;GRR;1;7;8;2;6;run090
14295;RGR;RGG;0;6;6;2;4;run090
14296;RRG;BGB;0;1;1;0;1;run090
14297;RRG;BRB;0;1;1;1;0;run090
14298;RRG;GGG;0;1;1;0;1;run090
14299;RRG;GGR;0;1;1;1;0;run090
14300;RRG;GRG;0;1;1;1;0;run090
14301;RRG;GRR;0;3;3;2;1;run090
14302;RRG;RBR;0;4;4;3;1;run090
14303;RRG;RGG;0;1;1;1;0;run090
14304;RRG;RGR;6;37;43;12;31;run090
14305;RRR;BRR;0;1;1;0;1;run090
14306;RRR;GGB;0;1;1;0;1;run090
14307;RRR;GGG;1;5;6;4;2;run090
14308;RRR;GGR;0;2;2;0;2;run090
14309;RRR;GRR;0;1;1;1;0;run090
14310;RRR;RGR;0;1;1;1;0;run090
14311;BBB;GRR;0;1;1;0;1;run091
14312;BBG;BBB;1;9;10;2;8;run091
14313;BBG;BBR;0;2;2;1;1;run091
14314;BBG;BGB;0;1;1;1;0;run091
14315;BBG;BGG;0;1;1;1;0;run091
14316;BBG;BRB;0;2;2;2;0;run091
14317;BBG;BRR;0;1;1;0;1;run091
14318;BBG;GBB;1;1;2;0;2;run091
14319;BBG;GBG;1;6;7;5;2;run091
14320;BBG;GGB;0;18;18;13;5;run091
14321;BBG;GGG;1;29;30;15;15;run091
14322;BBG;GGR;0;2;2;2;0;run091
14323;BBG;GRG;0;1;1;1;0;run091
14324;BBG;GRR;0;3;3;3;0;run091
14325;BBG;RBR;0;2;2;2;0;run091
14326;BBG;RGR;0;2;2;2;0;run091
14327;BBG;RRG;1;2;3;2;1;run091
14328;BBG;RRR;0;1;1;0;1;run091
14329;BGG;BBB;0;1;1;1;0;run091
14330;BGG;BRB;0;1;1;0;1;run091
14331;BGG;GGG;0;1;1;0;1;run091
14332;BGG;RBB;0;1;1;1;0;run091
14333;BGG;RBG;1;0;1;0;1;run091
14334;BRB;BBB;0;1;1;0;1;run091
14335;BRB;GGB;1;0;1;1;0;run091
14336;BRB;GGG;0;2;2;2;0;run091
14337;BRB;RBB;1;0;1;0;1;run091
14338;BRR;BBB;0;1;1;1;0;run091
14339;BRR;BRB;0;1;1;0;1;run091
14340;BRR;GBB;1;0;1;1;0;run091
14341;GBB;BBB;1;16;17;8;9;run091
14342;GBB;BBG;0;2;2;0;2;run091
14343;GBB;BGB;0;1;1;1;0;run091
14344;GBB;BGG;0;3;3;3;0;run091
14345;GBB;BRB;0;9;9;8;1;run091
14346;GBB;BRR;0;2;2;0;2;run091
14347;GBB;GBG;1;1;2;0;2;run091
14348;GBB;GGB;2;59;61;3;58;run091
14349;GBB;GGG;4;95;99;36;63;run091
14350;GBB;GGR;0;1;1;0;1;run091
14351;GBB;GRG;0;1;1;0;1;run091
14352;GBB;GRR;1;8;9;2;7;run091
14353;GBB;RBB;0;2;2;1;1;run091
14354;GBB;RBG;0;1;1;1;0;run091
14355;GBB;RBR;1;1;2;0;2;run091
14356;GBB;RGG;0;2;2;1;1;run091
14357;GBB;RGR;0;1;1;1;0;run091
14358;GBB;RRG;0;3;3;1;2;run091
14359;GBG;BRB;0;1;1;0;1;run091
14360;GBG;BRR;0;3;3;2;1;run091
14361;GBG;GGB;0;1;1;0;1;run091
14362;GBG;GGR;0;3;3;0;3;run091
14363;GBG;RBR;0;1;1;1;0;run091
14364;GBG;RGR;1;1;2;1;1;run091
14365;GBG;RRR;0;1;1;0;1;run091
14366;GGB;BBB;1;8;9;6;3;run091
14367;GGB;BBG;0;1;1;0;1;run091
14368;GGB;BGB;0;1;1;1;0;run091
14369;GGB;BRB;3;5;8;8;0;run091
14370;GGB;BRR;0;1;1;0;1;run091
14371;GGB;GBG;0;2;2;1;1;run091
14372;GGB;GGG;4;37;41;2;39;run091
14373;GGB;GGR;0;9;9;6;3;run091
14374;GGB;GRR;1;4;5;4;1;run091
14375;GGB;RBB;0;2;2;2;0;run091
14376;GGB;RBG;0;2;2;2;0;run091
14377;GGB;RBR;0;2;2;0;2;run091
14378;GGB;RGG;0;1;1;1;0;run091
14379;GGB;RGR;1;2;3;3;0;run091
14380;GGB;RRG;1;3;4;0;4;run091
14381;GGB;RRR;0;3;3;3;0;run091
14382;GGG;BBB;4;22;26;8;18;run091
14383;GGG;BBG;0;2;2;1;1;run091
14384;GGG;BBR;0;3;3;2;1;run091
14385;GGG;BGB;0;2;2;2;0;run091
14386;GGG;BGG;0;3;3;3;0;run091
14387;GGG;BRB;0;3;3;0;3;run091
14388;GGG;BRR;0;3;3;2;1;run091
14389;GGG;GBB;0;1;1;1;0;run091
14390;GGG;GGB;1;3;4;2;2;run091
14391;GGG;GGR;0;21;21;7;14;run091
14392;GGG;GRG;0;2;2;2;0;run091
14393;GGG;GRR;2;15;17;9;8;run091
14394;GGG;RBB;0;1;1;1;0;run091
14395;GGG;RBR;1;4;5;1;4;run091
14396;GGG;RGG;1;7;8;8;0;run091
14397;GGG;RGR;0;3;3;3;0;run091
14398;GGG;RRG;0;2;2;1;1;run091
14399;GGG;RRR;0;1;1;0;1;run091
14400;GGR;BBB;0;1;1;1;0;run091
14401;GGR;BGG;0;2;2;2;0;run091
14402;GGR;BRB;0;1;1;1;0;run091
14403;GRG;BBB;0;3;3;2;1;run091
14404;GRG;BGB;0;3;3;2;1;run091
14405;GRG;BGG;0;1;1;0;1;run091
14406;GRG;BRB;0;5;5;0;5;run091
14407;GRG;BRR;0;1;1;0;1;run091
14408;GRG;GBB;0;3;3;0;3;run091
14409;GRG;GGB;0;14;14;4;10;run091
14410;GRG;GGG;0;10;10;6;4;run091
14411;GRG;GGR;0;2;2;0;2;run091
14412;GRG;GRR;0;1;1;0;1;run091
14413;GRG;RBR;1;2;3;2;1;run091
14414;GRG;RGG;0;2;2;1;1;run091
14415;GRG;RGR;0;1;1;0;1;run091
14416;GRR;BBB;0;3;3;3;0;run091
14417;GRR;BBR;0;2;2;0;2;run091
14418;GRR;BRB;1;8;9;6;3;run091
14419;GRR;BRR;1;6;7;3;4;run091
14420;GRR;GBB;0;1;1;0;1;run091
14421;GRR;GBG;0;1;1;1;0;run091
14422;GRR;GGR;1;9;10;7;3;run091
14423;GRR;RBR;0;1;1;0;1;run091
14424;GRR;RGG;1;3;4;1;3;run091
14425;GRR;RGR;0;1;1;0;1;run091
14426;GRR;RRR;0;1;1;0;1;run091
14427;RBB;BBB;0;1;1;0;1;run091
14428;RBB;GGG;0;3;3;1;2;run091
14429;RBG;GRR;0;1;1;1;0;run091
14430;RBG;RBR;0;1;1;1;0;run091
14431;RBG;RGR;0;1;1;1;0;run091
14432;RBR;BBB;0;3;3;2;1;run091
14433;RBR;BRB;0;1;1;0;1;run091
14434;RBR;BRR;0;2;2;2;0;run091
14435;RBR;GGG;0;1;1;1;0;run091
14436;RBR;GGR;1;2;3;2;1;run091
14437;RBR;GRG;0;1;1;0;1;run091
14438;RBR;GRR;1;15;16;4;12;run091
14439;RBR;RGG;0;4;4;2;2;run091
14440;RBR;RGR;0;1;1;0;1;run091
14441;RBR;RRR;0;3;3;2;1;run091
14442;RGG;BGG;0;1;1;1;0;run091
14443;RGG;RGR;0;1;1;0;1;run091
14444;RGR;BBB;0;9;9;4;5;run091
14445;RGR;BBR;0;1;1;1;0;run091
14446;RGR;BGB;1;8;9;5;4;run091
14447;RGR;BRB;0;3;3;2;1;run091
14448;RGR;BRR;0;3;3;2;1;run091
14449;RGR;GBG;0;1;1;1;0;run091
14450;RGR;GGB;0;3;3;2;1;run091
14451;RGR;GGG;0;2;2;0;2;run091
14452;RGR;GGR;0;8;8;5;3;run091
14453;RGR;GRR;1;7;8;7;1;run091
14454;RGR;RGG;0;6;6;4;2;run091
14455;RRG;BGB;0;1;1;0;1;run091
14456;RRG;BRB;0;1;1;0;1;run091
14457;RRG;GGG;0;1;1;0;1;run091
14458;RRG;GGR;0;1;1;1;0;run091
14459;RRG;GRG;0;1;1;0;1;run091
14460;RRG;GRR;0;3;3;1;2;run091
14461;RRG;RBR;0;4;4;4;0;run091
14462;RRG;RGG;0;1;1;0;1;run091
14463;RRG;RGR;6;37;43;28;15;run091
14464;RRR;BRR;0;1;1;1;0;run091
14465;RRR;GGB;0;1;1;1;0;run091
14466;RRR;GGG;1;5;6;3;3;run091
14467;RRR;GGR;0;2;2;1;1;run091
14468;RRR;GRR;0;1;1;0;1;run091
14469;RRR;RGR;0;1;1;1;0;run091
14470;BBB;GRR;0;1;1;1;0;run092
14471;BBG;BBB;1;9;10;1;9;run092
14472;BBG;BBR;0;2;2;2;0;run092
14473;BBG;BGB;0;1;1;1;0;run092
14474;BBG;BGG;0;1;1;1;0;run092
14475;BBG;BRB;0;2;2;0;2;run092
14476;BBG;BRR;0;1;1;0;1;run092
14477;BBG;GBB;1;1;2;2;0;run092
14478;BBG;GBG;1;6;7;4;3;run092
14479;BBG;GGB;0;18;18;15;3;run092
14480;BBG;GGG;1;29;30;5;25;run092
14481;BBG;GGR;0;2;2;2;0;run092
14482;BBG;GRG;0;1;1;1;0;run092
14483;BBG;GRR;0;3;3;3;0;run092
14484;BBG;RBR;0;2;2;1;1;run092
14485;BBG;RGR;0;2;2;1;1;run092
14486;BBG;RRG;1;2;3;1;2;run092
14487;BBG;RRR;0;1;1;1;0;run092
14488;BGG;BBB;0;1;1;1;0;run092
14489;BGG;BRB;0;1;1;0;1;run092
14490;BGG;GGG;0;1;1;1;0;run092
14491;BGG;RBB;0;1;1;1;0;run092
14492;BGG;RBG;1;0;1;1;0;run092
14493;BRB;BBB;0;1;1;1;0;run092
14494;BRB;GGB;1;0;1;0;1;run092
14495;BRB;GGG;0;2;2;2;0;run092
14496;BRB;RBB;1;0;1;0;1;run092
14497;BRR;BBB;0;1;1;1;0;run092
14498;BRR;BRB;0;1;1;1;0;run092
14499;BRR;GBB;1;0;1;1;0;run092
14500;GBB;BBB;1;16;17;4;13;run092
14501;GBB;BBG;0;2;2;1;1;run092
14502;GBB;BGB;0;1;1;1;0;run092
14503;GBB;BGG;0;3;3;1;2;run092
14504;GBB;BRB;0;9;9;2;7;run092
14505;GBB;BRR;0;2;2;2;0;run092
14506;GBB;GBG;1;1;2;0;2;run092
14507;GBB;GGB;2;59;61;47;14;run092
14508;GBB;GGG;4;95;99;26;73;run092
14509;GBB;GGR;0;1;1;1;0;run092
14510;GBB;GRG;0;1;1;0;1;run092
14511;GBB;GRR;1;8;9;6;3;run092
14512;GBB;RBB;0;2;2;2;0;run092
14513;GBB;RBG;0;1;1;1;0;run092
14514;GBB;RBR;1;1;2;0;2;run092
14515;GBB;RGG;0;2;2;2;0;run092
14516;GBB;RGR;0;1;1;1;0;run092
14517;GBB;RRG;0;3;3;3;0;run092
14518;GBG;BRB;0;1;1;1;0;run092
14519;GBG;BRR;0;3;3;2;1;run092
14520;GBG;GGB;0;1;1;1;0;run092
14521;GBG;GGR;0;3;3;0;3;run092
14522;GBG;RBR;0;1;1;1;0;run092
14523;GBG;RGR;1;1;2;1;1;run092
14524;GBG;RRR;0;1;1;0;1;run092
14525;GGB;BBB;1;8;9;3;6;run092
14526;GGB;BBG;0;1;1;0;1;run092
14527;GGB;BGB;0;1;1;1;0;run092
14528;GGB;BRB;3;5;8;3;5;run092
14529;GGB;BRR;0;1;1;1;0;run092
14530;GGB;GBG;0;2;2;0;2;run092
14531;GGB;GGG;4;37;41;3;38;run092
14532;GGB;GGR;0;9;9;1;8;run092
14533;GGB;GRR;1;4;5;2;3;run092
14534;GGB;RBB;0;2;2;2;0;run092
14535;GGB;RBG;0;2;2;2;0;run092
14536;GGB;RBR;0;2;2;1;1;run092
14537;GGB;RGG;0;1;1;1;0;run092
14538;GGB;RGR;1;2;3;3;0;run092
14539;GGB;RRG;1;3;4;3;1;run092
14540;GGB;RRR;0;3;3;3;0;run092
14541;GGG;BBB;4;22;26;7;19;run092
14542;GGG;BBG;0;2;2;2;0;run092
14543;GGG;BBR;0;3;3;1;2;run092
14544;GGG;BGB;0;2;2;1;1;run092
14545;GGG;BGG;0;3;3;3;0;run092
14546;GGG;BRB;0;3;3;1;2;run092
14547;GGG;BRR;0;3;3;1;2;run092
14548;GGG;GBB;0;1;1;0;1;run092
14549;GGG;GGB;1;3;4;1;3;run092
14550;GGG;GGR;0;21;21;6;15;run092
14551;GGG;GRG;0;2;2;2;0;run092
14552;GGG;GRR;2;15;17;2;15;run092
14553;GGG;RBB;0;1;1;1;0;run092
14554;GGG;RBR;1;4;5;5;0;run092
14555;GGG;RGG;1;7;8;4;4;run092
14556;GGG;RGR;0;3;3;0;3;run092
14557;GGG;RRG;0;2;2;1;1;run092
14558;GGG;RRR;0;1;1;0;1;run092
14559;GGR;BBB;0;1;1;1;0;run092
14560;GGR;BGG;0;2;2;1;1;run092
14561;GGR;BRB;0;1;1;1;0;run092
14562;GRG;BBB;0;3;3;2;1;run092
14563;GRG;BGB;0;3;3;0;3;run092
14564;GRG;BGG;0;1;1;1;0;run092
14565;GRG;BRB;0;5;5;2;3;run092
14566;GRG;BRR;0;1;1;1;0;run092
14567;GRG;GBB;0;3;3;2;1;run092
14568;GRG;GGB;0;14;14;12;2;run092
14569;GRG;GGG;0;10;10;1;9;run092
14570;GRG;GGR;0;2;2;1;1;run092
14571;GRG;GRR;0;1;1;1;0;run092
14572;GRG;RBR;1;2;3;0;3;run092
14573;GRG;RGG;0;2;2;2;0;run092
14574;GRG;RGR;0;1;1;0;1;run092
14575;GRR;BBB;0;3;3;1;2;run092
14576;GRR;BBR;0;2;2;2;0;run092
14577;GRR;BRB;1;8;9;1;8;run092
14578;GRR;BRR;1;6;7;3;4;run092
14579;GRR;GBB;0;1;1;1;0;run092
14580;GRR;GBG;0;1;1;0;1;run092
14581;GRR;GGR;1;9;10;2;8;run092
14582;GRR;RBR;0;1;1;1;0;run092
14583;GRR;RGG;1;3;4;1;3;run092
14584;GRR;RGR;0;1;1;0;1;run092
14585;GRR;RRR;0;1;1;0;1;run092
14586;RBB;BBB;0;1;1;0;1;run092
14587;RBB;GGG;0;3;3;1;2;run092
14588;RBG;GRR;0;1;1;1;0;run092
14589;RBG;RBR;0;1;1;0;1;run092
14590;RBG;RGR;0;1;1;0;1;run092
14591;RBR;BBB;0;3;3;3;0;run092
14592;RBR;BRB;0;1;1;0;1;run092
14593;RBR;BRR;0;2;2;1;1;run092
14594;RBR;GGG;0;1;1;1;0;run092
14595;RBR;GGR;1;2;3;3;0;run092
14596;RBR;GRG;0;1;1;0;1;run092
14597;RBR;GRR;1;15;16;1;15;run092
14598;RBR;RGG;0;4;4;4;0;run092
14599;RBR;RGR;0;1;1;0;1;run092
14600;RBR;RRR;0;3;3;2;1;run092
14601;RGG;BGG;0;1;1;0;1;run092
14602;RGG;RGR;0;1;1;0;1;run092
14603;RGR;BBB;0;9;9;0;9;run092
14604;RGR;BBR;0;1;1;0;1;run092
14605;RGR;BGB;1;8;9;6;3;run092
14606;RGR;BRB;0;3;3;1;2;run092
14607;RGR;BRR;0;3;3;3;0;run092
14608;RGR;GBG;0;1;1;1;0;run092
14609;RGR;GGB;0;3;3;2;1;run092
14610;RGR;GGG;0;2;2;2;0;run092
14611;RGR;GGR;0;8;8;3;5;run092
14612;RGR;GRR;1;7;8;5;3;run092
14613;RGR;RGG;0;6;6;2;4;run092
14614;RRG;BGB;0;1;1;0;1;run092
14615;RRG;BRB;0;1;1;0;1;run092
14616;RRG;GGG;0;1;1;1;0;run092
14617;RRG;GGR;0;1;1;0;1;run092
14618;RRG;GRG;0;1;1;1;0;run092
14619;RRG;GRR;0;3;3;3;0;run092
14620;RRG;RBR;0;4;4;4;0;run092
14621;RRG;RGG;0;1;1;0;1;run092
14622;RRG;RGR;6;37;43;8;35;run092
14623;RRR;BRR;0;1;1;1;0;run092
14624;RRR;GGB;0;1;1;0;1;run092
14625;RRR;GGG;1;5;6;2;4;run092
14626;RRR;GGR;0;2;2;1;1;run092
14627;RRR;GRR;0;1;1;1;0;run092
14628;RRR;RGR;0;1;1;0;1;run092
14629;BBB;GRR;0;1;1;0;1;run093
14630;BBG;BBB;1;9;10;3;7;run093
14631;BBG;BBR;0;2;2;2;0;run093
14632;BBG;BGB;0;1;1;0;1;run093
14633;BBG;BGG;0;1;1;0;1;run093
14634;BBG;BRB;0;2;2;1;1;run093
14635;BBG;BRR;0;1;1;1;0;run093
14636;BBG;GBB;1;1;2;1;1;run093
14637;BBG;GBG;1;6;7;4;3;run093
14638;BBG;GGB;0;18;18;6;12;run093
14639;BBG;GGG;1;29;30;19;11;run093
14640;BBG;GGR;0;2;2;2;0;run093
14641;BBG;GRG;0;1;1;1;0;run093
14642;BBG;GRR;0;3;3;3;0;run093
14643;BBG;RBR;0;2;2;0;2;run093
14644;BBG;RGR;0;2;2;0;2;run093
14645;BBG;RRG;1;2;3;0;3;run093
14646;BBG;RRR;0;1;1;0;1;run093
14647;BGG;BBB;0;1;1;1;0;run093
14648;BGG;BRB;0;1;1;1;0;run093
14649;BGG;GGG;0;1;1;0;1;run093
14650;BGG;RBB;0;1;1;1;0;run093
14651;BGG;RBG;1;0;1;0;1;run093
14652;BRB;BBB;0;1;1;0;1;run093
14653;BRB;GGB;1;0;1;0;1;run093
14654;BRB;GGG;0;2;2;2;0;run093
14655;BRB;RBB;1;0;1;0;1;run093
14656;BRR;BBB;0;1;1;0;1;run093
14657;BRR;BRB;0;1;1;1;0;run093
14658;BRR;GBB;1;0;1;1;0;run093
14659;GBB;BBB;1;16;17;12;5;run093
14660;GBB;BBG;0;2;2;1;1;run093
14661;GBB;BGB;0;1;1;1;0;run093
14662;GBB;BGG;0;3;3;0;3;run093
14663;GBB;BRB;0;9;9;4;5;run093
14664;GBB;BRR;0;2;2;2;0;run093
14665;GBB;GBG;1;1;2;2;0;run093
14666;GBB;GGB;2;59;61;36;25;run093
14667;GBB;GGG;4;95;99;6;93;run093
14668;GBB;GGR;0;1;1;0;1;run093
14669;GBB;GRG;0;1;1;1;0;run093
14670;GBB;GRR;1;8;9;8;1;run093
14671;GBB;RBB;0;2;2;2;0;run093
14672;GBB;RBG;0;1;1;1;0;run093
14673;GBB;RBR;1;1;2;1;1;run093
14674;GBB;RGG;0;2;2;0;2;run093
14675;GBB;RGR;0;1;1;0;1;run093
14676;GBB;RRG;0;3;3;3;0;run093
14677;GBG;BRB;0;1;1;0;1;run093
14678;GBG;BRR;0;3;3;1;2;run093
14679;GBG;GGB;0;1;1;1;0;run093
14680;GBG;GGR;0;3;3;3;0;run093
14681;GBG;RBR;0;1;1;0;1;run093
14682;GBG;RGR;1;1;2;2;0;run093
14683;GBG;RRR;0;1;1;0;1;run093
14684;GGB;BBB;1;8;9;8;1;run093
14685;GGB;BBG;0;1;1;0;1;run093
14686;GGB;BGB;0;1;1;1;0;run093
14687;GGB;BRB;3;5;8;3;5;run093
14688;GGB;BRR;0;1;1;1;0;run093
14689;GGB;GBG;0;2;2;2;0;run093
14690;GGB;GGG;4;37;41;33;8;run093
14691;GGB;GGR;0;9;9;3;6;run093
14692;GGB;GRR;1;4;5;4;1;run093
14693;GGB;RBB;0;2;2;0;2;run093
14694;GGB;RBG;0;2;2;0;2;run093
14695;GGB;RBR;0;2;2;1;1;run093
14696;GGB;RGG;0;1;1;1;0;run093
14697;GGB;RGR;1;2;3;0;3;run093
14698;GGB;RRG;1;3;4;0;4;run093
14699;GGB;RRR;0;3;3;0;3;run093
14700;GGG;BBB;4;22;26;16;10;run093
14701;GGG;BBG;0;2;2;2;0;run093
14702;GGG;BBR;0;3;3;0;3;run093
14703;GGG;BGB;0;2;2;2;0;run093
14704;GGG;BGG;0;3;3;2;1;run093
14705;GGG;BRB;0;3;3;0;3;run093
14706;GGG;BRR;0;3;3;2;1;run093
14707;GGG;GBB;0;1;1;0;1;run093
14708;GGG;GGB;1;3;4;2;2;run093
14709;GGG;GGR;0;21;21;5;16;run093
14710;GGG;GRG;0;2;2;2;0;run093
14711;GGG;GRR;2;15;17;15;2;run093
14712;GGG;RBB;0;1;1;1;0;run093
14713;GGG;RBR;1;4;5;3;2;run093
14714;GGG;RGG;1;7;8;5;3;run093
14715;GGG;RGR;0;3;3;2;1;run093
14716;GGG;RRG;0;2;2;0;2;run093
14717;GGG;RRR;0;1;1;0;1;run093
14718;GGR;BBB;0;1;1;1;0;run093
14719;GGR;BGG;0;2;2;1;1;run093
14720;GGR;BRB;0;1;1;0;1;run093
14721;GRG;BBB;0;3;3;1;2;run093
14722;GRG;BGB;0;3;3;1;2;run093
14723;GRG;BGG;0;1;1;0;1;run093
14724;GRG;BRB;0;5;5;0;5;run093
14725;GRG;BRR;0;1;1;0;1;run093
14726;GRG;GBB;0;3;3;0;3;run093
14727;GRG;GGB;0;14;14;4;10;run093
14728;GRG;GGG;0;10;10;8;2;run093
14729;GRG;GGR;0;2;2;0;2;run093
14730;GRG;GRR;0;1;1;0;1;run093
14731;GRG;RBR;1;2;3;3;0;run093
14732;GRG;RGG;0;2;2;0;2;run093
14733;GRG;RGR;0;1;1;1;0;run093
14734;GRR;BBB;0;3;3;0;3;run093
14735;GRR;BBR;0;2;2;1;1;run093
14736;GRR;BRB;1;8;9;4;5;run093
14737;GRR;BRR;1;6;7;7;0;run093
14738;GRR;GBB;0;1;1;0;1;run093
14739;GRR;GBG;0;1;1;1;0;run093
14740;GRR;GGR;1;9;10;3;7;run093
14741;GRR;RBR;0;1;1;1;0;run093
14742;GRR;RGG;1;3;4;0;4;run093
14743;GRR;RGR;0;1;1;0;1;run093
14744;GRR;RRR;0;1;1;0;1;run093
14745;RBB;BBB;0;1;1;1;0;run093
14746;RBB;GGG;0;3;3;0;3;run093
14747;RBG;GRR;0;1;1;0;1;run093
14748;RBG;RBR;0;1;1;1;0;run093
14749;RBG;RGR;0;1;1;1;0;run093
14750;RBR;BBB;0;3;3;0;3;run093
14751;RBR;BRB;0;1;1;1;0;run093
14752;RBR;BRR;0;2;2;2;0;run093
14753;RBR;GGG;0;1;1;0;1;run093
14754;RBR;GGR;1;2;3;1;2;run093
14755;RBR;GRG;0;1;1;0;1;run093
14756;RBR;GRR;1;15;16;11;5;run093
14757;RBR;RGG;0;4;4;4;0;run093
14758;RBR;RGR;0;1;1;0;1;run093
14759;RBR;RRR;0;3;3;1;2;run093
14760;RGG;BGG;0;1;1;1;0;run093
14761;RGG;RGR;0;1;1;0;1;run093
14762;RGR;BBB;0;9;9;0;9;run093
14763;RGR;BBR;0;1;1;0;1;run093
14764;RGR;BGB;1;8;9;5;4;run093
14765;RGR;BRB;0;3;3;0;3;run093
14766;RGR;BRR;0;3;3;2;1;run093
14767;RGR;GBG;0;1;1;0;1;run093
14768;RGR;GGB;0;3;3;3;0;run093
14769;RGR;GGG;0;2;2;1;1;run093
14770;RGR;GGR;0;8;8;6;2;run093
14771;RGR;GRR;1;7;8;6;2;run093
14772;RGR;RGG;0;6;6;4;2;run093
14773;RRG;BGB;0;1;1;0;1;run093
14774;RRG;BRB;0;1;1;0;1;run093
14775;RRG;GGG;0;1;1;1;0;run093
14776;RRG;GGR;0;1;1;1;0;run093
14777;RRG;GRG;0;1;1;0;1;run093
14778;RRG;GRR;0;3;3;2;1;run093
14779;RRG;RBR;0;4;4;2;2;run093
14780;RRG;RGG;0;1;1;1;0;run093
14781;RRG;RGR;6;37;43;24;19;run093
14782;RRR;BRR;0;1;1;1;0;run093
14783;RRR;GGB;0;1;1;1;0;run093
14784;RRR;GGG;1;5;6;3;3;run093
14785;RRR;GGR;0;2;2;2;0;run093
14786;RRR;GRR;0;1;1;0;1;run093
14787;RRR;RGR;0;1;1;1;0;run093
14788;BBB;GRR;0;1;1;1;0;run094
14789;BBG;BBB;1;9;10;1;9;run094
14790;BBG;BBR;0;2;2;1;1;run094
14791;BBG;BGB;0;1;1;1;0;run094
14792;BBG;BGG;0;1;1;0;1;run094
14793;BBG;BRB;0;2;2;2;0;run094
14794;BBG;BRR;0;1;1;0;1;run094
14795;BBG;GBB;1;1;2;1;1;run094
14796;BBG;GBG;1;6;7;3;4;run094
14797;BBG;GGB;0;18;18;6;12;run094
14798;BBG;GGG;1;29;30;3;27;run094
14799;BBG;GGR;0;2;2;1;1;run094
14800;BBG;GRG;0;1;1;1;0;run094
14801;BBG;GRR;0;3;3;2;1;run094
14802;BBG;RBR;0;2;2;2;0;run094
14803;BBG;RGR;0;2;2;2;0;run094
14804;BBG;RRG;1;2;3;0;3;run094
14805;BBG;RRR;0;1;1;0;1;run094
14806;BGG;BBB;0;1;1;1;0;run094
14807;BGG;BRB;0;1;1;0;1;run094
14808;BGG;GGG;0;1;1;1;0;run094
14809;BGG;RBB;0;1;1;0;1;run094
14810;BGG;RBG;1;0;1;1;0;run094
14811;BRB;BBB;0;1;1;0;1;run094
14812;BRB;GGB;1;0;1;0;1;run094
14813;BRB;GGG;0;2;2;2;0;run094
14814;BRB;RBB;1;0;1;0;1;run094
14815;BRR;BBB;0;1;1;1;0;run094
14816;BRR;BRB;0;1;1;1;0;run094
14817;BRR;GBB;1;0;1;0;1;run094
14818;GBB;BBB;1;16;17;6;11;run094
14819;GBB;BBG;0;2;2;2;0;run094
14820;GBB;BGB;0;1;1;0;1;run094
14821;GBB;BGG;0;3;3;0;3;run094
14822;GBB;BRB;0;9;9;6;3;run094
14823;GBB;BRR;0;2;2;0;2;run094
14824;GBB;GBG;1;1;2;0;2;run094
14825;GBB;GGB;2;59;61;40;21;run094
14826;GBB;GGG;4;95;99;9;90;run094
14827;GBB;GGR;0;1;1;1;0;run094
14828;GBB;GRG;0;1;1;1;0;run094
14829;GBB;GRR;1;8;9;0;9;run094
14830;GBB;RBB;0;2;2;1;1;run094
14831;GBB;RBG;0;1;1;0;1;run094
14832;GBB;RBR;1;1;2;0;2;run094
14833;GBB;RGG;0;2;2;0;2;run094
14834;GBB;RGR;0;1;1;1;0;run094
14835;GBB;RRG;0;3;3;1;2;run094
14836;GBG;BRB;0;1;1;0;1;run094
14837;GBG;BRR;0;3;3;1;2;run094
14838;GBG;GGB;0;1;1;0;1;run094
14839;GBG;GGR;0;3;3;1;2;run094
14840;GBG;RBR;0;1;1;1;0;run094
14841;GBG;RGR;1;1;2;2;0;run094
14842;GBG;RRR;0;1;1;0;1;run094
14843;GGB;BBB;1;8;9;4;5;run094
14844;GGB;BBG;0;1;1;1;0;run094
14845;GGB;BGB;0;1;1;1;0;run094
14846;GGB;BRB;3;5;8;2;6;run094
14847;GGB;BRR;0;1;1;1;0;run094
14848;GGB;GBG;0;2;2;0;2;run094
14849;GGB;GGG;4;37;41;28;13;run094
14850;GGB;GGR;0;9;9;6;3;run094
14851;GGB;GRR;1;4;5;1;4;run094
14852;GGB;RBB;0;2;2;1;1;run094
14853;GGB;RBG;0;2;2;2;0;run094
14854;GGB;RBR;0;2;2;2;0;run094
14855;GGB;RGG;0;1;1;1;0;run094
14856;GGB;RGR;1;2;3;0;3;run094
14857;GGB;RRG;1;3;4;0;4;run094
14858;GGB;RRR;0;3;3;1;2;run094
14859;GGG;BBB;4;22;26;22;4;run094
14860;GGG;BBG;0;2;2;0;2;run094
14861;GGG;BBR;0;3;3;0;3;run094
14862;GGG;BGB;0;2;2;2;0;run094
14863;GGG;BGG;0;3;3;3;0;run094
14864;GGG;BRB;0;3;3;2;1;run094
14865;GGG;BRR;0;3;3;3;0;run094
14866;GGG;GBB;0;1;1;0;1;run094
14867;GGG;GGB;1;3;4;2;2;run094
14868;GGG;GGR;0;21;21;18;3;run094
14869;GGG;GRG;0;2;2;0;2;run094
14870;GGG;GRR;2;15;17;7;10;run094
14871;GGG;RBB;0;1;1;0;1;run094
14872;GGG;RBR;1;4;5;4;1;run094
14873;GGG;RGG;1;7;8;7;1;run094
14874;GGG;RGR;0;3;3;1;2;run094
14875;GGG;RRG;0;2;2;0;2;run094
14876;GGG;RRR;0;1;1;1;0;run094
14877;GGR;BBB;0;1;1;1;0;run094
14878;GGR;BGG;0;2;2;0;2;run094
14879;GGR;BRB;0;1;1;0;1;run094
14880;GRG;BBB;0;3;3;3;0;run094
14881;GRG;BGB;0;3;3;1;2;run094
14882;GRG;BGG;0;1;1;1;0;run094
14883;GRG;BRB;0;5;5;3;2;run094
14884;GRG;BRR;0;1;1;1;0;run094
14885;GRG;GBB;0;3;3;0;3;run094
14886;GRG;GGB;0;14;14;3;11;run094
14887;GRG;GGG;0;10;10;1;9;run094
14888;GRG;GGR;0;2;2;2;0;run094
14889;GRG;GRR;0;1;1;1;0;run094
14890;GRG;RBR;1;2;3;1;2;run094
14891;GRG;RGG;0;2;2;0;2;run094
14892;GRG;RGR;0;1;1;1;0;run094
14893;GRR;BBB;0;3;3;1;2;run094
14894;GRR;BBR;0;2;2;1;1;run094
14895;GRR;BRB;1;8;9;4;5;run094
14896;GRR;BRR;1;6;7;5;2;run094
14897;GRR;GBB;0;1;1;0;1;run094
14898;GRR;GBG;0;1;1;1;0;run094
14899;GRR;GGR;1;9;10;10;0;run094
14900;GRR;RBR;0;1;1;1;0;run094
14901;GRR;RGG;1;3;4;0;4;run094
14902;GRR;RGR;0;1;1;0;1;run094
14903;GRR;RRR;0;1;1;0;1;run094
14904;RBB;BBB;0;1;1;1;0;run094
14905;RBB;GGG;0;3;3;3;0;run094
14906;RBG;GRR;0;1;1;0;1;run094
14907;RBG;RBR;0;1;1;1;0;run094
14908;RBG;RGR;0;1;1;0;1;run094
14909;RBR;BBB;0;3;3;3;0;run094
14910;RBR;BRB;0;1;1;0;1;run094
14911;RBR;BRR;0;2;2;1;1;run094
14912;RBR;GGG;0;1;1;0;1;run094
14913;RBR;GGR;1;2;3;3;0;run094
14914;RBR;GRG;0;1;1;1;0;run094
14915;RBR;GRR;1;15;16;6;10;run094
14916;RBR;RGG;0;4;4;4;0;run094
14917;RBR;RGR;0;1;1;0;1;run094
14918;RBR;RRR;0;3;3;3;0;run094
14919;RGG;BGG;0;1;1;1;0;run094
14920;RGG;RGR;0;1;1;1;0;run094
14921;RGR;BBB;0;9;9;1;8;run094
14922;RGR;BBR;0;1;1;1;0;run094
14923;RGR;BGB;1;8;9;3;6;run094
14924;RGR;BRB;0;3;3;3;0;run094
14925;RGR;BRR;0;3;3;2;1;run094
14926;RGR;GBG;0;1;1;1;0;run094
14927;RGR;GGB;0;3;3;0;3;run094
14928;RGR;GGG;0;2;2;1;1;run094
14929;RGR;GGR;0;8;8;6;2;run094
14930;RGR;GRR;1;7;8;8;0;run094
14931;RGR;RGG;0;6;6;0;6;run094
14932;RRG;BGB;0;1;1;0;1;run094
14933;RRG;BRB;0;1;1;1;0;run094
14934;RRG;GGG;0;1;1;0;1;run094
14935;RRG;GGR;0;1;1;1;0;run094
14936;RRG;GRG;0;1;1;1;0;run094
14937;RRG;GRR;0;3;3;3;0;run094
14938;RRG;RBR;0;4;4;0;4;run094
14939;RRG;RGG;0;1;1;0;1;run094
14940;RRG;RGR;6;37;43;14;29;run094
14941;RRR;BRR;0;1;1;0;1;run094
14942;RRR;GGB;0;1;1;1;0;run094
14943;RRR;GGG;1;5;6;3;3;run094
14944;RRR;GGR;0;2;2;1;1;run094
14945;RRR;GRR;0;1;1;0;1;run094
14946;RRR;RGR;0;1;1;1;0;run094
14947;BBB;GRR;0;1;1;0;1;run095
14948;BBG;BBB;1;9;10;10;0;run095
14949;BBG;BBR;0;2;2;0;2;run095
14950;BBG;BGB;0;1;1;1;0;run095
14951;BBG;BGG;0;1;1;1;0;run095
14952;BBG;BRB;0;2;2;2;0;run095
14953;BBG;BRR;0;1;1;0;1;run095
14954;BBG;GBB;1;1;2;0;2;run095
14955;BBG;GBG;1;6;7;1;6;run095
14956;BBG;GGB;0;18;18;13;5;run095
14957;BBG;GGG;1;29;30;5;25;run095
14958;BBG;GGR;0;2;2;0;2;run095
14959;BBG;GRG;0;1;1;0;1;run095
14960;BBG;GRR;0;3;3;2;1;run095
14961;BBG;RBR;0;2;2;2;0;run095
14962;BBG;RGR;0;2;2;1;1;run095
14963;BBG;RRG;1;2;3;1;2;run095
14964;BBG;RRR;0;1;1;0;1;run095
14965;BGG;BBB;0;1;1;1;0;run095
14966;BGG;BRB;0;1;1;1;0;run095
14967;BGG;GGG;0;1;1;0;1;run095
14968;BGG;RBB;0;1;1;0;1;run095
14969;BGG;RBG;1;0;1;1;0;run095
14970;BRB;BBB;0;1;1;1;0;run095
14971;BRB;GGB;1;0;1;0;1;run095
14972;BRB;GGG;0;2;2;1;1;run095
14973;BRB;RBB;1;0;1;1;0;run095
14974;BRR;BBB;0;1;1;1;0;run095
14975;BRR;BRB;0;1;1;1;0;run095
14976;BRR;GBB;1;0;1;1;0;run095
14977;GBB;BBB;1;16;17;11;6;run095
14978;GBB;BBG;0;2;2;1;1;run095
14979;GBB;BGB;0;1;1;0;1;run095
14980;GBB;BGG;0;3;3;0;3;run095
14981;GBB;BRB;0;9;9;2;7;run095
14982;GBB;BRR;0;2;2;1;1;run095
14983;GBB;GBG;1;1;2;2;0;run095
14984;GBB;GGB;2;59;61;28;33;run095
14985;GBB;GGG;4;95;99;69;30;run095
14986;GBB;GGR;0;1;1;0;1;run095
14987;GBB;GRG;0;1;1;0;1;run095
14988;GBB;GRR;1;8;9;6;3;run095
14989;GBB;RBB;0;2;2;2;0;run095
14990;GBB;RBG;0;1;1;0;1;run095
14991;GBB;RBR;1;1;2;1;1;run095
14992;GBB;RGG;0;2;2;1;1;run095
14993;GBB;RGR;0;1;1;0;1;run095
14994;GBB;RRG;0;3;3;0;3;run095
14995;GBG;BRB;0;1;1;1;0;run095
14996;GBG;BRR;0;3;3;2;1;run095
14997;GBG;GGB;0;1;1;1;0;run095
14998;GBG;GGR;0;3;3;2;1;run095
14999;GBG;RBR;0;1;1;0;1;run095
15000;GBG;RGR;1;1;2;0;2;run095
15001;GBG;RRR;0;1;1;1;0;run095
15002;GGB;BBB;1;8;9;9;0;run095
15003;GGB;BBG;0;1;1;0;1;run095
15004;GGB;BGB;0;1;1;1;0;run095
15005;GGB;BRB;3;5;8;6;2;run095
15006;GGB;BRR;0;1;1;1;0;run095
15007;GGB;GBG;0;2;2;0;2;run095
15008;GGB;GGG;4;37;41;30;11;run095
15009;GGB;GGR;0;9;9;4;5;run095
15010;GGB;GRR;1;4;5;2;3;run095
15011;GGB;RBB;0;2;2;1;1;run095
15012;GGB;RBG;0;2;2;0;2;run095
15013;GGB;RBR;0;2;2;2;0;run095
15014;GGB;RGG;0;1;1;0;1;run095
15015;GGB;RGR;1;2;3;2;1;run095
15016;GGB;RRG;1;3;4;3;1;run095
15017;GGB;RRR;0;3;3;3;0;run095
15018;GGG;BBB;4;22;26;12;14;run095
15019;GGG;BBG;0;2;2;0;2;run095
15020;GGG;BBR;0;3;3;1;2;run095
15021;GGG;BGB;0;2;2;1;1;run095
15022;GGG;BGG;0;3;3;3;0;run095
15023;GGG;BRB;0;3;3;2;1;run095
15024;GGG;BRR;0;3;3;0;3;run095
15025;GGG;GBB;0;1;1;1;0;run095
15026;GGG;GGB;1;3;4;1;3;run095
15027;GGG;GGR;0;21;21;16;5;run095
15028;GGG;GRG;0;2;2;2;0;run095
15029;GGG;GRR;2;15;17;8;9;run095
15030;GGG;RBB;0;1;1;0;1;run095
15031;GGG;RBR;1;4;5;5;0;run095
15032;GGG;RGG;1;7;8;0;8;run095
15033;GGG;RGR;0;3;3;1;2;run095
15034;GGG;RRG;0;2;2;2;0;run095
15035;GGG;RRR;0;1;1;0;1;run095
15036;GGR;BBB;0;1;1;0;1;run095
15037;GGR;BGG;0;2;2;0;2;run095
15038;GGR;BRB;0;1;1;1;0;run095
15039;GRG;BBB;0;3;3;2;1;run095
15040;GRG;BGB;0;3;3;0;3;run095
15041;GRG;BGG;0;1;1;0;1;run095
15042;GRG;BRB;0;5;5;2;3;run095
15043;GRG;BRR;0;1;1;0;1;run095
15044;GRG;GBB;0;3;3;2;1;run095
15045;GRG;GGB;0;14;14;14;0;run095
15046;GRG;GGG;0;10;10;10;0;run095
15047;GRG;GGR;0;2;2;0;2;run095
15048;GRG;GRR;0;1;1;0;1;run095
15049;GRG;RBR;1;2;3;1;2;run095
15050;GRG;RGG;0;2;2;0;2;run095
15051;GRG;RGR;0;1;1;0;1;run095
15052;GRR;BBB;0;3;3;3;0;run095
15053;GRR;BBR;0;2;2;0;2;run095
15054;GRR;BRB;1;8;9;8;1;run095
15055;GRR;BRR;1;6;7;7;0;run095
15056;GRR;GBB;0;1;1;1;0;run095
15057;GRR;GBG;0;1;1;0;1;run095
15058;GRR;GGR;1;9;10;7;3;run095
15059;GRR;RBR;0;1;1;0;1;run095
15060;GRR;RGG;1;3;4;0;4;run095
15061;GRR;RGR;0;1;1;1;0;run095
15062;GRR;RRR;0;1;1;1;0;run095
15063;RBB;BBB;0;1;1;1;0;run095
15064;RBB;GGG;0;3;3;0;3;run095
15065;RBG;GRR;0;1;1;1;0;run095
15066;RBG;RBR;0;1;1;0;1;run095
15067;RBG;RGR;0;1;1;1;0;run095
15068;RBR;BBB;0;3;3;0;3;run095
15069;RBR;BRB;0;1;1;0;1;run095
15070;RBR;BRR;0;2;2;0;2;run095
15071;RBR;GGG;0;1;1;1;0;run095
15072;RBR;GGR;1;2;3;2;1;run095
15073;RBR;GRG;0;1;1;0;1;run095
15074;RBR;GRR;1;15;16;7;9;run095
15075;RBR;RGG;0;4;4;2;2;run095
15076;RBR;RGR;0;1;1;0;1;run095
15077;RBR;RRR;0;3;3;1;2;run095
15078;RGG;BGG;0;1;1;1;0;run095
15079;RGG;RGR;0;1;1;0;1;run095
15080;RGR;BBB;0;9;9;3;6;run095
15081;RGR;BBR;0;1;1;1;0;run095
15082;RGR;BGB;1;8;9;5;4;run095
15083;RGR;BRB;0;3;3;1;2;run095
15084;RGR;BRR;0;3;3;0;3;run095
15085;RGR;GBG;0;1;1;1;0;run095
15086;RGR;GGB;0;3;3;3;0;run095
15087;RGR;GGG;0;2;2;2;0;run095
15088;RGR;GGR;0;8;8;1;7;run095
15089;RGR;GRR;1;7;8;6;2;run095
15090;RGR;RGG;0;6;6;3;3;run095
15091;RRG;BGB;0;1;1;1;0;run095
15092;RRG;BRB;0;1;1;0;1;run095
15093;RRG;GGG;0;1;1;0;1;run095
15094;RRG;GGR;0;1;1;0;1;run095
15095;RRG;GRG;0;1;1;0;1;run095
15096;RRG;GRR;0;3;3;3;0;run095
15097;RRG;RBR;0;4;4;2;2;run095
15098;RRG;RGG;0;1;1;1;0;run095
15099;RRG;RGR;6;37;43;23;20;run095
15100;RRR;BRR;0;1;1;1;0;run095
15101;RRR;GGB;0;1;1;1;0;run095
15102;RRR;GGG;1;5;6;1;5;run095
15103;RRR;GGR;0;2;2;1;1;run095
15104;RRR;GRR;0;1;1;0;1;run095
15105;RRR;RGR;0;1;1;0;1;run095
15106;BBB;GRR;0;1;1;0;1;run096
15107;BBG;BBB;1;9;10;0;10;run096
15108;BBG;BBR;0;2;2;2;0;run096
15109;BBG;BGB;0;1;1;0;1;run096
15110;BBG;BGG;0;1;1;0;1;run096
15111;BBG;BRB;0;2;2;0;2;run096
15112;BBG;BRR;0;1;1;1;0;run096
15113;BBG;GBB;1;1;2;0;2;run096
15114;BBG;GBG;1;6;7;6;1;run096
15115;BBG;GGB;0;18;18;8;10;run096
15116;BBG;GGG;1;29;30;1;29;run096
15117;BBG;GGR;0;2;2;2;0;run096
15118;BBG;GRG;0;1;1;1;0;run096
15119;BBG;GRR;0;3;3;2;1;run096
15120;BBG;RBR;0;2;2;1;1;run096
15121;BBG;RGR;0;2;2;0;2;run096
15122;BBG;RRG;1;2;3;3;0;run096
15123;BBG;RRR;0;1;1;0;1;run096
15124;BGG;BBB;0;1;1;0;1;run096
15125;BGG;BRB;0;1;1;1;0;run096
15126;BGG;GGG;0;1;1;1;0;run096
15127;BGG;RBB;0;1;1;1;0;run096
15128;BGG;RBG;1;0;1;1;0;run096
15129;BRB;BBB;0;1;1;0;1;run096
15130;BRB;GGB;1;0;1;1;0;run096
15131;BRB;GGG;0;2;2;2;0;run096
15132;BRB;RBB;1;0;1;0;1;run096
15133;BRR;BBB;0;1;1;0;1;run096
15134;BRR;BRB;0;1;1;0;1;run096
15135;BRR;GBB;1;0;1;1;0;run096
15136;GBB;BBB;1;16;17;9;8;run096
15137;GBB;BBG;0;2;2;1;1;run096
15138;GBB;BGB;0;1;1;1;0;run096
15139;GBB;BGG;0;3;3;3;0;run096
15140;GBB;BRB;0;9;9;6;3;run096
15141;GBB;BRR;0;2;2;0;2;run096
15142;GBB;GBG;1;1;2;0;2;run096
15143;GBB;GGB;2;59;61;51;10;run096
15144;GBB;GGG;4;95;99;57;42;run096
15145;GBB;GGR;0;1;1;0;1;run096
15146;GBB;GRG;0;1;1;1;0;run096
15147;GBB;GRR;1;8;9;6;3;run096
15148;GBB;RBB;0;2;2;2;0;run096
15149;GBB;RBG;0;1;1;0;1;run096
15150;GBB;RBR;1;1;2;1;1;run096
15151;GBB;RGG;0;2;2;1;1;run096
15152;GBB;RGR;0;1;1;0;1;run096
15153;GBB;RRG;0;3;3;3;0;run096
15154;GBG;BRB;0;1;1;0;1;run096
15155;GBG;BRR;0;3;3;3;0;run096
15156;GBG;GGB;0;1;1;1;0;run096
15157;GBG;GGR;0;3;3;1;2;run096
15158;GBG;RBR;0;1;1;1;0;run096
15159;GBG;RGR;1;1;2;0;2;run096
15160;GBG;RRR;0;1;1;1;0;run096
15161;GGB;BBB;1;8;9;1;8;run096
15162;GGB;BBG;0;1;1;1;0;run096
15163;GGB;BGB;0;1;1;0;1;run096
15164;GGB;BRB;3;5;8;6;2;run096
15165;GGB;BRR;0;1;1;1;0;run096
15166;GGB;GBG;0;2;2;0;2;run096
15167;GGB;GGG;4;37;41;13;28;run096
15168;GGB;GGR;0;9;9;8;1;run096
15169;GGB;GRR;1;4;5;0;5;run096
15170;GGB;RBB;0;2;2;0;2;run096
15171;GGB;RBG;0;2;2;0;2;run096
15172;GGB;RBR;0;2;2;0;2;run096
15173;GGB;RGG;0;1;1;1;0;run096
15174;GGB;RGR;1;2;3;0;3;run096
15175;GGB;RRG;1;3;4;2;2;run096
15176;GGB;RRR;0;3;3;0;3;run096
15177;GGG;BBB;4;22;26;16;10;run096
15178;GGG;BBG;0;2;2;2;0;run096
15179;GGG;BBR;0;3;3;1;2;run096
15180;GGG;BGB;0;2;2;1;1;run096
15181;GGG;BGG;0;3;3;1;2;run096
15182;GGG;BRB;0;3;3;0;3;run096
15183;GGG;BRR;0;3;3;3;0;run096
15184;GGG;GBB;0;1;1;1;0;run096
15185;GGG;GGB;1;3;4;3;1;run096
15186;GGG;GGR;0;21;21;17;4;run096
15187;GGG;GRG;0;2;2;2;0;run096
15188;GGG;GRR;2;15;17;5;12;run096
15189;GGG;RBB;0;1;1;0;1;run096
15190;GGG;RBR;1;4;5;1;4;run096
15191;GGG;RGG;1;7;8;6;2;run096
15192;GGG;RGR;0;3;3;3;0;run096
15193;GGG;RRG;0;2;2;0;2;run096
15194;GGG;RRR;0;1;1;1;0;run096
15195;GGR;BBB;0;1;1;1;0;run096
15196;GGR;BGG;0;2;2;1;1;run096
15197;GGR;BRB;0;1;1;1;0;run096
15198;GRG;BBB;0;3;3;2;1;run096
15199;GRG;BGB;0;3;3;0;3;run096
15200;GRG;BGG;0;1;1;0;1;run096
15201;GRG;BRB;0;5;5;3;2;run096
15202;GRG;BRR;0;1;1;0;1;run096
15203;GRG;GBB;0;3;3;0;3;run096
15204;GRG;GGB;0;14;14;11;3;run096
15205;GRG;GGG;0;10;10;0;10;run096
15206;GRG;GGR;0;2;2;0;2;run096
15207;GRG;GRR;0;1;1;0;1;run096
15208;GRG;RBR;1;2;3;3;0;run096
15209;GRG;RGG;0;2;2;2;0;run096
15210;GRG;RGR;0;1;1;1;0;run096
15211;GRR;BBB;0;3;3;3;0;run096
15212;GRR;BBR;0;2;2;2;0;run096
15213;GRR;BRB;1;8;9;9;0;run096
15214;GRR;BRR;1;6;7;0;7;run096
15215;GRR;GBB;0;1;1;1;0;run096
15216;GRR;GBG;0;1;1;0;1;run096
15217;GRR;GGR;1;9;10;9;1;run096
15218;GRR;RBR;0;1;1;0;1;run096
15219;GRR;RGG;1;3;4;4;0;run096
15220;GRR;RGR;0;1;1;1;0;run096
15221;GRR;RRR;0;1;1;0;1;run096
15222;RBB;BBB;0;1;1;1;0;run096
15223;RBB;GGG;0;3;3;2;1;run096
15224;RBG;GRR;0;1;1;0;1;run096
15225;RBG;RBR;0;1;1;1;0;run096
15226;RBG;RGR;0;1;1;1;0;run096
15227;RBR;BBB;0;3;3;2;1;run096
15228;RBR;BRB;0;1;1;1;0;run096
15229;RBR;BRR;0;2;2;1;1;run096
15230;RBR;GGG;0;1;1;1;0;run096
15231;RBR;GGR;1;2;3;1;2;run096
15232;RBR;GRG;0;1;1;1;0;run096
15233;RBR;GRR;1;15;16;14;2;run096
15234;RBR;RGG;0;4;4;2;2;run096
15235;RBR;RGR;0;1;1;1;0;run096
15236;RBR;RRR;0;3;3;2;1;run096
15237;RGG;BGG;0;1;1;0;1;run096
15238;RGG;RGR;0;1;1;1;0;run096
15239;RGR;BBB;0;9;9;5;4;run096
15240;RGR;BBR;0;1;1;0;1;run096
15241;RGR;BGB;1;8;9;6;3;run096
15242;RGR;BRB;0;3;3;1;2;run096
15243;RGR;BRR;0;3;3;3;0;run096
15244;RGR;GBG;0;1;1;1;0;run096
15245;RGR;GGB;0;3;3;0;3;run096
15246;RGR;GGG;0;2;2;1;1;run096
15247;RGR;GGR;0;8;8;0;8;run096
15248;RGR;GRR;1;7;8;0;8;run096
15249;RGR;RGG;0;6;6;3;3;run096
15250;RRG;BGB;0;1;1;1;0;run096
15251;RRG;BRB;0;1;1;1;0;run096
15252;RRG;GGG;0;1;1;0;1;run096
15253;RRG;GGR;0;1;1;1;0;run096
15254;RRG;GRG;0;1;1;1;0;run096
15255;RRG;GRR;0;3;3;0;3;run096
15256;RRG;RBR;0;4;4;1;3;run096
15257;RRG;RGG;0;1;1;1;0;run096
15258;RRG;RGR;6;37;43;8;35;run096
15259;RRR;BRR;0;1;1;1;0;run096
15260;RRR;GGB;0;1;1;1;0;run096
15261;RRR;GGG;1;5;6;6;0;run096
15262;RRR;GGR;0;2;2;1;1;run096
15263;RRR;GRR;0;1;1;0;1;run096
15264;RRR;RGR;0;1;1;1;0;run096
15265;BBB;GRR;0;1;1;1;0;run097
15266;BBG;BBB;1;9;10;8;2;run097
15267;BBG;BBR;0;2;2;0;2;run097
15268;BBG;BGB;0;1;1;0;1;run097
15269;BBG;BGG;0;1;1;1;0;run097
15270;BBG;BRB;0;2;2;0;2;run097
15271;BBG;BRR;0;1;1;1;0;run097
15272;BBG;GBB;1;1;2;0;2;run097
15273;BBG;GBG;1;6;7;0;7;run097
15274;BBG;GGB;0;18;18;4;14;run097
15275;BBG;GGG;1;29;30;0;30;run097
15276;BBG;GGR;0;2;2;2;0;run097
15277;BBG;GRG;0;1;1;1;0;run097
15278;BBG;GRR;0;3;3;3;0;run097
15279;BBG;RBR;0;2;2;1;1;run097
15280;BBG;RGR;0;2;2;1;1;run097
15281;BBG;RRG;1;2;3;3;0;run097
15282;BBG;RRR;0;1;1;1;0;run097
15283;BGG;BBB;0;1;1;1;0;run097
15284;BGG;BRB;0;1;1;0;1;run097
15285;BGG;GGG;0;1;1;0;1;run097
15286;BGG;RBB;0;1;1;0;1;run097
15287;BGG;RBG;1;0;1;0;1;run097
15288;BRB;BBB;0;1;1;1;0;run097
15289;BRB;GGB;1;0;1;1;0;run097
15290;BRB;GGG;0;2;2;2;0;run097
15291;BRB;RBB;1;0;1;0;1;run097
15292;BRR;BBB;0;1;1;0;1;run097
15293;BRR;BRB;0;1;1;1;0;run097
15294;BRR;GBB;1;0;1;1;0;run097
15295;GBB;BBB;1;16;17;13;4;run097
15296;GBB;BBG;0;2;2;0;2;run097
15297;GBB;BGB;0;1;1;0;1;run097
15298;GBB;BGG;0;3;3;0;3;run097
15299;GBB;BRB;0;9;9;3;6;run097
15300;GBB;BRR;0;2;2;1;1;run097
15301;GBB;GBG;1;1;2;1;1;run097
15302;GBB;GGB;2;59;61;52;9;run097
15303;GBB;GGG;4;95;99;45;54;run097
15304;GBB;GGR;0;1;1;1;0;run097
15305;GBB;GRG;0;1;1;1;0;run097
15306;GBB;GRR;1;8;9;5;4;run097
15307;GBB;RBB;0;2;2;2;0;run097
15308;GBB;RBG;0;1;1;0;1;run097
15309;GBB;RBR;1;1;2;0;2;run097
15310;GBB;RGG;0;2;2;0;2;run097
15311;GBB;RGR;0;1;1;0;1;run097
15312;GBB;RRG;0;3;3;1;2;run097
15313;GBG;BRB;0;1;1;0;1;run097
15314;GBG;BRR;0;3;3;0;3;run097
15315;GBG;GGB;0;1;1;1;0;run097
15316;GBG;GGR;0;3;3;3;0;run097
15317;GBG;RBR;0;1;1;0;1;run097
15318;GBG;RGR;1;1;2;0;2;run097
15319;GBG;RRR;0;1;1;1;0;run097
15320;GGB;BBB;1;8;9;8;1;run097
15321;GGB;BBG;0;1;1;0;1;run097
15322;GGB;BGB;0;1;1;1;0;run097
15323;GGB;BRB;3;5;8;4;4;run097
15324;GGB;BRR;0;1;1;1;0;run097
15325;GGB;GBG;0;2;2;2;0;run097
15326;GGB;GGG;4;37;41;0;41;run097
15327;GGB;GGR;0;9;9;3;6;run097
15328;GGB;GRR;1;4;5;4;1;run097
15329;GGB;RBB;0;2;2;0;2;run097
15330;GGB;RBG;0;2;2;0;2;run097
15331;GGB;RBR;0;2;2;1;1;run097
15332;GGB;RGG;0;1;1;1;0;run097
15333;GGB;RGR;1;2;3;2;1;run097
15334;GGB;RRG;1;3;4;4;0;run097
15335;GGB;RRR;0;3;3;3;0;run097
15336;GGG;BBB;4;22;26;12;14;run097
15337;GGG;BBG;0;2;2;1;1;run097
15338;GGG;BBR;0;3;3;0;3;run097
15339;GGG;BGB;0;2;2;1;1;run097
15340;GGG;BGG;0;3;3;3;0;run097
15341;GGG;BRB;0;3;3;3;0;run097
15342;GGG;BRR;0;3;3;1;2;run097
15343;GGG;GBB;0;1;1;0;1;run097
15344;GGG;GGB;1;3;4;3;1;run097
15345;GGG;GGR;0;21;21;4;17;run097
15346;GGG;GRG;0;2;2;1;1;run097
15347;GGG;GRR;2;15;17;16;1;run097
15348;GGG;RBB;0;1;1;0;1;run097
15349;GGG;RBR;1;4;5;1;4;run097
15350;GGG;RGG;1;7;8;1;7;run097
15351;GGG;RGR;0;3;3;2;1;run097
15352;GGG;RRG;0;2;2;2;0;run097
15353;GGG;RRR;0;1;1;1;0;run097
15354;GGR;BBB;0;1;1;1;0;run097
15355;GGR;BGG;0;2;2;1;1;run097
15356;GGR;BRB;0;1;1;1;0;run097
15357;GRG;BBB;0;3;3;0;3;run097
15358;GRG;BGB;0;3;3;3;0;run097
15359;GRG;BGG;0;1;1;0;1;run097
15360;GRG;BRB;0;5;5;5;0;run097
15361;GRG;BRR;0;1;1;0;1;run097
15362;GRG;GBB;0;3;3;3;0;run097
15363;GRG;GGB;0;14;14;9;5;run097
15364;GRG;GGG;0;10;10;0;10;run097
15365;GRG;GGR;0;2;2;2;0;run097
15366;GRG;GRR;0;1;1;0;1;run097
15367;GRG;RBR;1;2;3;0;3;run097
15368;GRG;RGG;0;2;2;1;1;run097
15369;GRG;RGR;0;1;1;1;0;run097
15370;GRR;BBB;0;3;3;3;0;run097
15371;GRR;BBR;0;2;2;1;1;run097
15372;GRR;BRB;1;8;9;7;2;run097
15373;GRR;BRR;1;6;7;2;5;run097
15374;GRR;GBB;0;1;1;1;0;run097
15375;GRR;GBG;0;1;1;1;0;run097
15376;GRR;GGR;1;9;10;5;5;run097
15377;GRR;RBR;0;1;1;0;1;run097
15378;GRR;RGG;1;3;4;1;3;run097
15379;GRR;RGR;0;1;1;1;0;run097
15380;GRR;RRR;0;1;1;0;1;run097
15381;RBB;BBB;0;1;1;1;0;run097
15382;RBB;GGG;0;3;3;3;0;run097
15383;RBG;GRR;0;1;1;1;0;run097
15384;RBG;RBR;0;1;1;0;1;run097
15385;RBG;RGR;0;1;1;1;0;run097
15386;RBR;BBB;0;3;3;3;0;run097
15387;RBR;BRB;0;1;1;1;0;run097
15388;RBR;BRR;0;2;2;0;2;run097
15389;RBR;GGG;0;1;1;0;1;run097
15390;RBR;GGR;1;2;3;1;2;run097
15391;RBR;GRG;0;1;1;1;0;run097
15392;RBR;GRR;1;15;16;8;8;run097
15393;RBR;RGG;0;4;4;2;2;run097
15394;RBR;RGR;0;1;1;0;1;run097
15395;RBR;RRR;0;3;3;2;1;run097
15396;RGG;BGG;0;1;1;1;0;run097
15397;RGG;RGR;0;1;1;1;0;run097
15398;RGR;BBB;0;9;9;3;6;run097
15399;RGR;BBR;0;1;1;1;0;run097
15400;RGR;BGB;1;8;9;4;5;run097
15401;RGR;BRB;0;3;3;0;3;run097
15402;RGR;BRR;0;3;3;3;0;run097
15403;RGR;GBG;0;1;1;1;0;run097
15404;RGR;GGB;0;3;3;0;3;run097
15405;RGR;GGG;0;2;2;2;0;run097
15406;RGR;GGR;0;8;8;0;8;run097
15407;RGR;GRR;1;7;8;6;2;run097
15408;RGR;RGG;0;6;6;3;3;run097
15409;RRG;BGB;0;1;1;1;0;run097
15410;RRG;BRB;0;1;1;1;0;run097
15411;RRG;GGG;0;1;1;1;0;run097
15412;RRG;GGR;0;1;1;1;0;run097
15413;RRG;GRG;0;1;1;0;1;run097
15414;RRG;GRR;0;3;3;2;1;run097
15415;RRG;RBR;0;4;4;2;2;run097
15416;RRG;RGG;0;1;1;1;0;run097
15417;RRG;RGR;6;37;43;15;28;run097
15418;RRR;BRR;0;1;1;1;0;run097
15419;RRR;GGB;0;1;1;0;1;run097
15420;RRR;GGG;1;5;6;4;2;run097
15421;RRR;GGR;0;2;2;2;0;run097
15422;RRR;GRR;0;1;1;0;1;run097
15423;RRR;RGR;0;1;1;0;1;run097
15424;BBB;GRR;0;1;1;1;0;run098
15425;BBG;BBB;1;9;10;1;9;run098
15426;BBG;BBR;0;2;2;1;1;run098
15427;BBG;BGB;0;1;1;0;1;run098
15428;BBG;BGG;0;1;1;0;1;run098
15429;BBG;BRB;0;2;2;1;1;run098
15430;BBG;BRR;0;1;1;0;1;run098
15431;BBG;GBB;1;1;2;2;0;run098
15432;BBG;GBG;1;6;7;4;3;run098
15433;BBG;GGB;0;18;18;16;2;run098
15434;BBG;GGG;1;29;30;9;21;run098
15435;BBG;GGR;0;2;2;0;2;run098
15436;BBG;GRG;0;1;1;1;0;run098
15437;BBG;GRR;0;3;3;1;2;run098
15438;BBG;RBR;0;2;2;0;2;run098
15439;BBG;RGR;0;2;2;1;1;run098
15440;BBG;RRG;1;2;3;3;0;run098
15441;BBG;RRR;0;1;1;0;1;run098
15442;BGG;BBB;0;1;1;1;0;run098
15443;BGG;BRB;0;1;1;0;1;run098
15444;BGG;GGG;0;1;1;1;0;run098
15445;BGG;RBB;0;1;1;1;0;run098
15446;BGG;RBG;1;0;1;1;0;run098
15447;BRB;BBB;0;1;1;1;0;run098
15448;BRB;GGB;1;0;1;0;1;run098
15449;BRB;GGG;0;2;2;2;0;run098
15450;BRB;RBB;1;0;1;1;0;run098
15451;BRR;BBB;0;1;1;0;1;run098
15452;BRR;BRB;0;1;1;1;0;run098
15453;BRR;GBB;1;0;1;1;0;run098
15454;GBB;BBB;1;16;17;9;8;run098
15455;GBB;BBG;0;2;2;1;1;run098
15456;GBB;BGB;0;1;1;0;1;run098
15457;GBB;BGG;0;3;3;3;0;run098
15458;GBB;BRB;0;9;9;7;2;run098
15459;GBB;BRR;0;2;2;0;2;run098
15460;GBB;GBG;1;1;2;2;0;run098
15461;GBB;GGB;2;59;61;61;0;run098
15462;GBB;GGG;4;95;99;54;45;run098
15463;GBB;GGR;0;1;1;1;0;run098
15464;GBB;GRG;0;1;1;0;1;run098
15465;GBB;GRR;1;8;9;1;8;run098
15466;GBB;RBB;0;2;2;0;2;run098
15467;GBB;RBG;0;1;1;1;0;run098
15468;GBB;RBR;1;1;2;0;2;run098
15469;GBB;RGG;0;2;2;2;0;run098
15470;GBB;RGR;0;1;1;1;0;run098
15471;GBB;RRG;0;3;3;1;2;run098
15472;GBG;BRB;0;1;1;1;0;run098
15473;GBG;BRR;0;3;3;3;0;run098
15474;GBG;GGB;0;1;1;1;0;run098
15475;GBG;GGR;0;3;3;3;0;run098
15476;GBG;RBR;0;1;1;0;1;run098
15477;GBG;RGR;1;1;2;1;1;run098
15478;GBG;RRR;0;1;1;1;0;run098
15479;GGB;BBB;1;8;9;5;4;run098
15480;GGB;BBG;0;1;1;1;0;run098
15481;GGB;BGB;0;1;1;0;1;run098
15482;GGB;BRB;3;5;8;3;5;run098
15483;GGB;BRR;0;1;1;1;0;run098
15484;GGB;GBG;0;2;2;2;0;run098
15485;GGB;GGG;4;37;41;17;24;run098
15486;GGB;GGR;0;9;9;0;9;run098
15487;GGB;GRR;1;4;5;1;4;run098
15488;GGB;RBB;0;2;2;2;0;run098
15489;GGB;RBG;0;2;2;2;0;run098
15490;GGB;RBR;0;2;2;2;0;run098
15491;GGB;RGG;0;1;1;0;1;run098
15492;GGB;RGR;1;2;3;1;2;run098
15493;GGB;RRG;1;3;4;1;3;run098
15494;GGB;RRR;0;3;3;2;1;run098
15495;GGG;BBB;4;22;26;10;16;run098
15496;GGG;BBG;0;2;2;2;0;run098
15497;GGG;BBR;0;3;3;3;0;run098
15498;GGG;BGB;0;2;2;0;2;run098
15499;GGG;BGG;0;3;3;0;3;run098
15500;GGG;BRB;0;3;3;2;1;run098
15501;GGG;BRR;0;3;3;2;1;run098
15502;GGG;GBB;0;1;1;1;0;run098
15503;GGG;GGB;1;3;4;4;0;run098
15504;GGG;GGR;0;21;21;21;0;run098
15505;GGG;GRG;0;2;2;0;2;run098
15506;GGG;GRR;2;15;17;16;1;run098
15507;GGG;RBB;0;1;1;1;0;run098
15508;GGG;RBR;1;4;5;4;1;run098
15509;GGG;RGG;1;7;8;1;7;run098
15510;GGG;RGR;0;3;3;2;1;run098
15511;GGG;RRG;0;2;2;0;2;run098
15512;GGG;RRR;0;1;1;0;1;run098
15513;GGR;BBB;0;1;1;1;0;run098
15514;GGR;BGG;0;2;2;0;2;run098
15515;GGR;BRB;0;1;1;0;1;run098
15516;GRG;BBB;0;3;3;0;3;run098
15517;GRG;BGB;0;3;3;1;2;run098
15518;GRG;BGG;0;1;1;1;0;run098
15519;GRG;BRB;0;5;5;1;4;run098
15520;GRG;BRR;0;1;1;1;0;run098
15521;GRG;GBB;0;3;3;1;2;run098
15522;GRG;GGB;0;14;14;11;3;run098
15523;GRG;GGG;0;10;10;1;9;run098
15524;GRG;GGR;0;2;2;1;1;run098
15525;GRG;GRR;0;1;1;1;0;run098
15526;GRG;RBR;1;2;3;2;1;run098
15527;GRG;RGG;0;2;2;2;0;run098
15528;GRG;RGR;0;1;1;0;1;run098
15529;GRR;BBB;0;3;3;1;2;run098
15530;GRR;BBR;0;2;2;2;0;run098
15531;GRR;BRB;1;8;9;4;5;run098
15532;GRR;BRR;1;6;7;0;7;run098
15533;GRR;GBB;0;1;1;1;0;run098
15534;GRR;GBG;0;1;1;1;0;run098
15535;GRR;GGR;1;9;10;3;7;run098
15536;GRR;RBR;0;1;1;0;1;run098
15537;GRR;RGG;1;3;4;2;2;run098
15538;GRR;RGR;0;1;1;1;0;run098
15539;GRR;RRR;0;1;1;1;0;run098
15540;RBB;BBB;0;1;1;0;1;run098
15541;RBB;GGG;0;3;3;2;1;run098
15542;RBG;GRR;0;1;1;1;0;run098
15543;RBG;RBR;0;1;1;0;1;run098
15544;RBG;RGR;0;1;1;0;1;run098
15545;RBR;BBB;0;3;3;1;2;run098
15546;RBR;BRB;0;1;1;1;0;run098
15547;RBR;BRR;0;2;2;1;1;run098
15548;RBR;GGG;0;1;1;1;0;run098
15549;RBR;GGR;1;2;3;1;2;run098
15550;RBR;GRG;0;1;1;1;0;run098
15551;RBR;GRR;1;15;16;1;15;run098
15552;RBR;RGG;0;4;4;2;2;run098
15553;RBR;RGR;0;1;1;1;0;run098
15554;RBR;RRR;0;3;3;2;1;run098
15555;RGG;BGG;0;1;1;1;0;run098
15556;RGG;RGR;0;1;1;1;0;run098
15557;RGR;BBB;0;9;9;5;4;run098
15558;RGR;BBR;0;1;1;1;0;run098
15559;RGR;BGB;1;8;9;7;2;run098
15560;RGR;BRB;0;3;3;1;2;run098
15561;RGR;BRR;0;3;3;2;1;run098
15562;RGR;GBG;0;1;1;1;0;run098
15563;RGR;GGB;0;3;3;2;1;run098
15564;RGR;GGG;0;2;2;1;1;run098
15565;RGR;GGR;0;8;8;7;1;run098
15566;RGR;GRR;1;7;8;7;1;run098
15567;RGR;RGG;0;6;6;4;2;run098
15568;RRG;BGB;0;1;1;0;1;run098
15569;RRG;BRB;0;1;1;1;0;run098
15570;RRG;GGG;0;1;1;0;1;run098
15571;RRG;GGR;0;1;1;1;0;run098
15572;RRG;GRG;0;1;1;0;1;run098
15573;RRG;GRR;0;3;3;2;1;run098
15574;RRG;RBR;0;4;4;4;0;run098
15575;RRG;RGG;0;1;1;1;0;run098
15576;RRG;RGR;6;37;43;5;38;run098
15577;RRR;BRR;0;1;1;1;0;run098
15578;RRR;GGB;0;1;1;0;1;run098
15579;RRR;GGG;1;5;6;6;0;run098
15580;RRR;GGR;0;2;2;1;1;run098
15581;RRR;GRR;0;1;1;0;1;run098
15582;RRR;RGR;0;1;1;0;1;run098
15583;BBB;GRR;0;1;1;1;0;run099
15584;BBG;BBB;1;9;10;0;10;run099
15585;BBG;BBR;0;2;2;1;1;run099
15586;BBG;BGB;0;1;1;1;0;run099
15587;BBG;BGG;0;1;1;0;1;run099
15588;BBG;BRB;0;2;2;2;0;run099
15589;BBG;BRR;0;1;1;1;0;run099
15590;BBG;GBB;1;1;2;1;1;run099
15591;BBG;GBG;1;6;7;1;6;run099
15592;BBG;GGB;0;18;18;5;13;run099
15593;BBG;GGG;1;29;30;12;18;run099
15594;BBG;GGR;0;2;2;2;0;run099
15595;BBG;GRG;0;1;1;1;0;run099
15596;BBG;GRR;0;3;3;0;3;run099
15597;BBG;RBR;0;2;2;1;1;run099
15598;BBG;RGR;0;2;2;1;1;run099
15599;BBG;RRG;1;2;3;1;2;run099
15600;BBG;RRR;0;1;1;1;0;run099
15601;BGG;BBB;0;1;1;0;1;run099
15602;BGG;BRB;0;1;1;1;0;run099
15603;BGG;GGG;0;1;1;1;0;run099
15604;BGG;RBB;0;1;1;1;0;run099
15605;BGG;RBG;1;0;1;1;0;run099
15606;BRB;BBB;0;1;1;0;1;run099
15607;BRB;GGB;1;0;1;0;1;run099
15608;BRB;GGG;0;2;2;1;1;run099
15609;BRB;RBB;1;0;1;0;1;run099
15610;BRR;BBB;0;1;1;1;0;run099
15611;BRR;BRB;0;1;1;1;0;run099
15612;BRR;GBB;1;0;1;1;0;run099
15613;GBB;BBB;1;16;17;4;13;run099
15614;GBB;BBG;0;2;2;2;0;run099
15615;GBB;BGB;0;1;1;1;0;run099
15616;GBB;BGG;0;3;3;1;2;run099
15617;GBB;BRB;0;9;9;4;5;run099
15618;GBB;BRR;0;2;2;1;1;run099
15619;GBB;GBG;1;1;2;1;1;run099
15620;GBB;GGB;2;59;61;0;61;run099
15621;GBB;GGG;4;95;99;13;86;run099
15622;GBB;GGR;0;1;1;1;0;run099
15623;GBB;GRG;0;1;1;0;1;run099
15624;GBB;GRR;1;8;9;5;4;run099
15625;GBB;RBB;0;2;2;2;0;run099
15626;GBB;RBG;0;1;1;1;0;run099
15627;GBB;RBR;1;1;2;2;0;run099
15628;GBB;RGG;0;2;2;2;0;run099
15629;GBB;RGR;0;1;1;1;0;run099
15630;GBB;RRG;0;3;3;3;0;run099
15631;GBG;BRB;0;1;1;0;1;run099
15632;GBG;BRR;0;3;3;2;1;run099
15633;GBG;GGB;0;1;1;0;1;run099
15634;GBG;GGR;0;3;3;0;3;run099
15635;GBG;RBR;0;1;1;0;1;run099
15636;GBG;RGR;1;1;2;1;1;run099
15637;GBG;RRR;0;1;1;0;1;run099
15638;GGB;BBB;1;8;9;8;1;run099
15639;GGB;BBG;0;1;1;0;1;run099
15640;GGB;BGB;0;1;1;0;1;run099
15641;GGB;BRB;3;5;8;7;1;run099
15642;GGB;BRR;0;1;1;0;1;run099
15643;GGB;GBG;0;2;2;2;0;run099
15644;GGB;GGG;4;37;41;37;4;run099
15645;GGB;GGR;0;9;9;7;2;run099
15646;GGB;GRR;1;4;5;2;3;run099
15647;GGB;RBB;0;2;2;2;0;run099
15648;GGB;RBG;0;2;2;1;1;run099
15649;GGB;RBR;0;2;2;2;0;run099
15650;GGB;RGG;0;1;1;1;0;run099
15651;GGB;RGR;1;2;3;0;3;run099
15652;GGB;RRG;1;3;4;3;1;run099
15653;GGB;RRR;0;3;3;2;1;run099
15654;GGG;BBB;4;22;26;14;12;run099
15655;GGG;BBG;0;2;2;2;0;run099
15656;GGG;BBR;0;3;3;0;3;run099
15657;GGG;BGB;0;2;2;2;0;run099
15658;GGG;BGG;0;3;3;2;1;run099
15659;GGG;BRB;0;3;3;1;2;run099
15660;GGG;BRR;0;3;3;2;1;run099
15661;GGG;GBB;0;1;1;1;0;run099
15662;GGG;GGB;1;3;4;3;1;run099
15663;GGG;GGR;0;21;21;2;19;run099
15664;GGG;GRG;0;2;2;2;0;run099
15665;GGG;GRR;2;15;17;9;8;run099
15666;GGG;RBB;0;1;1;0;1;run099
15667;GGG;RBR;1;4;5;4;1;run099
15668;GGG;RGG;1;7;8;3;5;run099
15669;GGG;RGR;0;3;3;0;3;run099
15670;GGG;RRG;0;2;2;2;0;run099
15671;GGG;RRR;0;1;1;0;1;run099
15672;GGR;BBB;0;1;1;0;1;run099
15673;GGR;BGG;0;2;2;2;0;run099
15674;GGR;BRB;0;1;1;0;1;run099
15675;GRG;BBB;0;3;3;3;0;run099
15676;GRG;BGB;0;3;3;0;3;run099
15677;GRG;BGG;0;1;1;0;1;run099
15678;GRG;BRB;0;5;5;3;2;run099
15679;GRG;BRR;0;1;1;1;0;run099
15680;GRG;GBB;0;3;3;2;1;run099
15681;GRG;GGB;0;14;14;12;2;run099
15682;GRG;GGG;0;10;10;6;4;run099
15683;GRG;GGR;0;2;2;2;0;run099
15684;GRG;GRR;0;1;1;1;0;run099
15685;GRG;RBR;1;2;3;1;2;run099
15686;GRG;RGG;0;2;2;2;0;run099
15687;GRG;RGR;0;1;1;1;0;run099
15688;GRR;BBB;0;3;3;2;1;run099
15689;GRR;BBR;0;2;2;2;0;run099
15690;GRR;BRB;1;8;9;7;2;run099
15691;GRR;BRR;1;6;7;7;0;run099
15692;GRR;GBB;0;1;1;0;1;run099
15693;GRR;GBG;0;1;1;0;1;run099
15694;GRR;GGR;1;9;10;0;10;run099
15695;GRR;RBR;0;1;1;0;1;run099
15696;GRR;RGG;1;3;4;3;1;run099
15697;GRR;RGR;0;1;1;1;0;run099
15698;GRR;RRR;0;1;1;1;0;run099
15699;RBB;BBB;0;1;1;0;1;run099
15700;RBB;GGG;0;3;3;1;2;run099
15701;RBG;GRR;0;1;1;1;0;run099
15702;RBG;RBR;0;1;1;0;1;run099
15703;RBG;RGR;0;1;1;1;0;run099
15704;RBR;BBB;0;3;3;0;3;run099
15705;RBR;BRB;0;1;1;1;0;run099
15706;RBR;BRR;0;2;2;0;2;run099
15707;RBR;GGG;0;1;1;0;1;run099
15708;RBR;GGR;1;2;3;1;2;run099
15709;RBR;GRG;0;1;1;1;0;run099
15710;RBR;GRR;1;15;16;3;13;run099
15711;RBR;RGG;0;4;4;3;1;run099
15712;RBR;RGR;0;1;1;1;0;run099
15713;RBR;RRR;0;3;3;0;3;run099
15714;RGG;BGG;0;1;1;0;1;run099
15715;RGG;RGR;0;1;1;0;1;run099
15716;RGR;BBB;0;9;9;1;8;run099
15717;RGR;BBR;0;1;1;0;1;run099
15718;RGR;BGB;1;8;9;9;0;run099
15719;RGR;BRB;0;3;3;3;0;run099
15720;RGR;BRR;0;3;3;0;3;run099
15721;RGR;GBG;0;1;1;0;1;run099
15722;RGR;GGB;0;3;3;0;3;run099
15723;RGR;GGG;0;2;2;1;1;run099
15724;RGR;GGR;0;8;8;0;8;run099
15725;RGR;GRR;1;7;8;8;0;run099
15726;RGR;RGG;0;6;6;5;1;run099
15727;RRG;BGB;0;1;1;0;1;run099
15728;RRG;BRB;0;1;1;0;1;run099
15729;RRG;GGG;0;1;1;0;1;run099
15730;RRG;GGR;0;1;1;1;0;run099
15731;RRG;GRG;0;1;1;0;1;run099
15732;RRG;GRR;0;3;3;2;1;run099
15733;RRG;RBR;0;4;4;0;4;run099
15734;RRG;RGG;0;1;1;1;0;run099
15735;RRG;RGR;6;37;43;41;2;run099
15736;RRR;BRR;0;1;1;0;1;run099
15737;RRR;GGB;0;1;1;1;0;run099
15738;RRR;GGG;1;5;6;3;3;run099
15739;RRR;GGR;0;2;2;2;0;run099
15740;RRR;GRR;0;1;1;1;0;run099
15741;RRR;RGR;0;1;1;0;1;run099
15742;BBB;GRR;0;1;1;1;0;run100
15743;BBG;BBB;1;9;10;6;4;run100
15744;BBG;BBR;0;2;2;1;1;run100
15745;BBG;BGB;0;1;1;1;0;run100
15746;BBG;BGG;0;1;1;0;1;run100
15747;BBG;BRB;0;2;2;0;2;run100
15748;BBG;BRR;0;1;1;1;0;run100
15749;BBG;GBB;1;1;2;1;1;run100
15750;BBG;GBG;1;6;7;3;4;run100
15751;BBG;GGB;0;18;18;5;13;run100
15752;BBG;GGG;1;29;30;3;27;run100
15753;BBG;GGR;0;2;2;2;0;run100
15754;BBG;GRG;0;1;1;1;0;run100
15755;BBG;GRR;0;3;3;1;2;run100
15756;BBG;RBR;0;2;2;2;0;run100
15757;BBG;RGR;0;2;2;2;0;run100
15758;BBG;RRG;1;2;3;2;1;run100
15759;BBG;RRR;0;1;1;0;1;run100
15760;BGG;BBB;0;1;1;1;0;run100
15761;BGG;BRB;0;1;1;1;0;run100
15762;BGG;GGG;0;1;1;0;1;run100
15763;BGG;RBB;0;1;1;1;0;run100
15764;BGG;RBG;1;0;1;0;1;run100
15765;BRB;BBB;0;1;1;0;1;run100
15766;BRB;GGB;1;0;1;1;0;run100
15767;BRB;GGG;0;2;2;1;1;run100
15768;BRB;RBB;1;0;1;0;1;run100
15769;BRR;BBB;0;1;1;1;0;run100
15770;BRR;BRB;0;1;1;0;1;run100
15771;BRR;GBB;1;0;1;1;0;run100
15772;GBB;BBB;1;16;17;3;14;run100
15773;GBB;BBG;0;2;2;1;1;run100
15774;GBB;BGB;0;1;1;1;0;run100
15775;GBB;BGG;0;3;3;3;0;run100
15776;GBB;BRB;0;9;9;4;5;run100
15777;GBB;BRR;0;2;2;2;0;run100
15778;GBB;GBG;1;1;2;2;0;run100
15779;GBB;GGB;2;59;61;56;5;run100
15780;GBB;GGG;4;95;99;15;84;run100
15781;GBB;GGR;0;1;1;0;1;run100
15782;GBB;GRG;0;1;1;1;0;run100
15783;GBB;GRR;1;8;9;1;8;run100
15784;GBB;RBB;0;2;2;1;1;run100
15785;GBB;RBG;0;1;1;0;1;run100
15786;GBB;RBR;1;1;2;0;2;run100
15787;GBB;RGG;0;2;2;1;1;run100
15788;GBB;RGR;0;1;1;1;0;run100
15789;GBB;RRG;0;3;3;0;3;run100
15790;GBG;BRB;0;1;1;0;1;run100
15791;GBG;BRR;0;3;3;2;1;run100
15792;GBG;GGB;0;1;1;0;1;run100
15793;GBG;GGR;0;3;3;2;1;run100
15794;GBG;RBR;0;1;1;0;1;run100
15795;GBG;RGR;1;1;2;2;0;run100
15796;GBG;RRR;0;1;1;0;1;run100
15797;GGB;BBB;1;8;9;5;4;run100
15798;GGB;BBG;0;1;1;0;1;run100
15799;GGB;BGB;0;1;1;0;1;run100
15800;GGB;BRB;3;5;8;8;0;run100
15801;GGB;BRR;0;1;1;1;0;run100
15802;GGB;GBG;0;2;2;2;0;run100
15803;GGB;GGG;4;37;41;6;35;run100
15804;GGB;GGR;0;9;9;0;9;run100
15805;GGB;GRR;1;4;5;0;5;run100
15806;GGB;RBB;0;2;2;1;1;run100
15807;GGB;RBG;0;2;2;1;1;run100
15808;GGB;RBR;0;2;2;2;0;run100
15809;GGB;RGG;0;1;1;0;1;run100
15810;GGB;RGR;1;2;3;1;2;run100
15811;GGB;RRG;1;3;4;2;2;run100
15812;GGB;RRR;0;3;3;1;2;run100
15813;GGG;BBB;4;22;26;3;23;run100
15814;GGG;BBG;0;2;2;2;0;run100
15815;GGG;BBR;0;3;3;2;1;run100
15816;GGG;BGB;0;2;2;2;0;run100
15817;GGG;BGG;0;3;3;1;2;run100
15818;GGG;BRB;0;3;3;3;0;run100
15819;GGG;BRR;0;3;3;2;1;run100
15820;GGG;GBB;0;1;1;1;0;run100
15821;GGG;GGB;1;3;4;4;0;run100
15822;GGG;GGR;0;21;21;14;7;run100
15823;GGG;GRG;0;2;2;2;0;run100
15824;GGG;GRR;2;15;17;14;3;run100
15825;GGG;RBB;0;1;1;1;0;run100
15826;GGG;RBR;1;4;5;3;2;run100
15827;GGG;RGG;1;7;8;2;6;run100
15828;GGG;RGR;0;3;3;0;3;run100
15829;GGG;RRG;0;2;2;1;1;run100
15830;GGG;RRR;0;1;1;1;0;run100
15831;GGR;BBB;0;1;1;0;1;run100
15832;GGR;BGG;0;2;2;2;0;run100
15833;GGR;BRB;0;1;1;0;1;run100
15834;GRG;BBB;0;3;3;3;0;run100
15835;GRG;BGB;0;3;3;0;3;run100
15836;GRG;BGG;0;1;1;1;0;run100
15837;GRG;BRB;0;5;5;3;2;run100
15838;GRG;BRR;0;1;1;0;1;run100
15839;GRG;GBB;0;3;3;0;3;run100
15840;GRG;GGB;0;14;14;9;5;run100
15841;GRG;GGG;0;10;10;8;2;run100
15842;GRG;GGR;0;2;2;1;1;run100
15843;GRG;GRR;0;1;1;1;0;run100
15844;GRG;RBR;1;2;3;0;3;run100
15845;GRG;RGG;0;2;2;1;1;run100
15846;GRG;RGR;0;1;1;1;0;run100
15847;GRR;BBB;0;3;3;2;1;run100
15848;GRR;BBR;0;2;2;0;2;run100
15849;GRR;BRB;1;8;9;9;0;run100
15850;GRR;BRR;1;6;7;2;5;run100
15851;GRR;GBB;0;1;1;0;1;run100
15852;GRR;GBG;0;1;1;0;1;run100
15853;GRR;GGR;1;9;10;2;8;run100
15854;GRR;RBR;0;1;1;1;0;run100
15855;GRR;RGG;1;3;4;1;3;run100
15856;GRR;RGR;0;1;1;0;1;run100
15857;GRR;RRR;0;1;1;1;0;run100
15858;RBB;BBB;0;1;1;0;1;run100
15859;RBB;GGG;0;3;3;3;0;run100
15860;RBG;GRR;0;1;1;1;0;run100
15861;RBG;RBR;0;1;1;0;1;run100
15862;RBG;RGR;0;1;1;1;0;run100
15863;RBR;BBB;0;3;3;2;1;run100
15864;RBR;BRB;0;1;1;1;0;run100
15865;RBR;BRR;0;2;2;2;0;run100
15866;RBR;GGG;0;1;1;1;0;run100
15867;RBR;GGR;1;2;3;1;2;run100
15868;RBR;GRG;0;1;1;0;1;run100
15869;RBR;GRR;1;15;16;11;5;run100
15870;RBR;RGG;0;4;4;1;3;run100
15871;RBR;RGR;0;1;1;0;1;run100
15872;RBR;RRR;0;3;3;2;1;run100
15873;RGG;BGG;0;1;1;1;0;run100
15874;RGG;RGR;0;1;1;1;0;run100
15875;RGR;BBB;0;9;9;0;9;run100
15876;RGR;BBR;0;1;1;1;0;run100
15877;RGR;BGB;1;8;9;7;2;run100
15878;RGR;BRB;0;3;3;3;0;run100
15879;RGR;BRR;0;3;3;2;1;run100
15880;RGR;GBG;0;1;1;1;0;run100
15881;RGR;GGB;0;3;3;1;2;run100
15882;RGR;GGG;0;2;2;2;0;run100
15883;RGR;GGR;0;8;8;5;3;run100
15884;RGR;GRR;1;7;8;5;3;run100
15885;RGR;RGG;0;6;6;2;4;run100
15886;RRG;BGB;0;1;1;0;1;run100
15887;RRG;BRB;0;1;1;1;0;run100
15888;RRG;GGG;0;1;1;0;1;run100
15889;RRG;GGR;0;1;1;1;0;run100
15890;RRG;GRG;0;1;1;1;0;run100
15891;RRG;GRR;0;3;3;1;2;run100
15892;RRG;RBR;0;4;4;3;1;run100
15893;RRG;RGG;0;1;1;0;1;run100
15894;RRG;RGR;6;37;43;43;0;run100
15895;RRR;BRR;0;1;1;0;1;run100
15896;RRR;GGB;0;1;1;1;0;run100
15897;RRR;GGG;1;5;6;3;3;run100
15898;RRR;GGR;0;2;2;0;2;run100
15899;RRR;GRR;0;1;1;1;0;run100
15900;RRR;RGR;0;1;1;0;1;run100
