"","actor","subject","observed.crowd","observed.displace","observed.totalCD","random.displace","random.crowd","runID"
"1","BBB","BRB",0,1,1,0,1,"run001"
"2","BBB","GGG",1,2,3,3,0,"run001"
"3","BBB","GRR",0,2,2,2,0,"run001"
"4","BBB","RBG",0,1,1,0,1,"run001"
"5","BBB","RRG",1,3,4,1,3,"run001"
"6","BBB","RRR",0,2,2,0,2,"run001"
"7","BBG","BBB",1,4,5,2,3,"run001"
"8","BBG","BGB",0,1,1,1,0,"run001"
"9","BBG","BGG",0,1,1,1,0,"run001"
"10","BBG","BRB",1,16,17,0,17,"run001"
"11","BBG","GBB",0,1,1,0,1,"run001"
"12","BBG","GBG",2,7,9,4,5,"run001"
"13","BBG","GGB",2,25,27,9,18,"run001"
"14","BBG","GGG",4,38,42,9,33,"run001"
"15","BBG","GRG",1,9,10,6,4,"run001"
"16","BBG","GRR",0,1,1,0,1,"run001"
"17","BBG","RBB",0,1,1,0,1,"run001"
"18","BBG","RBG",0,4,4,4,0,"run001"
"19","BBG","RBR",0,1,1,0,1,"run001"
"20","BBG","RGR",0,1,1,0,1,"run001"
"21","BBG","RRG",1,2,3,0,3,"run001"
"22","BBG","RRR",0,7,7,5,2,"run001"
"23","BGB","BBB",0,2,2,0,2,"run001"
"24","BGB","RRG",0,1,1,0,1,"run001"
"25","BGG","BBB",0,3,3,1,2,"run001"
"26","BGG","BBR",0,1,1,1,0,"run001"
"27","BGG","GRG",0,1,1,1,0,"run001"
"28","BGG","RBG",1,1,2,0,2,"run001"
"29","BGG","RGG",0,3,3,3,0,"run001"
"30","BGG","RGR",0,1,1,0,1,"run001"
"31","BGG","RRR",1,1,2,0,2,"run001"
"32","BRB","BBB",0,13,13,3,10,"run001"
"33","BRB","BBR",0,1,1,0,1,"run001"
"34","BRB","BRR",0,3,3,1,2,"run001"
"35","BRB","GGG",0,1,1,1,0,"run001"
"36","BRB","GGR",0,1,1,1,0,"run001"
"37","BRB","RBB",0,1,1,1,0,"run001"
"38","BRB","RBG",0,1,1,0,1,"run001"
"39","BRB","RGR",0,1,1,1,0,"run001"
"40","BRB","RRR",0,1,1,1,0,"run001"
"41","BRR","BBB",0,11,11,3,8,"run001"
"42","BRR","BGB",1,1,2,1,1,"run001"
"43","BRR","BGG",0,1,1,1,0,"run001"
"44","BRR","BRB",0,1,1,0,1,"run001"
"45","BRR","RBB",0,2,2,2,0,"run001"
"46","GBB","BBB",12,38,50,5,45,"run001"
"47","GBB","BGG",0,1,1,0,1,"run001"
"48","GBB","BRB",1,9,10,7,3,"run001"
"49","GBB","BRR",1,3,4,3,1,"run001"
"50","GBB","GBG",0,4,4,0,4,"run001"
"51","GBB","GGB",0,21,21,5,16,"run001"
"52","GBB","GGG",7,86,93,38,55,"run001"
"53","GBB","GGR",1,3,4,2,2,"run001"
"54","GBB","GRG",0,6,6,1,5,"run001"
"55","GBB","GRR",0,1,1,1,0,"run001"
"56","GBB","RBB",0,2,2,1,1,"run001"
"57","GBB","RBG",3,9,12,1,11,"run001"
"58","GBB","RBR",1,0,1,0,1,"run001"
"59","GBB","RGG",1,0,1,1,0,"run001"
"60","GBB","RGR",2,1,3,1,2,"run001"
"61","GBB","RRG",0,2,2,1,1,"run001"
"62","GBB","RRR",1,9,10,5,5,"run001"
"63","GBG","BBB",0,5,5,0,5,"run001"
"64","GBG","BBR",0,1,1,0,1,"run001"
"65","GBG","BRB",1,4,5,2,3,"run001"
"66","GBG","BRR",1,0,1,1,0,"run001"
"67","GBG","GGB",0,4,4,3,1,"run001"
"68","GBG","GGG",4,11,15,5,10,"run001"
"69","GBG","RBB",1,0,1,1,0,"run001"
"70","GBG","RBG",0,1,1,0,1,"run001"
"71","GBG","RGG",0,1,1,0,1,"run001"
"72","GBG","RGR",1,3,4,0,4,"run001"
"73","GBG","RRG",1,3,4,3,1,"run001"
"74","GGB","BBB",3,16,19,12,7,"run001"
"75","GGB","BBR",1,4,5,0,5,"run001"
"76","GGB","BGB",0,3,3,3,0,"run001"
"77","GGB","BGG",0,4,4,0,4,"run001"
"78","GGB","BRB",0,1,1,0,1,"run001"
"79","GGB","BRR",1,15,16,13,3,"run001"
"80","GGB","GBB",0,1,1,1,0,"run001"
"81","GGB","GBG",1,0,1,0,1,"run001"
"82","GGB","GGG",13,48,61,28,33,"run001"
"83","GGB","GGR",0,7,7,4,3,"run001"
"84","GGB","GRR",0,4,4,3,1,"run001"
"85","GGB","RBB",0,5,5,5,0,"run001"
"86","GGB","RBG",0,4,4,4,0,"run001"
"87","GGB","RBR",0,5,5,3,2,"run001"
"88","GGB","RGG",1,5,6,3,3,"run001"
"89","GGB","RGR",0,2,2,0,2,"run001"
"90","GGB","RRG",1,5,6,4,2,"run001"
"91","GGB","RRR",1,5,6,4,2,"run001"
"92","GGG","BBB",8,31,39,30,9,"run001"
"93","GGG","BGB",0,2,2,1,1,"run001"
"94","GGG","BGG",1,7,8,0,8,"run001"
"95","GGG","BRB",1,3,4,0,4,"run001"
"96","GGG","BRR",0,6,6,6,0,"run001"
"97","GGG","GGB",5,1,6,6,0,"run001"
"98","GGG","GGR",1,9,10,2,8,"run001"
"99","GGG","GRR",0,2,2,1,1,"run001"
"100","GGG","RBB",1,8,9,1,8,"run001"
"101","GGG","RBG",0,6,6,1,5,"run001"
"102","GGG","RBR",0,21,21,15,6,"run001"
"103","GGG","RGG",0,3,3,2,1,"run001"
"104","GGG","RGR",1,12,13,13,0,"run001"
"105","GGG","RRG",1,23,24,9,15,"run001"
"106","GGG","RRR",0,3,3,3,0,"run001"
"107","GGR","BBB",0,2,2,2,0,"run001"
"108","GGR","BBR",0,2,2,2,0,"run001"
"109","GGR","BGG",0,1,1,1,0,"run001"
"110","GGR","BRR",1,0,1,0,1,"run001"
"111","GGR","GRR",1,0,1,0,1,"run001"
"112","GGR","RBB",0,2,2,1,1,"run001"
"113","GRG","BBB",3,8,11,9,2,"run001"
"114","GRG","BBR",0,1,1,0,1,"run001"
"115","GRG","BGG",0,1,1,0,1,"run001"
"116","GRG","BRB",0,3,3,2,1,"run001"
"117","GRG","BRR",0,1,1,1,0,"run001"
"118","GRG","GBG",0,1,1,0,1,"run001"
"119","GRG","GGB",2,15,17,9,8,"run001"
"120","GRG","GGG",3,12,15,15,0,"run001"
"121","GRG","GGR",0,5,5,4,1,"run001"
"122","GRG","GRR",0,1,1,1,0,"run001"
"123","GRG","RBG",0,1,1,0,1,"run001"
"124","GRG","RBR",0,1,1,0,1,"run001"
"125","GRG","RGR",1,2,3,3,0,"run001"
"126","GRG","RRG",2,4,6,4,2,"run001"
"127","GRR","BBB",0,1,1,1,0,"run001"
"128","GRR","BBR",0,1,1,1,0,"run001"
"129","GRR","BGB",1,2,3,3,0,"run001"
"130","GRR","BGG",0,2,2,0,2,"run001"
"131","GRR","BRB",0,1,1,0,1,"run001"
"132","GRR","BRR",0,2,2,1,1,"run001"
"133","GRR","GGG",0,1,1,0,1,"run001"
"134","GRR","GGR",0,1,1,0,1,"run001"
"135","RBB","BBB",0,1,1,0,1,"run001"
"136","RBB","BBR",0,1,1,0,1,"run001"
"137","RBB","BRB",0,1,1,1,0,"run001"
"138","RBB","GRR",0,1,1,1,0,"run001"
"139","RBB","RGG",0,1,1,1,0,"run001"
"140","RBG","BBB",2,8,10,3,7,"run001"
"141","RBG","BBG",0,1,1,0,1,"run001"
"142","RBG","BRR",0,1,1,0,1,"run001"
"143","RBG","GBB",0,1,1,0,1,"run001"
"144","RBG","GRR",0,3,3,1,2,"run001"
"145","RBG","RBB",1,1,2,0,2,"run001"
"146","RBG","RBR",0,1,1,0,1,"run001"
"147","RBG","RGR",0,1,1,1,0,"run001"
"148","RBR","BBB",0,13,13,2,11,"run001"
"149","RBR","BBR",0,1,1,0,1,"run001"
"150","RBR","BGB",2,4,6,5,1,"run001"
"151","RBR","BGG",0,2,2,2,0,"run001"
"152","RBR","BRB",1,0,1,0,1,"run001"
"153","RBR","BRR",1,4,5,3,2,"run001"
"154","RBR","GGB",0,12,12,0,12,"run001"
"155","RBR","GRR",4,4,8,8,0,"run001"
"156","RBR","RBB",0,3,3,3,0,"run001"
"157","RBR","RGG",2,9,11,1,10,"run001"
"158","RBR","RGR",1,0,1,1,0,"run001"
"159","RBR","RRR",0,1,1,1,0,"run001"
"160","RGG","BBB",0,8,8,0,8,"run001"
"161","RGG","BBR",1,2,3,1,2,"run001"
"162","RGG","BGB",0,1,1,0,1,"run001"
"163","RGG","BRR",0,4,4,2,2,"run001"
"164","RGG","GGG",0,1,1,0,1,"run001"
"165","RGG","GGR",0,3,3,2,1,"run001"
"166","RGG","GRR",0,8,8,3,5,"run001"
"167","RGG","RBB",0,1,1,0,1,"run001"
"168","RGR","BBB",2,5,7,7,0,"run001"
"169","RGR","BBR",1,1,2,2,0,"run001"
"170","RGR","BGB",2,5,7,4,3,"run001"
"171","RGR","BGG",2,2,4,2,2,"run001"
"172","RGR","BRR",1,5,6,3,3,"run001"
"173","RGR","GGB",2,12,14,1,13,"run001"
"174","RGR","GGG",0,2,2,0,2,"run001"
"175","RGR","GGR",0,4,4,3,1,"run001"
"176","RGR","RBB",0,4,4,0,4,"run001"
"177","RGR","RGG",1,1,2,1,1,"run001"
"178","RGR","RRG",0,3,3,0,3,"run001"
"179","RRG","BBB",2,33,35,25,10,"run001"
"180","RRG","BBR",0,5,5,1,4,"run001"
"181","RRG","BGB",1,10,11,1,10,"run001"
"182","RRG","BGG",0,2,2,2,0,"run001"
"183","RRG","BRB",2,40,42,16,26,"run001"
"184","RRG","BRR",1,16,17,1,16,"run001"
"185","RRG","GGG",2,14,16,10,6,"run001"
"186","RRG","GGR",0,5,5,2,3,"run001"
"187","RRG","GRG",1,0,1,0,1,"run001"
"188","RRG","GRR",3,8,11,2,9,"run001"
"189","RRG","RBB",1,1,2,0,2,"run001"
"190","RRG","RGG",0,1,1,0,1,"run001"
"191","RRG","RGR",0,1,1,1,0,"run001"
"192","RRR","BBR",1,0,1,1,0,"run001"
"193","RRR","BGB",2,1,3,0,3,"run001"
"194","RRR","BGG",1,0,1,1,0,"run001"
"195","RRR","BRB",1,1,2,1,1,"run001"
"196","RRR","BRR",1,1,2,1,1,"run001"
"197","RRR","GGR",0,1,1,0,1,"run001"
"198","RRR","GRR",0,3,3,3,0,"run001"
"199","RRR","RBB",1,2,3,0,3,"run001"
"200","RRR","RBR",0,2,2,0,2,"run001"
"201","RRR","RGG",0,1,1,1,0,"run001"
"202","RRR","RGR",1,2,3,0,3,"run001"
"203","RRR","RRG",2,2,4,4,0,"run001"
"204","BBB","BRB",0,1,1,0,1,"run002"
"205","BBB","GGG",1,2,3,2,1,"run002"
"206","BBB","GRR",0,2,2,1,1,"run002"
"207","BBB","RBG",0,1,1,1,0,"run002"
"208","BBB","RRG",1,3,4,0,4,"run002"
"209","BBB","RRR",0,2,2,0,2,"run002"
"210","BBG","BBB",1,4,5,0,5,"run002"
"211","BBG","BGB",0,1,1,1,0,"run002"
"212","BBG","BGG",0,1,1,0,1,"run002"
"213","BBG","BRB",1,16,17,8,9,"run002"
"214","BBG","GBB",0,1,1,1,0,"run002"
"215","BBG","GBG",2,7,9,0,9,"run002"
"216","BBG","GGB",2,25,27,2,25,"run002"
"217","BBG","GGG",4,38,42,15,27,"run002"
"218","BBG","GRG",1,9,10,1,9,"run002"
"219","BBG","GRR",0,1,1,0,1,"run002"
"220","BBG","RBB",0,1,1,0,1,"run002"
"221","BBG","RBG",0,4,4,0,4,"run002"
"222","BBG","RBR",0,1,1,1,0,"run002"
"223","BBG","RGR",0,1,1,0,1,"run002"
"224","BBG","RRG",1,2,3,3,0,"run002"
"225","BBG","RRR",0,7,7,3,4,"run002"
"226","BGB","BBB",0,2,2,2,0,"run002"
"227","BGB","RRG",0,1,1,1,0,"run002"
"228","BGG","BBB",0,3,3,0,3,"run002"
"229","BGG","BBR",0,1,1,1,0,"run002"
"230","BGG","GRG",0,1,1,1,0,"run002"
"231","BGG","RBG",1,1,2,0,2,"run002"
"232","BGG","RGG",0,3,3,1,2,"run002"
"233","BGG","RGR",0,1,1,1,0,"run002"
"234","BGG","RRR",1,1,2,1,1,"run002"
"235","BRB","BBB",0,13,13,2,11,"run002"
"236","BRB","BBR",0,1,1,0,1,"run002"
"237","BRB","BRR",0,3,3,2,1,"run002"
"238","BRB","GGG",0,1,1,1,0,"run002"
"239","BRB","GGR",0,1,1,0,1,"run002"
"240","BRB","RBB",0,1,1,0,1,"run002"
"241","BRB","RBG",0,1,1,1,0,"run002"
"242","BRB","RGR",0,1,1,1,0,"run002"
"243","BRB","RRR",0,1,1,1,0,"run002"
"244","BRR","BBB",0,11,11,6,5,"run002"
"245","BRR","BGB",1,1,2,1,1,"run002"
"246","BRR","BGG",0,1,1,0,1,"run002"
"247","BRR","BRB",0,1,1,1,0,"run002"
"248","BRR","RBB",0,2,2,2,0,"run002"
"249","GBB","BBB",12,38,50,0,50,"run002"
"250","GBB","BGG",0,1,1,0,1,"run002"
"251","GBB","BRB",1,9,10,8,2,"run002"
"252","GBB","BRR",1,3,4,4,0,"run002"
"253","GBB","GBG",0,4,4,0,4,"run002"
"254","GBB","GGB",0,21,21,17,4,"run002"
"255","GBB","GGG",7,86,93,7,86,"run002"
"256","GBB","GGR",1,3,4,3,1,"run002"
"257","GBB","GRG",0,6,6,4,2,"run002"
"258","GBB","GRR",0,1,1,1,0,"run002"
"259","GBB","RBB",0,2,2,1,1,"run002"
"260","GBB","RBG",3,9,12,4,8,"run002"
"261","GBB","RBR",1,0,1,1,0,"run002"
"262","GBB","RGG",1,0,1,1,0,"run002"
"263","GBB","RGR",2,1,3,0,3,"run002"
"264","GBB","RRG",0,2,2,1,1,"run002"
"265","GBB","RRR",1,9,10,6,4,"run002"
"266","GBG","BBB",0,5,5,1,4,"run002"
"267","GBG","BBR",0,1,1,1,0,"run002"
"268","GBG","BRB",1,4,5,3,2,"run002"
"269","GBG","BRR",1,0,1,1,0,"run002"
"270","GBG","GGB",0,4,4,3,1,"run002"
"271","GBG","GGG",4,11,15,3,12,"run002"
"272","GBG","RBB",1,0,1,0,1,"run002"
"273","GBG","RBG",0,1,1,1,0,"run002"
"274","GBG","RGG",0,1,1,0,1,"run002"
"275","GBG","RGR",1,3,4,1,3,"run002"
"276","GBG","RRG",1,3,4,2,2,"run002"
"277","GGB","BBB",3,16,19,14,5,"run002"
"278","GGB","BBR",1,4,5,4,1,"run002"
"279","GGB","BGB",0,3,3,2,1,"run002"
"280","GGB","BGG",0,4,4,4,0,"run002"
"281","GGB","BRB",0,1,1,1,0,"run002"
"282","GGB","BRR",1,15,16,12,4,"run002"
"283","GGB","GBB",0,1,1,0,1,"run002"
"284","GGB","GBG",1,0,1,0,1,"run002"
"285","GGB","GGG",13,48,61,37,24,"run002"
"286","GGB","GGR",0,7,7,0,7,"run002"
"287","GGB","GRR",0,4,4,1,3,"run002"
"288","GGB","RBB",0,5,5,0,5,"run002"
"289","GGB","RBG",0,4,4,4,0,"run002"
"290","GGB","RBR",0,5,5,3,2,"run002"
"291","GGB","RGG",1,5,6,0,6,"run002"
"292","GGB","RGR",0,2,2,1,1,"run002"
"293","GGB","RRG",1,5,6,0,6,"run002"
"294","GGB","RRR",1,5,6,6,0,"run002"
"295","GGG","BBB",8,31,39,20,19,"run002"
"296","GGG","BGB",0,2,2,2,0,"run002"
"297","GGG","BGG",1,7,8,8,0,"run002"
"298","GGG","BRB",1,3,4,1,3,"run002"
"299","GGG","BRR",0,6,6,5,1,"run002"
"300","GGG","GGB",5,1,6,4,2,"run002"
"301","GGG","GGR",1,9,10,10,0,"run002"
"302","GGG","GRR",0,2,2,0,2,"run002"
"303","GGG","RBB",1,8,9,8,1,"run002"
"304","GGG","RBG",0,6,6,1,5,"run002"
"305","GGG","RBR",0,21,21,19,2,"run002"
"306","GGG","RGG",0,3,3,0,3,"run002"
"307","GGG","RGR",1,12,13,3,10,"run002"
"308","GGG","RRG",1,23,24,21,3,"run002"
"309","GGG","RRR",0,3,3,3,0,"run002"
"310","GGR","BBB",0,2,2,0,2,"run002"
"311","GGR","BBR",0,2,2,0,2,"run002"
"312","GGR","BGG",0,1,1,1,0,"run002"
"313","GGR","BRR",1,0,1,0,1,"run002"
"314","GGR","GRR",1,0,1,1,0,"run002"
"315","GGR","RBB",0,2,2,1,1,"run002"
"316","GRG","BBB",3,8,11,6,5,"run002"
"317","GRG","BBR",0,1,1,1,0,"run002"
"318","GRG","BGG",0,1,1,0,1,"run002"
"319","GRG","BRB",0,3,3,0,3,"run002"
"320","GRG","BRR",0,1,1,1,0,"run002"
"321","GRG","GBG",0,1,1,0,1,"run002"
"322","GRG","GGB",2,15,17,14,3,"run002"
"323","GRG","GGG",3,12,15,12,3,"run002"
"324","GRG","GGR",0,5,5,0,5,"run002"
"325","GRG","GRR",0,1,1,0,1,"run002"
"326","GRG","RBG",0,1,1,1,0,"run002"
"327","GRG","RBR",0,1,1,0,1,"run002"
"328","GRG","RGR",1,2,3,2,1,"run002"
"329","GRG","RRG",2,4,6,0,6,"run002"
"330","GRR","BBB",0,1,1,0,1,"run002"
"331","GRR","BBR",0,1,1,0,1,"run002"
"332","GRR","BGB",1,2,3,1,2,"run002"
"333","GRR","BGG",0,2,2,0,2,"run002"
"334","GRR","BRB",0,1,1,0,1,"run002"
"335","GRR","BRR",0,2,2,0,2,"run002"
"336","GRR","GGG",0,1,1,0,1,"run002"
"337","GRR","GGR",0,1,1,1,0,"run002"
"338","RBB","BBB",0,1,1,0,1,"run002"
"339","RBB","BBR",0,1,1,1,0,"run002"
"340","RBB","BRB",0,1,1,0,1,"run002"
"341","RBB","GRR",0,1,1,1,0,"run002"
"342","RBB","RGG",0,1,1,1,0,"run002"
"343","RBG","BBB",2,8,10,9,1,"run002"
"344","RBG","BBG",0,1,1,0,1,"run002"
"345","RBG","BRR",0,1,1,1,0,"run002"
"346","RBG","GBB",0,1,1,1,0,"run002"
"347","RBG","GRR",0,3,3,3,0,"run002"
"348","RBG","RBB",1,1,2,2,0,"run002"
"349","RBG","RBR",0,1,1,0,1,"run002"
"350","RBG","RGR",0,1,1,0,1,"run002"
"351","RBR","BBB",0,13,13,6,7,"run002"
"352","RBR","BBR",0,1,1,0,1,"run002"
"353","RBR","BGB",2,4,6,4,2,"run002"
"354","RBR","BGG",0,2,2,1,1,"run002"
"355","RBR","BRB",1,0,1,1,0,"run002"
"356","RBR","BRR",1,4,5,4,1,"run002"
"357","RBR","GGB",0,12,12,0,12,"run002"
"358","RBR","GRR",4,4,8,4,4,"run002"
"359","RBR","RBB",0,3,3,3,0,"run002"
"360","RBR","RGG",2,9,11,3,8,"run002"
"361","RBR","RGR",1,0,1,0,1,"run002"
"362","RBR","RRR",0,1,1,0,1,"run002"
"363","RGG","BBB",0,8,8,7,1,"run002"
"364","RGG","BBR",1,2,3,2,1,"run002"
"365","RGG","BGB",0,1,1,1,0,"run002"
"366","RGG","BRR",0,4,4,1,3,"run002"
"367","RGG","GGG",0,1,1,0,1,"run002"
"368","RGG","GGR",0,3,3,2,1,"run002"
"369","RGG","GRR",0,8,8,0,8,"run002"
"370","RGG","RBB",0,1,1,1,0,"run002"
"371","RGR","BBB",2,5,7,1,6,"run002"
"372","RGR","BBR",1,1,2,1,1,"run002"
"373","RGR","BGB",2,5,7,3,4,"run002"
"374","RGR","BGG",2,2,4,4,0,"run002"
"375","RGR","BRR",1,5,6,1,5,"run002"
"376","RGR","GGB",2,12,14,11,3,"run002"
"377","RGR","GGG",0,2,2,1,1,"run002"
"378","RGR","GGR",0,4,4,4,0,"run002"
"379","RGR","RBB",0,4,4,3,1,"run002"
"380","RGR","RGG",1,1,2,2,0,"run002"
"381","RGR","RRG",0,3,3,0,3,"run002"
"382","RRG","BBB",2,33,35,17,18,"run002"
"383","RRG","BBR",0,5,5,5,0,"run002"
"384","RRG","BGB",1,10,11,2,9,"run002"
"385","RRG","BGG",0,2,2,0,2,"run002"
"386","RRG","BRB",2,40,42,17,25,"run002"
"387","RRG","BRR",1,16,17,10,7,"run002"
"388","RRG","GGG",2,14,16,1,15,"run002"
"389","RRG","GGR",0,5,5,5,0,"run002"
"390","RRG","GRG",1,0,1,1,0,"run002"
"391","RRG","GRR",3,8,11,4,7,"run002"
"392","RRG","RBB",1,1,2,1,1,"run002"
"393","RRG","RGG",0,1,1,1,0,"run002"
"394","RRG","RGR",0,1,1,1,0,"run002"
"395","RRR","BBR",1,0,1,0,1,"run002"
"396","RRR","BGB",2,1,3,2,1,"run002"
"397","RRR","BGG",1,0,1,1,0,"run002"
"398","RRR","BRB",1,1,2,2,0,"run002"
"399","RRR","BRR",1,1,2,1,1,"run002"
"400","RRR","GGR",0,1,1,0,1,"run002"
"401","RRR","GRR",0,3,3,1,2,"run002"
"402","RRR","RBB",1,2,3,3,0,"run002"
"403","RRR","RBR",0,2,2,1,1,"run002"
"404","RRR","RGG",0,1,1,1,0,"run002"
"405","RRR","RGR",1,2,3,0,3,"run002"
"406","RRR","RRG",2,2,4,2,2,"run002"
"407","BBB","BRB",0,1,1,0,1,"run003"
"408","BBB","GGG",1,2,3,1,2,"run003"
"409","BBB","GRR",0,2,2,2,0,"run003"
"410","BBB","RBG",0,1,1,1,0,"run003"
"411","BBB","RRG",1,3,4,1,3,"run003"
"412","BBB","RRR",0,2,2,2,0,"run003"
"413","BBG","BBB",1,4,5,3,2,"run003"
"414","BBG","BGB",0,1,1,1,0,"run003"
"415","BBG","BGG",0,1,1,0,1,"run003"
"416","BBG","BRB",1,16,17,7,10,"run003"
"417","BBG","GBB",0,1,1,1,0,"run003"
"418","BBG","GBG",2,7,9,7,2,"run003"
"419","BBG","GGB",2,25,27,7,20,"run003"
"420","BBG","GGG",4,38,42,36,6,"run003"
"421","BBG","GRG",1,9,10,1,9,"run003"
"422","BBG","GRR",0,1,1,0,1,"run003"
"423","BBG","RBB",0,1,1,1,0,"run003"
"424","BBG","RBG",0,4,4,4,0,"run003"
"425","BBG","RBR",0,1,1,0,1,"run003"
"426","BBG","RGR",0,1,1,1,0,"run003"
"427","BBG","RRG",1,2,3,0,3,"run003"
"428","BBG","RRR",0,7,7,0,7,"run003"
"429","BGB","BBB",0,2,2,0,2,"run003"
"430","BGB","RRG",0,1,1,1,0,"run003"
"431","BGG","BBB",0,3,3,3,0,"run003"
"432","BGG","BBR",0,1,1,1,0,"run003"
"433","BGG","GRG",0,1,1,1,0,"run003"
"434","BGG","RBG",1,1,2,0,2,"run003"
"435","BGG","RGG",0,3,3,3,0,"run003"
"436","BGG","RGR",0,1,1,1,0,"run003"
"437","BGG","RRR",1,1,2,1,1,"run003"
"438","BRB","BBB",0,13,13,11,2,"run003"
"439","BRB","BBR",0,1,1,0,1,"run003"
"440","BRB","BRR",0,3,3,1,2,"run003"
"441","BRB","GGG",0,1,1,1,0,"run003"
"442","BRB","GGR",0,1,1,0,1,"run003"
"443","BRB","RBB",0,1,1,1,0,"run003"
"444","BRB","RBG",0,1,1,0,1,"run003"
"445","BRB","RGR",0,1,1,0,1,"run003"
"446","BRB","RRR",0,1,1,0,1,"run003"
"447","BRR","BBB",0,11,11,2,9,"run003"
"448","BRR","BGB",1,1,2,1,1,"run003"
"449","BRR","BGG",0,1,1,0,1,"run003"
"450","BRR","BRB",0,1,1,0,1,"run003"
"451","BRR","RBB",0,2,2,2,0,"run003"
"452","GBB","BBB",12,38,50,7,43,"run003"
"453","GBB","BGG",0,1,1,1,0,"run003"
"454","GBB","BRB",1,9,10,3,7,"run003"
"455","GBB","BRR",1,3,4,0,4,"run003"
"456","GBB","GBG",0,4,4,2,2,"run003"
"457","GBB","GGB",0,21,21,5,16,"run003"
"458","GBB","GGG",7,86,93,56,37,"run003"
"459","GBB","GGR",1,3,4,1,3,"run003"
"460","GBB","GRG",0,6,6,4,2,"run003"
"461","GBB","GRR",0,1,1,1,0,"run003"
"462","GBB","RBB",0,2,2,2,0,"run003"
"463","GBB","RBG",3,9,12,9,3,"run003"
"464","GBB","RBR",1,0,1,0,1,"run003"
"465","GBB","RGG",1,0,1,0,1,"run003"
"466","GBB","RGR",2,1,3,0,3,"run003"
"467","GBB","RRG",0,2,2,0,2,"run003"
"468","GBB","RRR",1,9,10,4,6,"run003"
"469","GBG","BBB",0,5,5,1,4,"run003"
"470","GBG","BBR",0,1,1,1,0,"run003"
"471","GBG","BRB",1,4,5,5,0,"run003"
"472","GBG","BRR",1,0,1,0,1,"run003"
"473","GBG","GGB",0,4,4,2,2,"run003"
"474","GBG","GGG",4,11,15,9,6,"run003"
"475","GBG","RBB",1,0,1,1,0,"run003"
"476","GBG","RBG",0,1,1,1,0,"run003"
"477","GBG","RGG",0,1,1,0,1,"run003"
"478","GBG","RGR",1,3,4,2,2,"run003"
"479","GBG","RRG",1,3,4,3,1,"run003"
"480","GGB","BBB",3,16,19,11,8,"run003"
"481","GGB","BBR",1,4,5,1,4,"run003"
"482","GGB","BGB",0,3,3,0,3,"run003"
"483","GGB","BGG",0,4,4,3,1,"run003"
"484","GGB","BRB",0,1,1,1,0,"run003"
"485","GGB","BRR",1,15,16,0,16,"run003"
"486","GGB","GBB",0,1,1,0,1,"run003"
"487","GGB","GBG",1,0,1,1,0,"run003"
"488","GGB","GGG",13,48,61,52,9,"run003"
"489","GGB","GGR",0,7,7,1,6,"run003"
"490","GGB","GRR",0,4,4,1,3,"run003"
"491","GGB","RBB",0,5,5,5,0,"run003"
"492","GGB","RBG",0,4,4,2,2,"run003"
"493","GGB","RBR",0,5,5,0,5,"run003"
"494","GGB","RGG",1,5,6,1,5,"run003"
"495","GGB","RGR",0,2,2,1,1,"run003"
"496","GGB","RRG",1,5,6,4,2,"run003"
"497","GGB","RRR",1,5,6,6,0,"run003"
"498","GGG","BBB",8,31,39,10,29,"run003"
"499","GGG","BGB",0,2,2,1,1,"run003"
"500","GGG","BGG",1,7,8,3,5,"run003"
"501","GGG","BRB",1,3,4,0,4,"run003"
"502","GGG","BRR",0,6,6,4,2,"run003"
"503","GGG","GGB",5,1,6,5,1,"run003"
"504","GGG","GGR",1,9,10,6,4,"run003"
"505","GGG","GRR",0,2,2,2,0,"run003"
"506","GGG","RBB",1,8,9,2,7,"run003"
"507","GGG","RBG",0,6,6,3,3,"run003"
"508","GGG","RBR",0,21,21,3,18,"run003"
"509","GGG","RGG",0,3,3,2,1,"run003"
"510","GGG","RGR",1,12,13,12,1,"run003"
"511","GGG","RRG",1,23,24,15,9,"run003"
"512","GGG","RRR",0,3,3,0,3,"run003"
"513","GGR","BBB",0,2,2,1,1,"run003"
"514","GGR","BBR",0,2,2,2,0,"run003"
"515","GGR","BGG",0,1,1,1,0,"run003"
"516","GGR","BRR",1,0,1,1,0,"run003"
"517","GGR","GRR",1,0,1,0,1,"run003"
"518","GGR","RBB",0,2,2,2,0,"run003"
"519","GRG","BBB",3,8,11,1,10,"run003"
"520","GRG","BBR",0,1,1,0,1,"run003"
"521","GRG","BGG",0,1,1,0,1,"run003"
"522","GRG","BRB",0,3,3,2,1,"run003"
"523","GRG","BRR",0,1,1,0,1,"run003"
"524","GRG","GBG",0,1,1,0,1,"run003"
"525","GRG","GGB",2,15,17,8,9,"run003"
"526","GRG","GGG",3,12,15,9,6,"run003"
"527","GRG","GGR",0,5,5,5,0,"run003"
"528","GRG","GRR",0,1,1,1,0,"run003"
"529","GRG","RBG",0,1,1,0,1,"run003"
"530","GRG","RBR",0,1,1,0,1,"run003"
"531","GRG","RGR",1,2,3,1,2,"run003"
"532","GRG","RRG",2,4,6,4,2,"run003"
"533","GRR","BBB",0,1,1,1,0,"run003"
"534","GRR","BBR",0,1,1,1,0,"run003"
"535","GRR","BGB",1,2,3,3,0,"run003"
"536","GRR","BGG",0,2,2,0,2,"run003"
"537","GRR","BRB",0,1,1,0,1,"run003"
"538","GRR","BRR",0,2,2,1,1,"run003"
"539","GRR","GGG",0,1,1,1,0,"run003"
"540","GRR","GGR",0,1,1,0,1,"run003"
"541","RBB","BBB",0,1,1,0,1,"run003"
"542","RBB","BBR",0,1,1,0,1,"run003"
"543","RBB","BRB",0,1,1,0,1,"run003"
"544","RBB","GRR",0,1,1,1,0,"run003"
"545","RBB","RGG",0,1,1,0,1,"run003"
"546","RBG","BBB",2,8,10,0,10,"run003"
"547","RBG","BBG",0,1,1,1,0,"run003"
"548","RBG","BRR",0,1,1,1,0,"run003"
"549","RBG","GBB",0,1,1,1,0,"run003"
"550","RBG","GRR",0,3,3,0,3,"run003"
"551","RBG","RBB",1,1,2,0,2,"run003"
"552","RBG","RBR",0,1,1,0,1,"run003"
"553","RBG","RGR",0,1,1,1,0,"run003"
"554","RBR","BBB",0,13,13,4,9,"run003"
"555","RBR","BBR",0,1,1,0,1,"run003"
"556","RBR","BGB",2,4,6,4,2,"run003"
"557","RBR","BGG",0,2,2,0,2,"run003"
"558","RBR","BRB",1,0,1,1,0,"run003"
"559","RBR","BRR",1,4,5,5,0,"run003"
"560","RBR","GGB",0,12,12,4,8,"run003"
"561","RBR","GRR",4,4,8,2,6,"run003"
"562","RBR","RBB",0,3,3,1,2,"run003"
"563","RBR","RGG",2,9,11,11,0,"run003"
"564","RBR","RGR",1,0,1,1,0,"run003"
"565","RBR","RRR",0,1,1,1,0,"run003"
"566","RGG","BBB",0,8,8,2,6,"run003"
"567","RGG","BBR",1,2,3,1,2,"run003"
"568","RGG","BGB",0,1,1,0,1,"run003"
"569","RGG","BRR",0,4,4,4,0,"run003"
"570","RGG","GGG",0,1,1,0,1,"run003"
"571","RGG","GGR",0,3,3,0,3,"run003"
"572","RGG","GRR",0,8,8,3,5,"run003"
"573","RGG","RBB",0,1,1,1,0,"run003"
"574","RGR","BBB",2,5,7,7,0,"run003"
"575","RGR","BBR",1,1,2,1,1,"run003"
"576","RGR","BGB",2,5,7,2,5,"run003"
"577","RGR","BGG",2,2,4,0,4,"run003"
"578","RGR","BRR",1,5,6,5,1,"run003"
"579","RGR","GGB",2,12,14,3,11,"run003"
"580","RGR","GGG",0,2,2,1,1,"run003"
"581","RGR","GGR",0,4,4,3,1,"run003"
"582","RGR","RBB",0,4,4,0,4,"run003"
"583","RGR","RGG",1,1,2,2,0,"run003"
"584","RGR","RRG",0,3,3,3,0,"run003"
"585","RRG","BBB",2,33,35,34,1,"run003"
"586","RRG","BBR",0,5,5,4,1,"run003"
"587","RRG","BGB",1,10,11,5,6,"run003"
"588","RRG","BGG",0,2,2,0,2,"run003"
"589","RRG","BRB",2,40,42,3,39,"run003"
"590","RRG","BRR",1,16,17,1,16,"run003"
"591","RRG","GGG",2,14,16,3,13,"run003"
"592","RRG","GGR",0,5,5,3,2,"run003"
"593","RRG","GRG",1,0,1,1,0,"run003"
"594","RRG","GRR",3,8,11,10,1,"run003"
"595","RRG","RBB",1,1,2,1,1,"run003"
"596","RRG","RGG",0,1,1,0,1,"run003"
"597","RRG","RGR",0,1,1,0,1,"run003"
"598","RRR","BBR",1,0,1,0,1,"run003"
"599","RRR","BGB",2,1,3,0,3,"run003"
"600","RRR","BGG",1,0,1,0,1,"run003"
"601","RRR","BRB",1,1,2,0,2,"run003"
"602","RRR","BRR",1,1,2,1,1,"run003"
"603","RRR","GGR",0,1,1,1,0,"run003"
"604","RRR","GRR",0,3,3,2,1,"run003"
"605","RRR","RBB",1,2,3,1,2,"run003"
"606","RRR","RBR",0,2,2,0,2,"run003"
"607","RRR","RGG",0,1,1,1,0,"run003"
"608","RRR","RGR",1,2,3,1,2,"run003"
"609","RRR","RRG",2,2,4,3,1,"run003"
"610","BBB","BRB",0,1,1,1,0,"run004"
"611","BBB","GGG",1,2,3,2,1,"run004"
"612","BBB","GRR",0,2,2,2,0,"run004"
"613","BBB","RBG",0,1,1,0,1,"run004"
"614","BBB","RRG",1,3,4,3,1,"run004"
"615","BBB","RRR",0,2,2,2,0,"run004"
"616","BBG","BBB",1,4,5,5,0,"run004"
"617","BBG","BGB",0,1,1,0,1,"run004"
"618","BBG","BGG",0,1,1,1,0,"run004"
"619","BBG","BRB",1,16,17,5,12,"run004"
"620","BBG","GBB",0,1,1,1,0,"run004"
"621","BBG","GBG",2,7,9,7,2,"run004"
"622","BBG","GGB",2,25,27,0,27,"run004"
"623","BBG","GGG",4,38,42,19,23,"run004"
"624","BBG","GRG",1,9,10,10,0,"run004"
"625","BBG","GRR",0,1,1,0,1,"run004"
"626","BBG","RBB",0,1,1,0,1,"run004"
"627","BBG","RBG",0,4,4,4,0,"run004"
"628","BBG","RBR",0,1,1,1,0,"run004"
"629","BBG","RGR",0,1,1,1,0,"run004"
"630","BBG","RRG",1,2,3,0,3,"run004"
"631","BBG","RRR",0,7,7,4,3,"run004"
"632","BGB","BBB",0,2,2,1,1,"run004"
"633","BGB","RRG",0,1,1,1,0,"run004"
"634","BGG","BBB",0,3,3,2,1,"run004"
"635","BGG","BBR",0,1,1,1,0,"run004"
"636","BGG","GRG",0,1,1,0,1,"run004"
"637","BGG","RBG",1,1,2,2,0,"run004"
"638","BGG","RGG",0,3,3,0,3,"run004"
"639","BGG","RGR",0,1,1,1,0,"run004"
"640","BGG","RRR",1,1,2,0,2,"run004"
"641","BRB","BBB",0,13,13,0,13,"run004"
"642","BRB","BBR",0,1,1,1,0,"run004"
"643","BRB","BRR",0,3,3,2,1,"run004"
"644","BRB","GGG",0,1,1,0,1,"run004"
"645","BRB","GGR",0,1,1,1,0,"run004"
"646","BRB","RBB",0,1,1,1,0,"run004"
"647","BRB","RBG",0,1,1,0,1,"run004"
"648","BRB","RGR",0,1,1,1,0,"run004"
"649","BRB","RRR",0,1,1,0,1,"run004"
"650","BRR","BBB",0,11,11,7,4,"run004"
"651","BRR","BGB",1,1,2,1,1,"run004"
"652","BRR","BGG",0,1,1,0,1,"run004"
"653","BRR","BRB",0,1,1,1,0,"run004"
"654","BRR","RBB",0,2,2,0,2,"run004"
"655","GBB","BBB",12,38,50,19,31,"run004"
"656","GBB","BGG",0,1,1,1,0,"run004"
"657","GBB","BRB",1,9,10,4,6,"run004"
"658","GBB","BRR",1,3,4,0,4,"run004"
"659","GBB","GBG",0,4,4,1,3,"run004"
"660","GBB","GGB",0,21,21,9,12,"run004"
"661","GBB","GGG",7,86,93,51,42,"run004"
"662","GBB","GGR",1,3,4,1,3,"run004"
"663","GBB","GRG",0,6,6,1,5,"run004"
"664","GBB","GRR",0,1,1,1,0,"run004"
"665","GBB","RBB",0,2,2,2,0,"run004"
"666","GBB","RBG",3,9,12,5,7,"run004"
"667","GBB","RBR",1,0,1,0,1,"run004"
"668","GBB","RGG",1,0,1,0,1,"run004"
"669","GBB","RGR",2,1,3,1,2,"run004"
"670","GBB","RRG",0,2,2,1,1,"run004"
"671","GBB","RRR",1,9,10,0,10,"run004"
"672","GBG","BBB",0,5,5,3,2,"run004"
"673","GBG","BBR",0,1,1,1,0,"run004"
"674","GBG","BRB",1,4,5,3,2,"run004"
"675","GBG","BRR",1,0,1,0,1,"run004"
"676","GBG","GGB",0,4,4,0,4,"run004"
"677","GBG","GGG",4,11,15,6,9,"run004"
"678","GBG","RBB",1,0,1,1,0,"run004"
"679","GBG","RBG",0,1,1,0,1,"run004"
"680","GBG","RGG",0,1,1,0,1,"run004"
"681","GBG","RGR",1,3,4,4,0,"run004"
"682","GBG","RRG",1,3,4,3,1,"run004"
"683","GGB","BBB",3,16,19,9,10,"run004"
"684","GGB","BBR",1,4,5,0,5,"run004"
"685","GGB","BGB",0,3,3,3,0,"run004"
"686","GGB","BGG",0,4,4,0,4,"run004"
"687","GGB","BRB",0,1,1,1,0,"run004"
"688","GGB","BRR",1,15,16,14,2,"run004"
"689","GGB","GBB",0,1,1,0,1,"run004"
"690","GGB","GBG",1,0,1,1,0,"run004"
"691","GGB","GGG",13,48,61,31,30,"run004"
"692","GGB","GGR",0,7,7,5,2,"run004"
"693","GGB","GRR",0,4,4,3,1,"run004"
"694","GGB","RBB",0,5,5,3,2,"run004"
"695","GGB","RBG",0,4,4,4,0,"run004"
"696","GGB","RBR",0,5,5,4,1,"run004"
"697","GGB","RGG",1,5,6,1,5,"run004"
"698","GGB","RGR",0,2,2,0,2,"run004"
"699","GGB","RRG",1,5,6,4,2,"run004"
"700","GGB","RRR",1,5,6,5,1,"run004"
"701","GGG","BBB",8,31,39,11,28,"run004"
"702","GGG","BGB",0,2,2,1,1,"run004"
"703","GGG","BGG",1,7,8,4,4,"run004"
"704","GGG","BRB",1,3,4,0,4,"run004"
"705","GGG","BRR",0,6,6,6,0,"run004"
"706","GGG","GGB",5,1,6,2,4,"run004"
"707","GGG","GGR",1,9,10,0,10,"run004"
"708","GGG","GRR",0,2,2,2,0,"run004"
"709","GGG","RBB",1,8,9,1,8,"run004"
"710","GGG","RBG",0,6,6,0,6,"run004"
"711","GGG","RBR",0,21,21,12,9,"run004"
"712","GGG","RGG",0,3,3,2,1,"run004"
"713","GGG","RGR",1,12,13,6,7,"run004"
"714","GGG","RRG",1,23,24,4,20,"run004"
"715","GGG","RRR",0,3,3,0,3,"run004"
"716","GGR","BBB",0,2,2,2,0,"run004"
"717","GGR","BBR",0,2,2,0,2,"run004"
"718","GGR","BGG",0,1,1,0,1,"run004"
"719","GGR","BRR",1,0,1,0,1,"run004"
"720","GGR","GRR",1,0,1,0,1,"run004"
"721","GGR","RBB",0,2,2,2,0,"run004"
"722","GRG","BBB",3,8,11,2,9,"run004"
"723","GRG","BBR",0,1,1,0,1,"run004"
"724","GRG","BGG",0,1,1,0,1,"run004"
"725","GRG","BRB",0,3,3,1,2,"run004"
"726","GRG","BRR",0,1,1,1,0,"run004"
"727","GRG","GBG",0,1,1,0,1,"run004"
"728","GRG","GGB",2,15,17,8,9,"run004"
"729","GRG","GGG",3,12,15,2,13,"run004"
"730","GRG","GGR",0,5,5,2,3,"run004"
"731","GRG","GRR",0,1,1,0,1,"run004"
"732","GRG","RBG",0,1,1,1,0,"run004"
"733","GRG","RBR",0,1,1,0,1,"run004"
"734","GRG","RGR",1,2,3,2,1,"run004"
"735","GRG","RRG",2,4,6,4,2,"run004"
"736","GRR","BBB",0,1,1,0,1,"run004"
"737","GRR","BBR",0,1,1,1,0,"run004"
"738","GRR","BGB",1,2,3,0,3,"run004"
"739","GRR","BGG",0,2,2,1,1,"run004"
"740","GRR","BRB",0,1,1,1,0,"run004"
"741","GRR","BRR",0,2,2,0,2,"run004"
"742","GRR","GGG",0,1,1,0,1,"run004"
"743","GRR","GGR",0,1,1,0,1,"run004"
"744","RBB","BBB",0,1,1,1,0,"run004"
"745","RBB","BBR",0,1,1,0,1,"run004"
"746","RBB","BRB",0,1,1,0,1,"run004"
"747","RBB","GRR",0,1,1,1,0,"run004"
"748","RBB","RGG",0,1,1,1,0,"run004"
"749","RBG","BBB",2,8,10,2,8,"run004"
"750","RBG","BBG",0,1,1,0,1,"run004"
"751","RBG","BRR",0,1,1,1,0,"run004"
"752","RBG","GBB",0,1,1,0,1,"run004"
"753","RBG","GRR",0,3,3,2,1,"run004"
"754","RBG","RBB",1,1,2,1,1,"run004"
"755","RBG","RBR",0,1,1,1,0,"run004"
"756","RBG","RGR",0,1,1,1,0,"run004"
"757","RBR","BBB",0,13,13,13,0,"run004"
"758","RBR","BBR",0,1,1,0,1,"run004"
"759","RBR","BGB",2,4,6,4,2,"run004"
"760","RBR","BGG",0,2,2,2,0,"run004"
"761","RBR","BRB",1,0,1,1,0,"run004"
"762","RBR","BRR",1,4,5,3,2,"run004"
"763","RBR","GGB",0,12,12,2,10,"run004"
"764","RBR","GRR",4,4,8,4,4,"run004"
"765","RBR","RBB",0,3,3,3,0,"run004"
"766","RBR","RGG",2,9,11,2,9,"run004"
"767","RBR","RGR",1,0,1,0,1,"run004"
"768","RBR","RRR",0,1,1,0,1,"run004"
"769","RGG","BBB",0,8,8,6,2,"run004"
"770","RGG","BBR",1,2,3,3,0,"run004"
"771","RGG","BGB",0,1,1,1,0,"run004"
"772","RGG","BRR",0,4,4,4,0,"run004"
"773","RGG","GGG",0,1,1,0,1,"run004"
"774","RGG","GGR",0,3,3,1,2,"run004"
"775","RGG","GRR",0,8,8,8,0,"run004"
"776","RGG","RBB",0,1,1,1,0,"run004"
"777","RGR","BBB",2,5,7,3,4,"run004"
"778","RGR","BBR",1,1,2,1,1,"run004"
"779","RGR","BGB",2,5,7,3,4,"run004"
"780","RGR","BGG",2,2,4,2,2,"run004"
"781","RGR","BRR",1,5,6,5,1,"run004"
"782","RGR","GGB",2,12,14,11,3,"run004"
"783","RGR","GGG",0,2,2,1,1,"run004"
"784","RGR","GGR",0,4,4,3,1,"run004"
"785","RGR","RBB",0,4,4,0,4,"run004"
"786","RGR","RGG",1,1,2,1,1,"run004"
"787","RGR","RRG",0,3,3,0,3,"run004"
"788","RRG","BBB",2,33,35,21,14,"run004"
"789","RRG","BBR",0,5,5,1,4,"run004"
"790","RRG","BGB",1,10,11,10,1,"run004"
"791","RRG","BGG",0,2,2,0,2,"run004"
"792","RRG","BRB",2,40,42,33,9,"run004"
"793","RRG","BRR",1,16,17,15,2,"run004"
"794","RRG","GGG",2,14,16,1,15,"run004"
"795","RRG","GGR",0,5,5,4,1,"run004"
"796","RRG","GRG",1,0,1,1,0,"run004"
"797","RRG","GRR",3,8,11,9,2,"run004"
"798","RRG","RBB",1,1,2,1,1,"run004"
"799","RRG","RGG",0,1,1,0,1,"run004"
"800","RRG","RGR",0,1,1,0,1,"run004"
"801","RRR","BBR",1,0,1,0,1,"run004"
"802","RRR","BGB",2,1,3,0,3,"run004"
"803","RRR","BGG",1,0,1,1,0,"run004"
"804","RRR","BRB",1,1,2,2,0,"run004"
"805","RRR","BRR",1,1,2,2,0,"run004"
"806","RRR","GGR",0,1,1,1,0,"run004"
"807","RRR","GRR",0,3,3,2,1,"run004"
"808","RRR","RBB",1,2,3,2,1,"run004"
"809","RRR","RBR",0,2,2,2,0,"run004"
"810","RRR","RGG",0,1,1,1,0,"run004"
"811","RRR","RGR",1,2,3,0,3,"run004"
"812","RRR","RRG",2,2,4,4,0,"run004"
"813","BBB","BRB",0,1,1,1,0,"run005"
"814","BBB","GGG",1,2,3,2,1,"run005"
"815","BBB","GRR",0,2,2,0,2,"run005"
"816","BBB","RBG",0,1,1,0,1,"run005"
"817","BBB","RRG",1,3,4,2,2,"run005"
"818","BBB","RRR",0,2,2,0,2,"run005"
"819","BBG","BBB",1,4,5,0,5,"run005"
"820","BBG","BGB",0,1,1,0,1,"run005"
"821","BBG","BGG",0,1,1,1,0,"run005"
"822","BBG","BRB",1,16,17,6,11,"run005"
"823","BBG","GBB",0,1,1,0,1,"run005"
"824","BBG","GBG",2,7,9,2,7,"run005"
"825","BBG","GGB",2,25,27,2,25,"run005"
"826","BBG","GGG",4,38,42,37,5,"run005"
"827","BBG","GRG",1,9,10,9,1,"run005"
"828","BBG","GRR",0,1,1,0,1,"run005"
"829","BBG","RBB",0,1,1,0,1,"run005"
"830","BBG","RBG",0,4,4,3,1,"run005"
"831","BBG","RBR",0,1,1,1,0,"run005"
"832","BBG","RGR",0,1,1,1,0,"run005"
"833","BBG","RRG",1,2,3,0,3,"run005"
"834","BBG","RRR",0,7,7,7,0,"run005"
"835","BGB","BBB",0,2,2,2,0,"run005"
"836","BGB","RRG",0,1,1,0,1,"run005"
"837","BGG","BBB",0,3,3,1,2,"run005"
"838","BGG","BBR",0,1,1,1,0,"run005"
"839","BGG","GRG",0,1,1,0,1,"run005"
"840","BGG","RBG",1,1,2,1,1,"run005"
"841","BGG","RGG",0,3,3,0,3,"run005"
"842","BGG","RGR",0,1,1,1,0,"run005"
"843","BGG","RRR",1,1,2,1,1,"run005"
"844","BRB","BBB",0,13,13,2,11,"run005"
"845","BRB","BBR",0,1,1,0,1,"run005"
"846","BRB","BRR",0,3,3,1,2,"run005"
"847","BRB","GGG",0,1,1,1,0,"run005"
"848","BRB","GGR",0,1,1,1,0,"run005"
"849","BRB","RBB",0,1,1,1,0,"run005"
"850","BRB","RBG",0,1,1,0,1,"run005"
"851","BRB","RGR",0,1,1,0,1,"run005"
"852","BRB","RRR",0,1,1,0,1,"run005"
"853","BRR","BBB",0,11,11,10,1,"run005"
"854","BRR","BGB",1,1,2,1,1,"run005"
"855","BRR","BGG",0,1,1,1,0,"run005"
"856","BRR","BRB",0,1,1,1,0,"run005"
"857","BRR","RBB",0,2,2,0,2,"run005"
"858","GBB","BBB",12,38,50,9,41,"run005"
"859","GBB","BGG",0,1,1,1,0,"run005"
"860","GBB","BRB",1,9,10,3,7,"run005"
"861","GBB","BRR",1,3,4,3,1,"run005"
"862","GBB","GBG",0,4,4,3,1,"run005"
"863","GBB","GGB",0,21,21,19,2,"run005"
"864","GBB","GGG",7,86,93,60,33,"run005"
"865","GBB","GGR",1,3,4,2,2,"run005"
"866","GBB","GRG",0,6,6,6,0,"run005"
"867","GBB","GRR",0,1,1,1,0,"run005"
"868","GBB","RBB",0,2,2,0,2,"run005"
"869","GBB","RBG",3,9,12,10,2,"run005"
"870","GBB","RBR",1,0,1,0,1,"run005"
"871","GBB","RGG",1,0,1,1,0,"run005"
"872","GBB","RGR",2,1,3,2,1,"run005"
"873","GBB","RRG",0,2,2,1,1,"run005"
"874","GBB","RRR",1,9,10,3,7,"run005"
"875","GBG","BBB",0,5,5,0,5,"run005"
"876","GBG","BBR",0,1,1,1,0,"run005"
"877","GBG","BRB",1,4,5,3,2,"run005"
"878","GBG","BRR",1,0,1,1,0,"run005"
"879","GBG","GGB",0,4,4,3,1,"run005"
"880","GBG","GGG",4,11,15,12,3,"run005"
"881","GBG","RBB",1,0,1,1,0,"run005"
"882","GBG","RBG",0,1,1,0,1,"run005"
"883","GBG","RGG",0,1,1,0,1,"run005"
"884","GBG","RGR",1,3,4,3,1,"run005"
"885","GBG","RRG",1,3,4,0,4,"run005"
"886","GGB","BBB",3,16,19,19,0,"run005"
"887","GGB","BBR",1,4,5,4,1,"run005"
"888","GGB","BGB",0,3,3,1,2,"run005"
"889","GGB","BGG",0,4,4,2,2,"run005"
"890","GGB","BRB",0,1,1,0,1,"run005"
"891","GGB","BRR",1,15,16,3,13,"run005"
"892","GGB","GBB",0,1,1,0,1,"run005"
"893","GGB","GBG",1,0,1,1,0,"run005"
"894","GGB","GGG",13,48,61,26,35,"run005"
"895","GGB","GGR",0,7,7,2,5,"run005"
"896","GGB","GRR",0,4,4,3,1,"run005"
"897","GGB","RBB",0,5,5,2,3,"run005"
"898","GGB","RBG",0,4,4,0,4,"run005"
"899","GGB","RBR",0,5,5,5,0,"run005"
"900","GGB","RGG",1,5,6,1,5,"run005"
"901","GGB","RGR",0,2,2,0,2,"run005"
"902","GGB","RRG",1,5,6,3,3,"run005"
"903","GGB","RRR",1,5,6,0,6,"run005"
"904","GGG","BBB",8,31,39,16,23,"run005"
"905","GGG","BGB",0,2,2,1,1,"run005"
"906","GGG","BGG",1,7,8,0,8,"run005"
"907","GGG","BRB",1,3,4,4,0,"run005"
"908","GGG","BRR",0,6,6,1,5,"run005"
"909","GGG","GGB",5,1,6,6,0,"run005"
"910","GGG","GGR",1,9,10,7,3,"run005"
"911","GGG","GRR",0,2,2,1,1,"run005"
"912","GGG","RBB",1,8,9,7,2,"run005"
"913","GGG","RBG",0,6,6,4,2,"run005"
"914","GGG","RBR",0,21,21,7,14,"run005"
"915","GGG","RGG",0,3,3,3,0,"run005"
"916","GGG","RGR",1,12,13,13,0,"run005"
"917","GGG","RRG",1,23,24,16,8,"run005"
"918","GGG","RRR",0,3,3,1,2,"run005"
"919","GGR","BBB",0,2,2,0,2,"run005"
"920","GGR","BBR",0,2,2,2,0,"run005"
"921","GGR","BGG",0,1,1,1,0,"run005"
"922","GGR","BRR",1,0,1,0,1,"run005"
"923","GGR","GRR",1,0,1,0,1,"run005"
"924","GGR","RBB",0,2,2,0,2,"run005"
"925","GRG","BBB",3,8,11,11,0,"run005"
"926","GRG","BBR",0,1,1,0,1,"run005"
"927","GRG","BGG",0,1,1,0,1,"run005"
"928","GRG","BRB",0,3,3,3,0,"run005"
"929","GRG","BRR",0,1,1,0,1,"run005"
"930","GRG","GBG",0,1,1,0,1,"run005"
"931","GRG","GGB",2,15,17,12,5,"run005"
"932","GRG","GGG",3,12,15,9,6,"run005"
"933","GRG","GGR",0,5,5,5,0,"run005"
"934","GRG","GRR",0,1,1,0,1,"run005"
"935","GRG","RBG",0,1,1,1,0,"run005"
"936","GRG","RBR",0,1,1,0,1,"run005"
"937","GRG","RGR",1,2,3,3,0,"run005"
"938","GRG","RRG",2,4,6,6,0,"run005"
"939","GRR","BBB",0,1,1,0,1,"run005"
"940","GRR","BBR",0,1,1,0,1,"run005"
"941","GRR","BGB",1,2,3,0,3,"run005"
"942","GRR","BGG",0,2,2,1,1,"run005"
"943","GRR","BRB",0,1,1,0,1,"run005"
"944","GRR","BRR",0,2,2,2,0,"run005"
"945","GRR","GGG",0,1,1,0,1,"run005"
"946","GRR","GGR",0,1,1,1,0,"run005"
"947","RBB","BBB",0,1,1,0,1,"run005"
"948","RBB","BBR",0,1,1,1,0,"run005"
"949","RBB","BRB",0,1,1,1,0,"run005"
"950","RBB","GRR",0,1,1,1,0,"run005"
"951","RBB","RGG",0,1,1,1,0,"run005"
"952","RBG","BBB",2,8,10,10,0,"run005"
"953","RBG","BBG",0,1,1,1,0,"run005"
"954","RBG","BRR",0,1,1,1,0,"run005"
"955","RBG","GBB",0,1,1,0,1,"run005"
"956","RBG","GRR",0,3,3,2,1,"run005"
"957","RBG","RBB",1,1,2,0,2,"run005"
"958","RBG","RBR",0,1,1,1,0,"run005"
"959","RBG","RGR",0,1,1,1,0,"run005"
"960","RBR","BBB",0,13,13,5,8,"run005"
"961","RBR","BBR",0,1,1,1,0,"run005"
"962","RBR","BGB",2,4,6,5,1,"run005"
"963","RBR","BGG",0,2,2,2,0,"run005"
"964","RBR","BRB",1,0,1,0,1,"run005"
"965","RBR","BRR",1,4,5,4,1,"run005"
"966","RBR","GGB",0,12,12,7,5,"run005"
"967","RBR","GRR",4,4,8,1,7,"run005"
"968","RBR","RBB",0,3,3,2,1,"run005"
"969","RBR","RGG",2,9,11,10,1,"run005"
"970","RBR","RGR",1,0,1,0,1,"run005"
"971","RBR","RRR",0,1,1,0,1,"run005"
"972","RGG","BBB",0,8,8,4,4,"run005"
"973","RGG","BBR",1,2,3,2,1,"run005"
"974","RGG","BGB",0,1,1,0,1,"run005"
"975","RGG","BRR",0,4,4,2,2,"run005"
"976","RGG","GGG",0,1,1,0,1,"run005"
"977","RGG","GGR",0,3,3,2,1,"run005"
"978","RGG","GRR",0,8,8,2,6,"run005"
"979","RGG","RBB",0,1,1,0,1,"run005"
"980","RGR","BBB",2,5,7,7,0,"run005"
"981","RGR","BBR",1,1,2,2,0,"run005"
"982","RGR","BGB",2,5,7,6,1,"run005"
"983","RGR","BGG",2,2,4,2,2,"run005"
"984","RGR","BRR",1,5,6,0,6,"run005"
"985","RGR","GGB",2,12,14,3,11,"run005"
"986","RGR","GGG",0,2,2,0,2,"run005"
"987","RGR","GGR",0,4,4,3,1,"run005"
"988","RGR","RBB",0,4,4,3,1,"run005"
"989","RGR","RGG",1,1,2,0,2,"run005"
"990","RGR","RRG",0,3,3,3,0,"run005"
"991","RRG","BBB",2,33,35,24,11,"run005"
"992","RRG","BBR",0,5,5,1,4,"run005"
"993","RRG","BGB",1,10,11,5,6,"run005"
"994","RRG","BGG",0,2,2,0,2,"run005"
"995","RRG","BRB",2,40,42,20,22,"run005"
"996","RRG","BRR",1,16,17,10,7,"run005"
"997","RRG","GGG",2,14,16,16,0,"run005"
"998","RRG","GGR",0,5,5,3,2,"run005"
"999","RRG","GRG",1,0,1,1,0,"run005"
"1000","RRG","GRR",3,8,11,9,2,"run005"
"1001","RRG","RBB",1,1,2,2,0,"run005"
"1002","RRG","RGG",0,1,1,0,1,"run005"
"1003","RRG","RGR",0,1,1,0,1,"run005"
"1004","RRR","BBR",1,0,1,0,1,"run005"
"1005","RRR","BGB",2,1,3,0,3,"run005"
"1006","RRR","BGG",1,0,1,0,1,"run005"
"1007","RRR","BRB",1,1,2,2,0,"run005"
"1008","RRR","BRR",1,1,2,2,0,"run005"
"1009","RRR","GGR",0,1,1,0,1,"run005"
"1010","RRR","GRR",0,3,3,2,1,"run005"
"1011","RRR","RBB",1,2,3,3,0,"run005"
"1012","RRR","RBR",0,2,2,2,0,"run005"
"1013","RRR","RGG",0,1,1,0,1,"run005"
"1014","RRR","RGR",1,2,3,3,0,"run005"
"1015","RRR","RRG",2,2,4,2,2,"run005"
"1016","BBB","BRB",0,1,1,0,1,"run006"
"1017","BBB","GGG",1,2,3,1,2,"run006"
"1018","BBB","GRR",0,2,2,0,2,"run006"
"1019","BBB","RBG",0,1,1,1,0,"run006"
"1020","BBB","RRG",1,3,4,3,1,"run006"
"1021","BBB","RRR",0,2,2,2,0,"run006"
"1022","BBG","BBB",1,4,5,0,5,"run006"
"1023","BBG","BGB",0,1,1,1,0,"run006"
"1024","BBG","BGG",0,1,1,1,0,"run006"
"1025","BBG","BRB",1,16,17,1,16,"run006"
"1026","BBG","GBB",0,1,1,1,0,"run006"
"1027","BBG","GBG",2,7,9,2,7,"run006"
"1028","BBG","GGB",2,25,27,20,7,"run006"
"1029","BBG","GGG",4,38,42,7,35,"run006"
"1030","BBG","GRG",1,9,10,0,10,"run006"
"1031","BBG","GRR",0,1,1,1,0,"run006"
"1032","BBG","RBB",0,1,1,0,1,"run006"
"1033","BBG","RBG",0,4,4,0,4,"run006"
"1034","BBG","RBR",0,1,1,1,0,"run006"
"1035","BBG","RGR",0,1,1,0,1,"run006"
"1036","BBG","RRG",1,2,3,1,2,"run006"
"1037","BBG","RRR",0,7,7,0,7,"run006"
"1038","BGB","BBB",0,2,2,1,1,"run006"
"1039","BGB","RRG",0,1,1,1,0,"run006"
"1040","BGG","BBB",0,3,3,3,0,"run006"
"1041","BGG","BBR",0,1,1,1,0,"run006"
"1042","BGG","GRG",0,1,1,0,1,"run006"
"1043","BGG","RBG",1,1,2,0,2,"run006"
"1044","BGG","RGG",0,3,3,2,1,"run006"
"1045","BGG","RGR",0,1,1,1,0,"run006"
"1046","BGG","RRR",1,1,2,1,1,"run006"
"1047","BRB","BBB",0,13,13,12,1,"run006"
"1048","BRB","BBR",0,1,1,1,0,"run006"
"1049","BRB","BRR",0,3,3,1,2,"run006"
"1050","BRB","GGG",0,1,1,0,1,"run006"
"1051","BRB","GGR",0,1,1,0,1,"run006"
"1052","BRB","RBB",0,1,1,0,1,"run006"
"1053","BRB","RBG",0,1,1,0,1,"run006"
"1054","BRB","RGR",0,1,1,1,0,"run006"
"1055","BRB","RRR",0,1,1,0,1,"run006"
"1056","BRR","BBB",0,11,11,2,9,"run006"
"1057","BRR","BGB",1,1,2,0,2,"run006"
"1058","BRR","BGG",0,1,1,0,1,"run006"
"1059","BRR","BRB",0,1,1,1,0,"run006"
"1060","BRR","RBB",0,2,2,2,0,"run006"
"1061","GBB","BBB",12,38,50,28,22,"run006"
"1062","GBB","BGG",0,1,1,0,1,"run006"
"1063","GBB","BRB",1,9,10,1,9,"run006"
"1064","GBB","BRR",1,3,4,2,2,"run006"
"1065","GBB","GBG",0,4,4,1,3,"run006"
"1066","GBB","GGB",0,21,21,17,4,"run006"
"1067","GBB","GGG",7,86,93,63,30,"run006"
"1068","GBB","GGR",1,3,4,3,1,"run006"
"1069","GBB","GRG",0,6,6,4,2,"run006"
"1070","GBB","GRR",0,1,1,1,0,"run006"
"1071","GBB","RBB",0,2,2,2,0,"run006"
"1072","GBB","RBG",3,9,12,12,0,"run006"
"1073","GBB","RBR",1,0,1,1,0,"run006"
"1074","GBB","RGG",1,0,1,1,0,"run006"
"1075","GBB","RGR",2,1,3,2,1,"run006"
"1076","GBB","RRG",0,2,2,2,0,"run006"
"1077","GBB","RRR",1,9,10,3,7,"run006"
"1078","GBG","BBB",0,5,5,5,0,"run006"
"1079","GBG","BBR",0,1,1,0,1,"run006"
"1080","GBG","BRB",1,4,5,1,4,"run006"
"1081","GBG","BRR",1,0,1,0,1,"run006"
"1082","GBG","GGB",0,4,4,4,0,"run006"
"1083","GBG","GGG",4,11,15,5,10,"run006"
"1084","GBG","RBB",1,0,1,1,0,"run006"
"1085","GBG","RBG",0,1,1,1,0,"run006"
"1086","GBG","RGG",0,1,1,1,0,"run006"
"1087","GBG","RGR",1,3,4,3,1,"run006"
"1088","GBG","RRG",1,3,4,3,1,"run006"
"1089","GGB","BBB",3,16,19,14,5,"run006"
"1090","GGB","BBR",1,4,5,3,2,"run006"
"1091","GGB","BGB",0,3,3,2,1,"run006"
"1092","GGB","BGG",0,4,4,2,2,"run006"
"1093","GGB","BRB",0,1,1,1,0,"run006"
"1094","GGB","BRR",1,15,16,16,0,"run006"
"1095","GGB","GBB",0,1,1,1,0,"run006"
"1096","GGB","GBG",1,0,1,1,0,"run006"
"1097","GGB","GGG",13,48,61,52,9,"run006"
"1098","GGB","GGR",0,7,7,2,5,"run006"
"1099","GGB","GRR",0,4,4,1,3,"run006"
"1100","GGB","RBB",0,5,5,2,3,"run006"
"1101","GGB","RBG",0,4,4,2,2,"run006"
"1102","GGB","RBR",0,5,5,4,1,"run006"
"1103","GGB","RGG",1,5,6,1,5,"run006"
"1104","GGB","RGR",0,2,2,0,2,"run006"
"1105","GGB","RRG",1,5,6,3,3,"run006"
"1106","GGB","RRR",1,5,6,2,4,"run006"
"1107","GGG","BBB",8,31,39,39,0,"run006"
"1108","GGG","BGB",0,2,2,0,2,"run006"
"1109","GGG","BGG",1,7,8,7,1,"run006"
"1110","GGG","BRB",1,3,4,3,1,"run006"
"1111","GGG","BRR",0,6,6,5,1,"run006"
"1112","GGG","GGB",5,1,6,3,3,"run006"
"1113","GGG","GGR",1,9,10,4,6,"run006"
"1114","GGG","GRR",0,2,2,1,1,"run006"
"1115","GGG","RBB",1,8,9,6,3,"run006"
"1116","GGG","RBG",0,6,6,1,5,"run006"
"1117","GGG","RBR",0,21,21,10,11,"run006"
"1118","GGG","RGG",0,3,3,2,1,"run006"
"1119","GGG","RGR",1,12,13,12,1,"run006"
"1120","GGG","RRG",1,23,24,17,7,"run006"
"1121","GGG","RRR",0,3,3,0,3,"run006"
"1122","GGR","BBB",0,2,2,2,0,"run006"
"1123","GGR","BBR",0,2,2,1,1,"run006"
"1124","GGR","BGG",0,1,1,1,0,"run006"
"1125","GGR","BRR",1,0,1,1,0,"run006"
"1126","GGR","GRR",1,0,1,0,1,"run006"
"1127","GGR","RBB",0,2,2,1,1,"run006"
"1128","GRG","BBB",3,8,11,11,0,"run006"
"1129","GRG","BBR",0,1,1,0,1,"run006"
"1130","GRG","BGG",0,1,1,0,1,"run006"
"1131","GRG","BRB",0,3,3,2,1,"run006"
"1132","GRG","BRR",0,1,1,1,0,"run006"
"1133","GRG","GBG",0,1,1,1,0,"run006"
"1134","GRG","GGB",2,15,17,2,15,"run006"
"1135","GRG","GGG",3,12,15,1,14,"run006"
"1136","GRG","GGR",0,5,5,1,4,"run006"
"1137","GRG","GRR",0,1,1,1,0,"run006"
"1138","GRG","RBG",0,1,1,1,0,"run006"
"1139","GRG","RBR",0,1,1,0,1,"run006"
"1140","GRG","RGR",1,2,3,0,3,"run006"
"1141","GRG","RRG",2,4,6,2,4,"run006"
"1142","GRR","BBB",0,1,1,0,1,"run006"
"1143","GRR","BBR",0,1,1,0,1,"run006"
"1144","GRR","BGB",1,2,3,0,3,"run006"
"1145","GRR","BGG",0,2,2,2,0,"run006"
"1146","GRR","BRB",0,1,1,1,0,"run006"
"1147","GRR","BRR",0,2,2,0,2,"run006"
"1148","GRR","GGG",0,1,1,1,0,"run006"
"1149","GRR","GGR",0,1,1,1,0,"run006"
"1150","RBB","BBB",0,1,1,0,1,"run006"
"1151","RBB","BBR",0,1,1,0,1,"run006"
"1152","RBB","BRB",0,1,1,0,1,"run006"
"1153","RBB","GRR",0,1,1,1,0,"run006"
"1154","RBB","RGG",0,1,1,1,0,"run006"
"1155","RBG","BBB",2,8,10,9,1,"run006"
"1156","RBG","BBG",0,1,1,0,1,"run006"
"1157","RBG","BRR",0,1,1,0,1,"run006"
"1158","RBG","GBB",0,1,1,0,1,"run006"
"1159","RBG","GRR",0,3,3,1,2,"run006"
"1160","RBG","RBB",1,1,2,0,2,"run006"
"1161","RBG","RBR",0,1,1,1,0,"run006"
"1162","RBG","RGR",0,1,1,0,1,"run006"
"1163","RBR","BBB",0,13,13,2,11,"run006"
"1164","RBR","BBR",0,1,1,0,1,"run006"
"1165","RBR","BGB",2,4,6,1,5,"run006"
"1166","RBR","BGG",0,2,2,1,1,"run006"
"1167","RBR","BRB",1,0,1,0,1,"run006"
"1168","RBR","BRR",1,4,5,3,2,"run006"
"1169","RBR","GGB",0,12,12,3,9,"run006"
"1170","RBR","GRR",4,4,8,0,8,"run006"
"1171","RBR","RBB",0,3,3,1,2,"run006"
"1172","RBR","RGG",2,9,11,4,7,"run006"
"1173","RBR","RGR",1,0,1,0,1,"run006"
"1174","RBR","RRR",0,1,1,0,1,"run006"
"1175","RGG","BBB",0,8,8,8,0,"run006"
"1176","RGG","BBR",1,2,3,1,2,"run006"
"1177","RGG","BGB",0,1,1,1,0,"run006"
"1178","RGG","BRR",0,4,4,4,0,"run006"
"1179","RGG","GGG",0,1,1,0,1,"run006"
"1180","RGG","GGR",0,3,3,0,3,"run006"
"1181","RGG","GRR",0,8,8,3,5,"run006"
"1182","RGG","RBB",0,1,1,0,1,"run006"
"1183","RGR","BBB",2,5,7,1,6,"run006"
"1184","RGR","BBR",1,1,2,0,2,"run006"
"1185","RGR","BGB",2,5,7,2,5,"run006"
"1186","RGR","BGG",2,2,4,2,2,"run006"
"1187","RGR","BRR",1,5,6,4,2,"run006"
"1188","RGR","GGB",2,12,14,3,11,"run006"
"1189","RGR","GGG",0,2,2,1,1,"run006"
"1190","RGR","GGR",0,4,4,1,3,"run006"
"1191","RGR","RBB",0,4,4,4,0,"run006"
"1192","RGR","RGG",1,1,2,0,2,"run006"
"1193","RGR","RRG",0,3,3,0,3,"run006"
"1194","RRG","BBB",2,33,35,27,8,"run006"
"1195","RRG","BBR",0,5,5,0,5,"run006"
"1196","RRG","BGB",1,10,11,1,10,"run006"
"1197","RRG","BGG",0,2,2,0,2,"run006"
"1198","RRG","BRB",2,40,42,33,9,"run006"
"1199","RRG","BRR",1,16,17,12,5,"run006"
"1200","RRG","GGG",2,14,16,14,2,"run006"
"1201","RRG","GGR",0,5,5,2,3,"run006"
"1202","RRG","GRG",1,0,1,0,1,"run006"
"1203","RRG","GRR",3,8,11,5,6,"run006"
"1204","RRG","RBB",1,1,2,2,0,"run006"
"1205","RRG","RGG",0,1,1,0,1,"run006"
"1206","RRG","RGR",0,1,1,0,1,"run006"
"1207","RRR","BBR",1,0,1,1,0,"run006"
"1208","RRR","BGB",2,1,3,1,2,"run006"
"1209","RRR","BGG",1,0,1,1,0,"run006"
"1210","RRR","BRB",1,1,2,1,1,"run006"
"1211","RRR","BRR",1,1,2,0,2,"run006"
"1212","RRR","GGR",0,1,1,0,1,"run006"
"1213","RRR","GRR",0,3,3,2,1,"run006"
"1214","RRR","RBB",1,2,3,3,0,"run006"
"1215","RRR","RBR",0,2,2,2,0,"run006"
"1216","RRR","RGG",0,1,1,1,0,"run006"
"1217","RRR","RGR",1,2,3,1,2,"run006"
"1218","RRR","RRG",2,2,4,0,4,"run006"
"1219","BBB","BRB",0,1,1,1,0,"run007"
"1220","BBB","GGG",1,2,3,2,1,"run007"
"1221","BBB","GRR",0,2,2,2,0,"run007"
"1222","BBB","RBG",0,1,1,1,0,"run007"
"1223","BBB","RRG",1,3,4,1,3,"run007"
"1224","BBB","RRR",0,2,2,2,0,"run007"
"1225","BBG","BBB",1,4,5,1,4,"run007"
"1226","BBG","BGB",0,1,1,1,0,"run007"
"1227","BBG","BGG",0,1,1,1,0,"run007"
"1228","BBG","BRB",1,16,17,2,15,"run007"
"1229","BBG","GBB",0,1,1,1,0,"run007"
"1230","BBG","GBG",2,7,9,7,2,"run007"
"1231","BBG","GGB",2,25,27,21,6,"run007"
"1232","BBG","GGG",4,38,42,7,35,"run007"
"1233","BBG","GRG",1,9,10,10,0,"run007"
"1234","BBG","GRR",0,1,1,1,0,"run007"
"1235","BBG","RBB",0,1,1,1,0,"run007"
"1236","BBG","RBG",0,4,4,2,2,"run007"
"1237","BBG","RBR",0,1,1,1,0,"run007"
"1238","BBG","RGR",0,1,1,1,0,"run007"
"1239","BBG","RRG",1,2,3,1,2,"run007"
"1240","BBG","RRR",0,7,7,6,1,"run007"
"1241","BGB","BBB",0,2,2,2,0,"run007"
"1242","BGB","RRG",0,1,1,1,0,"run007"
"1243","BGG","BBB",0,3,3,3,0,"run007"
"1244","BGG","BBR",0,1,1,1,0,"run007"
"1245","BGG","GRG",0,1,1,0,1,"run007"
"1246","BGG","RBG",1,1,2,0,2,"run007"
"1247","BGG","RGG",0,3,3,3,0,"run007"
"1248","BGG","RGR",0,1,1,0,1,"run007"
"1249","BGG","RRR",1,1,2,1,1,"run007"
"1250","BRB","BBB",0,13,13,9,4,"run007"
"1251","BRB","BBR",0,1,1,0,1,"run007"
"1252","BRB","BRR",0,3,3,1,2,"run007"
"1253","BRB","GGG",0,1,1,1,0,"run007"
"1254","BRB","GGR",0,1,1,1,0,"run007"
"1255","BRB","RBB",0,1,1,1,0,"run007"
"1256","BRB","RBG",0,1,1,0,1,"run007"
"1257","BRB","RGR",0,1,1,1,0,"run007"
"1258","BRB","RRR",0,1,1,1,0,"run007"
"1259","BRR","BBB",0,11,11,0,11,"run007"
"1260","BRR","BGB",1,1,2,2,0,"run007"
"1261","BRR","BGG",0,1,1,1,0,"run007"
"1262","BRR","BRB",0,1,1,1,0,"run007"
"1263","BRR","RBB",0,2,2,0,2,"run007"
"1264","GBB","BBB",12,38,50,2,48,"run007"
"1265","GBB","BGG",0,1,1,0,1,"run007"
"1266","GBB","BRB",1,9,10,4,6,"run007"
"1267","GBB","BRR",1,3,4,0,4,"run007"
"1268","GBB","GBG",0,4,4,4,0,"run007"
"1269","GBB","GGB",0,21,21,21,0,"run007"
"1270","GBB","GGG",7,86,93,7,86,"run007"
"1271","GBB","GGR",1,3,4,4,0,"run007"
"1272","GBB","GRG",0,6,6,6,0,"run007"
"1273","GBB","GRR",0,1,1,0,1,"run007"
"1274","GBB","RBB",0,2,2,2,0,"run007"
"1275","GBB","RBG",3,9,12,1,11,"run007"
"1276","GBB","RBR",1,0,1,1,0,"run007"
"1277","GBB","RGG",1,0,1,1,0,"run007"
"1278","GBB","RGR",2,1,3,0,3,"run007"
"1279","GBB","RRG",0,2,2,1,1,"run007"
"1280","GBB","RRR",1,9,10,7,3,"run007"
"1281","GBG","BBB",0,5,5,1,4,"run007"
"1282","GBG","BBR",0,1,1,1,0,"run007"
"1283","GBG","BRB",1,4,5,1,4,"run007"
"1284","GBG","BRR",1,0,1,1,0,"run007"
"1285","GBG","GGB",0,4,4,2,2,"run007"
"1286","GBG","GGG",4,11,15,15,0,"run007"
"1287","GBG","RBB",1,0,1,1,0,"run007"
"1288","GBG","RBG",0,1,1,0,1,"run007"
"1289","GBG","RGG",0,1,1,0,1,"run007"
"1290","GBG","RGR",1,3,4,2,2,"run007"
"1291","GBG","RRG",1,3,4,4,0,"run007"
"1292","GGB","BBB",3,16,19,8,11,"run007"
"1293","GGB","BBR",1,4,5,5,0,"run007"
"1294","GGB","BGB",0,3,3,2,1,"run007"
"1295","GGB","BGG",0,4,4,3,1,"run007"
"1296","GGB","BRB",0,1,1,1,0,"run007"
"1297","GGB","BRR",1,15,16,7,9,"run007"
"1298","GGB","GBB",0,1,1,0,1,"run007"
"1299","GGB","GBG",1,0,1,1,0,"run007"
"1300","GGB","GGG",13,48,61,9,52,"run007"
"1301","GGB","GGR",0,7,7,4,3,"run007"
"1302","GGB","GRR",0,4,4,0,4,"run007"
"1303","GGB","RBB",0,5,5,0,5,"run007"
"1304","GGB","RBG",0,4,4,3,1,"run007"
"1305","GGB","RBR",0,5,5,5,0,"run007"
"1306","GGB","RGG",1,5,6,3,3,"run007"
"1307","GGB","RGR",0,2,2,0,2,"run007"
"1308","GGB","RRG",1,5,6,2,4,"run007"
"1309","GGB","RRR",1,5,6,4,2,"run007"
"1310","GGG","BBB",8,31,39,17,22,"run007"
"1311","GGG","BGB",0,2,2,0,2,"run007"
"1312","GGG","BGG",1,7,8,0,8,"run007"
"1313","GGG","BRB",1,3,4,0,4,"run007"
"1314","GGG","BRR",0,6,6,3,3,"run007"
"1315","GGG","GGB",5,1,6,2,4,"run007"
"1316","GGG","GGR",1,9,10,1,9,"run007"
"1317","GGG","GRR",0,2,2,0,2,"run007"
"1318","GGG","RBB",1,8,9,9,0,"run007"
"1319","GGG","RBG",0,6,6,0,6,"run007"
"1320","GGG","RBR",0,21,21,7,14,"run007"
"1321","GGG","RGG",0,3,3,0,3,"run007"
"1322","GGG","RGR",1,12,13,10,3,"run007"
"1323","GGG","RRG",1,23,24,8,16,"run007"
"1324","GGG","RRR",0,3,3,1,2,"run007"
"1325","GGR","BBB",0,2,2,1,1,"run007"
"1326","GGR","BBR",0,2,2,2,0,"run007"
"1327","GGR","BGG",0,1,1,1,0,"run007"
"1328","GGR","BRR",1,0,1,1,0,"run007"
"1329","GGR","GRR",1,0,1,0,1,"run007"
"1330","GGR","RBB",0,2,2,1,1,"run007"
"1331","GRG","BBB",3,8,11,7,4,"run007"
"1332","GRG","BBR",0,1,1,1,0,"run007"
"1333","GRG","BGG",0,1,1,0,1,"run007"
"1334","GRG","BRB",0,3,3,1,2,"run007"
"1335","GRG","BRR",0,1,1,0,1,"run007"
"1336","GRG","GBG",0,1,1,1,0,"run007"
"1337","GRG","GGB",2,15,17,12,5,"run007"
"1338","GRG","GGG",3,12,15,14,1,"run007"
"1339","GRG","GGR",0,5,5,1,4,"run007"
"1340","GRG","GRR",0,1,1,0,1,"run007"
"1341","GRG","RBG",0,1,1,0,1,"run007"
"1342","GRG","RBR",0,1,1,0,1,"run007"
"1343","GRG","RGR",1,2,3,2,1,"run007"
"1344","GRG","RRG",2,4,6,1,5,"run007"
"1345","GRR","BBB",0,1,1,0,1,"run007"
"1346","GRR","BBR",0,1,1,1,0,"run007"
"1347","GRR","BGB",1,2,3,1,2,"run007"
"1348","GRR","BGG",0,2,2,1,1,"run007"
"1349","GRR","BRB",0,1,1,1,0,"run007"
"1350","GRR","BRR",0,2,2,0,2,"run007"
"1351","GRR","GGG",0,1,1,0,1,"run007"
"1352","GRR","GGR",0,1,1,0,1,"run007"
"1353","RBB","BBB",0,1,1,1,0,"run007"
"1354","RBB","BBR",0,1,1,0,1,"run007"
"1355","RBB","BRB",0,1,1,1,0,"run007"
"1356","RBB","GRR",0,1,1,0,1,"run007"
"1357","RBB","RGG",0,1,1,1,0,"run007"
"1358","RBG","BBB",2,8,10,10,0,"run007"
"1359","RBG","BBG",0,1,1,1,0,"run007"
"1360","RBG","BRR",0,1,1,0,1,"run007"
"1361","RBG","GBB",0,1,1,0,1,"run007"
"1362","RBG","GRR",0,3,3,2,1,"run007"
"1363","RBG","RBB",1,1,2,1,1,"run007"
"1364","RBG","RBR",0,1,1,1,0,"run007"
"1365","RBG","RGR",0,1,1,1,0,"run007"
"1366","RBR","BBB",0,13,13,12,1,"run007"
"1367","RBR","BBR",0,1,1,1,0,"run007"
"1368","RBR","BGB",2,4,6,3,3,"run007"
"1369","RBR","BGG",0,2,2,0,2,"run007"
"1370","RBR","BRB",1,0,1,1,0,"run007"
"1371","RBR","BRR",1,4,5,4,1,"run007"
"1372","RBR","GGB",0,12,12,3,9,"run007"
"1373","RBR","GRR",4,4,8,6,2,"run007"
"1374","RBR","RBB",0,3,3,2,1,"run007"
"1375","RBR","RGG",2,9,11,11,0,"run007"
"1376","RBR","RGR",1,0,1,0,1,"run007"
"1377","RBR","RRR",0,1,1,0,1,"run007"
"1378","RGG","BBB",0,8,8,2,6,"run007"
"1379","RGG","BBR",1,2,3,3,0,"run007"
"1380","RGG","BGB",0,1,1,1,0,"run007"
"1381","RGG","BRR",0,4,4,0,4,"run007"
"1382","RGG","GGG",0,1,1,0,1,"run007"
"1383","RGG","GGR",0,3,3,1,2,"run007"
"1384","RGG","GRR",0,8,8,8,0,"run007"
"1385","RGG","RBB",0,1,1,1,0,"run007"
"1386","RGR","BBB",2,5,7,0,7,"run007"
"1387","RGR","BBR",1,1,2,2,0,"run007"
"1388","RGR","BGB",2,5,7,1,6,"run007"
"1389","RGR","BGG",2,2,4,1,3,"run007"
"1390","RGR","BRR",1,5,6,3,3,"run007"
"1391","RGR","GGB",2,12,14,2,12,"run007"
"1392","RGR","GGG",0,2,2,2,0,"run007"
"1393","RGR","GGR",0,4,4,4,0,"run007"
"1394","RGR","RBB",0,4,4,1,3,"run007"
"1395","RGR","RGG",1,1,2,2,0,"run007"
"1396","RGR","RRG",0,3,3,3,0,"run007"
"1397","RRG","BBB",2,33,35,1,34,"run007"
"1398","RRG","BBR",0,5,5,0,5,"run007"
"1399","RRG","BGB",1,10,11,10,1,"run007"
"1400","RRG","BGG",0,2,2,2,0,"run007"
"1401","RRG","BRB",2,40,42,1,41,"run007"
"1402","RRG","BRR",1,16,17,0,17,"run007"
"1403","RRG","GGG",2,14,16,5,11,"run007"
"1404","RRG","GGR",0,5,5,5,0,"run007"
"1405","RRG","GRG",1,0,1,1,0,"run007"
"1406","RRG","GRR",3,8,11,7,4,"run007"
"1407","RRG","RBB",1,1,2,2,0,"run007"
"1408","RRG","RGG",0,1,1,1,0,"run007"
"1409","RRG","RGR",0,1,1,0,1,"run007"
"1410","RRR","BBR",1,0,1,1,0,"run007"
"1411","RRR","BGB",2,1,3,2,1,"run007"
"1412","RRR","BGG",1,0,1,1,0,"run007"
"1413","RRR","BRB",1,1,2,2,0,"run007"
"1414","RRR","BRR",1,1,2,2,0,"run007"
"1415","RRR","GGR",0,1,1,1,0,"run007"
"1416","RRR","GRR",0,3,3,1,2,"run007"
"1417","RRR","RBB",1,2,3,0,3,"run007"
"1418","RRR","RBR",0,2,2,0,2,"run007"
"1419","RRR","RGG",0,1,1,0,1,"run007"
"1420","RRR","RGR",1,2,3,1,2,"run007"
"1421","RRR","RRG",2,2,4,4,0,"run007"
"1422","BBB","BRB",0,1,1,1,0,"run008"
"1423","BBB","GGG",1,2,3,3,0,"run008"
"1424","BBB","GRR",0,2,2,2,0,"run008"
"1425","BBB","RBG",0,1,1,1,0,"run008"
"1426","BBB","RRG",1,3,4,3,1,"run008"
"1427","BBB","RRR",0,2,2,2,0,"run008"
"1428","BBG","BBB",1,4,5,1,4,"run008"
"1429","BBG","BGB",0,1,1,0,1,"run008"
"1430","BBG","BGG",0,1,1,1,0,"run008"
"1431","BBG","BRB",1,16,17,0,17,"run008"
"1432","BBG","GBB",0,1,1,0,1,"run008"
"1433","BBG","GBG",2,7,9,1,8,"run008"
"1434","BBG","GGB",2,25,27,2,25,"run008"
"1435","BBG","GGG",4,38,42,34,8,"run008"
"1436","BBG","GRG",1,9,10,5,5,"run008"
"1437","BBG","GRR",0,1,1,1,0,"run008"
"1438","BBG","RBB",0,1,1,1,0,"run008"
"1439","BBG","RBG",0,4,4,2,2,"run008"
"1440","BBG","RBR",0,1,1,1,0,"run008"
"1441","BBG","RGR",0,1,1,1,0,"run008"
"1442","BBG","RRG",1,2,3,1,2,"run008"
"1443","BBG","RRR",0,7,7,0,7,"run008"
"1444","BGB","BBB",0,2,2,0,2,"run008"
"1445","BGB","RRG",0,1,1,1,0,"run008"
"1446","BGG","BBB",0,3,3,1,2,"run008"
"1447","BGG","BBR",0,1,1,0,1,"run008"
"1448","BGG","GRG",0,1,1,1,0,"run008"
"1449","BGG","RBG",1,1,2,2,0,"run008"
"1450","BGG","RGG",0,3,3,2,1,"run008"
"1451","BGG","RGR",0,1,1,1,0,"run008"
"1452","BGG","RRR",1,1,2,2,0,"run008"
"1453","BRB","BBB",0,13,13,1,12,"run008"
"1454","BRB","BBR",0,1,1,0,1,"run008"
"1455","BRB","BRR",0,3,3,1,2,"run008"
"1456","BRB","GGG",0,1,1,0,1,"run008"
"1457","BRB","GGR",0,1,1,0,1,"run008"
"1458","BRB","RBB",0,1,1,1,0,"run008"
"1459","BRB","RBG",0,1,1,0,1,"run008"
"1460","BRB","RGR",0,1,1,1,0,"run008"
"1461","BRB","RRR",0,1,1,0,1,"run008"
"1462","BRR","BBB",0,11,11,9,2,"run008"
"1463","BRR","BGB",1,1,2,1,1,"run008"
"1464","BRR","BGG",0,1,1,0,1,"run008"
"1465","BRR","BRB",0,1,1,1,0,"run008"
"1466","BRR","RBB",0,2,2,2,0,"run008"
"1467","GBB","BBB",12,38,50,47,3,"run008"
"1468","GBB","BGG",0,1,1,1,0,"run008"
"1469","GBB","BRB",1,9,10,4,6,"run008"
"1470","GBB","BRR",1,3,4,3,1,"run008"
"1471","GBB","GBG",0,4,4,4,0,"run008"
"1472","GBB","GGB",0,21,21,5,16,"run008"
"1473","GBB","GGG",7,86,93,9,84,"run008"
"1474","GBB","GGR",1,3,4,3,1,"run008"
"1475","GBB","GRG",0,6,6,2,4,"run008"
"1476","GBB","GRR",0,1,1,0,1,"run008"
"1477","GBB","RBB",0,2,2,2,0,"run008"
"1478","GBB","RBG",3,9,12,8,4,"run008"
"1479","GBB","RBR",1,0,1,1,0,"run008"
"1480","GBB","RGG",1,0,1,1,0,"run008"
"1481","GBB","RGR",2,1,3,2,1,"run008"
"1482","GBB","RRG",0,2,2,1,1,"run008"
"1483","GBB","RRR",1,9,10,6,4,"run008"
"1484","GBG","BBB",0,5,5,4,1,"run008"
"1485","GBG","BBR",0,1,1,1,0,"run008"
"1486","GBG","BRB",1,4,5,4,1,"run008"
"1487","GBG","BRR",1,0,1,0,1,"run008"
"1488","GBG","GGB",0,4,4,3,1,"run008"
"1489","GBG","GGG",4,11,15,6,9,"run008"
"1490","GBG","RBB",1,0,1,0,1,"run008"
"1491","GBG","RBG",0,1,1,1,0,"run008"
"1492","GBG","RGG",0,1,1,1,0,"run008"
"1493","GBG","RGR",1,3,4,0,4,"run008"
"1494","GBG","RRG",1,3,4,1,3,"run008"
"1495","GGB","BBB",3,16,19,11,8,"run008"
"1496","GGB","BBR",1,4,5,2,3,"run008"
"1497","GGB","BGB",0,3,3,2,1,"run008"
"1498","GGB","BGG",0,4,4,0,4,"run008"
"1499","GGB","BRB",0,1,1,1,0,"run008"
"1500","GGB","BRR",1,15,16,14,2,"run008"
"1501","GGB","GBB",0,1,1,1,0,"run008"
"1502","GGB","GBG",1,0,1,0,1,"run008"
"1503","GGB","GGG",13,48,61,51,10,"run008"
"1504","GGB","GGR",0,7,7,3,4,"run008"
"1505","GGB","GRR",0,4,4,0,4,"run008"
"1506","GGB","RBB",0,5,5,0,5,"run008"
"1507","GGB","RBG",0,4,4,1,3,"run008"
"1508","GGB","RBR",0,5,5,0,5,"run008"
"1509","GGB","RGG",1,5,6,6,0,"run008"
"1510","GGB","RGR",0,2,2,0,2,"run008"
"1511","GGB","RRG",1,5,6,3,3,"run008"
"1512","GGB","RRR",1,5,6,3,3,"run008"
"1513","GGG","BBB",8,31,39,4,35,"run008"
"1514","GGG","BGB",0,2,2,1,1,"run008"
"1515","GGG","BGG",1,7,8,1,7,"run008"
"1516","GGG","BRB",1,3,4,3,1,"run008"
"1517","GGG","BRR",0,6,6,3,3,"run008"
"1518","GGG","GGB",5,1,6,1,5,"run008"
"1519","GGG","GGR",1,9,10,8,2,"run008"
"1520","GGG","GRR",0,2,2,0,2,"run008"
"1521","GGG","RBB",1,8,9,1,8,"run008"
"1522","GGG","RBG",0,6,6,0,6,"run008"
"1523","GGG","RBR",0,21,21,17,4,"run008"
"1524","GGG","RGG",0,3,3,1,2,"run008"
"1525","GGG","RGR",1,12,13,3,10,"run008"
"1526","GGG","RRG",1,23,24,24,0,"run008"
"1527","GGG","RRR",0,3,3,0,3,"run008"
"1528","GGR","BBB",0,2,2,1,1,"run008"
"1529","GGR","BBR",0,2,2,2,0,"run008"
"1530","GGR","BGG",0,1,1,0,1,"run008"
"1531","GGR","BRR",1,0,1,0,1,"run008"
"1532","GGR","GRR",1,0,1,0,1,"run008"
"1533","GGR","RBB",0,2,2,0,2,"run008"
"1534","GRG","BBB",3,8,11,0,11,"run008"
"1535","GRG","BBR",0,1,1,0,1,"run008"
"1536","GRG","BGG",0,1,1,1,0,"run008"
"1537","GRG","BRB",0,3,3,2,1,"run008"
"1538","GRG","BRR",0,1,1,1,0,"run008"
"1539","GRG","GBG",0,1,1,0,1,"run008"
"1540","GRG","GGB",2,15,17,8,9,"run008"
"1541","GRG","GGG",3,12,15,7,8,"run008"
"1542","GRG","GGR",0,5,5,4,1,"run008"
"1543","GRG","GRR",0,1,1,0,1,"run008"
"1544","GRG","RBG",0,1,1,1,0,"run008"
"1545","GRG","RBR",0,1,1,1,0,"run008"
"1546","GRG","RGR",1,2,3,1,2,"run008"
"1547","GRG","RRG",2,4,6,2,4,"run008"
"1548","GRR","BBB",0,1,1,1,0,"run008"
"1549","GRR","BBR",0,1,1,1,0,"run008"
"1550","GRR","BGB",1,2,3,2,1,"run008"
"1551","GRR","BGG",0,2,2,2,0,"run008"
"1552","GRR","BRB",0,1,1,1,0,"run008"
"1553","GRR","BRR",0,2,2,1,1,"run008"
"1554","GRR","GGG",0,1,1,1,0,"run008"
"1555","GRR","GGR",0,1,1,1,0,"run008"
"1556","RBB","BBB",0,1,1,0,1,"run008"
"1557","RBB","BBR",0,1,1,1,0,"run008"
"1558","RBB","BRB",0,1,1,0,1,"run008"
"1559","RBB","GRR",0,1,1,0,1,"run008"
"1560","RBB","RGG",0,1,1,1,0,"run008"
"1561","RBG","BBB",2,8,10,4,6,"run008"
"1562","RBG","BBG",0,1,1,1,0,"run008"
"1563","RBG","BRR",0,1,1,0,1,"run008"
"1564","RBG","GBB",0,1,1,0,1,"run008"
"1565","RBG","GRR",0,3,3,1,2,"run008"
"1566","RBG","RBB",1,1,2,2,0,"run008"
"1567","RBG","RBR",0,1,1,1,0,"run008"
"1568","RBG","RGR",0,1,1,1,0,"run008"
"1569","RBR","BBB",0,13,13,4,9,"run008"
"1570","RBR","BBR",0,1,1,0,1,"run008"
"1571","RBR","BGB",2,4,6,5,1,"run008"
"1572","RBR","BGG",0,2,2,0,2,"run008"
"1573","RBR","BRB",1,0,1,1,0,"run008"
"1574","RBR","BRR",1,4,5,5,0,"run008"
"1575","RBR","GGB",0,12,12,12,0,"run008"
"1576","RBR","GRR",4,4,8,6,2,"run008"
"1577","RBR","RBB",0,3,3,1,2,"run008"
"1578","RBR","RGG",2,9,11,3,8,"run008"
"1579","RBR","RGR",1,0,1,1,0,"run008"
"1580","RBR","RRR",0,1,1,0,1,"run008"
"1581","RGG","BBB",0,8,8,4,4,"run008"
"1582","RGG","BBR",1,2,3,1,2,"run008"
"1583","RGG","BGB",0,1,1,1,0,"run008"
"1584","RGG","BRR",0,4,4,4,0,"run008"
"1585","RGG","GGG",0,1,1,1,0,"run008"
"1586","RGG","GGR",0,3,3,1,2,"run008"
"1587","RGG","GRR",0,8,8,0,8,"run008"
"1588","RGG","RBB",0,1,1,1,0,"run008"
"1589","RGR","BBB",2,5,7,1,6,"run008"
"1590","RGR","BBR",1,1,2,1,1,"run008"
"1591","RGR","BGB",2,5,7,7,0,"run008"
"1592","RGR","BGG",2,2,4,4,0,"run008"
"1593","RGR","BRR",1,5,6,6,0,"run008"
"1594","RGR","GGB",2,12,14,13,1,"run008"
"1595","RGR","GGG",0,2,2,1,1,"run008"
"1596","RGR","GGR",0,4,4,4,0,"run008"
"1597","RGR","RBB",0,4,4,0,4,"run008"
"1598","RGR","RGG",1,1,2,1,1,"run008"
"1599","RGR","RRG",0,3,3,3,0,"run008"
"1600","RRG","BBB",2,33,35,7,28,"run008"
"1601","RRG","BBR",0,5,5,4,1,"run008"
"1602","RRG","BGB",1,10,11,1,10,"run008"
"1603","RRG","BGG",0,2,2,2,0,"run008"
"1604","RRG","BRB",2,40,42,24,18,"run008"
"1605","RRG","BRR",1,16,17,10,7,"run008"
"1606","RRG","GGG",2,14,16,16,0,"run008"
"1607","RRG","GGR",0,5,5,2,3,"run008"
"1608","RRG","GRG",1,0,1,1,0,"run008"
"1609","RRG","GRR",3,8,11,6,5,"run008"
"1610","RRG","RBB",1,1,2,2,0,"run008"
"1611","RRG","RGG",0,1,1,0,1,"run008"
"1612","RRG","RGR",0,1,1,1,0,"run008"
"1613","RRR","BBR",1,0,1,1,0,"run008"
"1614","RRR","BGB",2,1,3,2,1,"run008"
"1615","RRR","BGG",1,0,1,0,1,"run008"
"1616","RRR","BRB",1,1,2,1,1,"run008"
"1617","RRR","BRR",1,1,2,0,2,"run008"
"1618","RRR","GGR",0,1,1,0,1,"run008"
"1619","RRR","GRR",0,3,3,2,1,"run008"
"1620","RRR","RBB",1,2,3,0,3,"run008"
"1621","RRR","RBR",0,2,2,1,1,"run008"
"1622","RRR","RGG",0,1,1,1,0,"run008"
"1623","RRR","RGR",1,2,3,0,3,"run008"
"1624","RRR","RRG",2,2,4,0,4,"run008"
"1625","BBB","BRB",0,1,1,0,1,"run009"
"1626","BBB","GGG",1,2,3,0,3,"run009"
"1627","BBB","GRR",0,2,2,1,1,"run009"
"1628","BBB","RBG",0,1,1,0,1,"run009"
"1629","BBB","RRG",1,3,4,2,2,"run009"
"1630","BBB","RRR",0,2,2,2,0,"run009"
"1631","BBG","BBB",1,4,5,3,2,"run009"
"1632","BBG","BGB",0,1,1,1,0,"run009"
"1633","BBG","BGG",0,1,1,0,1,"run009"
"1634","BBG","BRB",1,16,17,11,6,"run009"
"1635","BBG","GBB",0,1,1,0,1,"run009"
"1636","BBG","GBG",2,7,9,1,8,"run009"
"1637","BBG","GGB",2,25,27,4,23,"run009"
"1638","BBG","GGG",4,38,42,41,1,"run009"
"1639","BBG","GRG",1,9,10,2,8,"run009"
"1640","BBG","GRR",0,1,1,1,0,"run009"
"1641","BBG","RBB",0,1,1,1,0,"run009"
"1642","BBG","RBG",0,4,4,0,4,"run009"
"1643","BBG","RBR",0,1,1,1,0,"run009"
"1644","BBG","RGR",0,1,1,1,0,"run009"
"1645","BBG","RRG",1,2,3,0,3,"run009"
"1646","BBG","RRR",0,7,7,0,7,"run009"
"1647","BGB","BBB",0,2,2,0,2,"run009"
"1648","BGB","RRG",0,1,1,1,0,"run009"
"1649","BGG","BBB",0,3,3,1,2,"run009"
"1650","BGG","BBR",0,1,1,0,1,"run009"
"1651","BGG","GRG",0,1,1,1,0,"run009"
"1652","BGG","RBG",1,1,2,1,1,"run009"
"1653","BGG","RGG",0,3,3,1,2,"run009"
"1654","BGG","RGR",0,1,1,0,1,"run009"
"1655","BGG","RRR",1,1,2,2,0,"run009"
"1656","BRB","BBB",0,13,13,5,8,"run009"
"1657","BRB","BBR",0,1,1,1,0,"run009"
"1658","BRB","BRR",0,3,3,0,3,"run009"
"1659","BRB","GGG",0,1,1,0,1,"run009"
"1660","BRB","GGR",0,1,1,0,1,"run009"
"1661","BRB","RBB",0,1,1,1,0,"run009"
"1662","BRB","RBG",0,1,1,0,1,"run009"
"1663","BRB","RGR",0,1,1,0,1,"run009"
"1664","BRB","RRR",0,1,1,0,1,"run009"
"1665","BRR","BBB",0,11,11,0,11,"run009"
"1666","BRR","BGB",1,1,2,2,0,"run009"
"1667","BRR","BGG",0,1,1,0,1,"run009"
"1668","BRR","BRB",0,1,1,1,0,"run009"
"1669","BRR","RBB",0,2,2,2,0,"run009"
"1670","GBB","BBB",12,38,50,18,32,"run009"
"1671","GBB","BGG",0,1,1,0,1,"run009"
"1672","GBB","BRB",1,9,10,10,0,"run009"
"1673","GBB","BRR",1,3,4,0,4,"run009"
"1674","GBB","GBG",0,4,4,1,3,"run009"
"1675","GBB","GGB",0,21,21,6,15,"run009"
"1676","GBB","GGG",7,86,93,33,60,"run009"
"1677","GBB","GGR",1,3,4,4,0,"run009"
"1678","GBB","GRG",0,6,6,0,6,"run009"
"1679","GBB","GRR",0,1,1,0,1,"run009"
"1680","GBB","RBB",0,2,2,2,0,"run009"
"1681","GBB","RBG",3,9,12,6,6,"run009"
"1682","GBB","RBR",1,0,1,1,0,"run009"
"1683","GBB","RGG",1,0,1,0,1,"run009"
"1684","GBB","RGR",2,1,3,2,1,"run009"
"1685","GBB","RRG",0,2,2,2,0,"run009"
"1686","GBB","RRR",1,9,10,5,5,"run009"
"1687","GBG","BBB",0,5,5,0,5,"run009"
"1688","GBG","BBR",0,1,1,0,1,"run009"
"1689","GBG","BRB",1,4,5,4,1,"run009"
"1690","GBG","BRR",1,0,1,0,1,"run009"
"1691","GBG","GGB",0,4,4,1,3,"run009"
"1692","GBG","GGG",4,11,15,15,0,"run009"
"1693","GBG","RBB",1,0,1,0,1,"run009"
"1694","GBG","RBG",0,1,1,1,0,"run009"
"1695","GBG","RGG",0,1,1,1,0,"run009"
"1696","GBG","RGR",1,3,4,4,0,"run009"
"1697","GBG","RRG",1,3,4,4,0,"run009"
"1698","GGB","BBB",3,16,19,15,4,"run009"
"1699","GGB","BBR",1,4,5,2,3,"run009"
"1700","GGB","BGB",0,3,3,3,0,"run009"
"1701","GGB","BGG",0,4,4,4,0,"run009"
"1702","GGB","BRB",0,1,1,1,0,"run009"
"1703","GGB","BRR",1,15,16,7,9,"run009"
"1704","GGB","GBB",0,1,1,0,1,"run009"
"1705","GGB","GBG",1,0,1,1,0,"run009"
"1706","GGB","GGG",13,48,61,38,23,"run009"
"1707","GGB","GGR",0,7,7,6,1,"run009"
"1708","GGB","GRR",0,4,4,3,1,"run009"
"1709","GGB","RBB",0,5,5,0,5,"run009"
"1710","GGB","RBG",0,4,4,0,4,"run009"
"1711","GGB","RBR",0,5,5,2,3,"run009"
"1712","GGB","RGG",1,5,6,1,5,"run009"
"1713","GGB","RGR",0,2,2,2,0,"run009"
"1714","GGB","RRG",1,5,6,2,4,"run009"
"1715","GGB","RRR",1,5,6,4,2,"run009"
"1716","GGG","BBB",8,31,39,29,10,"run009"
"1717","GGG","BGB",0,2,2,0,2,"run009"
"1718","GGG","BGG",1,7,8,4,4,"run009"
"1719","GGG","BRB",1,3,4,2,2,"run009"
"1720","GGG","BRR",0,6,6,3,3,"run009"
"1721","GGG","GGB",5,1,6,6,0,"run009"
"1722","GGG","GGR",1,9,10,7,3,"run009"
"1723","GGG","GRR",0,2,2,0,2,"run009"
"1724","GGG","RBB",1,8,9,5,4,"run009"
"1725","GGG","RBG",0,6,6,0,6,"run009"
"1726","GGG","RBR",0,21,21,13,8,"run009"
"1727","GGG","RGG",0,3,3,2,1,"run009"
"1728","GGG","RGR",1,12,13,8,5,"run009"
"1729","GGG","RRG",1,23,24,8,16,"run009"
"1730","GGG","RRR",0,3,3,0,3,"run009"
"1731","GGR","BBB",0,2,2,2,0,"run009"
"1732","GGR","BBR",0,2,2,2,0,"run009"
"1733","GGR","BGG",0,1,1,0,1,"run009"
"1734","GGR","BRR",1,0,1,1,0,"run009"
"1735","GGR","GRR",1,0,1,0,1,"run009"
"1736","GGR","RBB",0,2,2,0,2,"run009"
"1737","GRG","BBB",3,8,11,9,2,"run009"
"1738","GRG","BBR",0,1,1,1,0,"run009"
"1739","GRG","BGG",0,1,1,0,1,"run009"
"1740","GRG","BRB",0,3,3,0,3,"run009"
"1741","GRG","BRR",0,1,1,0,1,"run009"
"1742","GRG","GBG",0,1,1,1,0,"run009"
"1743","GRG","GGB",2,15,17,13,4,"run009"
"1744","GRG","GGG",3,12,15,13,2,"run009"
"1745","GRG","GGR",0,5,5,0,5,"run009"
"1746","GRG","GRR",0,1,1,0,1,"run009"
"1747","GRG","RBG",0,1,1,1,0,"run009"
"1748","GRG","RBR",0,1,1,0,1,"run009"
"1749","GRG","RGR",1,2,3,3,0,"run009"
"1750","GRG","RRG",2,4,6,3,3,"run009"
"1751","GRR","BBB",0,1,1,0,1,"run009"
"1752","GRR","BBR",0,1,1,0,1,"run009"
"1753","GRR","BGB",1,2,3,3,0,"run009"
"1754","GRR","BGG",0,2,2,1,1,"run009"
"1755","GRR","BRB",0,1,1,0,1,"run009"
"1756","GRR","BRR",0,2,2,1,1,"run009"
"1757","GRR","GGG",0,1,1,1,0,"run009"
"1758","GRR","GGR",0,1,1,1,0,"run009"
"1759","RBB","BBB",0,1,1,0,1,"run009"
"1760","RBB","BBR",0,1,1,0,1,"run009"
"1761","RBB","BRB",0,1,1,1,0,"run009"
"1762","RBB","GRR",0,1,1,1,0,"run009"
"1763","RBB","RGG",0,1,1,0,1,"run009"
"1764","RBG","BBB",2,8,10,10,0,"run009"
"1765","RBG","BBG",0,1,1,0,1,"run009"
"1766","RBG","BRR",0,1,1,0,1,"run009"
"1767","RBG","GBB",0,1,1,1,0,"run009"
"1768","RBG","GRR",0,3,3,1,2,"run009"
"1769","RBG","RBB",1,1,2,0,2,"run009"
"1770","RBG","RBR",0,1,1,0,1,"run009"
"1771","RBG","RGR",0,1,1,0,1,"run009"
"1772","RBR","BBB",0,13,13,9,4,"run009"
"1773","RBR","BBR",0,1,1,1,0,"run009"
"1774","RBR","BGB",2,4,6,4,2,"run009"
"1775","RBR","BGG",0,2,2,1,1,"run009"
"1776","RBR","BRB",1,0,1,1,0,"run009"
"1777","RBR","BRR",1,4,5,5,0,"run009"
"1778","RBR","GGB",0,12,12,3,9,"run009"
"1779","RBR","GRR",4,4,8,5,3,"run009"
"1780","RBR","RBB",0,3,3,3,0,"run009"
"1781","RBR","RGG",2,9,11,5,6,"run009"
"1782","RBR","RGR",1,0,1,0,1,"run009"
"1783","RBR","RRR",0,1,1,0,1,"run009"
"1784","RGG","BBB",0,8,8,1,7,"run009"
"1785","RGG","BBR",1,2,3,3,0,"run009"
"1786","RGG","BGB",0,1,1,1,0,"run009"
"1787","RGG","BRR",0,4,4,2,2,"run009"
"1788","RGG","GGG",0,1,1,0,1,"run009"
"1789","RGG","GGR",0,3,3,2,1,"run009"
"1790","RGG","GRR",0,8,8,1,7,"run009"
"1791","RGG","RBB",0,1,1,1,0,"run009"
"1792","RGR","BBB",2,5,7,0,7,"run009"
"1793","RGR","BBR",1,1,2,1,1,"run009"
"1794","RGR","BGB",2,5,7,7,0,"run009"
"1795","RGR","BGG",2,2,4,2,2,"run009"
"1796","RGR","BRR",1,5,6,0,6,"run009"
"1797","RGR","GGB",2,12,14,14,0,"run009"
"1798","RGR","GGG",0,2,2,1,1,"run009"
"1799","RGR","GGR",0,4,4,3,1,"run009"
"1800","RGR","RBB",0,4,4,1,3,"run009"
"1801","RGR","RGG",1,1,2,2,0,"run009"
"1802","RGR","RRG",0,3,3,3,0,"run009"
"1803","RRG","BBB",2,33,35,7,28,"run009"
"1804","RRG","BBR",0,5,5,2,3,"run009"
"1805","RRG","BGB",1,10,11,4,7,"run009"
"1806","RRG","BGG",0,2,2,1,1,"run009"
"1807","RRG","BRB",2,40,42,28,14,"run009"
"1808","RRG","BRR",1,16,17,12,5,"run009"
"1809","RRG","GGG",2,14,16,11,5,"run009"
"1810","RRG","GGR",0,5,5,3,2,"run009"
"1811","RRG","GRG",1,0,1,1,0,"run009"
"1812","RRG","GRR",3,8,11,5,6,"run009"
"1813","RRG","RBB",1,1,2,0,2,"run009"
"1814","RRG","RGG",0,1,1,0,1,"run009"
"1815","RRG","RGR",0,1,1,0,1,"run009"
"1816","RRR","BBR",1,0,1,0,1,"run009"
"1817","RRR","BGB",2,1,3,2,1,"run009"
"1818","RRR","BGG",1,0,1,1,0,"run009"
"1819","RRR","BRB",1,1,2,1,1,"run009"
"1820","RRR","BRR",1,1,2,1,1,"run009"
"1821","RRR","GGR",0,1,1,0,1,"run009"
"1822","RRR","GRR",0,3,3,3,0,"run009"
"1823","RRR","RBB",1,2,3,3,0,"run009"
"1824","RRR","RBR",0,2,2,2,0,"run009"
"1825","RRR","RGG",0,1,1,0,1,"run009"
"1826","RRR","RGR",1,2,3,2,1,"run009"
"1827","RRR","RRG",2,2,4,4,0,"run009"
"1828","BBB","BRB",0,1,1,0,1,"run010"
"1829","BBB","GGG",1,2,3,0,3,"run010"
"1830","BBB","GRR",0,2,2,1,1,"run010"
"1831","BBB","RBG",0,1,1,1,0,"run010"
"1832","BBB","RRG",1,3,4,3,1,"run010"
"1833","BBB","RRR",0,2,2,2,0,"run010"
"1834","BBG","BBB",1,4,5,5,0,"run010"
"1835","BBG","BGB",0,1,1,0,1,"run010"
"1836","BBG","BGG",0,1,1,0,1,"run010"
"1837","BBG","BRB",1,16,17,14,3,"run010"
"1838","BBG","GBB",0,1,1,0,1,"run010"
"1839","BBG","GBG",2,7,9,9,0,"run010"
"1840","BBG","GGB",2,25,27,6,21,"run010"
"1841","BBG","GGG",4,38,42,9,33,"run010"
"1842","BBG","GRG",1,9,10,1,9,"run010"
"1843","BBG","GRR",0,1,1,1,0,"run010"
"1844","BBG","RBB",0,1,1,0,1,"run010"
"1845","BBG","RBG",0,4,4,2,2,"run010"
"1846","BBG","RBR",0,1,1,1,0,"run010"
"1847","BBG","RGR",0,1,1,1,0,"run010"
"1848","BBG","RRG",1,2,3,0,3,"run010"
"1849","BBG","RRR",0,7,7,4,3,"run010"
"1850","BGB","BBB",0,2,2,0,2,"run010"
"1851","BGB","RRG",0,1,1,0,1,"run010"
"1852","BGG","BBB",0,3,3,3,0,"run010"
"1853","BGG","BBR",0,1,1,1,0,"run010"
"1854","BGG","GRG",0,1,1,0,1,"run010"
"1855","BGG","RBG",1,1,2,1,1,"run010"
"1856","BGG","RGG",0,3,3,0,3,"run010"
"1857","BGG","RGR",0,1,1,1,0,"run010"
"1858","BGG","RRR",1,1,2,0,2,"run010"
"1859","BRB","BBB",0,13,13,6,7,"run010"
"1860","BRB","BBR",0,1,1,1,0,"run010"
"1861","BRB","BRR",0,3,3,1,2,"run010"
"1862","BRB","GGG",0,1,1,1,0,"run010"
"1863","BRB","GGR",0,1,1,0,1,"run010"
"1864","BRB","RBB",0,1,1,1,0,"run010"
"1865","BRB","RBG",0,1,1,0,1,"run010"
"1866","BRB","RGR",0,1,1,1,0,"run010"
"1867","BRB","RRR",0,1,1,1,0,"run010"
"1868","BRR","BBB",0,11,11,2,9,"run010"
"1869","BRR","BGB",1,1,2,1,1,"run010"
"1870","BRR","BGG",0,1,1,0,1,"run010"
"1871","BRR","BRB",0,1,1,1,0,"run010"
"1872","BRR","RBB",0,2,2,2,0,"run010"
"1873","GBB","BBB",12,38,50,14,36,"run010"
"1874","GBB","BGG",0,1,1,0,1,"run010"
"1875","GBB","BRB",1,9,10,9,1,"run010"
"1876","GBB","BRR",1,3,4,3,1,"run010"
"1877","GBB","GBG",0,4,4,2,2,"run010"
"1878","GBB","GGB",0,21,21,9,12,"run010"
"1879","GBB","GGG",7,86,93,77,16,"run010"
"1880","GBB","GGR",1,3,4,4,0,"run010"
"1881","GBB","GRG",0,6,6,0,6,"run010"
"1882","GBB","GRR",0,1,1,0,1,"run010"
"1883","GBB","RBB",0,2,2,0,2,"run010"
"1884","GBB","RBG",3,9,12,7,5,"run010"
"1885","GBB","RBR",1,0,1,1,0,"run010"
"1886","GBB","RGG",1,0,1,0,1,"run010"
"1887","GBB","RGR",2,1,3,1,2,"run010"
"1888","GBB","RRG",0,2,2,0,2,"run010"
"1889","GBB","RRR",1,9,10,0,10,"run010"
"1890","GBG","BBB",0,5,5,5,0,"run010"
"1891","GBG","BBR",0,1,1,1,0,"run010"
"1892","GBG","BRB",1,4,5,1,4,"run010"
"1893","GBG","BRR",1,0,1,0,1,"run010"
"1894","GBG","GGB",0,4,4,3,1,"run010"
"1895","GBG","GGG",4,11,15,2,13,"run010"
"1896","GBG","RBB",1,0,1,1,0,"run010"
"1897","GBG","RBG",0,1,1,0,1,"run010"
"1898","GBG","RGG",0,1,1,0,1,"run010"
"1899","GBG","RGR",1,3,4,1,3,"run010"
"1900","GBG","RRG",1,3,4,1,3,"run010"
"1901","GGB","BBB",3,16,19,6,13,"run010"
"1902","GGB","BBR",1,4,5,1,4,"run010"
"1903","GGB","BGB",0,3,3,0,3,"run010"
"1904","GGB","BGG",0,4,4,2,2,"run010"
"1905","GGB","BRB",0,1,1,0,1,"run010"
"1906","GGB","BRR",1,15,16,4,12,"run010"
"1907","GGB","GBB",0,1,1,0,1,"run010"
"1908","GGB","GBG",1,0,1,0,1,"run010"
"1909","GGB","GGG",13,48,61,38,23,"run010"
"1910","GGB","GGR",0,7,7,2,5,"run010"
"1911","GGB","GRR",0,4,4,0,4,"run010"
"1912","GGB","RBB",0,5,5,1,4,"run010"
"1913","GGB","RBG",0,4,4,2,2,"run010"
"1914","GGB","RBR",0,5,5,5,0,"run010"
"1915","GGB","RGG",1,5,6,1,5,"run010"
"1916","GGB","RGR",0,2,2,1,1,"run010"
"1917","GGB","RRG",1,5,6,5,1,"run010"
"1918","GGB","RRR",1,5,6,2,4,"run010"
"1919","GGG","BBB",8,31,39,14,25,"run010"
"1920","GGG","BGB",0,2,2,0,2,"run010"
"1921","GGG","BGG",1,7,8,1,7,"run010"
"1922","GGG","BRB",1,3,4,0,4,"run010"
"1923","GGG","BRR",0,6,6,2,4,"run010"
"1924","GGG","GGB",5,1,6,3,3,"run010"
"1925","GGG","GGR",1,9,10,3,7,"run010"
"1926","GGG","GRR",0,2,2,2,0,"run010"
"1927","GGG","RBB",1,8,9,2,7,"run010"
"1928","GGG","RBG",0,6,6,6,0,"run010"
"1929","GGG","RBR",0,21,21,16,5,"run010"
"1930","GGG","RGG",0,3,3,3,0,"run010"
"1931","GGG","RGR",1,12,13,13,0,"run010"
"1932","GGG","RRG",1,23,24,19,5,"run010"
"1933","GGG","RRR",0,3,3,1,2,"run010"
"1934","GGR","BBB",0,2,2,0,2,"run010"
"1935","GGR","BBR",0,2,2,2,0,"run010"
"1936","GGR","BGG",0,1,1,1,0,"run010"
"1937","GGR","BRR",1,0,1,0,1,"run010"
"1938","GGR","GRR",1,0,1,0,1,"run010"
"1939","GGR","RBB",0,2,2,0,2,"run010"
"1940","GRG","BBB",3,8,11,0,11,"run010"
"1941","GRG","BBR",0,1,1,1,0,"run010"
"1942","GRG","BGG",0,1,1,1,0,"run010"
"1943","GRG","BRB",0,3,3,2,1,"run010"
"1944","GRG","BRR",0,1,1,0,1,"run010"
"1945","GRG","GBG",0,1,1,1,0,"run010"
"1946","GRG","GGB",2,15,17,3,14,"run010"
"1947","GRG","GGG",3,12,15,2,13,"run010"
"1948","GRG","GGR",0,5,5,2,3,"run010"
"1949","GRG","GRR",0,1,1,1,0,"run010"
"1950","GRG","RBG",0,1,1,0,1,"run010"
"1951","GRG","RBR",0,1,1,0,1,"run010"
"1952","GRG","RGR",1,2,3,3,0,"run010"
"1953","GRG","RRG",2,4,6,5,1,"run010"
"1954","GRR","BBB",0,1,1,1,0,"run010"
"1955","GRR","BBR",0,1,1,0,1,"run010"
"1956","GRR","BGB",1,2,3,2,1,"run010"
"1957","GRR","BGG",0,2,2,0,2,"run010"
"1958","GRR","BRB",0,1,1,1,0,"run010"
"1959","GRR","BRR",0,2,2,1,1,"run010"
"1960","GRR","GGG",0,1,1,1,0,"run010"
"1961","GRR","GGR",0,1,1,0,1,"run010"
"1962","RBB","BBB",0,1,1,1,0,"run010"
"1963","RBB","BBR",0,1,1,0,1,"run010"
"1964","RBB","BRB",0,1,1,1,0,"run010"
"1965","RBB","GRR",0,1,1,1,0,"run010"
"1966","RBB","RGG",0,1,1,0,1,"run010"
"1967","RBG","BBB",2,8,10,1,9,"run010"
"1968","RBG","BBG",0,1,1,0,1,"run010"
"1969","RBG","BRR",0,1,1,0,1,"run010"
"1970","RBG","GBB",0,1,1,0,1,"run010"
"1971","RBG","GRR",0,3,3,2,1,"run010"
"1972","RBG","RBB",1,1,2,0,2,"run010"
"1973","RBG","RBR",0,1,1,0,1,"run010"
"1974","RBG","RGR",0,1,1,1,0,"run010"
"1975","RBR","BBB",0,13,13,13,0,"run010"
"1976","RBR","BBR",0,1,1,0,1,"run010"
"1977","RBR","BGB",2,4,6,5,1,"run010"
"1978","RBR","BGG",0,2,2,2,0,"run010"
"1979","RBR","BRB",1,0,1,1,0,"run010"
"1980","RBR","BRR",1,4,5,4,1,"run010"
"1981","RBR","GGB",0,12,12,5,7,"run010"
"1982","RBR","GRR",4,4,8,4,4,"run010"
"1983","RBR","RBB",0,3,3,3,0,"run010"
"1984","RBR","RGG",2,9,11,6,5,"run010"
"1985","RBR","RGR",1,0,1,1,0,"run010"
"1986","RBR","RRR",0,1,1,1,0,"run010"
"1987","RGG","BBB",0,8,8,0,8,"run010"
"1988","RGG","BBR",1,2,3,3,0,"run010"
"1989","RGG","BGB",0,1,1,1,0,"run010"
"1990","RGG","BRR",0,4,4,0,4,"run010"
"1991","RGG","GGG",0,1,1,1,0,"run010"
"1992","RGG","GGR",0,3,3,2,1,"run010"
"1993","RGG","GRR",0,8,8,6,2,"run010"
"1994","RGG","RBB",0,1,1,1,0,"run010"
"1995","RGR","BBB",2,5,7,3,4,"run010"
"1996","RGR","BBR",1,1,2,1,1,"run010"
"1997","RGR","BGB",2,5,7,5,2,"run010"
"1998","RGR","BGG",2,2,4,2,2,"run010"
"1999","RGR","BRR",1,5,6,4,2,"run010"
"2000","RGR","GGB",2,12,14,2,12,"run010"
"2001","RGR","GGG",0,2,2,2,0,"run010"
"2002","RGR","GGR",0,4,4,3,1,"run010"
"2003","RGR","RBB",0,4,4,3,1,"run010"
"2004","RGR","RGG",1,1,2,1,1,"run010"
"2005","RGR","RRG",0,3,3,1,2,"run010"
"2006","RRG","BBB",2,33,35,26,9,"run010"
"2007","RRG","BBR",0,5,5,1,4,"run010"
"2008","RRG","BGB",1,10,11,10,1,"run010"
"2009","RRG","BGG",0,2,2,1,1,"run010"
"2010","RRG","BRB",2,40,42,4,38,"run010"
"2011","RRG","BRR",1,16,17,8,9,"run010"
"2012","RRG","GGG",2,14,16,14,2,"run010"
"2013","RRG","GGR",0,5,5,3,2,"run010"
"2014","RRG","GRG",1,0,1,0,1,"run010"
"2015","RRG","GRR",3,8,11,6,5,"run010"
"2016","RRG","RBB",1,1,2,1,1,"run010"
"2017","RRG","RGG",0,1,1,0,1,"run010"
"2018","RRG","RGR",0,1,1,1,0,"run010"
"2019","RRR","BBR",1,0,1,0,1,"run010"
"2020","RRR","BGB",2,1,3,2,1,"run010"
"2021","RRR","BGG",1,0,1,0,1,"run010"
"2022","RRR","BRB",1,1,2,1,1,"run010"
"2023","RRR","BRR",1,1,2,2,0,"run010"
"2024","RRR","GGR",0,1,1,1,0,"run010"
"2025","RRR","GRR",0,3,3,1,2,"run010"
"2026","RRR","RBB",1,2,3,2,1,"run010"
"2027","RRR","RBR",0,2,2,2,0,"run010"
"2028","RRR","RGG",0,1,1,1,0,"run010"
"2029","RRR","RGR",1,2,3,1,2,"run010"
"2030","RRR","RRG",2,2,4,4,0,"run010"
"2031","BBB","BRB",0,1,1,1,0,"run011"
"2032","BBB","GGG",1,2,3,1,2,"run011"
"2033","BBB","GRR",0,2,2,0,2,"run011"
"2034","BBB","RBG",0,1,1,1,0,"run011"
"2035","BBB","RRG",1,3,4,0,4,"run011"
"2036","BBB","RRR",0,2,2,0,2,"run011"
"2037","BBG","BBB",1,4,5,3,2,"run011"
"2038","BBG","BGB",0,1,1,1,0,"run011"
"2039","BBG","BGG",0,1,1,1,0,"run011"
"2040","BBG","BRB",1,16,17,6,11,"run011"
"2041","BBG","GBB",0,1,1,1,0,"run011"
"2042","BBG","GBG",2,7,9,4,5,"run011"
"2043","BBG","GGB",2,25,27,2,25,"run011"
"2044","BBG","GGG",4,38,42,28,14,"run011"
"2045","BBG","GRG",1,9,10,10,0,"run011"
"2046","BBG","GRR",0,1,1,0,1,"run011"
"2047","BBG","RBB",0,1,1,0,1,"run011"
"2048","BBG","RBG",0,4,4,1,3,"run011"
"2049","BBG","RBR",0,1,1,0,1,"run011"
"2050","BBG","RGR",0,1,1,0,1,"run011"
"2051","BBG","RRG",1,2,3,3,0,"run011"
"2052","BBG","RRR",0,7,7,6,1,"run011"
"2053","BGB","BBB",0,2,2,2,0,"run011"
"2054","BGB","RRG",0,1,1,1,0,"run011"
"2055","BGG","BBB",0,3,3,1,2,"run011"
"2056","BGG","BBR",0,1,1,0,1,"run011"
"2057","BGG","GRG",0,1,1,0,1,"run011"
"2058","BGG","RBG",1,1,2,2,0,"run011"
"2059","BGG","RGG",0,3,3,1,2,"run011"
"2060","BGG","RGR",0,1,1,1,0,"run011"
"2061","BGG","RRR",1,1,2,0,2,"run011"
"2062","BRB","BBB",0,13,13,1,12,"run011"
"2063","BRB","BBR",0,1,1,0,1,"run011"
"2064","BRB","BRR",0,3,3,1,2,"run011"
"2065","BRB","GGG",0,1,1,1,0,"run011"
"2066","BRB","GGR",0,1,1,1,0,"run011"
"2067","BRB","RBB",0,1,1,0,1,"run011"
"2068","BRB","RBG",0,1,1,1,0,"run011"
"2069","BRB","RGR",0,1,1,0,1,"run011"
"2070","BRB","RRR",0,1,1,1,0,"run011"
"2071","BRR","BBB",0,11,11,7,4,"run011"
"2072","BRR","BGB",1,1,2,2,0,"run011"
"2073","BRR","BGG",0,1,1,1,0,"run011"
"2074","BRR","BRB",0,1,1,1,0,"run011"
"2075","BRR","RBB",0,2,2,0,2,"run011"
"2076","GBB","BBB",12,38,50,6,44,"run011"
"2077","GBB","BGG",0,1,1,1,0,"run011"
"2078","GBB","BRB",1,9,10,0,10,"run011"
"2079","GBB","BRR",1,3,4,4,0,"run011"
"2080","GBB","GBG",0,4,4,3,1,"run011"
"2081","GBB","GGB",0,21,21,17,4,"run011"
"2082","GBB","GGG",7,86,93,36,57,"run011"
"2083","GBB","GGR",1,3,4,3,1,"run011"
"2084","GBB","GRG",0,6,6,5,1,"run011"
"2085","GBB","GRR",0,1,1,0,1,"run011"
"2086","GBB","RBB",0,2,2,0,2,"run011"
"2087","GBB","RBG",3,9,12,5,7,"run011"
"2088","GBB","RBR",1,0,1,1,0,"run011"
"2089","GBB","RGG",1,0,1,1,0,"run011"
"2090","GBB","RGR",2,1,3,0,3,"run011"
"2091","GBB","RRG",0,2,2,1,1,"run011"
"2092","GBB","RRR",1,9,10,6,4,"run011"
"2093","GBG","BBB",0,5,5,0,5,"run011"
"2094","GBG","BBR",0,1,1,0,1,"run011"
"2095","GBG","BRB",1,4,5,3,2,"run011"
"2096","GBG","BRR",1,0,1,0,1,"run011"
"2097","GBG","GGB",0,4,4,3,1,"run011"
"2098","GBG","GGG",4,11,15,5,10,"run011"
"2099","GBG","RBB",1,0,1,1,0,"run011"
"2100","GBG","RBG",0,1,1,0,1,"run011"
"2101","GBG","RGG",0,1,1,1,0,"run011"
"2102","GBG","RGR",1,3,4,4,0,"run011"
"2103","GBG","RRG",1,3,4,0,4,"run011"
"2104","GGB","BBB",3,16,19,10,9,"run011"
"2105","GGB","BBR",1,4,5,3,2,"run011"
"2106","GGB","BGB",0,3,3,2,1,"run011"
"2107","GGB","BGG",0,4,4,2,2,"run011"
"2108","GGB","BRB",0,1,1,0,1,"run011"
"2109","GGB","BRR",1,15,16,3,13,"run011"
"2110","GGB","GBB",0,1,1,0,1,"run011"
"2111","GGB","GBG",1,0,1,0,1,"run011"
"2112","GGB","GGG",13,48,61,6,55,"run011"
"2113","GGB","GGR",0,7,7,3,4,"run011"
"2114","GGB","GRR",0,4,4,2,2,"run011"
"2115","GGB","RBB",0,5,5,3,2,"run011"
"2116","GGB","RBG",0,4,4,2,2,"run011"
"2117","GGB","RBR",0,5,5,4,1,"run011"
"2118","GGB","RGG",1,5,6,5,1,"run011"
"2119","GGB","RGR",0,2,2,0,2,"run011"
"2120","GGB","RRG",1,5,6,0,6,"run011"
"2121","GGB","RRR",1,5,6,0,6,"run011"
"2122","GGG","BBB",8,31,39,7,32,"run011"
"2123","GGG","BGB",0,2,2,1,1,"run011"
"2124","GGG","BGG",1,7,8,3,5,"run011"
"2125","GGG","BRB",1,3,4,2,2,"run011"
"2126","GGG","BRR",0,6,6,2,4,"run011"
"2127","GGG","GGB",5,1,6,5,1,"run011"
"2128","GGG","GGR",1,9,10,7,3,"run011"
"2129","GGG","GRR",0,2,2,0,2,"run011"
"2130","GGG","RBB",1,8,9,6,3,"run011"
"2131","GGG","RBG",0,6,6,4,2,"run011"
"2132","GGG","RBR",0,21,21,16,5,"run011"
"2133","GGG","RGG",0,3,3,3,0,"run011"
"2134","GGG","RGR",1,12,13,8,5,"run011"
"2135","GGG","RRG",1,23,24,6,18,"run011"
"2136","GGG","RRR",0,3,3,1,2,"run011"
"2137","GGR","BBB",0,2,2,0,2,"run011"
"2138","GGR","BBR",0,2,2,2,0,"run011"
"2139","GGR","BGG",0,1,1,0,1,"run011"
"2140","GGR","BRR",1,0,1,1,0,"run011"
"2141","GGR","GRR",1,0,1,1,0,"run011"
"2142","GGR","RBB",0,2,2,1,1,"run011"
"2143","GRG","BBB",3,8,11,8,3,"run011"
"2144","GRG","BBR",0,1,1,0,1,"run011"
"2145","GRG","BGG",0,1,1,1,0,"run011"
"2146","GRG","BRB",0,3,3,3,0,"run011"
"2147","GRG","BRR",0,1,1,1,0,"run011"
"2148","GRG","GBG",0,1,1,1,0,"run011"
"2149","GRG","GGB",2,15,17,11,6,"run011"
"2150","GRG","GGG",3,12,15,6,9,"run011"
"2151","GRG","GGR",0,5,5,4,1,"run011"
"2152","GRG","GRR",0,1,1,0,1,"run011"
"2153","GRG","RBG",0,1,1,0,1,"run011"
"2154","GRG","RBR",0,1,1,1,0,"run011"
"2155","GRG","RGR",1,2,3,2,1,"run011"
"2156","GRG","RRG",2,4,6,4,2,"run011"
"2157","GRR","BBB",0,1,1,1,0,"run011"
"2158","GRR","BBR",0,1,1,1,0,"run011"
"2159","GRR","BGB",1,2,3,3,0,"run011"
"2160","GRR","BGG",0,2,2,0,2,"run011"
"2161","GRR","BRB",0,1,1,0,1,"run011"
"2162","GRR","BRR",0,2,2,1,1,"run011"
"2163","GRR","GGG",0,1,1,1,0,"run011"
"2164","GRR","GGR",0,1,1,0,1,"run011"
"2165","RBB","BBB",0,1,1,0,1,"run011"
"2166","RBB","BBR",0,1,1,0,1,"run011"
"2167","RBB","BRB",0,1,1,1,0,"run011"
"2168","RBB","GRR",0,1,1,0,1,"run011"
"2169","RBB","RGG",0,1,1,1,0,"run011"
"2170","RBG","BBB",2,8,10,1,9,"run011"
"2171","RBG","BBG",0,1,1,1,0,"run011"
"2172","RBG","BRR",0,1,1,1,0,"run011"
"2173","RBG","GBB",0,1,1,0,1,"run011"
"2174","RBG","GRR",0,3,3,2,1,"run011"
"2175","RBG","RBB",1,1,2,0,2,"run011"
"2176","RBG","RBR",0,1,1,0,1,"run011"
"2177","RBG","RGR",0,1,1,0,1,"run011"
"2178","RBR","BBB",0,13,13,1,12,"run011"
"2179","RBR","BBR",0,1,1,1,0,"run011"
"2180","RBR","BGB",2,4,6,6,0,"run011"
"2181","RBR","BGG",0,2,2,0,2,"run011"
"2182","RBR","BRB",1,0,1,0,1,"run011"
"2183","RBR","BRR",1,4,5,5,0,"run011"
"2184","RBR","GGB",0,12,12,8,4,"run011"
"2185","RBR","GRR",4,4,8,7,1,"run011"
"2186","RBR","RBB",0,3,3,1,2,"run011"
"2187","RBR","RGG",2,9,11,8,3,"run011"
"2188","RBR","RGR",1,0,1,0,1,"run011"
"2189","RBR","RRR",0,1,1,1,0,"run011"
"2190","RGG","BBB",0,8,8,1,7,"run011"
"2191","RGG","BBR",1,2,3,2,1,"run011"
"2192","RGG","BGB",0,1,1,1,0,"run011"
"2193","RGG","BRR",0,4,4,2,2,"run011"
"2194","RGG","GGG",0,1,1,0,1,"run011"
"2195","RGG","GGR",0,3,3,1,2,"run011"
"2196","RGG","GRR",0,8,8,8,0,"run011"
"2197","RGG","RBB",0,1,1,0,1,"run011"
"2198","RGR","BBB",2,5,7,4,3,"run011"
"2199","RGR","BBR",1,1,2,1,1,"run011"
"2200","RGR","BGB",2,5,7,2,5,"run011"
"2201","RGR","BGG",2,2,4,3,1,"run011"
"2202","RGR","BRR",1,5,6,2,4,"run011"
"2203","RGR","GGB",2,12,14,8,6,"run011"
"2204","RGR","GGG",0,2,2,1,1,"run011"
"2205","RGR","GGR",0,4,4,1,3,"run011"
"2206","RGR","RBB",0,4,4,1,3,"run011"
"2207","RGR","RGG",1,1,2,2,0,"run011"
"2208","RGR","RRG",0,3,3,3,0,"run011"
"2209","RRG","BBB",2,33,35,4,31,"run011"
"2210","RRG","BBR",0,5,5,4,1,"run011"
"2211","RRG","BGB",1,10,11,5,6,"run011"
"2212","RRG","BGG",0,2,2,2,0,"run011"
"2213","RRG","BRB",2,40,42,7,35,"run011"
"2214","RRG","BRR",1,16,17,15,2,"run011"
"2215","RRG","GGG",2,14,16,4,12,"run011"
"2216","RRG","GGR",0,5,5,5,0,"run011"
"2217","RRG","GRG",1,0,1,1,0,"run011"
"2218","RRG","GRR",3,8,11,3,8,"run011"
"2219","RRG","RBB",1,1,2,1,1,"run011"
"2220","RRG","RGG",0,1,1,1,0,"run011"
"2221","RRG","RGR",0,1,1,0,1,"run011"
"2222","RRR","BBR",1,0,1,1,0,"run011"
"2223","RRR","BGB",2,1,3,0,3,"run011"
"2224","RRR","BGG",1,0,1,1,0,"run011"
"2225","RRR","BRB",1,1,2,0,2,"run011"
"2226","RRR","BRR",1,1,2,2,0,"run011"
"2227","RRR","GGR",0,1,1,0,1,"run011"
"2228","RRR","GRR",0,3,3,3,0,"run011"
"2229","RRR","RBB",1,2,3,0,3,"run011"
"2230","RRR","RBR",0,2,2,0,2,"run011"
"2231","RRR","RGG",0,1,1,1,0,"run011"
"2232","RRR","RGR",1,2,3,1,2,"run011"
"2233","RRR","RRG",2,2,4,3,1,"run011"
"2234","BBB","BRB",0,1,1,1,0,"run012"
"2235","BBB","GGG",1,2,3,1,2,"run012"
"2236","BBB","GRR",0,2,2,2,0,"run012"
"2237","BBB","RBG",0,1,1,0,1,"run012"
"2238","BBB","RRG",1,3,4,4,0,"run012"
"2239","BBB","RRR",0,2,2,0,2,"run012"
"2240","BBG","BBB",1,4,5,3,2,"run012"
"2241","BBG","BGB",0,1,1,1,0,"run012"
"2242","BBG","BGG",0,1,1,1,0,"run012"
"2243","BBG","BRB",1,16,17,17,0,"run012"
"2244","BBG","GBB",0,1,1,0,1,"run012"
"2245","BBG","GBG",2,7,9,1,8,"run012"
"2246","BBG","GGB",2,25,27,24,3,"run012"
"2247","BBG","GGG",4,38,42,37,5,"run012"
"2248","BBG","GRG",1,9,10,9,1,"run012"
"2249","BBG","GRR",0,1,1,1,0,"run012"
"2250","BBG","RBB",0,1,1,0,1,"run012"
"2251","BBG","RBG",0,4,4,4,0,"run012"
"2252","BBG","RBR",0,1,1,1,0,"run012"
"2253","BBG","RGR",0,1,1,1,0,"run012"
"2254","BBG","RRG",1,2,3,3,0,"run012"
"2255","BBG","RRR",0,7,7,0,7,"run012"
"2256","BGB","BBB",0,2,2,2,0,"run012"
"2257","BGB","RRG",0,1,1,1,0,"run012"
"2258","BGG","BBB",0,3,3,2,1,"run012"
"2259","BGG","BBR",0,1,1,1,0,"run012"
"2260","BGG","GRG",0,1,1,0,1,"run012"
"2261","BGG","RBG",1,1,2,2,0,"run012"
"2262","BGG","RGG",0,3,3,1,2,"run012"
"2263","BGG","RGR",0,1,1,1,0,"run012"
"2264","BGG","RRR",1,1,2,0,2,"run012"
"2265","BRB","BBB",0,13,13,12,1,"run012"
"2266","BRB","BBR",0,1,1,0,1,"run012"
"2267","BRB","BRR",0,3,3,1,2,"run012"
"2268","BRB","GGG",0,1,1,0,1,"run012"
"2269","BRB","GGR",0,1,1,1,0,"run012"
"2270","BRB","RBB",0,1,1,0,1,"run012"
"2271","BRB","RBG",0,1,1,1,0,"run012"
"2272","BRB","RGR",0,1,1,1,0,"run012"
"2273","BRB","RRR",0,1,1,1,0,"run012"
"2274","BRR","BBB",0,11,11,3,8,"run012"
"2275","BRR","BGB",1,1,2,2,0,"run012"
"2276","BRR","BGG",0,1,1,1,0,"run012"
"2277","BRR","BRB",0,1,1,1,0,"run012"
"2278","BRR","RBB",0,2,2,0,2,"run012"
"2279","GBB","BBB",12,38,50,12,38,"run012"
"2280","GBB","BGG",0,1,1,1,0,"run012"
"2281","GBB","BRB",1,9,10,10,0,"run012"
"2282","GBB","BRR",1,3,4,4,0,"run012"
"2283","GBB","GBG",0,4,4,3,1,"run012"
"2284","GBB","GGB",0,21,21,15,6,"run012"
"2285","GBB","GGG",7,86,93,70,23,"run012"
"2286","GBB","GGR",1,3,4,2,2,"run012"
"2287","GBB","GRG",0,6,6,4,2,"run012"
"2288","GBB","GRR",0,1,1,1,0,"run012"
"2289","GBB","RBB",0,2,2,2,0,"run012"
"2290","GBB","RBG",3,9,12,7,5,"run012"
"2291","GBB","RBR",1,0,1,0,1,"run012"
"2292","GBB","RGG",1,0,1,0,1,"run012"
"2293","GBB","RGR",2,1,3,1,2,"run012"
"2294","GBB","RRG",0,2,2,0,2,"run012"
"2295","GBB","RRR",1,9,10,6,4,"run012"
"2296","GBG","BBB",0,5,5,1,4,"run012"
"2297","GBG","BBR",0,1,1,1,0,"run012"
"2298","GBG","BRB",1,4,5,4,1,"run012"
"2299","GBG","BRR",1,0,1,1,0,"run012"
"2300","GBG","GGB",0,4,4,0,4,"run012"
"2301","GBG","GGG",4,11,15,3,12,"run012"
"2302","GBG","RBB",1,0,1,1,0,"run012"
"2303","GBG","RBG",0,1,1,0,1,"run012"
"2304","GBG","RGG",0,1,1,0,1,"run012"
"2305","GBG","RGR",1,3,4,1,3,"run012"
"2306","GBG","RRG",1,3,4,3,1,"run012"
"2307","GGB","BBB",3,16,19,7,12,"run012"
"2308","GGB","BBR",1,4,5,2,3,"run012"
"2309","GGB","BGB",0,3,3,0,3,"run012"
"2310","GGB","BGG",0,4,4,1,3,"run012"
"2311","GGB","BRB",0,1,1,1,0,"run012"
"2312","GGB","BRR",1,15,16,11,5,"run012"
"2313","GGB","GBB",0,1,1,1,0,"run012"
"2314","GGB","GBG",1,0,1,1,0,"run012"
"2315","GGB","GGG",13,48,61,61,0,"run012"
"2316","GGB","GGR",0,7,7,4,3,"run012"
"2317","GGB","GRR",0,4,4,4,0,"run012"
"2318","GGB","RBB",0,5,5,2,3,"run012"
"2319","GGB","RBG",0,4,4,2,2,"run012"
"2320","GGB","RBR",0,5,5,3,2,"run012"
"2321","GGB","RGG",1,5,6,5,1,"run012"
"2322","GGB","RGR",0,2,2,0,2,"run012"
"2323","GGB","RRG",1,5,6,3,3,"run012"
"2324","GGB","RRR",1,5,6,2,4,"run012"
"2325","GGG","BBB",8,31,39,4,35,"run012"
"2326","GGG","BGB",0,2,2,1,1,"run012"
"2327","GGG","BGG",1,7,8,5,3,"run012"
"2328","GGG","BRB",1,3,4,1,3,"run012"
"2329","GGG","BRR",0,6,6,1,5,"run012"
"2330","GGG","GGB",5,1,6,2,4,"run012"
"2331","GGG","GGR",1,9,10,9,1,"run012"
"2332","GGG","GRR",0,2,2,1,1,"run012"
"2333","GGG","RBB",1,8,9,5,4,"run012"
"2334","GGG","RBG",0,6,6,0,6,"run012"
"2335","GGG","RBR",0,21,21,6,15,"run012"
"2336","GGG","RGG",0,3,3,0,3,"run012"
"2337","GGG","RGR",1,12,13,11,2,"run012"
"2338","GGG","RRG",1,23,24,8,16,"run012"
"2339","GGG","RRR",0,3,3,3,0,"run012"
"2340","GGR","BBB",0,2,2,2,0,"run012"
"2341","GGR","BBR",0,2,2,2,0,"run012"
"2342","GGR","BGG",0,1,1,1,0,"run012"
"2343","GGR","BRR",1,0,1,1,0,"run012"
"2344","GGR","GRR",1,0,1,0,1,"run012"
"2345","GGR","RBB",0,2,2,0,2,"run012"
"2346","GRG","BBB",3,8,11,6,5,"run012"
"2347","GRG","BBR",0,1,1,1,0,"run012"
"2348","GRG","BGG",0,1,1,0,1,"run012"
"2349","GRG","BRB",0,3,3,3,0,"run012"
"2350","GRG","BRR",0,1,1,0,1,"run012"
"2351","GRG","GBG",0,1,1,1,0,"run012"
"2352","GRG","GGB",2,15,17,8,9,"run012"
"2353","GRG","GGG",3,12,15,7,8,"run012"
"2354","GRG","GGR",0,5,5,4,1,"run012"
"2355","GRG","GRR",0,1,1,0,1,"run012"
"2356","GRG","RBG",0,1,1,1,0,"run012"
"2357","GRG","RBR",0,1,1,1,0,"run012"
"2358","GRG","RGR",1,2,3,2,1,"run012"
"2359","GRG","RRG",2,4,6,2,4,"run012"
"2360","GRR","BBB",0,1,1,0,1,"run012"
"2361","GRR","BBR",0,1,1,0,1,"run012"
"2362","GRR","BGB",1,2,3,2,1,"run012"
"2363","GRR","BGG",0,2,2,2,0,"run012"
"2364","GRR","BRB",0,1,1,1,0,"run012"
"2365","GRR","BRR",0,2,2,1,1,"run012"
"2366","GRR","GGG",0,1,1,0,1,"run012"
"2367","GRR","GGR",0,1,1,1,0,"run012"
"2368","RBB","BBB",0,1,1,1,0,"run012"
"2369","RBB","BBR",0,1,1,0,1,"run012"
"2370","RBB","BRB",0,1,1,0,1,"run012"
"2371","RBB","GRR",0,1,1,0,1,"run012"
"2372","RBB","RGG",0,1,1,0,1,"run012"
"2373","RBG","BBB",2,8,10,1,9,"run012"
"2374","RBG","BBG",0,1,1,1,0,"run012"
"2375","RBG","BRR",0,1,1,1,0,"run012"
"2376","RBG","GBB",0,1,1,0,1,"run012"
"2377","RBG","GRR",0,3,3,2,1,"run012"
"2378","RBG","RBB",1,1,2,0,2,"run012"
"2379","RBG","RBR",0,1,1,0,1,"run012"
"2380","RBG","RGR",0,1,1,0,1,"run012"
"2381","RBR","BBB",0,13,13,2,11,"run012"
"2382","RBR","BBR",0,1,1,0,1,"run012"
"2383","RBR","BGB",2,4,6,6,0,"run012"
"2384","RBR","BGG",0,2,2,0,2,"run012"
"2385","RBR","BRB",1,0,1,0,1,"run012"
"2386","RBR","BRR",1,4,5,2,3,"run012"
"2387","RBR","GGB",0,12,12,10,2,"run012"
"2388","RBR","GRR",4,4,8,6,2,"run012"
"2389","RBR","RBB",0,3,3,3,0,"run012"
"2390","RBR","RGG",2,9,11,9,2,"run012"
"2391","RBR","RGR",1,0,1,0,1,"run012"
"2392","RBR","RRR",0,1,1,1,0,"run012"
"2393","RGG","BBB",0,8,8,1,7,"run012"
"2394","RGG","BBR",1,2,3,2,1,"run012"
"2395","RGG","BGB",0,1,1,0,1,"run012"
"2396","RGG","BRR",0,4,4,0,4,"run012"
"2397","RGG","GGG",0,1,1,0,1,"run012"
"2398","RGG","GGR",0,3,3,0,3,"run012"
"2399","RGG","GRR",0,8,8,0,8,"run012"
"2400","RGG","RBB",0,1,1,0,1,"run012"
"2401","RGR","BBB",2,5,7,7,0,"run012"
"2402","RGR","BBR",1,1,2,2,0,"run012"
"2403","RGR","BGB",2,5,7,0,7,"run012"
"2404","RGR","BGG",2,2,4,4,0,"run012"
"2405","RGR","BRR",1,5,6,1,5,"run012"
"2406","RGR","GGB",2,12,14,0,14,"run012"
"2407","RGR","GGG",0,2,2,0,2,"run012"
"2408","RGR","GGR",0,4,4,2,2,"run012"
"2409","RGR","RBB",0,4,4,4,0,"run012"
"2410","RGR","RGG",1,1,2,2,0,"run012"
"2411","RGR","RRG",0,3,3,2,1,"run012"
"2412","RRG","BBB",2,33,35,3,32,"run012"
"2413","RRG","BBR",0,5,5,2,3,"run012"
"2414","RRG","BGB",1,10,11,5,6,"run012"
"2415","RRG","BGG",0,2,2,2,0,"run012"
"2416","RRG","BRB",2,40,42,27,15,"run012"
"2417","RRG","BRR",1,16,17,2,15,"run012"
"2418","RRG","GGG",2,14,16,8,8,"run012"
"2419","RRG","GGR",0,5,5,1,4,"run012"
"2420","RRG","GRG",1,0,1,1,0,"run012"
"2421","RRG","GRR",3,8,11,3,8,"run012"
"2422","RRG","RBB",1,1,2,1,1,"run012"
"2423","RRG","RGG",0,1,1,1,0,"run012"
"2424","RRG","RGR",0,1,1,1,0,"run012"
"2425","RRR","BBR",1,0,1,1,0,"run012"
"2426","RRR","BGB",2,1,3,1,2,"run012"
"2427","RRR","BGG",1,0,1,1,0,"run012"
"2428","RRR","BRB",1,1,2,2,0,"run012"
"2429","RRR","BRR",1,1,2,1,1,"run012"
"2430","RRR","GGR",0,1,1,1,0,"run012"
"2431","RRR","GRR",0,3,3,2,1,"run012"
"2432","RRR","RBB",1,2,3,0,3,"run012"
"2433","RRR","RBR",0,2,2,0,2,"run012"
"2434","RRR","RGG",0,1,1,1,0,"run012"
"2435","RRR","RGR",1,2,3,2,1,"run012"
"2436","RRR","RRG",2,2,4,3,1,"run012"
"2437","BBB","BRB",0,1,1,1,0,"run013"
"2438","BBB","GGG",1,2,3,2,1,"run013"
"2439","BBB","GRR",0,2,2,0,2,"run013"
"2440","BBB","RBG",0,1,1,1,0,"run013"
"2441","BBB","RRG",1,3,4,4,0,"run013"
"2442","BBB","RRR",0,2,2,1,1,"run013"
"2443","BBG","BBB",1,4,5,5,0,"run013"
"2444","BBG","BGB",0,1,1,1,0,"run013"
"2445","BBG","BGG",0,1,1,1,0,"run013"
"2446","BBG","BRB",1,16,17,16,1,"run013"
"2447","BBG","GBB",0,1,1,1,0,"run013"
"2448","BBG","GBG",2,7,9,9,0,"run013"
"2449","BBG","GGB",2,25,27,14,13,"run013"
"2450","BBG","GGG",4,38,42,22,20,"run013"
"2451","BBG","GRG",1,9,10,4,6,"run013"
"2452","BBG","GRR",0,1,1,1,0,"run013"
"2453","BBG","RBB",0,1,1,0,1,"run013"
"2454","BBG","RBG",0,4,4,4,0,"run013"
"2455","BBG","RBR",0,1,1,0,1,"run013"
"2456","BBG","RGR",0,1,1,0,1,"run013"
"2457","BBG","RRG",1,2,3,3,0,"run013"
"2458","BBG","RRR",0,7,7,0,7,"run013"
"2459","BGB","BBB",0,2,2,2,0,"run013"
"2460","BGB","RRG",0,1,1,1,0,"run013"
"2461","BGG","BBB",0,3,3,3,0,"run013"
"2462","BGG","BBR",0,1,1,0,1,"run013"
"2463","BGG","GRG",0,1,1,1,0,"run013"
"2464","BGG","RBG",1,1,2,0,2,"run013"
"2465","BGG","RGG",0,3,3,0,3,"run013"
"2466","BGG","RGR",0,1,1,0,1,"run013"
"2467","BGG","RRR",1,1,2,2,0,"run013"
"2468","BRB","BBB",0,13,13,2,11,"run013"
"2469","BRB","BBR",0,1,1,0,1,"run013"
"2470","BRB","BRR",0,3,3,1,2,"run013"
"2471","BRB","GGG",0,1,1,1,0,"run013"
"2472","BRB","GGR",0,1,1,1,0,"run013"
"2473","BRB","RBB",0,1,1,1,0,"run013"
"2474","BRB","RBG",0,1,1,0,1,"run013"
"2475","BRB","RGR",0,1,1,1,0,"run013"
"2476","BRB","RRR",0,1,1,0,1,"run013"
"2477","BRR","BBB",0,11,11,7,4,"run013"
"2478","BRR","BGB",1,1,2,2,0,"run013"
"2479","BRR","BGG",0,1,1,0,1,"run013"
"2480","BRR","BRB",0,1,1,1,0,"run013"
"2481","BRR","RBB",0,2,2,0,2,"run013"
"2482","GBB","BBB",12,38,50,11,39,"run013"
"2483","GBB","BGG",0,1,1,1,0,"run013"
"2484","GBB","BRB",1,9,10,9,1,"run013"
"2485","GBB","BRR",1,3,4,4,0,"run013"
"2486","GBB","GBG",0,4,4,1,3,"run013"
"2487","GBB","GGB",0,21,21,16,5,"run013"
"2488","GBB","GGG",7,86,93,13,80,"run013"
"2489","GBB","GGR",1,3,4,0,4,"run013"
"2490","GBB","GRG",0,6,6,0,6,"run013"
"2491","GBB","GRR",0,1,1,1,0,"run013"
"2492","GBB","RBB",0,2,2,2,0,"run013"
"2493","GBB","RBG",3,9,12,1,11,"run013"
"2494","GBB","RBR",1,0,1,0,1,"run013"
"2495","GBB","RGG",1,0,1,0,1,"run013"
"2496","GBB","RGR",2,1,3,0,3,"run013"
"2497","GBB","RRG",0,2,2,1,1,"run013"
"2498","GBB","RRR",1,9,10,0,10,"run013"
"2499","GBG","BBB",0,5,5,0,5,"run013"
"2500","GBG","BBR",0,1,1,0,1,"run013"
"2501","GBG","BRB",1,4,5,5,0,"run013"
"2502","GBG","BRR",1,0,1,0,1,"run013"
"2503","GBG","GGB",0,4,4,0,4,"run013"
"2504","GBG","GGG",4,11,15,6,9,"run013"
"2505","GBG","RBB",1,0,1,1,0,"run013"
"2506","GBG","RBG",0,1,1,0,1,"run013"
"2507","GBG","RGG",0,1,1,1,0,"run013"
"2508","GBG","RGR",1,3,4,3,1,"run013"
"2509","GBG","RRG",1,3,4,2,2,"run013"
"2510","GGB","BBB",3,16,19,14,5,"run013"
"2511","GGB","BBR",1,4,5,5,0,"run013"
"2512","GGB","BGB",0,3,3,3,0,"run013"
"2513","GGB","BGG",0,4,4,2,2,"run013"
"2514","GGB","BRB",0,1,1,0,1,"run013"
"2515","GGB","BRR",1,15,16,16,0,"run013"
"2516","GGB","GBB",0,1,1,0,1,"run013"
"2517","GGB","GBG",1,0,1,1,0,"run013"
"2518","GGB","GGG",13,48,61,18,43,"run013"
"2519","GGB","GGR",0,7,7,7,0,"run013"
"2520","GGB","GRR",0,4,4,4,0,"run013"
"2521","GGB","RBB",0,5,5,4,1,"run013"
"2522","GGB","RBG",0,4,4,0,4,"run013"
"2523","GGB","RBR",0,5,5,2,3,"run013"
"2524","GGB","RGG",1,5,6,5,1,"run013"
"2525","GGB","RGR",0,2,2,2,0,"run013"
"2526","GGB","RRG",1,5,6,1,5,"run013"
"2527","GGB","RRR",1,5,6,5,1,"run013"
"2528","GGG","BBB",8,31,39,8,31,"run013"
"2529","GGG","BGB",0,2,2,2,0,"run013"
"2530","GGG","BGG",1,7,8,4,4,"run013"
"2531","GGG","BRB",1,3,4,4,0,"run013"
"2532","GGG","BRR",0,6,6,0,6,"run013"
"2533","GGG","GGB",5,1,6,5,1,"run013"
"2534","GGG","GGR",1,9,10,2,8,"run013"
"2535","GGG","GRR",0,2,2,0,2,"run013"
"2536","GGG","RBB",1,8,9,5,4,"run013"
"2537","GGG","RBG",0,6,6,0,6,"run013"
"2538","GGG","RBR",0,21,21,7,14,"run013"
"2539","GGG","RGG",0,3,3,3,0,"run013"
"2540","GGG","RGR",1,12,13,13,0,"run013"
"2541","GGG","RRG",1,23,24,19,5,"run013"
"2542","GGG","RRR",0,3,3,1,2,"run013"
"2543","GGR","BBB",0,2,2,0,2,"run013"
"2544","GGR","BBR",0,2,2,1,1,"run013"
"2545","GGR","BGG",0,1,1,1,0,"run013"
"2546","GGR","BRR",1,0,1,1,0,"run013"
"2547","GGR","GRR",1,0,1,1,0,"run013"
"2548","GGR","RBB",0,2,2,0,2,"run013"
"2549","GRG","BBB",3,8,11,8,3,"run013"
"2550","GRG","BBR",0,1,1,0,1,"run013"
"2551","GRG","BGG",0,1,1,0,1,"run013"
"2552","GRG","BRB",0,3,3,0,3,"run013"
"2553","GRG","BRR",0,1,1,0,1,"run013"
"2554","GRG","GBG",0,1,1,1,0,"run013"
"2555","GRG","GGB",2,15,17,2,15,"run013"
"2556","GRG","GGG",3,12,15,12,3,"run013"
"2557","GRG","GGR",0,5,5,5,0,"run013"
"2558","GRG","GRR",0,1,1,1,0,"run013"
"2559","GRG","RBG",0,1,1,0,1,"run013"
"2560","GRG","RBR",0,1,1,0,1,"run013"
"2561","GRG","RGR",1,2,3,1,2,"run013"
"2562","GRG","RRG",2,4,6,5,1,"run013"
"2563","GRR","BBB",0,1,1,0,1,"run013"
"2564","GRR","BBR",0,1,1,1,0,"run013"
"2565","GRR","BGB",1,2,3,0,3,"run013"
"2566","GRR","BGG",0,2,2,2,0,"run013"
"2567","GRR","BRB",0,1,1,0,1,"run013"
"2568","GRR","BRR",0,2,2,1,1,"run013"
"2569","GRR","GGG",0,1,1,1,0,"run013"
"2570","GRR","GGR",0,1,1,1,0,"run013"
"2571","RBB","BBB",0,1,1,0,1,"run013"
"2572","RBB","BBR",0,1,1,1,0,"run013"
"2573","RBB","BRB",0,1,1,0,1,"run013"
"2574","RBB","GRR",0,1,1,0,1,"run013"
"2575","RBB","RGG",0,1,1,0,1,"run013"
"2576","RBG","BBB",2,8,10,1,9,"run013"
"2577","RBG","BBG",0,1,1,1,0,"run013"
"2578","RBG","BRR",0,1,1,1,0,"run013"
"2579","RBG","GBB",0,1,1,0,1,"run013"
"2580","RBG","GRR",0,3,3,0,3,"run013"
"2581","RBG","RBB",1,1,2,2,0,"run013"
"2582","RBG","RBR",0,1,1,1,0,"run013"
"2583","RBG","RGR",0,1,1,1,0,"run013"
"2584","RBR","BBB",0,13,13,8,5,"run013"
"2585","RBR","BBR",0,1,1,0,1,"run013"
"2586","RBR","BGB",2,4,6,2,4,"run013"
"2587","RBR","BGG",0,2,2,2,0,"run013"
"2588","RBR","BRB",1,0,1,0,1,"run013"
"2589","RBR","BRR",1,4,5,3,2,"run013"
"2590","RBR","GGB",0,12,12,12,0,"run013"
"2591","RBR","GRR",4,4,8,7,1,"run013"
"2592","RBR","RBB",0,3,3,2,1,"run013"
"2593","RBR","RGG",2,9,11,3,8,"run013"
"2594","RBR","RGR",1,0,1,0,1,"run013"
"2595","RBR","RRR",0,1,1,1,0,"run013"
"2596","RGG","BBB",0,8,8,4,4,"run013"
"2597","RGG","BBR",1,2,3,2,1,"run013"
"2598","RGG","BGB",0,1,1,0,1,"run013"
"2599","RGG","BRR",0,4,4,4,0,"run013"
"2600","RGG","GGG",0,1,1,1,0,"run013"
"2601","RGG","GGR",0,3,3,0,3,"run013"
"2602","RGG","GRR",0,8,8,0,8,"run013"
"2603","RGG","RBB",0,1,1,0,1,"run013"
"2604","RGR","BBB",2,5,7,5,2,"run013"
"2605","RGR","BBR",1,1,2,0,2,"run013"
"2606","RGR","BGB",2,5,7,4,3,"run013"
"2607","RGR","BGG",2,2,4,3,1,"run013"
"2608","RGR","BRR",1,5,6,1,5,"run013"
"2609","RGR","GGB",2,12,14,13,1,"run013"
"2610","RGR","GGG",0,2,2,2,0,"run013"
"2611","RGR","GGR",0,4,4,3,1,"run013"
"2612","RGR","RBB",0,4,4,0,4,"run013"
"2613","RGR","RGG",1,1,2,0,2,"run013"
"2614","RGR","RRG",0,3,3,2,1,"run013"
"2615","RRG","BBB",2,33,35,10,25,"run013"
"2616","RRG","BBR",0,5,5,5,0,"run013"
"2617","RRG","BGB",1,10,11,8,3,"run013"
"2618","RRG","BGG",0,2,2,2,0,"run013"
"2619","RRG","BRB",2,40,42,18,24,"run013"
"2620","RRG","BRR",1,16,17,9,8,"run013"
"2621","RRG","GGG",2,14,16,12,4,"run013"
"2622","RRG","GGR",0,5,5,1,4,"run013"
"2623","RRG","GRG",1,0,1,0,1,"run013"
"2624","RRG","GRR",3,8,11,6,5,"run013"
"2625","RRG","RBB",1,1,2,0,2,"run013"
"2626","RRG","RGG",0,1,1,0,1,"run013"
"2627","RRG","RGR",0,1,1,1,0,"run013"
"2628","RRR","BBR",1,0,1,1,0,"run013"
"2629","RRR","BGB",2,1,3,0,3,"run013"
"2630","RRR","BGG",1,0,1,1,0,"run013"
"2631","RRR","BRB",1,1,2,1,1,"run013"
"2632","RRR","BRR",1,1,2,0,2,"run013"
"2633","RRR","GGR",0,1,1,0,1,"run013"
"2634","RRR","GRR",0,3,3,1,2,"run013"
"2635","RRR","RBB",1,2,3,2,1,"run013"
"2636","RRR","RBR",0,2,2,2,0,"run013"
"2637","RRR","RGG",0,1,1,1,0,"run013"
"2638","RRR","RGR",1,2,3,3,0,"run013"
"2639","RRR","RRG",2,2,4,3,1,"run013"
"2640","BBB","BRB",0,1,1,0,1,"run014"
"2641","BBB","GGG",1,2,3,0,3,"run014"
"2642","BBB","GRR",0,2,2,2,0,"run014"
"2643","BBB","RBG",0,1,1,1,0,"run014"
"2644","BBB","RRG",1,3,4,2,2,"run014"
"2645","BBB","RRR",0,2,2,1,1,"run014"
"2646","BBG","BBB",1,4,5,5,0,"run014"
"2647","BBG","BGB",0,1,1,1,0,"run014"
"2648","BBG","BGG",0,1,1,1,0,"run014"
"2649","BBG","BRB",1,16,17,14,3,"run014"
"2650","BBG","GBB",0,1,1,0,1,"run014"
"2651","BBG","GBG",2,7,9,8,1,"run014"
"2652","BBG","GGB",2,25,27,2,25,"run014"
"2653","BBG","GGG",4,38,42,27,15,"run014"
"2654","BBG","GRG",1,9,10,4,6,"run014"
"2655","BBG","GRR",0,1,1,0,1,"run014"
"2656","BBG","RBB",0,1,1,0,1,"run014"
"2657","BBG","RBG",0,4,4,1,3,"run014"
"2658","BBG","RBR",0,1,1,0,1,"run014"
"2659","BBG","RGR",0,1,1,0,1,"run014"
"2660","BBG","RRG",1,2,3,0,3,"run014"
"2661","BBG","RRR",0,7,7,5,2,"run014"
"2662","BGB","BBB",0,2,2,2,0,"run014"
"2663","BGB","RRG",0,1,1,1,0,"run014"
"2664","BGG","BBB",0,3,3,0,3,"run014"
"2665","BGG","BBR",0,1,1,1,0,"run014"
"2666","BGG","GRG",0,1,1,1,0,"run014"
"2667","BGG","RBG",1,1,2,0,2,"run014"
"2668","BGG","RGG",0,3,3,3,0,"run014"
"2669","BGG","RGR",0,1,1,1,0,"run014"
"2670","BGG","RRR",1,1,2,0,2,"run014"
"2671","BRB","BBB",0,13,13,11,2,"run014"
"2672","BRB","BBR",0,1,1,1,0,"run014"
"2673","BRB","BRR",0,3,3,1,2,"run014"
"2674","BRB","GGG",0,1,1,1,0,"run014"
"2675","BRB","GGR",0,1,1,1,0,"run014"
"2676","BRB","RBB",0,1,1,1,0,"run014"
"2677","BRB","RBG",0,1,1,0,1,"run014"
"2678","BRB","RGR",0,1,1,0,1,"run014"
"2679","BRB","RRR",0,1,1,1,0,"run014"
"2680","BRR","BBB",0,11,11,9,2,"run014"
"2681","BRR","BGB",1,1,2,2,0,"run014"
"2682","BRR","BGG",0,1,1,1,0,"run014"
"2683","BRR","BRB",0,1,1,0,1,"run014"
"2684","BRR","RBB",0,2,2,1,1,"run014"
"2685","GBB","BBB",12,38,50,16,34,"run014"
"2686","GBB","BGG",0,1,1,0,1,"run014"
"2687","GBB","BRB",1,9,10,8,2,"run014"
"2688","GBB","BRR",1,3,4,0,4,"run014"
"2689","GBB","GBG",0,4,4,1,3,"run014"
"2690","GBB","GGB",0,21,21,5,16,"run014"
"2691","GBB","GGG",7,86,93,27,66,"run014"
"2692","GBB","GGR",1,3,4,1,3,"run014"
"2693","GBB","GRG",0,6,6,0,6,"run014"
"2694","GBB","GRR",0,1,1,0,1,"run014"
"2695","GBB","RBB",0,2,2,0,2,"run014"
"2696","GBB","RBG",3,9,12,12,0,"run014"
"2697","GBB","RBR",1,0,1,1,0,"run014"
"2698","GBB","RGG",1,0,1,1,0,"run014"
"2699","GBB","RGR",2,1,3,1,2,"run014"
"2700","GBB","RRG",0,2,2,2,0,"run014"
"2701","GBB","RRR",1,9,10,4,6,"run014"
"2702","GBG","BBB",0,5,5,1,4,"run014"
"2703","GBG","BBR",0,1,1,1,0,"run014"
"2704","GBG","BRB",1,4,5,1,4,"run014"
"2705","GBG","BRR",1,0,1,1,0,"run014"
"2706","GBG","GGB",0,4,4,1,3,"run014"
"2707","GBG","GGG",4,11,15,6,9,"run014"
"2708","GBG","RBB",1,0,1,0,1,"run014"
"2709","GBG","RBG",0,1,1,1,0,"run014"
"2710","GBG","RGG",0,1,1,0,1,"run014"
"2711","GBG","RGR",1,3,4,0,4,"run014"
"2712","GBG","RRG",1,3,4,2,2,"run014"
"2713","GGB","BBB",3,16,19,18,1,"run014"
"2714","GGB","BBR",1,4,5,2,3,"run014"
"2715","GGB","BGB",0,3,3,0,3,"run014"
"2716","GGB","BGG",0,4,4,0,4,"run014"
"2717","GGB","BRB",0,1,1,1,0,"run014"
"2718","GGB","BRR",1,15,16,12,4,"run014"
"2719","GGB","GBB",0,1,1,0,1,"run014"
"2720","GGB","GBG",1,0,1,0,1,"run014"
"2721","GGB","GGG",13,48,61,29,32,"run014"
"2722","GGB","GGR",0,7,7,7,0,"run014"
"2723","GGB","GRR",0,4,4,4,0,"run014"
"2724","GGB","RBB",0,5,5,3,2,"run014"
"2725","GGB","RBG",0,4,4,3,1,"run014"
"2726","GGB","RBR",0,5,5,5,0,"run014"
"2727","GGB","RGG",1,5,6,4,2,"run014"
"2728","GGB","RGR",0,2,2,1,1,"run014"
"2729","GGB","RRG",1,5,6,3,3,"run014"
"2730","GGB","RRR",1,5,6,4,2,"run014"
"2731","GGG","BBB",8,31,39,14,25,"run014"
"2732","GGG","BGB",0,2,2,1,1,"run014"
"2733","GGG","BGG",1,7,8,7,1,"run014"
"2734","GGG","BRB",1,3,4,1,3,"run014"
"2735","GGG","BRR",0,6,6,2,4,"run014"
"2736","GGG","GGB",5,1,6,1,5,"run014"
"2737","GGG","GGR",1,9,10,7,3,"run014"
"2738","GGG","GRR",0,2,2,0,2,"run014"
"2739","GGG","RBB",1,8,9,2,7,"run014"
"2740","GGG","RBG",0,6,6,3,3,"run014"
"2741","GGG","RBR",0,21,21,11,10,"run014"
"2742","GGG","RGG",0,3,3,2,1,"run014"
"2743","GGG","RGR",1,12,13,12,1,"run014"
"2744","GGG","RRG",1,23,24,8,16,"run014"
"2745","GGG","RRR",0,3,3,0,3,"run014"
"2746","GGR","BBB",0,2,2,2,0,"run014"
"2747","GGR","BBR",0,2,2,1,1,"run014"
"2748","GGR","BGG",0,1,1,0,1,"run014"
"2749","GGR","BRR",1,0,1,0,1,"run014"
"2750","GGR","GRR",1,0,1,1,0,"run014"
"2751","GGR","RBB",0,2,2,2,0,"run014"
"2752","GRG","BBB",3,8,11,4,7,"run014"
"2753","GRG","BBR",0,1,1,1,0,"run014"
"2754","GRG","BGG",0,1,1,0,1,"run014"
"2755","GRG","BRB",0,3,3,3,0,"run014"
"2756","GRG","BRR",0,1,1,0,1,"run014"
"2757","GRG","GBG",0,1,1,1,0,"run014"
"2758","GRG","GGB",2,15,17,13,4,"run014"
"2759","GRG","GGG",3,12,15,3,12,"run014"
"2760","GRG","GGR",0,5,5,3,2,"run014"
"2761","GRG","GRR",0,1,1,0,1,"run014"
"2762","GRG","RBG",0,1,1,1,0,"run014"
"2763","GRG","RBR",0,1,1,1,0,"run014"
"2764","GRG","RGR",1,2,3,3,0,"run014"
"2765","GRG","RRG",2,4,6,1,5,"run014"
"2766","GRR","BBB",0,1,1,0,1,"run014"
"2767","GRR","BBR",0,1,1,1,0,"run014"
"2768","GRR","BGB",1,2,3,1,2,"run014"
"2769","GRR","BGG",0,2,2,1,1,"run014"
"2770","GRR","BRB",0,1,1,0,1,"run014"
"2771","GRR","BRR",0,2,2,1,1,"run014"
"2772","GRR","GGG",0,1,1,0,1,"run014"
"2773","GRR","GGR",0,1,1,0,1,"run014"
"2774","RBB","BBB",0,1,1,1,0,"run014"
"2775","RBB","BBR",0,1,1,1,0,"run014"
"2776","RBB","BRB",0,1,1,1,0,"run014"
"2777","RBB","GRR",0,1,1,0,1,"run014"
"2778","RBB","RGG",0,1,1,1,0,"run014"
"2779","RBG","BBB",2,8,10,5,5,"run014"
"2780","RBG","BBG",0,1,1,0,1,"run014"
"2781","RBG","BRR",0,1,1,0,1,"run014"
"2782","RBG","GBB",0,1,1,0,1,"run014"
"2783","RBG","GRR",0,3,3,2,1,"run014"
"2784","RBG","RBB",1,1,2,0,2,"run014"
"2785","RBG","RBR",0,1,1,0,1,"run014"
"2786","RBG","RGR",0,1,1,1,0,"run014"
"2787","RBR","BBB",0,13,13,10,3,"run014"
"2788","RBR","BBR",0,1,1,1,0,"run014"
"2789","RBR","BGB",2,4,6,0,6,"run014"
"2790","RBR","BGG",0,2,2,1,1,"run014"
"2791","RBR","BRB",1,0,1,1,0,"run014"
"2792","RBR","BRR",1,4,5,3,2,"run014"
"2793","RBR","GGB",0,12,12,10,2,"run014"
"2794","RBR","GRR",4,4,8,1,7,"run014"
"2795","RBR","RBB",0,3,3,3,0,"run014"
"2796","RBR","RGG",2,9,11,5,6,"run014"
"2797","RBR","RGR",1,0,1,0,1,"run014"
"2798","RBR","RRR",0,1,1,1,0,"run014"
"2799","RGG","BBB",0,8,8,4,4,"run014"
"2800","RGG","BBR",1,2,3,1,2,"run014"
"2801","RGG","BGB",0,1,1,0,1,"run014"
"2802","RGG","BRR",0,4,4,2,2,"run014"
"2803","RGG","GGG",0,1,1,1,0,"run014"
"2804","RGG","GGR",0,3,3,2,1,"run014"
"2805","RGG","GRR",0,8,8,3,5,"run014"
"2806","RGG","RBB",0,1,1,1,0,"run014"
"2807","RGR","BBB",2,5,7,5,2,"run014"
"2808","RGR","BBR",1,1,2,1,1,"run014"
"2809","RGR","BGB",2,5,7,0,7,"run014"
"2810","RGR","BGG",2,2,4,0,4,"run014"
"2811","RGR","BRR",1,5,6,4,2,"run014"
"2812","RGR","GGB",2,12,14,4,10,"run014"
"2813","RGR","GGG",0,2,2,2,0,"run014"
"2814","RGR","GGR",0,4,4,0,4,"run014"
"2815","RGR","RBB",0,4,4,1,3,"run014"
"2816","RGR","RGG",1,1,2,2,0,"run014"
"2817","RGR","RRG",0,3,3,1,2,"run014"
"2818","RRG","BBB",2,33,35,8,27,"run014"
"2819","RRG","BBR",0,5,5,2,3,"run014"
"2820","RRG","BGB",1,10,11,10,1,"run014"
"2821","RRG","BGG",0,2,2,0,2,"run014"
"2822","RRG","BRB",2,40,42,31,11,"run014"
"2823","RRG","BRR",1,16,17,8,9,"run014"
"2824","RRG","GGG",2,14,16,16,0,"run014"
"2825","RRG","GGR",0,5,5,2,3,"run014"
"2826","RRG","GRG",1,0,1,1,0,"run014"
"2827","RRG","GRR",3,8,11,5,6,"run014"
"2828","RRG","RBB",1,1,2,0,2,"run014"
"2829","RRG","RGG",0,1,1,1,0,"run014"
"2830","RRG","RGR",0,1,1,0,1,"run014"
"2831","RRR","BBR",1,0,1,1,0,"run014"
"2832","RRR","BGB",2,1,3,3,0,"run014"
"2833","RRR","BGG",1,0,1,1,0,"run014"
"2834","RRR","BRB",1,1,2,0,2,"run014"
"2835","RRR","BRR",1,1,2,2,0,"run014"
"2836","RRR","GGR",0,1,1,1,0,"run014"
"2837","RRR","GRR",0,3,3,2,1,"run014"
"2838","RRR","RBB",1,2,3,3,0,"run014"
"2839","RRR","RBR",0,2,2,1,1,"run014"
"2840","RRR","RGG",0,1,1,0,1,"run014"
"2841","RRR","RGR",1,2,3,1,2,"run014"
"2842","RRR","RRG",2,2,4,1,3,"run014"
"2843","BBB","BRB",0,1,1,0,1,"run015"
"2844","BBB","GGG",1,2,3,2,1,"run015"
"2845","BBB","GRR",0,2,2,1,1,"run015"
"2846","BBB","RBG",0,1,1,1,0,"run015"
"2847","BBB","RRG",1,3,4,0,4,"run015"
"2848","BBB","RRR",0,2,2,1,1,"run015"
"2849","BBG","BBB",1,4,5,0,5,"run015"
"2850","BBG","BGB",0,1,1,0,1,"run015"
"2851","BBG","BGG",0,1,1,0,1,"run015"
"2852","BBG","BRB",1,16,17,11,6,"run015"
"2853","BBG","GBB",0,1,1,0,1,"run015"
"2854","BBG","GBG",2,7,9,3,6,"run015"
"2855","BBG","GGB",2,25,27,5,22,"run015"
"2856","BBG","GGG",4,38,42,0,42,"run015"
"2857","BBG","GRG",1,9,10,4,6,"run015"
"2858","BBG","GRR",0,1,1,0,1,"run015"
"2859","BBG","RBB",0,1,1,0,1,"run015"
"2860","BBG","RBG",0,4,4,1,3,"run015"
"2861","BBG","RBR",0,1,1,0,1,"run015"
"2862","BBG","RGR",0,1,1,1,0,"run015"
"2863","BBG","RRG",1,2,3,1,2,"run015"
"2864","BBG","RRR",0,7,7,4,3,"run015"
"2865","BGB","BBB",0,2,2,0,2,"run015"
"2866","BGB","RRG",0,1,1,0,1,"run015"
"2867","BGG","BBB",0,3,3,0,3,"run015"
"2868","BGG","BBR",0,1,1,1,0,"run015"
"2869","BGG","GRG",0,1,1,1,0,"run015"
"2870","BGG","RBG",1,1,2,1,1,"run015"
"2871","BGG","RGG",0,3,3,1,2,"run015"
"2872","BGG","RGR",0,1,1,0,1,"run015"
"2873","BGG","RRR",1,1,2,2,0,"run015"
"2874","BRB","BBB",0,13,13,7,6,"run015"
"2875","BRB","BBR",0,1,1,0,1,"run015"
"2876","BRB","BRR",0,3,3,1,2,"run015"
"2877","BRB","GGG",0,1,1,0,1,"run015"
"2878","BRB","GGR",0,1,1,0,1,"run015"
"2879","BRB","RBB",0,1,1,0,1,"run015"
"2880","BRB","RBG",0,1,1,0,1,"run015"
"2881","BRB","RGR",0,1,1,0,1,"run015"
"2882","BRB","RRR",0,1,1,1,0,"run015"
"2883","BRR","BBB",0,11,11,5,6,"run015"
"2884","BRR","BGB",1,1,2,1,1,"run015"
"2885","BRR","BGG",0,1,1,0,1,"run015"
"2886","BRR","BRB",0,1,1,1,0,"run015"
"2887","BRR","RBB",0,2,2,1,1,"run015"
"2888","GBB","BBB",12,38,50,9,41,"run015"
"2889","GBB","BGG",0,1,1,0,1,"run015"
"2890","GBB","BRB",1,9,10,0,10,"run015"
"2891","GBB","BRR",1,3,4,4,0,"run015"
"2892","GBB","GBG",0,4,4,0,4,"run015"
"2893","GBB","GGB",0,21,21,6,15,"run015"
"2894","GBB","GGG",7,86,93,59,34,"run015"
"2895","GBB","GGR",1,3,4,0,4,"run015"
"2896","GBB","GRG",0,6,6,3,3,"run015"
"2897","GBB","GRR",0,1,1,1,0,"run015"
"2898","GBB","RBB",0,2,2,1,1,"run015"
"2899","GBB","RBG",3,9,12,6,6,"run015"
"2900","GBB","RBR",1,0,1,0,1,"run015"
"2901","GBB","RGG",1,0,1,0,1,"run015"
"2902","GBB","RGR",2,1,3,0,3,"run015"
"2903","GBB","RRG",0,2,2,2,0,"run015"
"2904","GBB","RRR",1,9,10,0,10,"run015"
"2905","GBG","BBB",0,5,5,0,5,"run015"
"2906","GBG","BBR",0,1,1,1,0,"run015"
"2907","GBG","BRB",1,4,5,1,4,"run015"
"2908","GBG","BRR",1,0,1,0,1,"run015"
"2909","GBG","GGB",0,4,4,0,4,"run015"
"2910","GBG","GGG",4,11,15,2,13,"run015"
"2911","GBG","RBB",1,0,1,0,1,"run015"
"2912","GBG","RBG",0,1,1,1,0,"run015"
"2913","GBG","RGG",0,1,1,1,0,"run015"
"2914","GBG","RGR",1,3,4,3,1,"run015"
"2915","GBG","RRG",1,3,4,0,4,"run015"
"2916","GGB","BBB",3,16,19,15,4,"run015"
"2917","GGB","BBR",1,4,5,4,1,"run015"
"2918","GGB","BGB",0,3,3,1,2,"run015"
"2919","GGB","BGG",0,4,4,4,0,"run015"
"2920","GGB","BRB",0,1,1,1,0,"run015"
"2921","GGB","BRR",1,15,16,7,9,"run015"
"2922","GGB","GBB",0,1,1,1,0,"run015"
"2923","GGB","GBG",1,0,1,0,1,"run015"
"2924","GGB","GGG",13,48,61,40,21,"run015"
"2925","GGB","GGR",0,7,7,0,7,"run015"
"2926","GGB","GRR",0,4,4,2,2,"run015"
"2927","GGB","RBB",0,5,5,4,1,"run015"
"2928","GGB","RBG",0,4,4,4,0,"run015"
"2929","GGB","RBR",0,5,5,1,4,"run015"
"2930","GGB","RGG",1,5,6,2,4,"run015"
"2931","GGB","RGR",0,2,2,0,2,"run015"
"2932","GGB","RRG",1,5,6,3,3,"run015"
"2933","GGB","RRR",1,5,6,2,4,"run015"
"2934","GGG","BBB",8,31,39,39,0,"run015"
"2935","GGG","BGB",0,2,2,2,0,"run015"
"2936","GGG","BGG",1,7,8,0,8,"run015"
"2937","GGG","BRB",1,3,4,2,2,"run015"
"2938","GGG","BRR",0,6,6,4,2,"run015"
"2939","GGG","GGB",5,1,6,1,5,"run015"
"2940","GGG","GGR",1,9,10,2,8,"run015"
"2941","GGG","GRR",0,2,2,1,1,"run015"
"2942","GGG","RBB",1,8,9,4,5,"run015"
"2943","GGG","RBG",0,6,6,4,2,"run015"
"2944","GGG","RBR",0,21,21,10,11,"run015"
"2945","GGG","RGG",0,3,3,2,1,"run015"
"2946","GGG","RGR",1,12,13,9,4,"run015"
"2947","GGG","RRG",1,23,24,2,22,"run015"
"2948","GGG","RRR",0,3,3,0,3,"run015"
"2949","GGR","BBB",0,2,2,1,1,"run015"
"2950","GGR","BBR",0,2,2,1,1,"run015"
"2951","GGR","BGG",0,1,1,0,1,"run015"
"2952","GGR","BRR",1,0,1,0,1,"run015"
"2953","GGR","GRR",1,0,1,1,0,"run015"
"2954","GGR","RBB",0,2,2,1,1,"run015"
"2955","GRG","BBB",3,8,11,10,1,"run015"
"2956","GRG","BBR",0,1,1,0,1,"run015"
"2957","GRG","BGG",0,1,1,0,1,"run015"
"2958","GRG","BRB",0,3,3,1,2,"run015"
"2959","GRG","BRR",0,1,1,0,1,"run015"
"2960","GRG","GBG",0,1,1,1,0,"run015"
"2961","GRG","GGB",2,15,17,8,9,"run015"
"2962","GRG","GGG",3,12,15,10,5,"run015"
"2963","GRG","GGR",0,5,5,4,1,"run015"
"2964","GRG","GRR",0,1,1,0,1,"run015"
"2965","GRG","RBG",0,1,1,1,0,"run015"
"2966","GRG","RBR",0,1,1,0,1,"run015"
"2967","GRG","RGR",1,2,3,3,0,"run015"
"2968","GRG","RRG",2,4,6,0,6,"run015"
"2969","GRR","BBB",0,1,1,0,1,"run015"
"2970","GRR","BBR",0,1,1,0,1,"run015"
"2971","GRR","BGB",1,2,3,1,2,"run015"
"2972","GRR","BGG",0,2,2,1,1,"run015"
"2973","GRR","BRB",0,1,1,0,1,"run015"
"2974","GRR","BRR",0,2,2,0,2,"run015"
"2975","GRR","GGG",0,1,1,0,1,"run015"
"2976","GRR","GGR",0,1,1,1,0,"run015"
"2977","RBB","BBB",0,1,1,1,0,"run015"
"2978","RBB","BBR",0,1,1,0,1,"run015"
"2979","RBB","BRB",0,1,1,1,0,"run015"
"2980","RBB","GRR",0,1,1,1,0,"run015"
"2981","RBB","RGG",0,1,1,1,0,"run015"
"2982","RBG","BBB",2,8,10,2,8,"run015"
"2983","RBG","BBG",0,1,1,1,0,"run015"
"2984","RBG","BRR",0,1,1,1,0,"run015"
"2985","RBG","GBB",0,1,1,1,0,"run015"
"2986","RBG","GRR",0,3,3,2,1,"run015"
"2987","RBG","RBB",1,1,2,0,2,"run015"
"2988","RBG","RBR",0,1,1,0,1,"run015"
"2989","RBG","RGR",0,1,1,0,1,"run015"
"2990","RBR","BBB",0,13,13,4,9,"run015"
"2991","RBR","BBR",0,1,1,0,1,"run015"
"2992","RBR","BGB",2,4,6,1,5,"run015"
"2993","RBR","BGG",0,2,2,2,0,"run015"
"2994","RBR","BRB",1,0,1,1,0,"run015"
"2995","RBR","BRR",1,4,5,2,3,"run015"
"2996","RBR","GGB",0,12,12,7,5,"run015"
"2997","RBR","GRR",4,4,8,7,1,"run015"
"2998","RBR","RBB",0,3,3,2,1,"run015"
"2999","RBR","RGG",2,9,11,10,1,"run015"
"3000","RBR","RGR",1,0,1,0,1,"run015"
"3001","RBR","RRR",0,1,1,0,1,"run015"
"3002","RGG","BBB",0,8,8,4,4,"run015"
"3003","RGG","BBR",1,2,3,2,1,"run015"
"3004","RGG","BGB",0,1,1,0,1,"run015"
"3005","RGG","BRR",0,4,4,1,3,"run015"
"3006","RGG","GGG",0,1,1,1,0,"run015"
"3007","RGG","GGR",0,3,3,1,2,"run015"
"3008","RGG","GRR",0,8,8,4,4,"run015"
"3009","RGG","RBB",0,1,1,0,1,"run015"
"3010","RGR","BBB",2,5,7,5,2,"run015"
"3011","RGR","BBR",1,1,2,1,1,"run015"
"3012","RGR","BGB",2,5,7,4,3,"run015"
"3013","RGR","BGG",2,2,4,0,4,"run015"
"3014","RGR","BRR",1,5,6,2,4,"run015"
"3015","RGR","GGB",2,12,14,14,0,"run015"
"3016","RGR","GGG",0,2,2,1,1,"run015"
"3017","RGR","GGR",0,4,4,1,3,"run015"
"3018","RGR","RBB",0,4,4,2,2,"run015"
"3019","RGR","RGG",1,1,2,0,2,"run015"
"3020","RGR","RRG",0,3,3,2,1,"run015"
"3021","RRG","BBB",2,33,35,17,18,"run015"
"3022","RRG","BBR",0,5,5,2,3,"run015"
"3023","RRG","BGB",1,10,11,11,0,"run015"
"3024","RRG","BGG",0,2,2,0,2,"run015"
"3025","RRG","BRB",2,40,42,39,3,"run015"
"3026","RRG","BRR",1,16,17,12,5,"run015"
"3027","RRG","GGG",2,14,16,2,14,"run015"
"3028","RRG","GGR",0,5,5,4,1,"run015"
"3029","RRG","GRG",1,0,1,1,0,"run015"
"3030","RRG","GRR",3,8,11,9,2,"run015"
"3031","RRG","RBB",1,1,2,0,2,"run015"
"3032","RRG","RGG",0,1,1,0,1,"run015"
"3033","RRG","RGR",0,1,1,1,0,"run015"
"3034","RRR","BBR",1,0,1,1,0,"run015"
"3035","RRR","BGB",2,1,3,3,0,"run015"
"3036","RRR","BGG",1,0,1,0,1,"run015"
"3037","RRR","BRB",1,1,2,0,2,"run015"
"3038","RRR","BRR",1,1,2,0,2,"run015"
"3039","RRR","GGR",0,1,1,1,0,"run015"
"3040","RRR","GRR",0,3,3,2,1,"run015"
"3041","RRR","RBB",1,2,3,2,1,"run015"
"3042","RRR","RBR",0,2,2,2,0,"run015"
"3043","RRR","RGG",0,1,1,1,0,"run015"
"3044","RRR","RGR",1,2,3,3,0,"run015"
"3045","RRR","RRG",2,2,4,3,1,"run015"
"3046","BBB","BRB",0,1,1,0,1,"run016"
"3047","BBB","GGG",1,2,3,2,1,"run016"
"3048","BBB","GRR",0,2,2,2,0,"run016"
"3049","BBB","RBG",0,1,1,0,1,"run016"
"3050","BBB","RRG",1,3,4,2,2,"run016"
"3051","BBB","RRR",0,2,2,1,1,"run016"
"3052","BBG","BBB",1,4,5,5,0,"run016"
"3053","BBG","BGB",0,1,1,0,1,"run016"
"3054","BBG","BGG",0,1,1,1,0,"run016"
"3055","BBG","BRB",1,16,17,16,1,"run016"
"3056","BBG","GBB",0,1,1,0,1,"run016"
"3057","BBG","GBG",2,7,9,9,0,"run016"
"3058","BBG","GGB",2,25,27,2,25,"run016"
"3059","BBG","GGG",4,38,42,37,5,"run016"
"3060","BBG","GRG",1,9,10,8,2,"run016"
"3061","BBG","GRR",0,1,1,1,0,"run016"
"3062","BBG","RBB",0,1,1,0,1,"run016"
"3063","BBG","RBG",0,4,4,4,0,"run016"
"3064","BBG","RBR",0,1,1,0,1,"run016"
"3065","BBG","RGR",0,1,1,1,0,"run016"
"3066","BBG","RRG",1,2,3,3,0,"run016"
"3067","BBG","RRR",0,7,7,5,2,"run016"
"3068","BGB","BBB",0,2,2,0,2,"run016"
"3069","BGB","RRG",0,1,1,0,1,"run016"
"3070","BGG","BBB",0,3,3,3,0,"run016"
"3071","BGG","BBR",0,1,1,0,1,"run016"
"3072","BGG","GRG",0,1,1,1,0,"run016"
"3073","BGG","RBG",1,1,2,1,1,"run016"
"3074","BGG","RGG",0,3,3,0,3,"run016"
"3075","BGG","RGR",0,1,1,0,1,"run016"
"3076","BGG","RRR",1,1,2,2,0,"run016"
"3077","BRB","BBB",0,13,13,8,5,"run016"
"3078","BRB","BBR",0,1,1,1,0,"run016"
"3079","BRB","BRR",0,3,3,3,0,"run016"
"3080","BRB","GGG",0,1,1,1,0,"run016"
"3081","BRB","GGR",0,1,1,0,1,"run016"
"3082","BRB","RBB",0,1,1,0,1,"run016"
"3083","BRB","RBG",0,1,1,1,0,"run016"
"3084","BRB","RGR",0,1,1,1,0,"run016"
"3085","BRB","RRR",0,1,1,0,1,"run016"
"3086","BRR","BBB",0,11,11,7,4,"run016"
"3087","BRR","BGB",1,1,2,2,0,"run016"
"3088","BRR","BGG",0,1,1,0,1,"run016"
"3089","BRR","BRB",0,1,1,0,1,"run016"
"3090","BRR","RBB",0,2,2,0,2,"run016"
"3091","GBB","BBB",12,38,50,40,10,"run016"
"3092","GBB","BGG",0,1,1,1,0,"run016"
"3093","GBB","BRB",1,9,10,1,9,"run016"
"3094","GBB","BRR",1,3,4,4,0,"run016"
"3095","GBB","GBG",0,4,4,0,4,"run016"
"3096","GBB","GGB",0,21,21,8,13,"run016"
"3097","GBB","GGG",7,86,93,72,21,"run016"
"3098","GBB","GGR",1,3,4,0,4,"run016"
"3099","GBB","GRG",0,6,6,4,2,"run016"
"3100","GBB","GRR",0,1,1,1,0,"run016"
"3101","GBB","RBB",0,2,2,1,1,"run016"
"3102","GBB","RBG",3,9,12,4,8,"run016"
"3103","GBB","RBR",1,0,1,0,1,"run016"
"3104","GBB","RGG",1,0,1,0,1,"run016"
"3105","GBB","RGR",2,1,3,1,2,"run016"
"3106","GBB","RRG",0,2,2,0,2,"run016"
"3107","GBB","RRR",1,9,10,1,9,"run016"
"3108","GBG","BBB",0,5,5,2,3,"run016"
"3109","GBG","BBR",0,1,1,1,0,"run016"
"3110","GBG","BRB",1,4,5,5,0,"run016"
"3111","GBG","BRR",1,0,1,0,1,"run016"
"3112","GBG","GGB",0,4,4,2,2,"run016"
"3113","GBG","GGG",4,11,15,6,9,"run016"
"3114","GBG","RBB",1,0,1,0,1,"run016"
"3115","GBG","RBG",0,1,1,1,0,"run016"
"3116","GBG","RGG",0,1,1,1,0,"run016"
"3117","GBG","RGR",1,3,4,4,0,"run016"
"3118","GBG","RRG",1,3,4,2,2,"run016"
"3119","GGB","BBB",3,16,19,14,5,"run016"
"3120","GGB","BBR",1,4,5,1,4,"run016"
"3121","GGB","BGB",0,3,3,2,1,"run016"
"3122","GGB","BGG",0,4,4,3,1,"run016"
"3123","GGB","BRB",0,1,1,0,1,"run016"
"3124","GGB","BRR",1,15,16,10,6,"run016"
"3125","GGB","GBB",0,1,1,0,1,"run016"
"3126","GGB","GBG",1,0,1,0,1,"run016"
"3127","GGB","GGG",13,48,61,36,25,"run016"
"3128","GGB","GGR",0,7,7,1,6,"run016"
"3129","GGB","GRR",0,4,4,0,4,"run016"
"3130","GGB","RBB",0,5,5,3,2,"run016"
"3131","GGB","RBG",0,4,4,2,2,"run016"
"3132","GGB","RBR",0,5,5,5,0,"run016"
"3133","GGB","RGG",1,5,6,4,2,"run016"
"3134","GGB","RGR",0,2,2,0,2,"run016"
"3135","GGB","RRG",1,5,6,0,6,"run016"
"3136","GGB","RRR",1,5,6,1,5,"run016"
"3137","GGG","BBB",8,31,39,13,26,"run016"
"3138","GGG","BGB",0,2,2,2,0,"run016"
"3139","GGG","BGG",1,7,8,8,0,"run016"
"3140","GGG","BRB",1,3,4,1,3,"run016"
"3141","GGG","BRR",0,6,6,2,4,"run016"
"3142","GGG","GGB",5,1,6,3,3,"run016"
"3143","GGG","GGR",1,9,10,9,1,"run016"
"3144","GGG","GRR",0,2,2,1,1,"run016"
"3145","GGG","RBB",1,8,9,0,9,"run016"
"3146","GGG","RBG",0,6,6,2,4,"run016"
"3147","GGG","RBR",0,21,21,6,15,"run016"
"3148","GGG","RGG",0,3,3,3,0,"run016"
"3149","GGG","RGR",1,12,13,1,12,"run016"
"3150","GGG","RRG",1,23,24,12,12,"run016"
"3151","GGG","RRR",0,3,3,1,2,"run016"
"3152","GGR","BBB",0,2,2,1,1,"run016"
"3153","GGR","BBR",0,2,2,2,0,"run016"
"3154","GGR","BGG",0,1,1,0,1,"run016"
"3155","GGR","BRR",1,0,1,1,0,"run016"
"3156","GGR","GRR",1,0,1,0,1,"run016"
"3157","GGR","RBB",0,2,2,0,2,"run016"
"3158","GRG","BBB",3,8,11,3,8,"run016"
"3159","GRG","BBR",0,1,1,0,1,"run016"
"3160","GRG","BGG",0,1,1,0,1,"run016"
"3161","GRG","BRB",0,3,3,3,0,"run016"
"3162","GRG","BRR",0,1,1,1,0,"run016"
"3163","GRG","GBG",0,1,1,0,1,"run016"
"3164","GRG","GGB",2,15,17,10,7,"run016"
"3165","GRG","GGG",3,12,15,0,15,"run016"
"3166","GRG","GGR",0,5,5,0,5,"run016"
"3167","GRG","GRR",0,1,1,1,0,"run016"
"3168","GRG","RBG",0,1,1,0,1,"run016"
"3169","GRG","RBR",0,1,1,0,1,"run016"
"3170","GRG","RGR",1,2,3,1,2,"run016"
"3171","GRG","RRG",2,4,6,0,6,"run016"
"3172","GRR","BBB",0,1,1,0,1,"run016"
"3173","GRR","BBR",0,1,1,0,1,"run016"
"3174","GRR","BGB",1,2,3,1,2,"run016"
"3175","GRR","BGG",0,2,2,0,2,"run016"
"3176","GRR","BRB",0,1,1,1,0,"run016"
"3177","GRR","BRR",0,2,2,1,1,"run016"
"3178","GRR","GGG",0,1,1,1,0,"run016"
"3179","GRR","GGR",0,1,1,0,1,"run016"
"3180","RBB","BBB",0,1,1,0,1,"run016"
"3181","RBB","BBR",0,1,1,1,0,"run016"
"3182","RBB","BRB",0,1,1,1,0,"run016"
"3183","RBB","GRR",0,1,1,0,1,"run016"
"3184","RBB","RGG",0,1,1,1,0,"run016"
"3185","RBG","BBB",2,8,10,3,7,"run016"
"3186","RBG","BBG",0,1,1,0,1,"run016"
"3187","RBG","BRR",0,1,1,0,1,"run016"
"3188","RBG","GBB",0,1,1,1,0,"run016"
"3189","RBG","GRR",0,3,3,0,3,"run016"
"3190","RBG","RBB",1,1,2,1,1,"run016"
"3191","RBG","RBR",0,1,1,0,1,"run016"
"3192","RBG","RGR",0,1,1,0,1,"run016"
"3193","RBR","BBB",0,13,13,3,10,"run016"
"3194","RBR","BBR",0,1,1,1,0,"run016"
"3195","RBR","BGB",2,4,6,0,6,"run016"
"3196","RBR","BGG",0,2,2,1,1,"run016"
"3197","RBR","BRB",1,0,1,1,0,"run016"
"3198","RBR","BRR",1,4,5,1,4,"run016"
"3199","RBR","GGB",0,12,12,1,11,"run016"
"3200","RBR","GRR",4,4,8,1,7,"run016"
"3201","RBR","RBB",0,3,3,0,3,"run016"
"3202","RBR","RGG",2,9,11,11,0,"run016"
"3203","RBR","RGR",1,0,1,1,0,"run016"
"3204","RBR","RRR",0,1,1,1,0,"run016"
"3205","RGG","BBB",0,8,8,7,1,"run016"
"3206","RGG","BBR",1,2,3,1,2,"run016"
"3207","RGG","BGB",0,1,1,0,1,"run016"
"3208","RGG","BRR",0,4,4,4,0,"run016"
"3209","RGG","GGG",0,1,1,1,0,"run016"
"3210","RGG","GGR",0,3,3,1,2,"run016"
"3211","RGG","GRR",0,8,8,1,7,"run016"
"3212","RGG","RBB",0,1,1,1,0,"run016"
"3213","RGR","BBB",2,5,7,0,7,"run016"
"3214","RGR","BBR",1,1,2,2,0,"run016"
"3215","RGR","BGB",2,5,7,6,1,"run016"
"3216","RGR","BGG",2,2,4,1,3,"run016"
"3217","RGR","BRR",1,5,6,0,6,"run016"
"3218","RGR","GGB",2,12,14,6,8,"run016"
"3219","RGR","GGG",0,2,2,2,0,"run016"
"3220","RGR","GGR",0,4,4,3,1,"run016"
"3221","RGR","RBB",0,4,4,1,3,"run016"
"3222","RGR","RGG",1,1,2,0,2,"run016"
"3223","RGR","RRG",0,3,3,1,2,"run016"
"3224","RRG","BBB",2,33,35,17,18,"run016"
"3225","RRG","BBR",0,5,5,2,3,"run016"
"3226","RRG","BGB",1,10,11,3,8,"run016"
"3227","RRG","BGG",0,2,2,2,0,"run016"
"3228","RRG","BRB",2,40,42,40,2,"run016"
"3229","RRG","BRR",1,16,17,15,2,"run016"
"3230","RRG","GGG",2,14,16,7,9,"run016"
"3231","RRG","GGR",0,5,5,0,5,"run016"
"3232","RRG","GRG",1,0,1,0,1,"run016"
"3233","RRG","GRR",3,8,11,6,5,"run016"
"3234","RRG","RBB",1,1,2,2,0,"run016"
"3235","RRG","RGG",0,1,1,0,1,"run016"
"3236","RRG","RGR",0,1,1,1,0,"run016"
"3237","RRR","BBR",1,0,1,1,0,"run016"
"3238","RRR","BGB",2,1,3,0,3,"run016"
"3239","RRR","BGG",1,0,1,1,0,"run016"
"3240","RRR","BRB",1,1,2,2,0,"run016"
"3241","RRR","BRR",1,1,2,1,1,"run016"
"3242","RRR","GGR",0,1,1,0,1,"run016"
"3243","RRR","GRR",0,3,3,0,3,"run016"
"3244","RRR","RBB",1,2,3,3,0,"run016"
"3245","RRR","RBR",0,2,2,2,0,"run016"
"3246","RRR","RGG",0,1,1,0,1,"run016"
"3247","RRR","RGR",1,2,3,1,2,"run016"
"3248","RRR","RRG",2,2,4,3,1,"run016"
"3249","BBB","BRB",0,1,1,1,0,"run017"
"3250","BBB","GGG",1,2,3,3,0,"run017"
"3251","BBB","GRR",0,2,2,0,2,"run017"
"3252","BBB","RBG",0,1,1,1,0,"run017"
"3253","BBB","RRG",1,3,4,3,1,"run017"
"3254","BBB","RRR",0,2,2,2,0,"run017"
"3255","BBG","BBB",1,4,5,4,1,"run017"
"3256","BBG","BGB",0,1,1,0,1,"run017"
"3257","BBG","BGG",0,1,1,1,0,"run017"
"3258","BBG","BRB",1,16,17,14,3,"run017"
"3259","BBG","GBB",0,1,1,0,1,"run017"
"3260","BBG","GBG",2,7,9,0,9,"run017"
"3261","BBG","GGB",2,25,27,9,18,"run017"
"3262","BBG","GGG",4,38,42,5,37,"run017"
"3263","BBG","GRG",1,9,10,7,3,"run017"
"3264","BBG","GRR",0,1,1,1,0,"run017"
"3265","BBG","RBB",0,1,1,0,1,"run017"
"3266","BBG","RBG",0,4,4,2,2,"run017"
"3267","BBG","RBR",0,1,1,1,0,"run017"
"3268","BBG","RGR",0,1,1,0,1,"run017"
"3269","BBG","RRG",1,2,3,0,3,"run017"
"3270","BBG","RRR",0,7,7,1,6,"run017"
"3271","BGB","BBB",0,2,2,0,2,"run017"
"3272","BGB","RRG",0,1,1,1,0,"run017"
"3273","BGG","BBB",0,3,3,2,1,"run017"
"3274","BGG","BBR",0,1,1,1,0,"run017"
"3275","BGG","GRG",0,1,1,0,1,"run017"
"3276","BGG","RBG",1,1,2,1,1,"run017"
"3277","BGG","RGG",0,3,3,3,0,"run017"
"3278","BGG","RGR",0,1,1,0,1,"run017"
"3279","BGG","RRR",1,1,2,2,0,"run017"
"3280","BRB","BBB",0,13,13,0,13,"run017"
"3281","BRB","BBR",0,1,1,0,1,"run017"
"3282","BRB","BRR",0,3,3,3,0,"run017"
"3283","BRB","GGG",0,1,1,1,0,"run017"
"3284","BRB","GGR",0,1,1,1,0,"run017"
"3285","BRB","RBB",0,1,1,0,1,"run017"
"3286","BRB","RBG",0,1,1,1,0,"run017"
"3287","BRB","RGR",0,1,1,0,1,"run017"
"3288","BRB","RRR",0,1,1,0,1,"run017"
"3289","BRR","BBB",0,11,11,2,9,"run017"
"3290","BRR","BGB",1,1,2,1,1,"run017"
"3291","BRR","BGG",0,1,1,1,0,"run017"
"3292","BRR","BRB",0,1,1,0,1,"run017"
"3293","BRR","RBB",0,2,2,2,0,"run017"
"3294","GBB","BBB",12,38,50,21,29,"run017"
"3295","GBB","BGG",0,1,1,0,1,"run017"
"3296","GBB","BRB",1,9,10,8,2,"run017"
"3297","GBB","BRR",1,3,4,4,0,"run017"
"3298","GBB","GBG",0,4,4,4,0,"run017"
"3299","GBB","GGB",0,21,21,1,20,"run017"
"3300","GBB","GGG",7,86,93,17,76,"run017"
"3301","GBB","GGR",1,3,4,3,1,"run017"
"3302","GBB","GRG",0,6,6,4,2,"run017"
"3303","GBB","GRR",0,1,1,1,0,"run017"
"3304","GBB","RBB",0,2,2,2,0,"run017"
"3305","GBB","RBG",3,9,12,11,1,"run017"
"3306","GBB","RBR",1,0,1,1,0,"run017"
"3307","GBB","RGG",1,0,1,1,0,"run017"
"3308","GBB","RGR",2,1,3,0,3,"run017"
"3309","GBB","RRG",0,2,2,0,2,"run017"
"3310","GBB","RRR",1,9,10,10,0,"run017"
"3311","GBG","BBB",0,5,5,2,3,"run017"
"3312","GBG","BBR",0,1,1,1,0,"run017"
"3313","GBG","BRB",1,4,5,1,4,"run017"
"3314","GBG","BRR",1,0,1,0,1,"run017"
"3315","GBG","GGB",0,4,4,0,4,"run017"
"3316","GBG","GGG",4,11,15,8,7,"run017"
"3317","GBG","RBB",1,0,1,1,0,"run017"
"3318","GBG","RBG",0,1,1,1,0,"run017"
"3319","GBG","RGG",0,1,1,0,1,"run017"
"3320","GBG","RGR",1,3,4,1,3,"run017"
"3321","GBG","RRG",1,3,4,3,1,"run017"
"3322","GGB","BBB",3,16,19,2,17,"run017"
"3323","GGB","BBR",1,4,5,2,3,"run017"
"3324","GGB","BGB",0,3,3,0,3,"run017"
"3325","GGB","BGG",0,4,4,0,4,"run017"
"3326","GGB","BRB",0,1,1,1,0,"run017"
"3327","GGB","BRR",1,15,16,2,14,"run017"
"3328","GGB","GBB",0,1,1,1,0,"run017"
"3329","GGB","GBG",1,0,1,0,1,"run017"
"3330","GGB","GGG",13,48,61,13,48,"run017"
"3331","GGB","GGR",0,7,7,4,3,"run017"
"3332","GGB","GRR",0,4,4,2,2,"run017"
"3333","GGB","RBB",0,5,5,0,5,"run017"
"3334","GGB","RBG",0,4,4,1,3,"run017"
"3335","GGB","RBR",0,5,5,4,1,"run017"
"3336","GGB","RGG",1,5,6,3,3,"run017"
"3337","GGB","RGR",0,2,2,2,0,"run017"
"3338","GGB","RRG",1,5,6,5,1,"run017"
"3339","GGB","RRR",1,5,6,1,5,"run017"
"3340","GGG","BBB",8,31,39,20,19,"run017"
"3341","GGG","BGB",0,2,2,2,0,"run017"
"3342","GGG","BGG",1,7,8,4,4,"run017"
"3343","GGG","BRB",1,3,4,2,2,"run017"
"3344","GGG","BRR",0,6,6,6,0,"run017"
"3345","GGG","GGB",5,1,6,0,6,"run017"
"3346","GGG","GGR",1,9,10,4,6,"run017"
"3347","GGG","GRR",0,2,2,2,0,"run017"
"3348","GGG","RBB",1,8,9,6,3,"run017"
"3349","GGG","RBG",0,6,6,0,6,"run017"
"3350","GGG","RBR",0,21,21,8,13,"run017"
"3351","GGG","RGG",0,3,3,2,1,"run017"
"3352","GGG","RGR",1,12,13,2,11,"run017"
"3353","GGG","RRG",1,23,24,23,1,"run017"
"3354","GGG","RRR",0,3,3,1,2,"run017"
"3355","GGR","BBB",0,2,2,0,2,"run017"
"3356","GGR","BBR",0,2,2,1,1,"run017"
"3357","GGR","BGG",0,1,1,1,0,"run017"
"3358","GGR","BRR",1,0,1,1,0,"run017"
"3359","GGR","GRR",1,0,1,0,1,"run017"
"3360","GGR","RBB",0,2,2,1,1,"run017"
"3361","GRG","BBB",3,8,11,10,1,"run017"
"3362","GRG","BBR",0,1,1,1,0,"run017"
"3363","GRG","BGG",0,1,1,1,0,"run017"
"3364","GRG","BRB",0,3,3,3,0,"run017"
"3365","GRG","BRR",0,1,1,0,1,"run017"
"3366","GRG","GBG",0,1,1,0,1,"run017"
"3367","GRG","GGB",2,15,17,8,9,"run017"
"3368","GRG","GGG",3,12,15,9,6,"run017"
"3369","GRG","GGR",0,5,5,3,2,"run017"
"3370","GRG","GRR",0,1,1,1,0,"run017"
"3371","GRG","RBG",0,1,1,1,0,"run017"
"3372","GRG","RBR",0,1,1,1,0,"run017"
"3373","GRG","RGR",1,2,3,0,3,"run017"
"3374","GRG","RRG",2,4,6,1,5,"run017"
"3375","GRR","BBB",0,1,1,1,0,"run017"
"3376","GRR","BBR",0,1,1,1,0,"run017"
"3377","GRR","BGB",1,2,3,0,3,"run017"
"3378","GRR","BGG",0,2,2,1,1,"run017"
"3379","GRR","BRB",0,1,1,1,0,"run017"
"3380","GRR","BRR",0,2,2,0,2,"run017"
"3381","GRR","GGG",0,1,1,0,1,"run017"
"3382","GRR","GGR",0,1,1,0,1,"run017"
"3383","RBB","BBB",0,1,1,0,1,"run017"
"3384","RBB","BBR",0,1,1,0,1,"run017"
"3385","RBB","BRB",0,1,1,1,0,"run017"
"3386","RBB","GRR",0,1,1,0,1,"run017"
"3387","RBB","RGG",0,1,1,1,0,"run017"
"3388","RBG","BBB",2,8,10,0,10,"run017"
"3389","RBG","BBG",0,1,1,1,0,"run017"
"3390","RBG","BRR",0,1,1,0,1,"run017"
"3391","RBG","GBB",0,1,1,1,0,"run017"
"3392","RBG","GRR",0,3,3,1,2,"run017"
"3393","RBG","RBB",1,1,2,1,1,"run017"
"3394","RBG","RBR",0,1,1,0,1,"run017"
"3395","RBG","RGR",0,1,1,1,0,"run017"
"3396","RBR","BBB",0,13,13,13,0,"run017"
"3397","RBR","BBR",0,1,1,1,0,"run017"
"3398","RBR","BGB",2,4,6,1,5,"run017"
"3399","RBR","BGG",0,2,2,1,1,"run017"
"3400","RBR","BRB",1,0,1,1,0,"run017"
"3401","RBR","BRR",1,4,5,1,4,"run017"
"3402","RBR","GGB",0,12,12,6,6,"run017"
"3403","RBR","GRR",4,4,8,2,6,"run017"
"3404","RBR","RBB",0,3,3,2,1,"run017"
"3405","RBR","RGG",2,9,11,2,9,"run017"
"3406","RBR","RGR",1,0,1,0,1,"run017"
"3407","RBR","RRR",0,1,1,0,1,"run017"
"3408","RGG","BBB",0,8,8,8,0,"run017"
"3409","RGG","BBR",1,2,3,2,1,"run017"
"3410","RGG","BGB",0,1,1,1,0,"run017"
"3411","RGG","BRR",0,4,4,4,0,"run017"
"3412","RGG","GGG",0,1,1,1,0,"run017"
"3413","RGG","GGR",0,3,3,2,1,"run017"
"3414","RGG","GRR",0,8,8,1,7,"run017"
"3415","RGG","RBB",0,1,1,0,1,"run017"
"3416","RGR","BBB",2,5,7,0,7,"run017"
"3417","RGR","BBR",1,1,2,1,1,"run017"
"3418","RGR","BGB",2,5,7,0,7,"run017"
"3419","RGR","BGG",2,2,4,2,2,"run017"
"3420","RGR","BRR",1,5,6,0,6,"run017"
"3421","RGR","GGB",2,12,14,9,5,"run017"
"3422","RGR","GGG",0,2,2,2,0,"run017"
"3423","RGR","GGR",0,4,4,3,1,"run017"
"3424","RGR","RBB",0,4,4,0,4,"run017"
"3425","RGR","RGG",1,1,2,0,2,"run017"
"3426","RGR","RRG",0,3,3,2,1,"run017"
"3427","RRG","BBB",2,33,35,21,14,"run017"
"3428","RRG","BBR",0,5,5,3,2,"run017"
"3429","RRG","BGB",1,10,11,7,4,"run017"
"3430","RRG","BGG",0,2,2,0,2,"run017"
"3431","RRG","BRB",2,40,42,21,21,"run017"
"3432","RRG","BRR",1,16,17,12,5,"run017"
"3433","RRG","GGG",2,14,16,1,15,"run017"
"3434","RRG","GGR",0,5,5,1,4,"run017"
"3435","RRG","GRG",1,0,1,0,1,"run017"
"3436","RRG","GRR",3,8,11,9,2,"run017"
"3437","RRG","RBB",1,1,2,0,2,"run017"
"3438","RRG","RGG",0,1,1,0,1,"run017"
"3439","RRG","RGR",0,1,1,0,1,"run017"
"3440","RRR","BBR",1,0,1,0,1,"run017"
"3441","RRR","BGB",2,1,3,0,3,"run017"
"3442","RRR","BGG",1,0,1,0,1,"run017"
"3443","RRR","BRB",1,1,2,1,1,"run017"
"3444","RRR","BRR",1,1,2,2,0,"run017"
"3445","RRR","GGR",0,1,1,1,0,"run017"
"3446","RRR","GRR",0,3,3,3,0,"run017"
"3447","RRR","RBB",1,2,3,2,1,"run017"
"3448","RRR","RBR",0,2,2,1,1,"run017"
"3449","RRR","RGG",0,1,1,1,0,"run017"
"3450","RRR","RGR",1,2,3,2,1,"run017"
"3451","RRR","RRG",2,2,4,1,3,"run017"
"3452","BBB","BRB",0,1,1,1,0,"run018"
"3453","BBB","GGG",1,2,3,3,0,"run018"
"3454","BBB","GRR",0,2,2,0,2,"run018"
"3455","BBB","RBG",0,1,1,1,0,"run018"
"3456","BBB","RRG",1,3,4,3,1,"run018"
"3457","BBB","RRR",0,2,2,1,1,"run018"
"3458","BBG","BBB",1,4,5,5,0,"run018"
"3459","BBG","BGB",0,1,1,0,1,"run018"
"3460","BBG","BGG",0,1,1,1,0,"run018"
"3461","BBG","BRB",1,16,17,10,7,"run018"
"3462","BBG","GBB",0,1,1,1,0,"run018"
"3463","BBG","GBG",2,7,9,8,1,"run018"
"3464","BBG","GGB",2,25,27,11,16,"run018"
"3465","BBG","GGG",4,38,42,3,39,"run018"
"3466","BBG","GRG",1,9,10,0,10,"run018"
"3467","BBG","GRR",0,1,1,1,0,"run018"
"3468","BBG","RBB",0,1,1,1,0,"run018"
"3469","BBG","RBG",0,4,4,4,0,"run018"
"3470","BBG","RBR",0,1,1,0,1,"run018"
"3471","BBG","RGR",0,1,1,1,0,"run018"
"3472","BBG","RRG",1,2,3,0,3,"run018"
"3473","BBG","RRR",0,7,7,2,5,"run018"
"3474","BGB","BBB",0,2,2,0,2,"run018"
"3475","BGB","RRG",0,1,1,1,0,"run018"
"3476","BGG","BBB",0,3,3,0,3,"run018"
"3477","BGG","BBR",0,1,1,0,1,"run018"
"3478","BGG","GRG",0,1,1,1,0,"run018"
"3479","BGG","RBG",1,1,2,1,1,"run018"
"3480","BGG","RGG",0,3,3,2,1,"run018"
"3481","BGG","RGR",0,1,1,1,0,"run018"
"3482","BGG","RRR",1,1,2,0,2,"run018"
"3483","BRB","BBB",0,13,13,6,7,"run018"
"3484","BRB","BBR",0,1,1,0,1,"run018"
"3485","BRB","BRR",0,3,3,1,2,"run018"
"3486","BRB","GGG",0,1,1,0,1,"run018"
"3487","BRB","GGR",0,1,1,0,1,"run018"
"3488","BRB","RBB",0,1,1,1,0,"run018"
"3489","BRB","RBG",0,1,1,0,1,"run018"
"3490","BRB","RGR",0,1,1,1,0,"run018"
"3491","BRB","RRR",0,1,1,1,0,"run018"
"3492","BRR","BBB",0,11,11,0,11,"run018"
"3493","BRR","BGB",1,1,2,0,2,"run018"
"3494","BRR","BGG",0,1,1,0,1,"run018"
"3495","BRR","BRB",0,1,1,0,1,"run018"
"3496","BRR","RBB",0,2,2,2,0,"run018"
"3497","GBB","BBB",12,38,50,11,39,"run018"
"3498","GBB","BGG",0,1,1,1,0,"run018"
"3499","GBB","BRB",1,9,10,4,6,"run018"
"3500","GBB","BRR",1,3,4,1,3,"run018"
"3501","GBB","GBG",0,4,4,1,3,"run018"
"3502","GBB","GGB",0,21,21,10,11,"run018"
"3503","GBB","GGG",7,86,93,16,77,"run018"
"3504","GBB","GGR",1,3,4,3,1,"run018"
"3505","GBB","GRG",0,6,6,0,6,"run018"
"3506","GBB","GRR",0,1,1,0,1,"run018"
"3507","GBB","RBB",0,2,2,2,0,"run018"
"3508","GBB","RBG",3,9,12,11,1,"run018"
"3509","GBB","RBR",1,0,1,0,1,"run018"
"3510","GBB","RGG",1,0,1,1,0,"run018"
"3511","GBB","RGR",2,1,3,3,0,"run018"
"3512","GBB","RRG",0,2,2,1,1,"run018"
"3513","GBB","RRR",1,9,10,7,3,"run018"
"3514","GBG","BBB",0,5,5,3,2,"run018"
"3515","GBG","BBR",0,1,1,1,0,"run018"
"3516","GBG","BRB",1,4,5,4,1,"run018"
"3517","GBG","BRR",1,0,1,1,0,"run018"
"3518","GBG","GGB",0,4,4,2,2,"run018"
"3519","GBG","GGG",4,11,15,12,3,"run018"
"3520","GBG","RBB",1,0,1,0,1,"run018"
"3521","GBG","RBG",0,1,1,0,1,"run018"
"3522","GBG","RGG",0,1,1,0,1,"run018"
"3523","GBG","RGR",1,3,4,0,4,"run018"
"3524","GBG","RRG",1,3,4,3,1,"run018"
"3525","GGB","BBB",3,16,19,10,9,"run018"
"3526","GGB","BBR",1,4,5,0,5,"run018"
"3527","GGB","BGB",0,3,3,1,2,"run018"
"3528","GGB","BGG",0,4,4,3,1,"run018"
"3529","GGB","BRB",0,1,1,1,0,"run018"
"3530","GGB","BRR",1,15,16,16,0,"run018"
"3531","GGB","GBB",0,1,1,1,0,"run018"
"3532","GGB","GBG",1,0,1,0,1,"run018"
"3533","GGB","GGG",13,48,61,37,24,"run018"
"3534","GGB","GGR",0,7,7,5,2,"run018"
"3535","GGB","GRR",0,4,4,0,4,"run018"
"3536","GGB","RBB",0,5,5,0,5,"run018"
"3537","GGB","RBG",0,4,4,1,3,"run018"
"3538","GGB","RBR",0,5,5,5,0,"run018"
"3539","GGB","RGG",1,5,6,2,4,"run018"
"3540","GGB","RGR",0,2,2,0,2,"run018"
"3541","GGB","RRG",1,5,6,5,1,"run018"
"3542","GGB","RRR",1,5,6,4,2,"run018"
"3543","GGG","BBB",8,31,39,33,6,"run018"
"3544","GGG","BGB",0,2,2,1,1,"run018"
"3545","GGG","BGG",1,7,8,8,0,"run018"
"3546","GGG","BRB",1,3,4,2,2,"run018"
"3547","GGG","BRR",0,6,6,3,3,"run018"
"3548","GGG","GGB",5,1,6,3,3,"run018"
"3549","GGG","GGR",1,9,10,4,6,"run018"
"3550","GGG","GRR",0,2,2,2,0,"run018"
"3551","GGG","RBB",1,8,9,0,9,"run018"
"3552","GGG","RBG",0,6,6,0,6,"run018"
"3553","GGG","RBR",0,21,21,6,15,"run018"
"3554","GGG","RGG",0,3,3,0,3,"run018"
"3555","GGG","RGR",1,12,13,10,3,"run018"
"3556","GGG","RRG",1,23,24,15,9,"run018"
"3557","GGG","RRR",0,3,3,2,1,"run018"
"3558","GGR","BBB",0,2,2,0,2,"run018"
"3559","GGR","BBR",0,2,2,1,1,"run018"
"3560","GGR","BGG",0,1,1,1,0,"run018"
"3561","GGR","BRR",1,0,1,1,0,"run018"
"3562","GGR","GRR",1,0,1,1,0,"run018"
"3563","GGR","RBB",0,2,2,0,2,"run018"
"3564","GRG","BBB",3,8,11,10,1,"run018"
"3565","GRG","BBR",0,1,1,1,0,"run018"
"3566","GRG","BGG",0,1,1,0,1,"run018"
"3567","GRG","BRB",0,3,3,0,3,"run018"
"3568","GRG","BRR",0,1,1,0,1,"run018"
"3569","GRG","GBG",0,1,1,1,0,"run018"
"3570","GRG","GGB",2,15,17,11,6,"run018"
"3571","GRG","GGG",3,12,15,1,14,"run018"
"3572","GRG","GGR",0,5,5,2,3,"run018"
"3573","GRG","GRR",0,1,1,0,1,"run018"
"3574","GRG","RBG",0,1,1,1,0,"run018"
"3575","GRG","RBR",0,1,1,1,0,"run018"
"3576","GRG","RGR",1,2,3,3,0,"run018"
"3577","GRG","RRG",2,4,6,1,5,"run018"
"3578","GRR","BBB",0,1,1,0,1,"run018"
"3579","GRR","BBR",0,1,1,0,1,"run018"
"3580","GRR","BGB",1,2,3,2,1,"run018"
"3581","GRR","BGG",0,2,2,1,1,"run018"
"3582","GRR","BRB",0,1,1,1,0,"run018"
"3583","GRR","BRR",0,2,2,2,0,"run018"
"3584","GRR","GGG",0,1,1,1,0,"run018"
"3585","GRR","GGR",0,1,1,1,0,"run018"
"3586","RBB","BBB",0,1,1,0,1,"run018"
"3587","RBB","BBR",0,1,1,1,0,"run018"
"3588","RBB","BRB",0,1,1,0,1,"run018"
"3589","RBB","GRR",0,1,1,1,0,"run018"
"3590","RBB","RGG",0,1,1,1,0,"run018"
"3591","RBG","BBB",2,8,10,9,1,"run018"
"3592","RBG","BBG",0,1,1,0,1,"run018"
"3593","RBG","BRR",0,1,1,0,1,"run018"
"3594","RBG","GBB",0,1,1,0,1,"run018"
"3595","RBG","GRR",0,3,3,2,1,"run018"
"3596","RBG","RBB",1,1,2,2,0,"run018"
"3597","RBG","RBR",0,1,1,0,1,"run018"
"3598","RBG","RGR",0,1,1,1,0,"run018"
"3599","RBR","BBB",0,13,13,0,13,"run018"
"3600","RBR","BBR",0,1,1,1,0,"run018"
"3601","RBR","BGB",2,4,6,3,3,"run018"
"3602","RBR","BGG",0,2,2,2,0,"run018"
"3603","RBR","BRB",1,0,1,0,1,"run018"
"3604","RBR","BRR",1,4,5,1,4,"run018"
"3605","RBR","GGB",0,12,12,7,5,"run018"
"3606","RBR","GRR",4,4,8,6,2,"run018"
"3607","RBR","RBB",0,3,3,2,1,"run018"
"3608","RBR","RGG",2,9,11,1,10,"run018"
"3609","RBR","RGR",1,0,1,0,1,"run018"
"3610","RBR","RRR",0,1,1,0,1,"run018"
"3611","RGG","BBB",0,8,8,2,6,"run018"
"3612","RGG","BBR",1,2,3,2,1,"run018"
"3613","RGG","BGB",0,1,1,0,1,"run018"
"3614","RGG","BRR",0,4,4,2,2,"run018"
"3615","RGG","GGG",0,1,1,1,0,"run018"
"3616","RGG","GGR",0,3,3,0,3,"run018"
"3617","RGG","GRR",0,8,8,5,3,"run018"
"3618","RGG","RBB",0,1,1,0,1,"run018"
"3619","RGR","BBB",2,5,7,2,5,"run018"
"3620","RGR","BBR",1,1,2,2,0,"run018"
"3621","RGR","BGB",2,5,7,0,7,"run018"
"3622","RGR","BGG",2,2,4,3,1,"run018"
"3623","RGR","BRR",1,5,6,0,6,"run018"
"3624","RGR","GGB",2,12,14,4,10,"run018"
"3625","RGR","GGG",0,2,2,2,0,"run018"
"3626","RGR","GGR",0,4,4,0,4,"run018"
"3627","RGR","RBB",0,4,4,1,3,"run018"
"3628","RGR","RGG",1,1,2,0,2,"run018"
"3629","RGR","RRG",0,3,3,3,0,"run018"
"3630","RRG","BBB",2,33,35,27,8,"run018"
"3631","RRG","BBR",0,5,5,1,4,"run018"
"3632","RRG","BGB",1,10,11,0,11,"run018"
"3633","RRG","BGG",0,2,2,1,1,"run018"
"3634","RRG","BRB",2,40,42,24,18,"run018"
"3635","RRG","BRR",1,16,17,13,4,"run018"
"3636","RRG","GGG",2,14,16,2,14,"run018"
"3637","RRG","GGR",0,5,5,0,5,"run018"
"3638","RRG","GRG",1,0,1,1,0,"run018"
"3639","RRG","GRR",3,8,11,8,3,"run018"
"3640","RRG","RBB",1,1,2,2,0,"run018"
"3641","RRG","RGG",0,1,1,0,1,"run018"
"3642","RRG","RGR",0,1,1,1,0,"run018"
"3643","RRR","BBR",1,0,1,0,1,"run018"
"3644","RRR","BGB",2,1,3,0,3,"run018"
"3645","RRR","BGG",1,0,1,0,1,"run018"
"3646","RRR","BRB",1,1,2,0,2,"run018"
"3647","RRR","BRR",1,1,2,0,2,"run018"
"3648","RRR","GGR",0,1,1,0,1,"run018"
"3649","RRR","GRR",0,3,3,0,3,"run018"
"3650","RRR","RBB",1,2,3,3,0,"run018"
"3651","RRR","RBR",0,2,2,1,1,"run018"
"3652","RRR","RGG",0,1,1,1,0,"run018"
"3653","RRR","RGR",1,2,3,0,3,"run018"
"3654","RRR","RRG",2,2,4,2,2,"run018"
"3655","BBB","BRB",0,1,1,0,1,"run019"
"3656","BBB","GGG",1,2,3,1,2,"run019"
"3657","BBB","GRR",0,2,2,1,1,"run019"
"3658","BBB","RBG",0,1,1,0,1,"run019"
"3659","BBB","RRG",1,3,4,4,0,"run019"
"3660","BBB","RRR",0,2,2,1,1,"run019"
"3661","BBG","BBB",1,4,5,0,5,"run019"
"3662","BBG","BGB",0,1,1,0,1,"run019"
"3663","BBG","BGG",0,1,1,0,1,"run019"
"3664","BBG","BRB",1,16,17,14,3,"run019"
"3665","BBG","GBB",0,1,1,0,1,"run019"
"3666","BBG","GBG",2,7,9,5,4,"run019"
"3667","BBG","GGB",2,25,27,11,16,"run019"
"3668","BBG","GGG",4,38,42,42,0,"run019"
"3669","BBG","GRG",1,9,10,3,7,"run019"
"3670","BBG","GRR",0,1,1,1,0,"run019"
"3671","BBG","RBB",0,1,1,1,0,"run019"
"3672","BBG","RBG",0,4,4,4,0,"run019"
"3673","BBG","RBR",0,1,1,1,0,"run019"
"3674","BBG","RGR",0,1,1,0,1,"run019"
"3675","BBG","RRG",1,2,3,2,1,"run019"
"3676","BBG","RRR",0,7,7,2,5,"run019"
"3677","BGB","BBB",0,2,2,0,2,"run019"
"3678","BGB","RRG",0,1,1,0,1,"run019"
"3679","BGG","BBB",0,3,3,3,0,"run019"
"3680","BGG","BBR",0,1,1,1,0,"run019"
"3681","BGG","GRG",0,1,1,0,1,"run019"
"3682","BGG","RBG",1,1,2,0,2,"run019"
"3683","BGG","RGG",0,3,3,3,0,"run019"
"3684","BGG","RGR",0,1,1,1,0,"run019"
"3685","BGG","RRR",1,1,2,2,0,"run019"
"3686","BRB","BBB",0,13,13,0,13,"run019"
"3687","BRB","BBR",0,1,1,1,0,"run019"
"3688","BRB","BRR",0,3,3,1,2,"run019"
"3689","BRB","GGG",0,1,1,1,0,"run019"
"3690","BRB","GGR",0,1,1,1,0,"run019"
"3691","BRB","RBB",0,1,1,1,0,"run019"
"3692","BRB","RBG",0,1,1,1,0,"run019"
"3693","BRB","RGR",0,1,1,0,1,"run019"
"3694","BRB","RRR",0,1,1,0,1,"run019"
"3695","BRR","BBB",0,11,11,5,6,"run019"
"3696","BRR","BGB",1,1,2,2,0,"run019"
"3697","BRR","BGG",0,1,1,0,1,"run019"
"3698","BRR","BRB",0,1,1,0,1,"run019"
"3699","BRR","RBB",0,2,2,0,2,"run019"
"3700","GBB","BBB",12,38,50,36,14,"run019"
"3701","GBB","BGG",0,1,1,0,1,"run019"
"3702","GBB","BRB",1,9,10,3,7,"run019"
"3703","GBB","BRR",1,3,4,0,4,"run019"
"3704","GBB","GBG",0,4,4,1,3,"run019"
"3705","GBB","GGB",0,21,21,18,3,"run019"
"3706","GBB","GGG",7,86,93,72,21,"run019"
"3707","GBB","GGR",1,3,4,1,3,"run019"
"3708","GBB","GRG",0,6,6,6,0,"run019"
"3709","GBB","GRR",0,1,1,1,0,"run019"
"3710","GBB","RBB",0,2,2,0,2,"run019"
"3711","GBB","RBG",3,9,12,3,9,"run019"
"3712","GBB","RBR",1,0,1,1,0,"run019"
"3713","GBB","RGG",1,0,1,0,1,"run019"
"3714","GBB","RGR",2,1,3,3,0,"run019"
"3715","GBB","RRG",0,2,2,1,1,"run019"
"3716","GBB","RRR",1,9,10,3,7,"run019"
"3717","GBG","BBB",0,5,5,1,4,"run019"
"3718","GBG","BBR",0,1,1,0,1,"run019"
"3719","GBG","BRB",1,4,5,5,0,"run019"
"3720","GBG","BRR",1,0,1,0,1,"run019"
"3721","GBG","GGB",0,4,4,2,2,"run019"
"3722","GBG","GGG",4,11,15,3,12,"run019"
"3723","GBG","RBB",1,0,1,1,0,"run019"
"3724","GBG","RBG",0,1,1,0,1,"run019"
"3725","GBG","RGG",0,1,1,1,0,"run019"
"3726","GBG","RGR",1,3,4,2,2,"run019"
"3727","GBG","RRG",1,3,4,2,2,"run019"
"3728","GGB","BBB",3,16,19,4,15,"run019"
"3729","GGB","BBR",1,4,5,0,5,"run019"
"3730","GGB","BGB",0,3,3,3,0,"run019"
"3731","GGB","BGG",0,4,4,1,3,"run019"
"3732","GGB","BRB",0,1,1,1,0,"run019"
"3733","GGB","BRR",1,15,16,10,6,"run019"
"3734","GGB","GBB",0,1,1,0,1,"run019"
"3735","GGB","GBG",1,0,1,0,1,"run019"
"3736","GGB","GGG",13,48,61,8,53,"run019"
"3737","GGB","GGR",0,7,7,6,1,"run019"
"3738","GGB","GRR",0,4,4,2,2,"run019"
"3739","GGB","RBB",0,5,5,5,0,"run019"
"3740","GGB","RBG",0,4,4,4,0,"run019"
"3741","GGB","RBR",0,5,5,0,5,"run019"
"3742","GGB","RGG",1,5,6,6,0,"run019"
"3743","GGB","RGR",0,2,2,0,2,"run019"
"3744","GGB","RRG",1,5,6,2,4,"run019"
"3745","GGB","RRR",1,5,6,4,2,"run019"
"3746","GGG","BBB",8,31,39,21,18,"run019"
"3747","GGG","BGB",0,2,2,2,0,"run019"
"3748","GGG","BGG",1,7,8,5,3,"run019"
"3749","GGG","BRB",1,3,4,2,2,"run019"
"3750","GGG","BRR",0,6,6,1,5,"run019"
"3751","GGG","GGB",5,1,6,6,0,"run019"
"3752","GGG","GGR",1,9,10,4,6,"run019"
"3753","GGG","GRR",0,2,2,1,1,"run019"
"3754","GGG","RBB",1,8,9,3,6,"run019"
"3755","GGG","RBG",0,6,6,5,1,"run019"
"3756","GGG","RBR",0,21,21,10,11,"run019"
"3757","GGG","RGG",0,3,3,1,2,"run019"
"3758","GGG","RGR",1,12,13,6,7,"run019"
"3759","GGG","RRG",1,23,24,10,14,"run019"
"3760","GGG","RRR",0,3,3,3,0,"run019"
"3761","GGR","BBB",0,2,2,1,1,"run019"
"3762","GGR","BBR",0,2,2,1,1,"run019"
"3763","GGR","BGG",0,1,1,0,1,"run019"
"3764","GGR","BRR",1,0,1,0,1,"run019"
"3765","GGR","GRR",1,0,1,1,0,"run019"
"3766","GGR","RBB",0,2,2,0,2,"run019"
"3767","GRG","BBB",3,8,11,0,11,"run019"
"3768","GRG","BBR",0,1,1,0,1,"run019"
"3769","GRG","BGG",0,1,1,0,1,"run019"
"3770","GRG","BRB",0,3,3,0,3,"run019"
"3771","GRG","BRR",0,1,1,1,0,"run019"
"3772","GRG","GBG",0,1,1,0,1,"run019"
"3773","GRG","GGB",2,15,17,0,17,"run019"
"3774","GRG","GGG",3,12,15,5,10,"run019"
"3775","GRG","GGR",0,5,5,1,4,"run019"
"3776","GRG","GRR",0,1,1,0,1,"run019"
"3777","GRG","RBG",0,1,1,0,1,"run019"
"3778","GRG","RBR",0,1,1,1,0,"run019"
"3779","GRG","RGR",1,2,3,2,1,"run019"
"3780","GRG","RRG",2,4,6,2,4,"run019"
"3781","GRR","BBB",0,1,1,0,1,"run019"
"3782","GRR","BBR",0,1,1,0,1,"run019"
"3783","GRR","BGB",1,2,3,1,2,"run019"
"3784","GRR","BGG",0,2,2,1,1,"run019"
"3785","GRR","BRB",0,1,1,1,0,"run019"
"3786","GRR","BRR",0,2,2,1,1,"run019"
"3787","GRR","GGG",0,1,1,1,0,"run019"
"3788","GRR","GGR",0,1,1,0,1,"run019"
"3789","RBB","BBB",0,1,1,1,0,"run019"
"3790","RBB","BBR",0,1,1,0,1,"run019"
"3791","RBB","BRB",0,1,1,0,1,"run019"
"3792","RBB","GRR",0,1,1,0,1,"run019"
"3793","RBB","RGG",0,1,1,1,0,"run019"
"3794","RBG","BBB",2,8,10,3,7,"run019"
"3795","RBG","BBG",0,1,1,0,1,"run019"
"3796","RBG","BRR",0,1,1,1,0,"run019"
"3797","RBG","GBB",0,1,1,1,0,"run019"
"3798","RBG","GRR",0,3,3,3,0,"run019"
"3799","RBG","RBB",1,1,2,1,1,"run019"
"3800","RBG","RBR",0,1,1,1,0,"run019"
"3801","RBG","RGR",0,1,1,1,0,"run019"
"3802","RBR","BBB",0,13,13,12,1,"run019"
"3803","RBR","BBR",0,1,1,0,1,"run019"
"3804","RBR","BGB",2,4,6,1,5,"run019"
"3805","RBR","BGG",0,2,2,1,1,"run019"
"3806","RBR","BRB",1,0,1,1,0,"run019"
"3807","RBR","BRR",1,4,5,2,3,"run019"
"3808","RBR","GGB",0,12,12,9,3,"run019"
"3809","RBR","GRR",4,4,8,3,5,"run019"
"3810","RBR","RBB",0,3,3,3,0,"run019"
"3811","RBR","RGG",2,9,11,11,0,"run019"
"3812","RBR","RGR",1,0,1,0,1,"run019"
"3813","RBR","RRR",0,1,1,1,0,"run019"
"3814","RGG","BBB",0,8,8,7,1,"run019"
"3815","RGG","BBR",1,2,3,2,1,"run019"
"3816","RGG","BGB",0,1,1,1,0,"run019"
"3817","RGG","BRR",0,4,4,2,2,"run019"
"3818","RGG","GGG",0,1,1,1,0,"run019"
"3819","RGG","GGR",0,3,3,1,2,"run019"
"3820","RGG","GRR",0,8,8,8,0,"run019"
"3821","RGG","RBB",0,1,1,0,1,"run019"
"3822","RGR","BBB",2,5,7,5,2,"run019"
"3823","RGR","BBR",1,1,2,0,2,"run019"
"3824","RGR","BGB",2,5,7,7,0,"run019"
"3825","RGR","BGG",2,2,4,2,2,"run019"
"3826","RGR","BRR",1,5,6,6,0,"run019"
"3827","RGR","GGB",2,12,14,3,11,"run019"
"3828","RGR","GGG",0,2,2,2,0,"run019"
"3829","RGR","GGR",0,4,4,0,4,"run019"
"3830","RGR","RBB",0,4,4,2,2,"run019"
"3831","RGR","RGG",1,1,2,2,0,"run019"
"3832","RGR","RRG",0,3,3,2,1,"run019"
"3833","RRG","BBB",2,33,35,24,11,"run019"
"3834","RRG","BBR",0,5,5,2,3,"run019"
"3835","RRG","BGB",1,10,11,7,4,"run019"
"3836","RRG","BGG",0,2,2,0,2,"run019"
"3837","RRG","BRB",2,40,42,9,33,"run019"
"3838","RRG","BRR",1,16,17,14,3,"run019"
"3839","RRG","GGG",2,14,16,1,15,"run019"
"3840","RRG","GGR",0,5,5,0,5,"run019"
"3841","RRG","GRG",1,0,1,1,0,"run019"
"3842","RRG","GRR",3,8,11,2,9,"run019"
"3843","RRG","RBB",1,1,2,2,0,"run019"
"3844","RRG","RGG",0,1,1,0,1,"run019"
"3845","RRG","RGR",0,1,1,0,1,"run019"
"3846","RRR","BBR",1,0,1,0,1,"run019"
"3847","RRR","BGB",2,1,3,1,2,"run019"
"3848","RRR","BGG",1,0,1,1,0,"run019"
"3849","RRR","BRB",1,1,2,1,1,"run019"
"3850","RRR","BRR",1,1,2,2,0,"run019"
"3851","RRR","GGR",0,1,1,1,0,"run019"
"3852","RRR","GRR",0,3,3,3,0,"run019"
"3853","RRR","RBB",1,2,3,3,0,"run019"
"3854","RRR","RBR",0,2,2,2,0,"run019"
"3855","RRR","RGG",0,1,1,0,1,"run019"
"3856","RRR","RGR",1,2,3,3,0,"run019"
"3857","RRR","RRG",2,2,4,1,3,"run019"
"3858","BBB","BRB",0,1,1,1,0,"run020"
"3859","BBB","GGG",1,2,3,2,1,"run020"
"3860","BBB","GRR",0,2,2,2,0,"run020"
"3861","BBB","RBG",0,1,1,1,0,"run020"
"3862","BBB","RRG",1,3,4,1,3,"run020"
"3863","BBB","RRR",0,2,2,0,2,"run020"
"3864","BBG","BBB",1,4,5,1,4,"run020"
"3865","BBG","BGB",0,1,1,0,1,"run020"
"3866","BBG","BGG",0,1,1,1,0,"run020"
"3867","BBG","BRB",1,16,17,12,5,"run020"
"3868","BBG","GBB",0,1,1,0,1,"run020"
"3869","BBG","GBG",2,7,9,8,1,"run020"
"3870","BBG","GGB",2,25,27,2,25,"run020"
"3871","BBG","GGG",4,38,42,13,29,"run020"
"3872","BBG","GRG",1,9,10,7,3,"run020"
"3873","BBG","GRR",0,1,1,1,0,"run020"
"3874","BBG","RBB",0,1,1,0,1,"run020"
"3875","BBG","RBG",0,4,4,3,1,"run020"
"3876","BBG","RBR",0,1,1,0,1,"run020"
"3877","BBG","RGR",0,1,1,0,1,"run020"
"3878","BBG","RRG",1,2,3,0,3,"run020"
"3879","BBG","RRR",0,7,7,0,7,"run020"
"3880","BGB","BBB",0,2,2,1,1,"run020"
"3881","BGB","RRG",0,1,1,1,0,"run020"
"3882","BGG","BBB",0,3,3,3,0,"run020"
"3883","BGG","BBR",0,1,1,1,0,"run020"
"3884","BGG","GRG",0,1,1,0,1,"run020"
"3885","BGG","RBG",1,1,2,0,2,"run020"
"3886","BGG","RGG",0,3,3,0,3,"run020"
"3887","BGG","RGR",0,1,1,1,0,"run020"
"3888","BGG","RRR",1,1,2,0,2,"run020"
"3889","BRB","BBB",0,13,13,5,8,"run020"
"3890","BRB","BBR",0,1,1,0,1,"run020"
"3891","BRB","BRR",0,3,3,1,2,"run020"
"3892","BRB","GGG",0,1,1,0,1,"run020"
"3893","BRB","GGR",0,1,1,1,0,"run020"
"3894","BRB","RBB",0,1,1,0,1,"run020"
"3895","BRB","RBG",0,1,1,1,0,"run020"
"3896","BRB","RGR",0,1,1,0,1,"run020"
"3897","BRB","RRR",0,1,1,0,1,"run020"
"3898","BRR","BBB",0,11,11,11,0,"run020"
"3899","BRR","BGB",1,1,2,0,2,"run020"
"3900","BRR","BGG",0,1,1,1,0,"run020"
"3901","BRR","BRB",0,1,1,0,1,"run020"
"3902","BRR","RBB",0,2,2,0,2,"run020"
"3903","GBB","BBB",12,38,50,9,41,"run020"
"3904","GBB","BGG",0,1,1,1,0,"run020"
"3905","GBB","BRB",1,9,10,1,9,"run020"
"3906","GBB","BRR",1,3,4,4,0,"run020"
"3907","GBB","GBG",0,4,4,2,2,"run020"
"3908","GBB","GGB",0,21,21,20,1,"run020"
"3909","GBB","GGG",7,86,93,24,69,"run020"
"3910","GBB","GGR",1,3,4,0,4,"run020"
"3911","GBB","GRG",0,6,6,0,6,"run020"
"3912","GBB","GRR",0,1,1,0,1,"run020"
"3913","GBB","RBB",0,2,2,1,1,"run020"
"3914","GBB","RBG",3,9,12,12,0,"run020"
"3915","GBB","RBR",1,0,1,1,0,"run020"
"3916","GBB","RGG",1,0,1,1,0,"run020"
"3917","GBB","RGR",2,1,3,1,2,"run020"
"3918","GBB","RRG",0,2,2,1,1,"run020"
"3919","GBB","RRR",1,9,10,3,7,"run020"
"3920","GBG","BBB",0,5,5,1,4,"run020"
"3921","GBG","BBR",0,1,1,0,1,"run020"
"3922","GBG","BRB",1,4,5,1,4,"run020"
"3923","GBG","BRR",1,0,1,0,1,"run020"
"3924","GBG","GGB",0,4,4,0,4,"run020"
"3925","GBG","GGG",4,11,15,13,2,"run020"
"3926","GBG","RBB",1,0,1,1,0,"run020"
"3927","GBG","RBG",0,1,1,1,0,"run020"
"3928","GBG","RGG",0,1,1,1,0,"run020"
"3929","GBG","RGR",1,3,4,4,0,"run020"
"3930","GBG","RRG",1,3,4,2,2,"run020"
"3931","GGB","BBB",3,16,19,0,19,"run020"
"3932","GGB","BBR",1,4,5,0,5,"run020"
"3933","GGB","BGB",0,3,3,2,1,"run020"
"3934","GGB","BGG",0,4,4,3,1,"run020"
"3935","GGB","BRB",0,1,1,1,0,"run020"
"3936","GGB","BRR",1,15,16,2,14,"run020"
"3937","GGB","GBB",0,1,1,0,1,"run020"
"3938","GGB","GBG",1,0,1,0,1,"run020"
"3939","GGB","GGG",13,48,61,30,31,"run020"
"3940","GGB","GGR",0,7,7,5,2,"run020"
"3941","GGB","GRR",0,4,4,3,1,"run020"
"3942","GGB","RBB",0,5,5,3,2,"run020"
"3943","GGB","RBG",0,4,4,0,4,"run020"
"3944","GGB","RBR",0,5,5,4,1,"run020"
"3945","GGB","RGG",1,5,6,0,6,"run020"
"3946","GGB","RGR",0,2,2,2,0,"run020"
"3947","GGB","RRG",1,5,6,2,4,"run020"
"3948","GGB","RRR",1,5,6,0,6,"run020"
"3949","GGG","BBB",8,31,39,39,0,"run020"
"3950","GGG","BGB",0,2,2,1,1,"run020"
"3951","GGG","BGG",1,7,8,3,5,"run020"
"3952","GGG","BRB",1,3,4,4,0,"run020"
"3953","GGG","BRR",0,6,6,2,4,"run020"
"3954","GGG","GGB",5,1,6,5,1,"run020"
"3955","GGG","GGR",1,9,10,2,8,"run020"
"3956","GGG","GRR",0,2,2,0,2,"run020"
"3957","GGG","RBB",1,8,9,4,5,"run020"
"3958","GGG","RBG",0,6,6,4,2,"run020"
"3959","GGG","RBR",0,21,21,2,19,"run020"
"3960","GGG","RGG",0,3,3,1,2,"run020"
"3961","GGG","RGR",1,12,13,1,12,"run020"
"3962","GGG","RRG",1,23,24,10,14,"run020"
"3963","GGG","RRR",0,3,3,1,2,"run020"
"3964","GGR","BBB",0,2,2,1,1,"run020"
"3965","GGR","BBR",0,2,2,0,2,"run020"
"3966","GGR","BGG",0,1,1,1,0,"run020"
"3967","GGR","BRR",1,0,1,0,1,"run020"
"3968","GGR","GRR",1,0,1,1,0,"run020"
"3969","GGR","RBB",0,2,2,2,0,"run020"
"3970","GRG","BBB",3,8,11,6,5,"run020"
"3971","GRG","BBR",0,1,1,0,1,"run020"
"3972","GRG","BGG",0,1,1,1,0,"run020"
"3973","GRG","BRB",0,3,3,0,3,"run020"
"3974","GRG","BRR",0,1,1,1,0,"run020"
"3975","GRG","GBG",0,1,1,0,1,"run020"
"3976","GRG","GGB",2,15,17,5,12,"run020"
"3977","GRG","GGG",3,12,15,10,5,"run020"
"3978","GRG","GGR",0,5,5,0,5,"run020"
"3979","GRG","GRR",0,1,1,0,1,"run020"
"3980","GRG","RBG",0,1,1,1,0,"run020"
"3981","GRG","RBR",0,1,1,0,1,"run020"
"3982","GRG","RGR",1,2,3,0,3,"run020"
"3983","GRG","RRG",2,4,6,2,4,"run020"
"3984","GRR","BBB",0,1,1,0,1,"run020"
"3985","GRR","BBR",0,1,1,0,1,"run020"
"3986","GRR","BGB",1,2,3,1,2,"run020"
"3987","GRR","BGG",0,2,2,2,0,"run020"
"3988","GRR","BRB",0,1,1,0,1,"run020"
"3989","GRR","BRR",0,2,2,1,1,"run020"
"3990","GRR","GGG",0,1,1,1,0,"run020"
"3991","GRR","GGR",0,1,1,0,1,"run020"
"3992","RBB","BBB",0,1,1,1,0,"run020"
"3993","RBB","BBR",0,1,1,1,0,"run020"
"3994","RBB","BRB",0,1,1,0,1,"run020"
"3995","RBB","GRR",0,1,1,0,1,"run020"
"3996","RBB","RGG",0,1,1,0,1,"run020"
"3997","RBG","BBB",2,8,10,0,10,"run020"
"3998","RBG","BBG",0,1,1,1,0,"run020"
"3999","RBG","BRR",0,1,1,1,0,"run020"
"4000","RBG","GBB",0,1,1,0,1,"run020"
"4001","RBG","GRR",0,3,3,3,0,"run020"
"4002","RBG","RBB",1,1,2,2,0,"run020"
"4003","RBG","RBR",0,1,1,1,0,"run020"
"4004","RBG","RGR",0,1,1,1,0,"run020"
"4005","RBR","BBB",0,13,13,4,9,"run020"
"4006","RBR","BBR",0,1,1,0,1,"run020"
"4007","RBR","BGB",2,4,6,5,1,"run020"
"4008","RBR","BGG",0,2,2,2,0,"run020"
"4009","RBR","BRB",1,0,1,0,1,"run020"
"4010","RBR","BRR",1,4,5,4,1,"run020"
"4011","RBR","GGB",0,12,12,5,7,"run020"
"4012","RBR","GRR",4,4,8,4,4,"run020"
"4013","RBR","RBB",0,3,3,0,3,"run020"
"4014","RBR","RGG",2,9,11,0,11,"run020"
"4015","RBR","RGR",1,0,1,0,1,"run020"
"4016","RBR","RRR",0,1,1,1,0,"run020"
"4017","RGG","BBB",0,8,8,7,1,"run020"
"4018","RGG","BBR",1,2,3,3,0,"run020"
"4019","RGG","BGB",0,1,1,0,1,"run020"
"4020","RGG","BRR",0,4,4,1,3,"run020"
"4021","RGG","GGG",0,1,1,1,0,"run020"
"4022","RGG","GGR",0,3,3,1,2,"run020"
"4023","RGG","GRR",0,8,8,5,3,"run020"
"4024","RGG","RBB",0,1,1,0,1,"run020"
"4025","RGR","BBB",2,5,7,1,6,"run020"
"4026","RGR","BBR",1,1,2,0,2,"run020"
"4027","RGR","BGB",2,5,7,1,6,"run020"
"4028","RGR","BGG",2,2,4,2,2,"run020"
"4029","RGR","BRR",1,5,6,0,6,"run020"
"4030","RGR","GGB",2,12,14,9,5,"run020"
"4031","RGR","GGG",0,2,2,2,0,"run020"
"4032","RGR","GGR",0,4,4,2,2,"run020"
"4033","RGR","RBB",0,4,4,0,4,"run020"
"4034","RGR","RGG",1,1,2,1,1,"run020"
"4035","RGR","RRG",0,3,3,1,2,"run020"
"4036","RRG","BBB",2,33,35,18,17,"run020"
"4037","RRG","BBR",0,5,5,1,4,"run020"
"4038","RRG","BGB",1,10,11,11,0,"run020"
"4039","RRG","BGG",0,2,2,2,0,"run020"
"4040","RRG","BRB",2,40,42,25,17,"run020"
"4041","RRG","BRR",1,16,17,13,4,"run020"
"4042","RRG","GGG",2,14,16,3,13,"run020"
"4043","RRG","GGR",0,5,5,3,2,"run020"
"4044","RRG","GRG",1,0,1,1,0,"run020"
"4045","RRG","GRR",3,8,11,8,3,"run020"
"4046","RRG","RBB",1,1,2,0,2,"run020"
"4047","RRG","RGG",0,1,1,1,0,"run020"
"4048","RRG","RGR",0,1,1,1,0,"run020"
"4049","RRR","BBR",1,0,1,1,0,"run020"
"4050","RRR","BGB",2,1,3,1,2,"run020"
"4051","RRR","BGG",1,0,1,0,1,"run020"
"4052","RRR","BRB",1,1,2,0,2,"run020"
"4053","RRR","BRR",1,1,2,1,1,"run020"
"4054","RRR","GGR",0,1,1,0,1,"run020"
"4055","RRR","GRR",0,3,3,3,0,"run020"
"4056","RRR","RBB",1,2,3,2,1,"run020"
"4057","RRR","RBR",0,2,2,0,2,"run020"
"4058","RRR","RGG",0,1,1,1,0,"run020"
"4059","RRR","RGR",1,2,3,2,1,"run020"
"4060","RRR","RRG",2,2,4,0,4,"run020"
"4061","BBB","BRB",0,1,1,0,1,"run021"
"4062","BBB","GGG",1,2,3,0,3,"run021"
"4063","BBB","GRR",0,2,2,2,0,"run021"
"4064","BBB","RBG",0,1,1,0,1,"run021"
"4065","BBB","RRG",1,3,4,1,3,"run021"
"4066","BBB","RRR",0,2,2,2,0,"run021"
"4067","BBG","BBB",1,4,5,4,1,"run021"
"4068","BBG","BGB",0,1,1,0,1,"run021"
"4069","BBG","BGG",0,1,1,0,1,"run021"
"4070","BBG","BRB",1,16,17,3,14,"run021"
"4071","BBG","GBB",0,1,1,1,0,"run021"
"4072","BBG","GBG",2,7,9,5,4,"run021"
"4073","BBG","GGB",2,25,27,7,20,"run021"
"4074","BBG","GGG",4,38,42,37,5,"run021"
"4075","BBG","GRG",1,9,10,10,0,"run021"
"4076","BBG","GRR",0,1,1,1,0,"run021"
"4077","BBG","RBB",0,1,1,1,0,"run021"
"4078","BBG","RBG",0,4,4,2,2,"run021"
"4079","BBG","RBR",0,1,1,1,0,"run021"
"4080","BBG","RGR",0,1,1,0,1,"run021"
"4081","BBG","RRG",1,2,3,1,2,"run021"
"4082","BBG","RRR",0,7,7,1,6,"run021"
"4083","BGB","BBB",0,2,2,1,1,"run021"
"4084","BGB","RRG",0,1,1,0,1,"run021"
"4085","BGG","BBB",0,3,3,1,2,"run021"
"4086","BGG","BBR",0,1,1,1,0,"run021"
"4087","BGG","GRG",0,1,1,0,1,"run021"
"4088","BGG","RBG",1,1,2,2,0,"run021"
"4089","BGG","RGG",0,3,3,1,2,"run021"
"4090","BGG","RGR",0,1,1,1,0,"run021"
"4091","BGG","RRR",1,1,2,0,2,"run021"
"4092","BRB","BBB",0,13,13,11,2,"run021"
"4093","BRB","BBR",0,1,1,1,0,"run021"
"4094","BRB","BRR",0,3,3,1,2,"run021"
"4095","BRB","GGG",0,1,1,0,1,"run021"
"4096","BRB","GGR",0,1,1,1,0,"run021"
"4097","BRB","RBB",0,1,1,1,0,"run021"
"4098","BRB","RBG",0,1,1,0,1,"run021"
"4099","BRB","RGR",0,1,1,0,1,"run021"
"4100","BRB","RRR",0,1,1,0,1,"run021"
"4101","BRR","BBB",0,11,11,8,3,"run021"
"4102","BRR","BGB",1,1,2,1,1,"run021"
"4103","BRR","BGG",0,1,1,0,1,"run021"
"4104","BRR","BRB",0,1,1,1,0,"run021"
"4105","BRR","RBB",0,2,2,0,2,"run021"
"4106","GBB","BBB",12,38,50,7,43,"run021"
"4107","GBB","BGG",0,1,1,0,1,"run021"
"4108","GBB","BRB",1,9,10,10,0,"run021"
"4109","GBB","BRR",1,3,4,0,4,"run021"
"4110","GBB","GBG",0,4,4,0,4,"run021"
"4111","GBB","GGB",0,21,21,1,20,"run021"
"4112","GBB","GGG",7,86,93,67,26,"run021"
"4113","GBB","GGR",1,3,4,4,0,"run021"
"4114","GBB","GRG",0,6,6,6,0,"run021"
"4115","GBB","GRR",0,1,1,1,0,"run021"
"4116","GBB","RBB",0,2,2,1,1,"run021"
"4117","GBB","RBG",3,9,12,7,5,"run021"
"4118","GBB","RBR",1,0,1,0,1,"run021"
"4119","GBB","RGG",1,0,1,1,0,"run021"
"4120","GBB","RGR",2,1,3,3,0,"run021"
"4121","GBB","RRG",0,2,2,1,1,"run021"
"4122","GBB","RRR",1,9,10,10,0,"run021"
"4123","GBG","BBB",0,5,5,1,4,"run021"
"4124","GBG","BBR",0,1,1,0,1,"run021"
"4125","GBG","BRB",1,4,5,1,4,"run021"
"4126","GBG","BRR",1,0,1,0,1,"run021"
"4127","GBG","GGB",0,4,4,4,0,"run021"
"4128","GBG","GGG",4,11,15,4,11,"run021"
"4129","GBG","RBB",1,0,1,1,0,"run021"
"4130","GBG","RBG",0,1,1,1,0,"run021"
"4131","GBG","RGG",0,1,1,1,0,"run021"
"4132","GBG","RGR",1,3,4,3,1,"run021"
"4133","GBG","RRG",1,3,4,4,0,"run021"
"4134","GGB","BBB",3,16,19,9,10,"run021"
"4135","GGB","BBR",1,4,5,1,4,"run021"
"4136","GGB","BGB",0,3,3,2,1,"run021"
"4137","GGB","BGG",0,4,4,2,2,"run021"
"4138","GGB","BRB",0,1,1,1,0,"run021"
"4139","GGB","BRR",1,15,16,6,10,"run021"
"4140","GGB","GBB",0,1,1,0,1,"run021"
"4141","GGB","GBG",1,0,1,1,0,"run021"
"4142","GGB","GGG",13,48,61,46,15,"run021"
"4143","GGB","GGR",0,7,7,5,2,"run021"
"4144","GGB","GRR",0,4,4,2,2,"run021"
"4145","GGB","RBB",0,5,5,4,1,"run021"
"4146","GGB","RBG",0,4,4,4,0,"run021"
"4147","GGB","RBR",0,5,5,0,5,"run021"
"4148","GGB","RGG",1,5,6,5,1,"run021"
"4149","GGB","RGR",0,2,2,0,2,"run021"
"4150","GGB","RRG",1,5,6,5,1,"run021"
"4151","GGB","RRR",1,5,6,4,2,"run021"
"4152","GGG","BBB",8,31,39,24,15,"run021"
"4153","GGG","BGB",0,2,2,0,2,"run021"
"4154","GGG","BGG",1,7,8,3,5,"run021"
"4155","GGG","BRB",1,3,4,4,0,"run021"
"4156","GGG","BRR",0,6,6,5,1,"run021"
"4157","GGG","GGB",5,1,6,1,5,"run021"
"4158","GGG","GGR",1,9,10,9,1,"run021"
"4159","GGG","GRR",0,2,2,1,1,"run021"
"4160","GGG","RBB",1,8,9,1,8,"run021"
"4161","GGG","RBG",0,6,6,0,6,"run021"
"4162","GGG","RBR",0,21,21,7,14,"run021"
"4163","GGG","RGG",0,3,3,2,1,"run021"
"4164","GGG","RGR",1,12,13,8,5,"run021"
"4165","GGG","RRG",1,23,24,21,3,"run021"
"4166","GGG","RRR",0,3,3,3,0,"run021"
"4167","GGR","BBB",0,2,2,1,1,"run021"
"4168","GGR","BBR",0,2,2,0,2,"run021"
"4169","GGR","BGG",0,1,1,1,0,"run021"
"4170","GGR","BRR",1,0,1,0,1,"run021"
"4171","GGR","GRR",1,0,1,0,1,"run021"
"4172","GGR","RBB",0,2,2,2,0,"run021"
"4173","GRG","BBB",3,8,11,2,9,"run021"
"4174","GRG","BBR",0,1,1,0,1,"run021"
"4175","GRG","BGG",0,1,1,0,1,"run021"
"4176","GRG","BRB",0,3,3,1,2,"run021"
"4177","GRG","BRR",0,1,1,1,0,"run021"
"4178","GRG","GBG",0,1,1,0,1,"run021"
"4179","GRG","GGB",2,15,17,17,0,"run021"
"4180","GRG","GGG",3,12,15,2,13,"run021"
"4181","GRG","GGR",0,5,5,4,1,"run021"
"4182","GRG","GRR",0,1,1,0,1,"run021"
"4183","GRG","RBG",0,1,1,0,1,"run021"
"4184","GRG","RBR",0,1,1,0,1,"run021"
"4185","GRG","RGR",1,2,3,1,2,"run021"
"4186","GRG","RRG",2,4,6,0,6,"run021"
"4187","GRR","BBB",0,1,1,1,0,"run021"
"4188","GRR","BBR",0,1,1,1,0,"run021"
"4189","GRR","BGB",1,2,3,1,2,"run021"
"4190","GRR","BGG",0,2,2,2,0,"run021"
"4191","GRR","BRB",0,1,1,0,1,"run021"
"4192","GRR","BRR",0,2,2,2,0,"run021"
"4193","GRR","GGG",0,1,1,0,1,"run021"
"4194","GRR","GGR",0,1,1,1,0,"run021"
"4195","RBB","BBB",0,1,1,0,1,"run021"
"4196","RBB","BBR",0,1,1,1,0,"run021"
"4197","RBB","BRB",0,1,1,1,0,"run021"
"4198","RBB","GRR",0,1,1,1,0,"run021"
"4199","RBB","RGG",0,1,1,0,1,"run021"
"4200","RBG","BBB",2,8,10,8,2,"run021"
"4201","RBG","BBG",0,1,1,1,0,"run021"
"4202","RBG","BRR",0,1,1,1,0,"run021"
"4203","RBG","GBB",0,1,1,1,0,"run021"
"4204","RBG","GRR",0,3,3,3,0,"run021"
"4205","RBG","RBB",1,1,2,0,2,"run021"
"4206","RBG","RBR",0,1,1,1,0,"run021"
"4207","RBG","RGR",0,1,1,0,1,"run021"
"4208","RBR","BBB",0,13,13,12,1,"run021"
"4209","RBR","BBR",0,1,1,1,0,"run021"
"4210","RBR","BGB",2,4,6,2,4,"run021"
"4211","RBR","BGG",0,2,2,1,1,"run021"
"4212","RBR","BRB",1,0,1,1,0,"run021"
"4213","RBR","BRR",1,4,5,5,0,"run021"
"4214","RBR","GGB",0,12,12,5,7,"run021"
"4215","RBR","GRR",4,4,8,1,7,"run021"
"4216","RBR","RBB",0,3,3,0,3,"run021"
"4217","RBR","RGG",2,9,11,1,10,"run021"
"4218","RBR","RGR",1,0,1,0,1,"run021"
"4219","RBR","RRR",0,1,1,1,0,"run021"
"4220","RGG","BBB",0,8,8,2,6,"run021"
"4221","RGG","BBR",1,2,3,2,1,"run021"
"4222","RGG","BGB",0,1,1,0,1,"run021"
"4223","RGG","BRR",0,4,4,3,1,"run021"
"4224","RGG","GGG",0,1,1,0,1,"run021"
"4225","RGG","GGR",0,3,3,0,3,"run021"
"4226","RGG","GRR",0,8,8,7,1,"run021"
"4227","RGG","RBB",0,1,1,0,1,"run021"
"4228","RGR","BBB",2,5,7,3,4,"run021"
"4229","RGR","BBR",1,1,2,1,1,"run021"
"4230","RGR","BGB",2,5,7,6,1,"run021"
"4231","RGR","BGG",2,2,4,4,0,"run021"
"4232","RGR","BRR",1,5,6,0,6,"run021"
"4233","RGR","GGB",2,12,14,3,11,"run021"
"4234","RGR","GGG",0,2,2,2,0,"run021"
"4235","RGR","GGR",0,4,4,2,2,"run021"
"4236","RGR","RBB",0,4,4,3,1,"run021"
"4237","RGR","RGG",1,1,2,2,0,"run021"
"4238","RGR","RRG",0,3,3,1,2,"run021"
"4239","RRG","BBB",2,33,35,32,3,"run021"
"4240","RRG","BBR",0,5,5,1,4,"run021"
"4241","RRG","BGB",1,10,11,4,7,"run021"
"4242","RRG","BGG",0,2,2,2,0,"run021"
"4243","RRG","BRB",2,40,42,42,0,"run021"
"4244","RRG","BRR",1,16,17,6,11,"run021"
"4245","RRG","GGG",2,14,16,9,7,"run021"
"4246","RRG","GGR",0,5,5,5,0,"run021"
"4247","RRG","GRG",1,0,1,1,0,"run021"
"4248","RRG","GRR",3,8,11,1,10,"run021"
"4249","RRG","RBB",1,1,2,2,0,"run021"
"4250","RRG","RGG",0,1,1,1,0,"run021"
"4251","RRG","RGR",0,1,1,0,1,"run021"
"4252","RRR","BBR",1,0,1,1,0,"run021"
"4253","RRR","BGB",2,1,3,0,3,"run021"
"4254","RRR","BGG",1,0,1,0,1,"run021"
"4255","RRR","BRB",1,1,2,2,0,"run021"
"4256","RRR","BRR",1,1,2,0,2,"run021"
"4257","RRR","GGR",0,1,1,0,1,"run021"
"4258","RRR","GRR",0,3,3,1,2,"run021"
"4259","RRR","RBB",1,2,3,1,2,"run021"
"4260","RRR","RBR",0,2,2,1,1,"run021"
"4261","RRR","RGG",0,1,1,1,0,"run021"
"4262","RRR","RGR",1,2,3,2,1,"run021"
"4263","RRR","RRG",2,2,4,3,1,"run021"
"4264","BBB","BRB",0,1,1,1,0,"run022"
"4265","BBB","GGG",1,2,3,0,3,"run022"
"4266","BBB","GRR",0,2,2,1,1,"run022"
"4267","BBB","RBG",0,1,1,1,0,"run022"
"4268","BBB","RRG",1,3,4,3,1,"run022"
"4269","BBB","RRR",0,2,2,2,0,"run022"
"4270","BBG","BBB",1,4,5,0,5,"run022"
"4271","BBG","BGB",0,1,1,0,1,"run022"
"4272","BBG","BGG",0,1,1,0,1,"run022"
"4273","BBG","BRB",1,16,17,2,15,"run022"
"4274","BBG","GBB",0,1,1,1,0,"run022"
"4275","BBG","GBG",2,7,9,3,6,"run022"
"4276","BBG","GGB",2,25,27,15,12,"run022"
"4277","BBG","GGG",4,38,42,7,35,"run022"
"4278","BBG","GRG",1,9,10,3,7,"run022"
"4279","BBG","GRR",0,1,1,0,1,"run022"
"4280","BBG","RBB",0,1,1,0,1,"run022"
"4281","BBG","RBG",0,4,4,1,3,"run022"
"4282","BBG","RBR",0,1,1,0,1,"run022"
"4283","BBG","RGR",0,1,1,1,0,"run022"
"4284","BBG","RRG",1,2,3,0,3,"run022"
"4285","BBG","RRR",0,7,7,3,4,"run022"
"4286","BGB","BBB",0,2,2,2,0,"run022"
"4287","BGB","RRG",0,1,1,0,1,"run022"
"4288","BGG","BBB",0,3,3,3,0,"run022"
"4289","BGG","BBR",0,1,1,1,0,"run022"
"4290","BGG","GRG",0,1,1,0,1,"run022"
"4291","BGG","RBG",1,1,2,1,1,"run022"
"4292","BGG","RGG",0,3,3,0,3,"run022"
"4293","BGG","RGR",0,1,1,0,1,"run022"
"4294","BGG","RRR",1,1,2,2,0,"run022"
"4295","BRB","BBB",0,13,13,4,9,"run022"
"4296","BRB","BBR",0,1,1,0,1,"run022"
"4297","BRB","BRR",0,3,3,2,1,"run022"
"4298","BRB","GGG",0,1,1,0,1,"run022"
"4299","BRB","GGR",0,1,1,0,1,"run022"
"4300","BRB","RBB",0,1,1,0,1,"run022"
"4301","BRB","RBG",0,1,1,1,0,"run022"
"4302","BRB","RGR",0,1,1,0,1,"run022"
"4303","BRB","RRR",0,1,1,1,0,"run022"
"4304","BRR","BBB",0,11,11,0,11,"run022"
"4305","BRR","BGB",1,1,2,1,1,"run022"
"4306","BRR","BGG",0,1,1,0,1,"run022"
"4307","BRR","BRB",0,1,1,0,1,"run022"
"4308","BRR","RBB",0,2,2,0,2,"run022"
"4309","GBB","BBB",12,38,50,37,13,"run022"
"4310","GBB","BGG",0,1,1,0,1,"run022"
"4311","GBB","BRB",1,9,10,1,9,"run022"
"4312","GBB","BRR",1,3,4,4,0,"run022"
"4313","GBB","GBG",0,4,4,1,3,"run022"
"4314","GBB","GGB",0,21,21,7,14,"run022"
"4315","GBB","GGG",7,86,93,50,43,"run022"
"4316","GBB","GGR",1,3,4,1,3,"run022"
"4317","GBB","GRG",0,6,6,4,2,"run022"
"4318","GBB","GRR",0,1,1,1,0,"run022"
"4319","GBB","RBB",0,2,2,2,0,"run022"
"4320","GBB","RBG",3,9,12,2,10,"run022"
"4321","GBB","RBR",1,0,1,1,0,"run022"
"4322","GBB","RGG",1,0,1,1,0,"run022"
"4323","GBB","RGR",2,1,3,2,1,"run022"
"4324","GBB","RRG",0,2,2,2,0,"run022"
"4325","GBB","RRR",1,9,10,1,9,"run022"
"4326","GBG","BBB",0,5,5,1,4,"run022"
"4327","GBG","BBR",0,1,1,0,1,"run022"
"4328","GBG","BRB",1,4,5,2,3,"run022"
"4329","GBG","BRR",1,0,1,1,0,"run022"
"4330","GBG","GGB",0,4,4,0,4,"run022"
"4331","GBG","GGG",4,11,15,13,2,"run022"
"4332","GBG","RBB",1,0,1,1,0,"run022"
"4333","GBG","RBG",0,1,1,1,0,"run022"
"4334","GBG","RGG",0,1,1,0,1,"run022"
"4335","GBG","RGR",1,3,4,2,2,"run022"
"4336","GBG","RRG",1,3,4,0,4,"run022"
"4337","GGB","BBB",3,16,19,18,1,"run022"
"4338","GGB","BBR",1,4,5,1,4,"run022"
"4339","GGB","BGB",0,3,3,0,3,"run022"
"4340","GGB","BGG",0,4,4,3,1,"run022"
"4341","GGB","BRB",0,1,1,0,1,"run022"
"4342","GGB","BRR",1,15,16,13,3,"run022"
"4343","GGB","GBB",0,1,1,0,1,"run022"
"4344","GGB","GBG",1,0,1,0,1,"run022"
"4345","GGB","GGG",13,48,61,12,49,"run022"
"4346","GGB","GGR",0,7,7,0,7,"run022"
"4347","GGB","GRR",0,4,4,0,4,"run022"
"4348","GGB","RBB",0,5,5,1,4,"run022"
"4349","GGB","RBG",0,4,4,2,2,"run022"
"4350","GGB","RBR",0,5,5,3,2,"run022"
"4351","GGB","RGG",1,5,6,5,1,"run022"
"4352","GGB","RGR",0,2,2,0,2,"run022"
"4353","GGB","RRG",1,5,6,6,0,"run022"
"4354","GGB","RRR",1,5,6,2,4,"run022"
"4355","GGG","BBB",8,31,39,39,0,"run022"
"4356","GGG","BGB",0,2,2,0,2,"run022"
"4357","GGG","BGG",1,7,8,3,5,"run022"
"4358","GGG","BRB",1,3,4,1,3,"run022"
"4359","GGG","BRR",0,6,6,4,2,"run022"
"4360","GGG","GGB",5,1,6,1,5,"run022"
"4361","GGG","GGR",1,9,10,6,4,"run022"
"4362","GGG","GRR",0,2,2,2,0,"run022"
"4363","GGG","RBB",1,8,9,2,7,"run022"
"4364","GGG","RBG",0,6,6,3,3,"run022"
"4365","GGG","RBR",0,21,21,4,17,"run022"
"4366","GGG","RGG",0,3,3,0,3,"run022"
"4367","GGG","RGR",1,12,13,5,8,"run022"
"4368","GGG","RRG",1,23,24,23,1,"run022"
"4369","GGG","RRR",0,3,3,0,3,"run022"
"4370","GGR","BBB",0,2,2,1,1,"run022"
"4371","GGR","BBR",0,2,2,0,2,"run022"
"4372","GGR","BGG",0,1,1,1,0,"run022"
"4373","GGR","BRR",1,0,1,1,0,"run022"
"4374","GGR","GRR",1,0,1,0,1,"run022"
"4375","GGR","RBB",0,2,2,2,0,"run022"
"4376","GRG","BBB",3,8,11,11,0,"run022"
"4377","GRG","BBR",0,1,1,1,0,"run022"
"4378","GRG","BGG",0,1,1,0,1,"run022"
"4379","GRG","BRB",0,3,3,1,2,"run022"
"4380","GRG","BRR",0,1,1,0,1,"run022"
"4381","GRG","GBG",0,1,1,1,0,"run022"
"4382","GRG","GGB",2,15,17,7,10,"run022"
"4383","GRG","GGG",3,12,15,12,3,"run022"
"4384","GRG","GGR",0,5,5,4,1,"run022"
"4385","GRG","GRR",0,1,1,1,0,"run022"
"4386","GRG","RBG",0,1,1,0,1,"run022"
"4387","GRG","RBR",0,1,1,0,1,"run022"
"4388","GRG","RGR",1,2,3,1,2,"run022"
"4389","GRG","RRG",2,4,6,3,3,"run022"
"4390","GRR","BBB",0,1,1,0,1,"run022"
"4391","GRR","BBR",0,1,1,0,1,"run022"
"4392","GRR","BGB",1,2,3,1,2,"run022"
"4393","GRR","BGG",0,2,2,2,0,"run022"
"4394","GRR","BRB",0,1,1,0,1,"run022"
"4395","GRR","BRR",0,2,2,1,1,"run022"
"4396","GRR","GGG",0,1,1,1,0,"run022"
"4397","GRR","GGR",0,1,1,0,1,"run022"
"4398","RBB","BBB",0,1,1,1,0,"run022"
"4399","RBB","BBR",0,1,1,0,1,"run022"
"4400","RBB","BRB",0,1,1,0,1,"run022"
"4401","RBB","GRR",0,1,1,0,1,"run022"
"4402","RBB","RGG",0,1,1,1,0,"run022"
"4403","RBG","BBB",2,8,10,9,1,"run022"
"4404","RBG","BBG",0,1,1,1,0,"run022"
"4405","RBG","BRR",0,1,1,0,1,"run022"
"4406","RBG","GBB",0,1,1,0,1,"run022"
"4407","RBG","GRR",0,3,3,3,0,"run022"
"4408","RBG","RBB",1,1,2,2,0,"run022"
"4409","RBG","RBR",0,1,1,1,0,"run022"
"4410","RBG","RGR",0,1,1,1,0,"run022"
"4411","RBR","BBB",0,13,13,12,1,"run022"
"4412","RBR","BBR",0,1,1,0,1,"run022"
"4413","RBR","BGB",2,4,6,2,4,"run022"
"4414","RBR","BGG",0,2,2,2,0,"run022"
"4415","RBR","BRB",1,0,1,1,0,"run022"
"4416","RBR","BRR",1,4,5,4,1,"run022"
"4417","RBR","GGB",0,12,12,11,1,"run022"
"4418","RBR","GRR",4,4,8,4,4,"run022"
"4419","RBR","RBB",0,3,3,0,3,"run022"
"4420","RBR","RGG",2,9,11,1,10,"run022"
"4421","RBR","RGR",1,0,1,1,0,"run022"
"4422","RBR","RRR",0,1,1,1,0,"run022"
"4423","RGG","BBB",0,8,8,5,3,"run022"
"4424","RGG","BBR",1,2,3,2,1,"run022"
"4425","RGG","BGB",0,1,1,1,0,"run022"
"4426","RGG","BRR",0,4,4,1,3,"run022"
"4427","RGG","GGG",0,1,1,1,0,"run022"
"4428","RGG","GGR",0,3,3,1,2,"run022"
"4429","RGG","GRR",0,8,8,0,8,"run022"
"4430","RGG","RBB",0,1,1,0,1,"run022"
"4431","RGR","BBB",2,5,7,5,2,"run022"
"4432","RGR","BBR",1,1,2,1,1,"run022"
"4433","RGR","BGB",2,5,7,7,0,"run022"
"4434","RGR","BGG",2,2,4,2,2,"run022"
"4435","RGR","BRR",1,5,6,1,5,"run022"
"4436","RGR","GGB",2,12,14,2,12,"run022"
"4437","RGR","GGG",0,2,2,1,1,"run022"
"4438","RGR","GGR",0,4,4,1,3,"run022"
"4439","RGR","RBB",0,4,4,1,3,"run022"
"4440","RGR","RGG",1,1,2,1,1,"run022"
"4441","RGR","RRG",0,3,3,1,2,"run022"
"4442","RRG","BBB",2,33,35,24,11,"run022"
"4443","RRG","BBR",0,5,5,2,3,"run022"
"4444","RRG","BGB",1,10,11,11,0,"run022"
"4445","RRG","BGG",0,2,2,2,0,"run022"
"4446","RRG","BRB",2,40,42,7,35,"run022"
"4447","RRG","BRR",1,16,17,12,5,"run022"
"4448","RRG","GGG",2,14,16,7,9,"run022"
"4449","RRG","GGR",0,5,5,5,0,"run022"
"4450","RRG","GRG",1,0,1,1,0,"run022"
"4451","RRG","GRR",3,8,11,1,10,"run022"
"4452","RRG","RBB",1,1,2,0,2,"run022"
"4453","RRG","RGG",0,1,1,0,1,"run022"
"4454","RRG","RGR",0,1,1,1,0,"run022"
"4455","RRR","BBR",1,0,1,0,1,"run022"
"4456","RRR","BGB",2,1,3,2,1,"run022"
"4457","RRR","BGG",1,0,1,0,1,"run022"
"4458","RRR","BRB",1,1,2,2,0,"run022"
"4459","RRR","BRR",1,1,2,0,2,"run022"
"4460","RRR","GGR",0,1,1,0,1,"run022"
"4461","RRR","GRR",0,3,3,2,1,"run022"
"4462","RRR","RBB",1,2,3,0,3,"run022"
"4463","RRR","RBR",0,2,2,0,2,"run022"
"4464","RRR","RGG",0,1,1,0,1,"run022"
"4465","RRR","RGR",1,2,3,1,2,"run022"
"4466","RRR","RRG",2,2,4,2,2,"run022"
"4467","BBB","BRB",0,1,1,0,1,"run023"
"4468","BBB","GGG",1,2,3,3,0,"run023"
"4469","BBB","GRR",0,2,2,2,0,"run023"
"4470","BBB","RBG",0,1,1,1,0,"run023"
"4471","BBB","RRG",1,3,4,0,4,"run023"
"4472","BBB","RRR",0,2,2,2,0,"run023"
"4473","BBG","BBB",1,4,5,4,1,"run023"
"4474","BBG","BGB",0,1,1,1,0,"run023"
"4475","BBG","BGG",0,1,1,1,0,"run023"
"4476","BBG","BRB",1,16,17,16,1,"run023"
"4477","BBG","GBB",0,1,1,0,1,"run023"
"4478","BBG","GBG",2,7,9,4,5,"run023"
"4479","BBG","GGB",2,25,27,16,11,"run023"
"4480","BBG","GGG",4,38,42,39,3,"run023"
"4481","BBG","GRG",1,9,10,3,7,"run023"
"4482","BBG","GRR",0,1,1,0,1,"run023"
"4483","BBG","RBB",0,1,1,1,0,"run023"
"4484","BBG","RBG",0,4,4,4,0,"run023"
"4485","BBG","RBR",0,1,1,1,0,"run023"
"4486","BBG","RGR",0,1,1,1,0,"run023"
"4487","BBG","RRG",1,2,3,1,2,"run023"
"4488","BBG","RRR",0,7,7,0,7,"run023"
"4489","BGB","BBB",0,2,2,1,1,"run023"
"4490","BGB","RRG",0,1,1,0,1,"run023"
"4491","BGG","BBB",0,3,3,1,2,"run023"
"4492","BGG","BBR",0,1,1,0,1,"run023"
"4493","BGG","GRG",0,1,1,0,1,"run023"
"4494","BGG","RBG",1,1,2,1,1,"run023"
"4495","BGG","RGG",0,3,3,2,1,"run023"
"4496","BGG","RGR",0,1,1,1,0,"run023"
"4497","BGG","RRR",1,1,2,0,2,"run023"
"4498","BRB","BBB",0,13,13,8,5,"run023"
"4499","BRB","BBR",0,1,1,0,1,"run023"
"4500","BRB","BRR",0,3,3,3,0,"run023"
"4501","BRB","GGG",0,1,1,0,1,"run023"
"4502","BRB","GGR",0,1,1,0,1,"run023"
"4503","BRB","RBB",0,1,1,1,0,"run023"
"4504","BRB","RBG",0,1,1,0,1,"run023"
"4505","BRB","RGR",0,1,1,0,1,"run023"
"4506","BRB","RRR",0,1,1,1,0,"run023"
"4507","BRR","BBB",0,11,11,0,11,"run023"
"4508","BRR","BGB",1,1,2,2,0,"run023"
"4509","BRR","BGG",0,1,1,1,0,"run023"
"4510","BRR","BRB",0,1,1,0,1,"run023"
"4511","BRR","RBB",0,2,2,0,2,"run023"
"4512","GBB","BBB",12,38,50,30,20,"run023"
"4513","GBB","BGG",0,1,1,0,1,"run023"
"4514","GBB","BRB",1,9,10,2,8,"run023"
"4515","GBB","BRR",1,3,4,2,2,"run023"
"4516","GBB","GBG",0,4,4,0,4,"run023"
"4517","GBB","GGB",0,21,21,7,14,"run023"
"4518","GBB","GGG",7,86,93,65,28,"run023"
"4519","GBB","GGR",1,3,4,2,2,"run023"
"4520","GBB","GRG",0,6,6,2,4,"run023"
"4521","GBB","GRR",0,1,1,1,0,"run023"
"4522","GBB","RBB",0,2,2,0,2,"run023"
"4523","GBB","RBG",3,9,12,12,0,"run023"
"4524","GBB","RBR",1,0,1,1,0,"run023"
"4525","GBB","RGG",1,0,1,1,0,"run023"
"4526","GBB","RGR",2,1,3,1,2,"run023"
"4527","GBB","RRG",0,2,2,0,2,"run023"
"4528","GBB","RRR",1,9,10,2,8,"run023"
"4529","GBG","BBB",0,5,5,5,0,"run023"
"4530","GBG","BBR",0,1,1,0,1,"run023"
"4531","GBG","BRB",1,4,5,3,2,"run023"
"4532","GBG","BRR",1,0,1,1,0,"run023"
"4533","GBG","GGB",0,4,4,3,1,"run023"
"4534","GBG","GGG",4,11,15,1,14,"run023"
"4535","GBG","RBB",1,0,1,0,1,"run023"
"4536","GBG","RBG",0,1,1,0,1,"run023"
"4537","GBG","RGG",0,1,1,1,0,"run023"
"4538","GBG","RGR",1,3,4,0,4,"run023"
"4539","GBG","RRG",1,3,4,4,0,"run023"
"4540","GGB","BBB",3,16,19,18,1,"run023"
"4541","GGB","BBR",1,4,5,5,0,"run023"
"4542","GGB","BGB",0,3,3,3,0,"run023"
"4543","GGB","BGG",0,4,4,3,1,"run023"
"4544","GGB","BRB",0,1,1,1,0,"run023"
"4545","GGB","BRR",1,15,16,11,5,"run023"
"4546","GGB","GBB",0,1,1,0,1,"run023"
"4547","GGB","GBG",1,0,1,1,0,"run023"
"4548","GGB","GGG",13,48,61,61,0,"run023"
"4549","GGB","GGR",0,7,7,0,7,"run023"
"4550","GGB","GRR",0,4,4,1,3,"run023"
"4551","GGB","RBB",0,5,5,3,2,"run023"
"4552","GGB","RBG",0,4,4,2,2,"run023"
"4553","GGB","RBR",0,5,5,1,4,"run023"
"4554","GGB","RGG",1,5,6,4,2,"run023"
"4555","GGB","RGR",0,2,2,0,2,"run023"
"4556","GGB","RRG",1,5,6,0,6,"run023"
"4557","GGB","RRR",1,5,6,1,5,"run023"
"4558","GGG","BBB",8,31,39,26,13,"run023"
"4559","GGG","BGB",0,2,2,0,2,"run023"
"4560","GGG","BGG",1,7,8,4,4,"run023"
"4561","GGG","BRB",1,3,4,0,4,"run023"
"4562","GGG","BRR",0,6,6,6,0,"run023"
"4563","GGG","GGB",5,1,6,1,5,"run023"
"4564","GGG","GGR",1,9,10,8,2,"run023"
"4565","GGG","GRR",0,2,2,0,2,"run023"
"4566","GGG","RBB",1,8,9,7,2,"run023"
"4567","GGG","RBG",0,6,6,4,2,"run023"
"4568","GGG","RBR",0,21,21,11,10,"run023"
"4569","GGG","RGG",0,3,3,1,2,"run023"
"4570","GGG","RGR",1,12,13,1,12,"run023"
"4571","GGG","RRG",1,23,24,1,23,"run023"
"4572","GGG","RRR",0,3,3,3,0,"run023"
"4573","GGR","BBB",0,2,2,2,0,"run023"
"4574","GGR","BBR",0,2,2,2,0,"run023"
"4575","GGR","BGG",0,1,1,1,0,"run023"
"4576","GGR","BRR",1,0,1,1,0,"run023"
"4577","GGR","GRR",1,0,1,1,0,"run023"
"4578","GGR","RBB",0,2,2,2,0,"run023"
"4579","GRG","BBB",3,8,11,0,11,"run023"
"4580","GRG","BBR",0,1,1,0,1,"run023"
"4581","GRG","BGG",0,1,1,1,0,"run023"
"4582","GRG","BRB",0,3,3,3,0,"run023"
"4583","GRG","BRR",0,1,1,0,1,"run023"
"4584","GRG","GBG",0,1,1,0,1,"run023"
"4585","GRG","GGB",2,15,17,7,10,"run023"
"4586","GRG","GGG",3,12,15,9,6,"run023"
"4587","GRG","GGR",0,5,5,2,3,"run023"
"4588","GRG","GRR",0,1,1,0,1,"run023"
"4589","GRG","RBG",0,1,1,0,1,"run023"
"4590","GRG","RBR",0,1,1,0,1,"run023"
"4591","GRG","RGR",1,2,3,2,1,"run023"
"4592","GRG","RRG",2,4,6,6,0,"run023"
"4593","GRR","BBB",0,1,1,0,1,"run023"
"4594","GRR","BBR",0,1,1,0,1,"run023"
"4595","GRR","BGB",1,2,3,3,0,"run023"
"4596","GRR","BGG",0,2,2,2,0,"run023"
"4597","GRR","BRB",0,1,1,1,0,"run023"
"4598","GRR","BRR",0,2,2,2,0,"run023"
"4599","GRR","GGG",0,1,1,1,0,"run023"
"4600","GRR","GGR",0,1,1,0,1,"run023"
"4601","RBB","BBB",0,1,1,0,1,"run023"
"4602","RBB","BBR",0,1,1,1,0,"run023"
"4603","RBB","BRB",0,1,1,0,1,"run023"
"4604","RBB","GRR",0,1,1,1,0,"run023"
"4605","RBB","RGG",0,1,1,1,0,"run023"
"4606","RBG","BBB",2,8,10,2,8,"run023"
"4607","RBG","BBG",0,1,1,0,1,"run023"
"4608","RBG","BRR",0,1,1,1,0,"run023"
"4609","RBG","GBB",0,1,1,1,0,"run023"
"4610","RBG","GRR",0,3,3,3,0,"run023"
"4611","RBG","RBB",1,1,2,0,2,"run023"
"4612","RBG","RBR",0,1,1,0,1,"run023"
"4613","RBG","RGR",0,1,1,0,1,"run023"
"4614","RBR","BBB",0,13,13,2,11,"run023"
"4615","RBR","BBR",0,1,1,0,1,"run023"
"4616","RBR","BGB",2,4,6,1,5,"run023"
"4617","RBR","BGG",0,2,2,2,0,"run023"
"4618","RBR","BRB",1,0,1,1,0,"run023"
"4619","RBR","BRR",1,4,5,0,5,"run023"
"4620","RBR","GGB",0,12,12,12,0,"run023"
"4621","RBR","GRR",4,4,8,1,7,"run023"
"4622","RBR","RBB",0,3,3,0,3,"run023"
"4623","RBR","RGG",2,9,11,0,11,"run023"
"4624","RBR","RGR",1,0,1,1,0,"run023"
"4625","RBR","RRR",0,1,1,0,1,"run023"
"4626","RGG","BBB",0,8,8,7,1,"run023"
"4627","RGG","BBR",1,2,3,3,0,"run023"
"4628","RGG","BGB",0,1,1,0,1,"run023"
"4629","RGG","BRR",0,4,4,1,3,"run023"
"4630","RGG","GGG",0,1,1,1,0,"run023"
"4631","RGG","GGR",0,3,3,3,0,"run023"
"4632","RGG","GRR",0,8,8,4,4,"run023"
"4633","RGG","RBB",0,1,1,0,1,"run023"
"4634","RGR","BBB",2,5,7,2,5,"run023"
"4635","RGR","BBR",1,1,2,0,2,"run023"
"4636","RGR","BGB",2,5,7,0,7,"run023"
"4637","RGR","BGG",2,2,4,4,0,"run023"
"4638","RGR","BRR",1,5,6,3,3,"run023"
"4639","RGR","GGB",2,12,14,14,0,"run023"
"4640","RGR","GGG",0,2,2,1,1,"run023"
"4641","RGR","GGR",0,4,4,3,1,"run023"
"4642","RGR","RBB",0,4,4,1,3,"run023"
"4643","RGR","RGG",1,1,2,2,0,"run023"
"4644","RGR","RRG",0,3,3,2,1,"run023"
"4645","RRG","BBB",2,33,35,17,18,"run023"
"4646","RRG","BBR",0,5,5,1,4,"run023"
"4647","RRG","BGB",1,10,11,9,2,"run023"
"4648","RRG","BGG",0,2,2,2,0,"run023"
"4649","RRG","BRB",2,40,42,30,12,"run023"
"4650","RRG","BRR",1,16,17,2,15,"run023"
"4651","RRG","GGG",2,14,16,0,16,"run023"
"4652","RRG","GGR",0,5,5,4,1,"run023"
"4653","RRG","GRG",1,0,1,0,1,"run023"
"4654","RRG","GRR",3,8,11,2,9,"run023"
"4655","RRG","RBB",1,1,2,2,0,"run023"
"4656","RRG","RGG",0,1,1,1,0,"run023"
"4657","RRG","RGR",0,1,1,1,0,"run023"
"4658","RRR","BBR",1,0,1,1,0,"run023"
"4659","RRR","BGB",2,1,3,3,0,"run023"
"4660","RRR","BGG",1,0,1,1,0,"run023"
"4661","RRR","BRB",1,1,2,1,1,"run023"
"4662","RRR","BRR",1,1,2,2,0,"run023"
"4663","RRR","GGR",0,1,1,1,0,"run023"
"4664","RRR","GRR",0,3,3,0,3,"run023"
"4665","RRR","RBB",1,2,3,1,2,"run023"
"4666","RRR","RBR",0,2,2,2,0,"run023"
"4667","RRR","RGG",0,1,1,1,0,"run023"
"4668","RRR","RGR",1,2,3,2,1,"run023"
"4669","RRR","RRG",2,2,4,1,3,"run023"
"4670","BBB","BRB",0,1,1,0,1,"run024"
"4671","BBB","GGG",1,2,3,2,1,"run024"
"4672","BBB","GRR",0,2,2,2,0,"run024"
"4673","BBB","RBG",0,1,1,1,0,"run024"
"4674","BBB","RRG",1,3,4,2,2,"run024"
"4675","BBB","RRR",0,2,2,0,2,"run024"
"4676","BBG","BBB",1,4,5,1,4,"run024"
"4677","BBG","BGB",0,1,1,1,0,"run024"
"4678","BBG","BGG",0,1,1,1,0,"run024"
"4679","BBG","BRB",1,16,17,8,9,"run024"
"4680","BBG","GBB",0,1,1,1,0,"run024"
"4681","BBG","GBG",2,7,9,8,1,"run024"
"4682","BBG","GGB",2,25,27,7,20,"run024"
"4683","BBG","GGG",4,38,42,16,26,"run024"
"4684","BBG","GRG",1,9,10,7,3,"run024"
"4685","BBG","GRR",0,1,1,0,1,"run024"
"4686","BBG","RBB",0,1,1,0,1,"run024"
"4687","BBG","RBG",0,4,4,4,0,"run024"
"4688","BBG","RBR",0,1,1,1,0,"run024"
"4689","BBG","RGR",0,1,1,0,1,"run024"
"4690","BBG","RRG",1,2,3,3,0,"run024"
"4691","BBG","RRR",0,7,7,4,3,"run024"
"4692","BGB","BBB",0,2,2,1,1,"run024"
"4693","BGB","RRG",0,1,1,0,1,"run024"
"4694","BGG","BBB",0,3,3,3,0,"run024"
"4695","BGG","BBR",0,1,1,0,1,"run024"
"4696","BGG","GRG",0,1,1,0,1,"run024"
"4697","BGG","RBG",1,1,2,0,2,"run024"
"4698","BGG","RGG",0,3,3,1,2,"run024"
"4699","BGG","RGR",0,1,1,0,1,"run024"
"4700","BGG","RRR",1,1,2,0,2,"run024"
"4701","BRB","BBB",0,13,13,3,10,"run024"
"4702","BRB","BBR",0,1,1,1,0,"run024"
"4703","BRB","BRR",0,3,3,1,2,"run024"
"4704","BRB","GGG",0,1,1,0,1,"run024"
"4705","BRB","GGR",0,1,1,1,0,"run024"
"4706","BRB","RBB",0,1,1,1,0,"run024"
"4707","BRB","RBG",0,1,1,1,0,"run024"
"4708","BRB","RGR",0,1,1,1,0,"run024"
"4709","BRB","RRR",0,1,1,1,0,"run024"
"4710","BRR","BBB",0,11,11,2,9,"run024"
"4711","BRR","BGB",1,1,2,0,2,"run024"
"4712","BRR","BGG",0,1,1,0,1,"run024"
"4713","BRR","BRB",0,1,1,0,1,"run024"
"4714","BRR","RBB",0,2,2,1,1,"run024"
"4715","GBB","BBB",12,38,50,6,44,"run024"
"4716","GBB","BGG",0,1,1,0,1,"run024"
"4717","GBB","BRB",1,9,10,5,5,"run024"
"4718","GBB","BRR",1,3,4,0,4,"run024"
"4719","GBB","GBG",0,4,4,1,3,"run024"
"4720","GBB","GGB",0,21,21,3,18,"run024"
"4721","GBB","GGG",7,86,93,14,79,"run024"
"4722","GBB","GGR",1,3,4,2,2,"run024"
"4723","GBB","GRG",0,6,6,5,1,"run024"
"4724","GBB","GRR",0,1,1,1,0,"run024"
"4725","GBB","RBB",0,2,2,2,0,"run024"
"4726","GBB","RBG",3,9,12,3,9,"run024"
"4727","GBB","RBR",1,0,1,1,0,"run024"
"4728","GBB","RGG",1,0,1,0,1,"run024"
"4729","GBB","RGR",2,1,3,1,2,"run024"
"4730","GBB","RRG",0,2,2,0,2,"run024"
"4731","GBB","RRR",1,9,10,0,10,"run024"
"4732","GBG","BBB",0,5,5,0,5,"run024"
"4733","GBG","BBR",0,1,1,0,1,"run024"
"4734","GBG","BRB",1,4,5,2,3,"run024"
"4735","GBG","BRR",1,0,1,0,1,"run024"
"4736","GBG","GGB",0,4,4,3,1,"run024"
"4737","GBG","GGG",4,11,15,6,9,"run024"
"4738","GBG","RBB",1,0,1,0,1,"run024"
"4739","GBG","RBG",0,1,1,0,1,"run024"
"4740","GBG","RGG",0,1,1,1,0,"run024"
"4741","GBG","RGR",1,3,4,4,0,"run024"
"4742","GBG","RRG",1,3,4,1,3,"run024"
"4743","GGB","BBB",3,16,19,9,10,"run024"
"4744","GGB","BBR",1,4,5,3,2,"run024"
"4745","GGB","BGB",0,3,3,3,0,"run024"
"4746","GGB","BGG",0,4,4,1,3,"run024"
"4747","GGB","BRB",0,1,1,1,0,"run024"
"4748","GGB","BRR",1,15,16,7,9,"run024"
"4749","GGB","GBB",0,1,1,0,1,"run024"
"4750","GGB","GBG",1,0,1,0,1,"run024"
"4751","GGB","GGG",13,48,61,9,52,"run024"
"4752","GGB","GGR",0,7,7,1,6,"run024"
"4753","GGB","GRR",0,4,4,1,3,"run024"
"4754","GGB","RBB",0,5,5,5,0,"run024"
"4755","GGB","RBG",0,4,4,2,2,"run024"
"4756","GGB","RBR",0,5,5,2,3,"run024"
"4757","GGB","RGG",1,5,6,4,2,"run024"
"4758","GGB","RGR",0,2,2,2,0,"run024"
"4759","GGB","RRG",1,5,6,1,5,"run024"
"4760","GGB","RRR",1,5,6,2,4,"run024"
"4761","GGG","BBB",8,31,39,30,9,"run024"
"4762","GGG","BGB",0,2,2,2,0,"run024"
"4763","GGG","BGG",1,7,8,0,8,"run024"
"4764","GGG","BRB",1,3,4,1,3,"run024"
"4765","GGG","BRR",0,6,6,1,5,"run024"
"4766","GGG","GGB",5,1,6,0,6,"run024"
"4767","GGG","GGR",1,9,10,7,3,"run024"
"4768","GGG","GRR",0,2,2,2,0,"run024"
"4769","GGG","RBB",1,8,9,3,6,"run024"
"4770","GGG","RBG",0,6,6,4,2,"run024"
"4771","GGG","RBR",0,21,21,10,11,"run024"
"4772","GGG","RGG",0,3,3,3,0,"run024"
"4773","GGG","RGR",1,12,13,1,12,"run024"
"4774","GGG","RRG",1,23,24,17,7,"run024"
"4775","GGG","RRR",0,3,3,1,2,"run024"
"4776","GGR","BBB",0,2,2,0,2,"run024"
"4777","GGR","BBR",0,2,2,1,1,"run024"
"4778","GGR","BGG",0,1,1,1,0,"run024"
"4779","GGR","BRR",1,0,1,0,1,"run024"
"4780","GGR","GRR",1,0,1,0,1,"run024"
"4781","GGR","RBB",0,2,2,0,2,"run024"
"4782","GRG","BBB",3,8,11,2,9,"run024"
"4783","GRG","BBR",0,1,1,0,1,"run024"
"4784","GRG","BGG",0,1,1,0,1,"run024"
"4785","GRG","BRB",0,3,3,2,1,"run024"
"4786","GRG","BRR",0,1,1,1,0,"run024"
"4787","GRG","GBG",0,1,1,1,0,"run024"
"4788","GRG","GGB",2,15,17,1,16,"run024"
"4789","GRG","GGG",3,12,15,15,0,"run024"
"4790","GRG","GGR",0,5,5,1,4,"run024"
"4791","GRG","GRR",0,1,1,1,0,"run024"
"4792","GRG","RBG",0,1,1,0,1,"run024"
"4793","GRG","RBR",0,1,1,1,0,"run024"
"4794","GRG","RGR",1,2,3,2,1,"run024"
"4795","GRG","RRG",2,4,6,0,6,"run024"
"4796","GRR","BBB",0,1,1,0,1,"run024"
"4797","GRR","BBR",0,1,1,0,1,"run024"
"4798","GRR","BGB",1,2,3,2,1,"run024"
"4799","GRR","BGG",0,2,2,1,1,"run024"
"4800","GRR","BRB",0,1,1,0,1,"run024"
"4801","GRR","BRR",0,2,2,2,0,"run024"
"4802","GRR","GGG",0,1,1,1,0,"run024"
"4803","GRR","GGR",0,1,1,0,1,"run024"
"4804","RBB","BBB",0,1,1,0,1,"run024"
"4805","RBB","BBR",0,1,1,0,1,"run024"
"4806","RBB","BRB",0,1,1,0,1,"run024"
"4807","RBB","GRR",0,1,1,0,1,"run024"
"4808","RBB","RGG",0,1,1,0,1,"run024"
"4809","RBG","BBB",2,8,10,5,5,"run024"
"4810","RBG","BBG",0,1,1,0,1,"run024"
"4811","RBG","BRR",0,1,1,0,1,"run024"
"4812","RBG","GBB",0,1,1,0,1,"run024"
"4813","RBG","GRR",0,3,3,2,1,"run024"
"4814","RBG","RBB",1,1,2,2,0,"run024"
"4815","RBG","RBR",0,1,1,1,0,"run024"
"4816","RBG","RGR",0,1,1,1,0,"run024"
"4817","RBR","BBB",0,13,13,2,11,"run024"
"4818","RBR","BBR",0,1,1,1,0,"run024"
"4819","RBR","BGB",2,4,6,0,6,"run024"
"4820","RBR","BGG",0,2,2,0,2,"run024"
"4821","RBR","BRB",1,0,1,0,1,"run024"
"4822","RBR","BRR",1,4,5,3,2,"run024"
"4823","RBR","GGB",0,12,12,0,12,"run024"
"4824","RBR","GRR",4,4,8,1,7,"run024"
"4825","RBR","RBB",0,3,3,0,3,"run024"
"4826","RBR","RGG",2,9,11,8,3,"run024"
"4827","RBR","RGR",1,0,1,1,0,"run024"
"4828","RBR","RRR",0,1,1,1,0,"run024"
"4829","RGG","BBB",0,8,8,0,8,"run024"
"4830","RGG","BBR",1,2,3,1,2,"run024"
"4831","RGG","BGB",0,1,1,1,0,"run024"
"4832","RGG","BRR",0,4,4,3,1,"run024"
"4833","RGG","GGG",0,1,1,1,0,"run024"
"4834","RGG","GGR",0,3,3,3,0,"run024"
"4835","RGG","GRR",0,8,8,5,3,"run024"
"4836","RGG","RBB",0,1,1,0,1,"run024"
"4837","RGR","BBB",2,5,7,7,0,"run024"
"4838","RGR","BBR",1,1,2,0,2,"run024"
"4839","RGR","BGB",2,5,7,4,3,"run024"
"4840","RGR","BGG",2,2,4,1,3,"run024"
"4841","RGR","BRR",1,5,6,6,0,"run024"
"4842","RGR","GGB",2,12,14,9,5,"run024"
"4843","RGR","GGG",0,2,2,0,2,"run024"
"4844","RGR","GGR",0,4,4,0,4,"run024"
"4845","RGR","RBB",0,4,4,3,1,"run024"
"4846","RGR","RGG",1,1,2,1,1,"run024"
"4847","RGR","RRG",0,3,3,3,0,"run024"
"4848","RRG","BBB",2,33,35,9,26,"run024"
"4849","RRG","BBR",0,5,5,1,4,"run024"
"4850","RRG","BGB",1,10,11,11,0,"run024"
"4851","RRG","BGG",0,2,2,2,0,"run024"
"4852","RRG","BRB",2,40,42,40,2,"run024"
"4853","RRG","BRR",1,16,17,4,13,"run024"
"4854","RRG","GGG",2,14,16,7,9,"run024"
"4855","RRG","GGR",0,5,5,5,0,"run024"
"4856","RRG","GRG",1,0,1,0,1,"run024"
"4857","RRG","GRR",3,8,11,5,6,"run024"
"4858","RRG","RBB",1,1,2,1,1,"run024"
"4859","RRG","RGG",0,1,1,0,1,"run024"
"4860","RRG","RGR",0,1,1,0,1,"run024"
"4861","RRR","BBR",1,0,1,0,1,"run024"
"4862","RRR","BGB",2,1,3,3,0,"run024"
"4863","RRR","BGG",1,0,1,0,1,"run024"
"4864","RRR","BRB",1,1,2,0,2,"run024"
"4865","RRR","BRR",1,1,2,2,0,"run024"
"4866","RRR","GGR",0,1,1,0,1,"run024"
"4867","RRR","GRR",0,3,3,3,0,"run024"
"4868","RRR","RBB",1,2,3,3,0,"run024"
"4869","RRR","RBR",0,2,2,0,2,"run024"
"4870","RRR","RGG",0,1,1,0,1,"run024"
"4871","RRR","RGR",1,2,3,3,0,"run024"
"4872","RRR","RRG",2,2,4,3,1,"run024"
"4873","BBB","BRB",0,1,1,0,1,"run025"
"4874","BBB","GGG",1,2,3,0,3,"run025"
"4875","BBB","GRR",0,2,2,0,2,"run025"
"4876","BBB","RBG",0,1,1,0,1,"run025"
"4877","BBB","RRG",1,3,4,0,4,"run025"
"4878","BBB","RRR",0,2,2,1,1,"run025"
"4879","BBG","BBB",1,4,5,2,3,"run025"
"4880","BBG","BGB",0,1,1,1,0,"run025"
"4881","BBG","BGG",0,1,1,1,0,"run025"
"4882","BBG","BRB",1,16,17,3,14,"run025"
"4883","BBG","GBB",0,1,1,0,1,"run025"
"4884","BBG","GBG",2,7,9,7,2,"run025"
"4885","BBG","GGB",2,25,27,2,25,"run025"
"4886","BBG","GGG",4,38,42,40,2,"run025"
"4887","BBG","GRG",1,9,10,7,3,"run025"
"4888","BBG","GRR",0,1,1,1,0,"run025"
"4889","BBG","RBB",0,1,1,0,1,"run025"
"4890","BBG","RBG",0,4,4,4,0,"run025"
"4891","BBG","RBR",0,1,1,0,1,"run025"
"4892","BBG","RGR",0,1,1,1,0,"run025"
"4893","BBG","RRG",1,2,3,1,2,"run025"
"4894","BBG","RRR",0,7,7,0,7,"run025"
"4895","BGB","BBB",0,2,2,2,0,"run025"
"4896","BGB","RRG",0,1,1,1,0,"run025"
"4897","BGG","BBB",0,3,3,3,0,"run025"
"4898","BGG","BBR",0,1,1,0,1,"run025"
"4899","BGG","GRG",0,1,1,0,1,"run025"
"4900","BGG","RBG",1,1,2,0,2,"run025"
"4901","BGG","RGG",0,3,3,0,3,"run025"
"4902","BGG","RGR",0,1,1,0,1,"run025"
"4903","BGG","RRR",1,1,2,0,2,"run025"
"4904","BRB","BBB",0,13,13,13,0,"run025"
"4905","BRB","BBR",0,1,1,0,1,"run025"
"4906","BRB","BRR",0,3,3,3,0,"run025"
"4907","BRB","GGG",0,1,1,0,1,"run025"
"4908","BRB","GGR",0,1,1,0,1,"run025"
"4909","BRB","RBB",0,1,1,1,0,"run025"
"4910","BRB","RBG",0,1,1,1,0,"run025"
"4911","BRB","RGR",0,1,1,0,1,"run025"
"4912","BRB","RRR",0,1,1,1,0,"run025"
"4913","BRR","BBB",0,11,11,5,6,"run025"
"4914","BRR","BGB",1,1,2,2,0,"run025"
"4915","BRR","BGG",0,1,1,0,1,"run025"
"4916","BRR","BRB",0,1,1,1,0,"run025"
"4917","BRR","RBB",0,2,2,0,2,"run025"
"4918","GBB","BBB",12,38,50,20,30,"run025"
"4919","GBB","BGG",0,1,1,1,0,"run025"
"4920","GBB","BRB",1,9,10,8,2,"run025"
"4921","GBB","BRR",1,3,4,3,1,"run025"
"4922","GBB","GBG",0,4,4,0,4,"run025"
"4923","GBB","GGB",0,21,21,1,20,"run025"
"4924","GBB","GGG",7,86,93,8,85,"run025"
"4925","GBB","GGR",1,3,4,2,2,"run025"
"4926","GBB","GRG",0,6,6,3,3,"run025"
"4927","GBB","GRR",0,1,1,1,0,"run025"
"4928","GBB","RBB",0,2,2,2,0,"run025"
"4929","GBB","RBG",3,9,12,2,10,"run025"
"4930","GBB","RBR",1,0,1,1,0,"run025"
"4931","GBB","RGG",1,0,1,1,0,"run025"
"4932","GBB","RGR",2,1,3,3,0,"run025"
"4933","GBB","RRG",0,2,2,0,2,"run025"
"4934","GBB","RRR",1,9,10,2,8,"run025"
"4935","GBG","BBB",0,5,5,3,2,"run025"
"4936","GBG","BBR",0,1,1,1,0,"run025"
"4937","GBG","BRB",1,4,5,2,3,"run025"
"4938","GBG","BRR",1,0,1,1,0,"run025"
"4939","GBG","GGB",0,4,4,2,2,"run025"
"4940","GBG","GGG",4,11,15,1,14,"run025"
"4941","GBG","RBB",1,0,1,1,0,"run025"
"4942","GBG","RBG",0,1,1,0,1,"run025"
"4943","GBG","RGG",0,1,1,1,0,"run025"
"4944","GBG","RGR",1,3,4,1,3,"run025"
"4945","GBG","RRG",1,3,4,4,0,"run025"
"4946","GGB","BBB",3,16,19,2,17,"run025"
"4947","GGB","BBR",1,4,5,4,1,"run025"
"4948","GGB","BGB",0,3,3,3,0,"run025"
"4949","GGB","BGG",0,4,4,1,3,"run025"
"4950","GGB","BRB",0,1,1,0,1,"run025"
"4951","GGB","BRR",1,15,16,9,7,"run025"
"4952","GGB","GBB",0,1,1,0,1,"run025"
"4953","GGB","GBG",1,0,1,1,0,"run025"
"4954","GGB","GGG",13,48,61,19,42,"run025"
"4955","GGB","GGR",0,7,7,3,4,"run025"
"4956","GGB","GRR",0,4,4,2,2,"run025"
"4957","GGB","RBB",0,5,5,3,2,"run025"
"4958","GGB","RBG",0,4,4,0,4,"run025"
"4959","GGB","RBR",0,5,5,5,0,"run025"
"4960","GGB","RGG",1,5,6,5,1,"run025"
"4961","GGB","RGR",0,2,2,2,0,"run025"
"4962","GGB","RRG",1,5,6,6,0,"run025"
"4963","GGB","RRR",1,5,6,0,6,"run025"
"4964","GGG","BBB",8,31,39,15,24,"run025"
"4965","GGG","BGB",0,2,2,1,1,"run025"
"4966","GGG","BGG",1,7,8,3,5,"run025"
"4967","GGG","BRB",1,3,4,4,0,"run025"
"4968","GGG","BRR",0,6,6,3,3,"run025"
"4969","GGG","GGB",5,1,6,5,1,"run025"
"4970","GGG","GGR",1,9,10,7,3,"run025"
"4971","GGG","GRR",0,2,2,2,0,"run025"
"4972","GGG","RBB",1,8,9,7,2,"run025"
"4973","GGG","RBG",0,6,6,5,1,"run025"
"4974","GGG","RBR",0,21,21,14,7,"run025"
"4975","GGG","RGG",0,3,3,3,0,"run025"
"4976","GGG","RGR",1,12,13,11,2,"run025"
"4977","GGG","RRG",1,23,24,8,16,"run025"
"4978","GGG","RRR",0,3,3,1,2,"run025"
"4979","GGR","BBB",0,2,2,0,2,"run025"
"4980","GGR","BBR",0,2,2,0,2,"run025"
"4981","GGR","BGG",0,1,1,1,0,"run025"
"4982","GGR","BRR",1,0,1,1,0,"run025"
"4983","GGR","GRR",1,0,1,0,1,"run025"
"4984","GGR","RBB",0,2,2,0,2,"run025"
"4985","GRG","BBB",3,8,11,5,6,"run025"
"4986","GRG","BBR",0,1,1,1,0,"run025"
"4987","GRG","BGG",0,1,1,1,0,"run025"
"4988","GRG","BRB",0,3,3,1,2,"run025"
"4989","GRG","BRR",0,1,1,0,1,"run025"
"4990","GRG","GBG",0,1,1,0,1,"run025"
"4991","GRG","GGB",2,15,17,17,0,"run025"
"4992","GRG","GGG",3,12,15,9,6,"run025"
"4993","GRG","GGR",0,5,5,1,4,"run025"
"4994","GRG","GRR",0,1,1,1,0,"run025"
"4995","GRG","RBG",0,1,1,1,0,"run025"
"4996","GRG","RBR",0,1,1,0,1,"run025"
"4997","GRG","RGR",1,2,3,3,0,"run025"
"4998","GRG","RRG",2,4,6,3,3,"run025"
"4999","GRR","BBB",0,1,1,1,0,"run025"
"5000","GRR","BBR",0,1,1,0,1,"run025"
"5001","GRR","BGB",1,2,3,2,1,"run025"
"5002","GRR","BGG",0,2,2,1,1,"run025"
"5003","GRR","BRB",0,1,1,0,1,"run025"
"5004","GRR","BRR",0,2,2,2,0,"run025"
"5005","GRR","GGG",0,1,1,0,1,"run025"
"5006","GRR","GGR",0,1,1,1,0,"run025"
"5007","RBB","BBB",0,1,1,0,1,"run025"
"5008","RBB","BBR",0,1,1,1,0,"run025"
"5009","RBB","BRB",0,1,1,0,1,"run025"
"5010","RBB","GRR",0,1,1,0,1,"run025"
"5011","RBB","RGG",0,1,1,0,1,"run025"
"5012","RBG","BBB",2,8,10,5,5,"run025"
"5013","RBG","BBG",0,1,1,0,1,"run025"
"5014","RBG","BRR",0,1,1,0,1,"run025"
"5015","RBG","GBB",0,1,1,0,1,"run025"
"5016","RBG","GRR",0,3,3,2,1,"run025"
"5017","RBG","RBB",1,1,2,2,0,"run025"
"5018","RBG","RBR",0,1,1,0,1,"run025"
"5019","RBG","RGR",0,1,1,1,0,"run025"
"5020","RBR","BBB",0,13,13,10,3,"run025"
"5021","RBR","BBR",0,1,1,1,0,"run025"
"5022","RBR","BGB",2,4,6,0,6,"run025"
"5023","RBR","BGG",0,2,2,0,2,"run025"
"5024","RBR","BRB",1,0,1,0,1,"run025"
"5025","RBR","BRR",1,4,5,2,3,"run025"
"5026","RBR","GGB",0,12,12,8,4,"run025"
"5027","RBR","GRR",4,4,8,8,0,"run025"
"5028","RBR","RBB",0,3,3,0,3,"run025"
"5029","RBR","RGG",2,9,11,2,9,"run025"
"5030","RBR","RGR",1,0,1,1,0,"run025"
"5031","RBR","RRR",0,1,1,0,1,"run025"
"5032","RGG","BBB",0,8,8,2,6,"run025"
"5033","RGG","BBR",1,2,3,2,1,"run025"
"5034","RGG","BGB",0,1,1,0,1,"run025"
"5035","RGG","BRR",0,4,4,2,2,"run025"
"5036","RGG","GGG",0,1,1,1,0,"run025"
"5037","RGG","GGR",0,3,3,3,0,"run025"
"5038","RGG","GRR",0,8,8,5,3,"run025"
"5039","RGG","RBB",0,1,1,1,0,"run025"
"5040","RGR","BBB",2,5,7,6,1,"run025"
"5041","RGR","BBR",1,1,2,2,0,"run025"
"5042","RGR","BGB",2,5,7,7,0,"run025"
"5043","RGR","BGG",2,2,4,3,1,"run025"
"5044","RGR","BRR",1,5,6,3,3,"run025"
"5045","RGR","GGB",2,12,14,13,1,"run025"
"5046","RGR","GGG",0,2,2,1,1,"run025"
"5047","RGR","GGR",0,4,4,4,0,"run025"
"5048","RGR","RBB",0,4,4,2,2,"run025"
"5049","RGR","RGG",1,1,2,1,1,"run025"
"5050","RGR","RRG",0,3,3,1,2,"run025"
"5051","RRG","BBB",2,33,35,25,10,"run025"
"5052","RRG","BBR",0,5,5,1,4,"run025"
"5053","RRG","BGB",1,10,11,2,9,"run025"
"5054","RRG","BGG",0,2,2,2,0,"run025"
"5055","RRG","BRB",2,40,42,24,18,"run025"
"5056","RRG","BRR",1,16,17,15,2,"run025"
"5057","RRG","GGG",2,14,16,7,9,"run025"
"5058","RRG","GGR",0,5,5,4,1,"run025"
"5059","RRG","GRG",1,0,1,1,0,"run025"
"5060","RRG","GRR",3,8,11,7,4,"run025"
"5061","RRG","RBB",1,1,2,0,2,"run025"
"5062","RRG","RGG",0,1,1,1,0,"run025"
"5063","RRG","RGR",0,1,1,0,1,"run025"
"5064","RRR","BBR",1,0,1,1,0,"run025"
"5065","RRR","BGB",2,1,3,1,2,"run025"
"5066","RRR","BGG",1,0,1,0,1,"run025"
"5067","RRR","BRB",1,1,2,1,1,"run025"
"5068","RRR","BRR",1,1,2,2,0,"run025"
"5069","RRR","GGR",0,1,1,0,1,"run025"
"5070","RRR","GRR",0,3,3,2,1,"run025"
"5071","RRR","RBB",1,2,3,3,0,"run025"
"5072","RRR","RBR",0,2,2,1,1,"run025"
"5073","RRR","RGG",0,1,1,1,0,"run025"
"5074","RRR","RGR",1,2,3,0,3,"run025"
"5075","RRR","RRG",2,2,4,0,4,"run025"
"5076","BBB","BRB",0,1,1,1,0,"run026"
"5077","BBB","GGG",1,2,3,3,0,"run026"
"5078","BBB","GRR",0,2,2,2,0,"run026"
"5079","BBB","RBG",0,1,1,1,0,"run026"
"5080","BBB","RRG",1,3,4,2,2,"run026"
"5081","BBB","RRR",0,2,2,2,0,"run026"
"5082","BBG","BBB",1,4,5,0,5,"run026"
"5083","BBG","BGB",0,1,1,0,1,"run026"
"5084","BBG","BGG",0,1,1,1,0,"run026"
"5085","BBG","BRB",1,16,17,3,14,"run026"
"5086","BBG","GBB",0,1,1,1,0,"run026"
"5087","BBG","GBG",2,7,9,5,4,"run026"
"5088","BBG","GGB",2,25,27,13,14,"run026"
"5089","BBG","GGG",4,38,42,5,37,"run026"
"5090","BBG","GRG",1,9,10,2,8,"run026"
"5091","BBG","GRR",0,1,1,1,0,"run026"
"5092","BBG","RBB",0,1,1,1,0,"run026"
"5093","BBG","RBG",0,4,4,2,2,"run026"
"5094","BBG","RBR",0,1,1,1,0,"run026"
"5095","BBG","RGR",0,1,1,0,1,"run026"
"5096","BBG","RRG",1,2,3,3,0,"run026"
"5097","BBG","RRR",0,7,7,5,2,"run026"
"5098","BGB","BBB",0,2,2,0,2,"run026"
"5099","BGB","RRG",0,1,1,0,1,"run026"
"5100","BGG","BBB",0,3,3,3,0,"run026"
"5101","BGG","BBR",0,1,1,1,0,"run026"
"5102","BGG","GRG",0,1,1,0,1,"run026"
"5103","BGG","RBG",1,1,2,2,0,"run026"
"5104","BGG","RGG",0,3,3,2,1,"run026"
"5105","BGG","RGR",0,1,1,1,0,"run026"
"5106","BGG","RRR",1,1,2,0,2,"run026"
"5107","BRB","BBB",0,13,13,12,1,"run026"
"5108","BRB","BBR",0,1,1,0,1,"run026"
"5109","BRB","BRR",0,3,3,0,3,"run026"
"5110","BRB","GGG",0,1,1,1,0,"run026"
"5111","BRB","GGR",0,1,1,1,0,"run026"
"5112","BRB","RBB",0,1,1,0,1,"run026"
"5113","BRB","RBG",0,1,1,1,0,"run026"
"5114","BRB","RGR",0,1,1,1,0,"run026"
"5115","BRB","RRR",0,1,1,0,1,"run026"
"5116","BRR","BBB",0,11,11,8,3,"run026"
"5117","BRR","BGB",1,1,2,2,0,"run026"
"5118","BRR","BGG",0,1,1,1,0,"run026"
"5119","BRR","BRB",0,1,1,1,0,"run026"
"5120","BRR","RBB",0,2,2,2,0,"run026"
"5121","GBB","BBB",12,38,50,11,39,"run026"
"5122","GBB","BGG",0,1,1,1,0,"run026"
"5123","GBB","BRB",1,9,10,9,1,"run026"
"5124","GBB","BRR",1,3,4,2,2,"run026"
"5125","GBB","GBG",0,4,4,2,2,"run026"
"5126","GBB","GGB",0,21,21,4,17,"run026"
"5127","GBB","GGG",7,86,93,22,71,"run026"
"5128","GBB","GGR",1,3,4,4,0,"run026"
"5129","GBB","GRG",0,6,6,3,3,"run026"
"5130","GBB","GRR",0,1,1,1,0,"run026"
"5131","GBB","RBB",0,2,2,1,1,"run026"
"5132","GBB","RBG",3,9,12,12,0,"run026"
"5133","GBB","RBR",1,0,1,1,0,"run026"
"5134","GBB","RGG",1,0,1,0,1,"run026"
"5135","GBB","RGR",2,1,3,2,1,"run026"
"5136","GBB","RRG",0,2,2,2,0,"run026"
"5137","GBB","RRR",1,9,10,2,8,"run026"
"5138","GBG","BBB",0,5,5,2,3,"run026"
"5139","GBG","BBR",0,1,1,0,1,"run026"
"5140","GBG","BRB",1,4,5,3,2,"run026"
"5141","GBG","BRR",1,0,1,0,1,"run026"
"5142","GBG","GGB",0,4,4,2,2,"run026"
"5143","GBG","GGG",4,11,15,9,6,"run026"
"5144","GBG","RBB",1,0,1,0,1,"run026"
"5145","GBG","RBG",0,1,1,0,1,"run026"
"5146","GBG","RGG",0,1,1,1,0,"run026"
"5147","GBG","RGR",1,3,4,3,1,"run026"
"5148","GBG","RRG",1,3,4,0,4,"run026"
"5149","GGB","BBB",3,16,19,10,9,"run026"
"5150","GGB","BBR",1,4,5,0,5,"run026"
"5151","GGB","BGB",0,3,3,0,3,"run026"
"5152","GGB","BGG",0,4,4,2,2,"run026"
"5153","GGB","BRB",0,1,1,0,1,"run026"
"5154","GGB","BRR",1,15,16,15,1,"run026"
"5155","GGB","GBB",0,1,1,0,1,"run026"
"5156","GGB","GBG",1,0,1,0,1,"run026"
"5157","GGB","GGG",13,48,61,54,7,"run026"
"5158","GGB","GGR",0,7,7,6,1,"run026"
"5159","GGB","GRR",0,4,4,3,1,"run026"
"5160","GGB","RBB",0,5,5,0,5,"run026"
"5161","GGB","RBG",0,4,4,3,1,"run026"
"5162","GGB","RBR",0,5,5,2,3,"run026"
"5163","GGB","RGG",1,5,6,2,4,"run026"
"5164","GGB","RGR",0,2,2,1,1,"run026"
"5165","GGB","RRG",1,5,6,2,4,"run026"
"5166","GGB","RRR",1,5,6,1,5,"run026"
"5167","GGG","BBB",8,31,39,27,12,"run026"
"5168","GGG","BGB",0,2,2,0,2,"run026"
"5169","GGG","BGG",1,7,8,7,1,"run026"
"5170","GGG","BRB",1,3,4,1,3,"run026"
"5171","GGG","BRR",0,6,6,5,1,"run026"
"5172","GGG","GGB",5,1,6,3,3,"run026"
"5173","GGG","GGR",1,9,10,6,4,"run026"
"5174","GGG","GRR",0,2,2,2,0,"run026"
"5175","GGG","RBB",1,8,9,2,7,"run026"
"5176","GGG","RBG",0,6,6,6,0,"run026"
"5177","GGG","RBR",0,21,21,5,16,"run026"
"5178","GGG","RGG",0,3,3,3,0,"run026"
"5179","GGG","RGR",1,12,13,1,12,"run026"
"5180","GGG","RRG",1,23,24,18,6,"run026"
"5181","GGG","RRR",0,3,3,3,0,"run026"
"5182","GGR","BBB",0,2,2,1,1,"run026"
"5183","GGR","BBR",0,2,2,0,2,"run026"
"5184","GGR","BGG",0,1,1,1,0,"run026"
"5185","GGR","BRR",1,0,1,1,0,"run026"
"5186","GGR","GRR",1,0,1,1,0,"run026"
"5187","GGR","RBB",0,2,2,2,0,"run026"
"5188","GRG","BBB",3,8,11,3,8,"run026"
"5189","GRG","BBR",0,1,1,1,0,"run026"
"5190","GRG","BGG",0,1,1,0,1,"run026"
"5191","GRG","BRB",0,3,3,0,3,"run026"
"5192","GRG","BRR",0,1,1,0,1,"run026"
"5193","GRG","GBG",0,1,1,1,0,"run026"
"5194","GRG","GGB",2,15,17,14,3,"run026"
"5195","GRG","GGG",3,12,15,10,5,"run026"
"5196","GRG","GGR",0,5,5,5,0,"run026"
"5197","GRG","GRR",0,1,1,1,0,"run026"
"5198","GRG","RBG",0,1,1,0,1,"run026"
"5199","GRG","RBR",0,1,1,1,0,"run026"
"5200","GRG","RGR",1,2,3,3,0,"run026"
"5201","GRG","RRG",2,4,6,0,6,"run026"
"5202","GRR","BBB",0,1,1,1,0,"run026"
"5203","GRR","BBR",0,1,1,0,1,"run026"
"5204","GRR","BGB",1,2,3,3,0,"run026"
"5205","GRR","BGG",0,2,2,1,1,"run026"
"5206","GRR","BRB",0,1,1,0,1,"run026"
"5207","GRR","BRR",0,2,2,1,1,"run026"
"5208","GRR","GGG",0,1,1,1,0,"run026"
"5209","GRR","GGR",0,1,1,1,0,"run026"
"5210","RBB","BBB",0,1,1,0,1,"run026"
"5211","RBB","BBR",0,1,1,0,1,"run026"
"5212","RBB","BRB",0,1,1,1,0,"run026"
"5213","RBB","GRR",0,1,1,1,0,"run026"
"5214","RBB","RGG",0,1,1,1,0,"run026"
"5215","RBG","BBB",2,8,10,3,7,"run026"
"5216","RBG","BBG",0,1,1,1,0,"run026"
"5217","RBG","BRR",0,1,1,0,1,"run026"
"5218","RBG","GBB",0,1,1,0,1,"run026"
"5219","RBG","GRR",0,3,3,2,1,"run026"
"5220","RBG","RBB",1,1,2,2,0,"run026"
"5221","RBG","RBR",0,1,1,1,0,"run026"
"5222","RBG","RGR",0,1,1,0,1,"run026"
"5223","RBR","BBB",0,13,13,5,8,"run026"
"5224","RBR","BBR",0,1,1,0,1,"run026"
"5225","RBR","BGB",2,4,6,3,3,"run026"
"5226","RBR","BGG",0,2,2,2,0,"run026"
"5227","RBR","BRB",1,0,1,0,1,"run026"
"5228","RBR","BRR",1,4,5,3,2,"run026"
"5229","RBR","GGB",0,12,12,8,4,"run026"
"5230","RBR","GRR",4,4,8,0,8,"run026"
"5231","RBR","RBB",0,3,3,1,2,"run026"
"5232","RBR","RGG",2,9,11,7,4,"run026"
"5233","RBR","RGR",1,0,1,1,0,"run026"
"5234","RBR","RRR",0,1,1,1,0,"run026"
"5235","RGG","BBB",0,8,8,2,6,"run026"
"5236","RGG","BBR",1,2,3,2,1,"run026"
"5237","RGG","BGB",0,1,1,1,0,"run026"
"5238","RGG","BRR",0,4,4,1,3,"run026"
"5239","RGG","GGG",0,1,1,1,0,"run026"
"5240","RGG","GGR",0,3,3,2,1,"run026"
"5241","RGG","GRR",0,8,8,8,0,"run026"
"5242","RGG","RBB",0,1,1,0,1,"run026"
"5243","RGR","BBB",2,5,7,5,2,"run026"
"5244","RGR","BBR",1,1,2,2,0,"run026"
"5245","RGR","BGB",2,5,7,6,1,"run026"
"5246","RGR","BGG",2,2,4,1,3,"run026"
"5247","RGR","BRR",1,5,6,6,0,"run026"
"5248","RGR","GGB",2,12,14,13,1,"run026"
"5249","RGR","GGG",0,2,2,2,0,"run026"
"5250","RGR","GGR",0,4,4,1,3,"run026"
"5251","RGR","RBB",0,4,4,4,0,"run026"
"5252","RGR","RGG",1,1,2,1,1,"run026"
"5253","RGR","RRG",0,3,3,0,3,"run026"
"5254","RRG","BBB",2,33,35,19,16,"run026"
"5255","RRG","BBR",0,5,5,5,0,"run026"
"5256","RRG","BGB",1,10,11,0,11,"run026"
"5257","RRG","BGG",0,2,2,0,2,"run026"
"5258","RRG","BRB",2,40,42,14,28,"run026"
"5259","RRG","BRR",1,16,17,6,11,"run026"
"5260","RRG","GGG",2,14,16,1,15,"run026"
"5261","RRG","GGR",0,5,5,1,4,"run026"
"5262","RRG","GRG",1,0,1,0,1,"run026"
"5263","RRG","GRR",3,8,11,8,3,"run026"
"5264","RRG","RBB",1,1,2,2,0,"run026"
"5265","RRG","RGG",0,1,1,0,1,"run026"
"5266","RRG","RGR",0,1,1,0,1,"run026"
"5267","RRR","BBR",1,0,1,1,0,"run026"
"5268","RRR","BGB",2,1,3,0,3,"run026"
"5269","RRR","BGG",1,0,1,0,1,"run026"
"5270","RRR","BRB",1,1,2,2,0,"run026"
"5271","RRR","BRR",1,1,2,0,2,"run026"
"5272","RRR","GGR",0,1,1,1,0,"run026"
"5273","RRR","GRR",0,3,3,3,0,"run026"
"5274","RRR","RBB",1,2,3,0,3,"run026"
"5275","RRR","RBR",0,2,2,2,0,"run026"
"5276","RRR","RGG",0,1,1,1,0,"run026"
"5277","RRR","RGR",1,2,3,0,3,"run026"
"5278","RRR","RRG",2,2,4,1,3,"run026"
"5279","BBB","BRB",0,1,1,0,1,"run027"
"5280","BBB","GGG",1,2,3,1,2,"run027"
"5281","BBB","GRR",0,2,2,1,1,"run027"
"5282","BBB","RBG",0,1,1,0,1,"run027"
"5283","BBB","RRG",1,3,4,2,2,"run027"
"5284","BBB","RRR",0,2,2,0,2,"run027"
"5285","BBG","BBB",1,4,5,0,5,"run027"
"5286","BBG","BGB",0,1,1,0,1,"run027"
"5287","BBG","BGG",0,1,1,0,1,"run027"
"5288","BBG","BRB",1,16,17,0,17,"run027"
"5289","BBG","GBB",0,1,1,0,1,"run027"
"5290","BBG","GBG",2,7,9,2,7,"run027"
"5291","BBG","GGB",2,25,27,10,17,"run027"
"5292","BBG","GGG",4,38,42,13,29,"run027"
"5293","BBG","GRG",1,9,10,7,3,"run027"
"5294","BBG","GRR",0,1,1,0,1,"run027"
"5295","BBG","RBB",0,1,1,1,0,"run027"
"5296","BBG","RBG",0,4,4,0,4,"run027"
"5297","BBG","RBR",0,1,1,1,0,"run027"
"5298","BBG","RGR",0,1,1,0,1,"run027"
"5299","BBG","RRG",1,2,3,3,0,"run027"
"5300","BBG","RRR",0,7,7,3,4,"run027"
"5301","BGB","BBB",0,2,2,2,0,"run027"
"5302","BGB","RRG",0,1,1,0,1,"run027"
"5303","BGG","BBB",0,3,3,0,3,"run027"
"5304","BGG","BBR",0,1,1,1,0,"run027"
"5305","BGG","GRG",0,1,1,0,1,"run027"
"5306","BGG","RBG",1,1,2,0,2,"run027"
"5307","BGG","RGG",0,3,3,0,3,"run027"
"5308","BGG","RGR",0,1,1,0,1,"run027"
"5309","BGG","RRR",1,1,2,1,1,"run027"
"5310","BRB","BBB",0,13,13,3,10,"run027"
"5311","BRB","BBR",0,1,1,0,1,"run027"
"5312","BRB","BRR",0,3,3,0,3,"run027"
"5313","BRB","GGG",0,1,1,0,1,"run027"
"5314","BRB","GGR",0,1,1,1,0,"run027"
"5315","BRB","RBB",0,1,1,1,0,"run027"
"5316","BRB","RBG",0,1,1,0,1,"run027"
"5317","BRB","RGR",0,1,1,1,0,"run027"
"5318","BRB","RRR",0,1,1,1,0,"run027"
"5319","BRR","BBB",0,11,11,8,3,"run027"
"5320","BRR","BGB",1,1,2,1,1,"run027"
"5321","BRR","BGG",0,1,1,1,0,"run027"
"5322","BRR","BRB",0,1,1,0,1,"run027"
"5323","BRR","RBB",0,2,2,0,2,"run027"
"5324","GBB","BBB",12,38,50,24,26,"run027"
"5325","GBB","BGG",0,1,1,1,0,"run027"
"5326","GBB","BRB",1,9,10,8,2,"run027"
"5327","GBB","BRR",1,3,4,4,0,"run027"
"5328","GBB","GBG",0,4,4,0,4,"run027"
"5329","GBB","GGB",0,21,21,7,14,"run027"
"5330","GBB","GGG",7,86,93,67,26,"run027"
"5331","GBB","GGR",1,3,4,3,1,"run027"
"5332","GBB","GRG",0,6,6,5,1,"run027"
"5333","GBB","GRR",0,1,1,0,1,"run027"
"5334","GBB","RBB",0,2,2,2,0,"run027"
"5335","GBB","RBG",3,9,12,8,4,"run027"
"5336","GBB","RBR",1,0,1,0,1,"run027"
"5337","GBB","RGG",1,0,1,0,1,"run027"
"5338","GBB","RGR",2,1,3,0,3,"run027"
"5339","GBB","RRG",0,2,2,1,1,"run027"
"5340","GBB","RRR",1,9,10,2,8,"run027"
"5341","GBG","BBB",0,5,5,4,1,"run027"
"5342","GBG","BBR",0,1,1,0,1,"run027"
"5343","GBG","BRB",1,4,5,2,3,"run027"
"5344","GBG","BRR",1,0,1,0,1,"run027"
"5345","GBG","GGB",0,4,4,1,3,"run027"
"5346","GBG","GGG",4,11,15,11,4,"run027"
"5347","GBG","RBB",1,0,1,1,0,"run027"
"5348","GBG","RBG",0,1,1,1,0,"run027"
"5349","GBG","RGG",0,1,1,0,1,"run027"
"5350","GBG","RGR",1,3,4,2,2,"run027"
"5351","GBG","RRG",1,3,4,2,2,"run027"
"5352","GGB","BBB",3,16,19,6,13,"run027"
"5353","GGB","BBR",1,4,5,3,2,"run027"
"5354","GGB","BGB",0,3,3,3,0,"run027"
"5355","GGB","BGG",0,4,4,4,0,"run027"
"5356","GGB","BRB",0,1,1,0,1,"run027"
"5357","GGB","BRR",1,15,16,4,12,"run027"
"5358","GGB","GBB",0,1,1,0,1,"run027"
"5359","GGB","GBG",1,0,1,1,0,"run027"
"5360","GGB","GGG",13,48,61,59,2,"run027"
"5361","GGB","GGR",0,7,7,7,0,"run027"
"5362","GGB","GRR",0,4,4,0,4,"run027"
"5363","GGB","RBB",0,5,5,2,3,"run027"
"5364","GGB","RBG",0,4,4,4,0,"run027"
"5365","GGB","RBR",0,5,5,3,2,"run027"
"5366","GGB","RGG",1,5,6,1,5,"run027"
"5367","GGB","RGR",0,2,2,2,0,"run027"
"5368","GGB","RRG",1,5,6,4,2,"run027"
"5369","GGB","RRR",1,5,6,1,5,"run027"
"5370","GGG","BBB",8,31,39,20,19,"run027"
"5371","GGG","BGB",0,2,2,0,2,"run027"
"5372","GGG","BGG",1,7,8,1,7,"run027"
"5373","GGG","BRB",1,3,4,2,2,"run027"
"5374","GGG","BRR",0,6,6,1,5,"run027"
"5375","GGG","GGB",5,1,6,4,2,"run027"
"5376","GGG","GGR",1,9,10,8,2,"run027"
"5377","GGG","GRR",0,2,2,0,2,"run027"
"5378","GGG","RBB",1,8,9,4,5,"run027"
"5379","GGG","RBG",0,6,6,6,0,"run027"
"5380","GGG","RBR",0,21,21,13,8,"run027"
"5381","GGG","RGG",0,3,3,3,0,"run027"
"5382","GGG","RGR",1,12,13,4,9,"run027"
"5383","GGG","RRG",1,23,24,17,7,"run027"
"5384","GGG","RRR",0,3,3,1,2,"run027"
"5385","GGR","BBB",0,2,2,2,0,"run027"
"5386","GGR","BBR",0,2,2,2,0,"run027"
"5387","GGR","BGG",0,1,1,0,1,"run027"
"5388","GGR","BRR",1,0,1,1,0,"run027"
"5389","GGR","GRR",1,0,1,1,0,"run027"
"5390","GGR","RBB",0,2,2,0,2,"run027"
"5391","GRG","BBB",3,8,11,8,3,"run027"
"5392","GRG","BBR",0,1,1,0,1,"run027"
"5393","GRG","BGG",0,1,1,1,0,"run027"
"5394","GRG","BRB",0,3,3,2,1,"run027"
"5395","GRG","BRR",0,1,1,0,1,"run027"
"5396","GRG","GBG",0,1,1,0,1,"run027"
"5397","GRG","GGB",2,15,17,8,9,"run027"
"5398","GRG","GGG",3,12,15,6,9,"run027"
"5399","GRG","GGR",0,5,5,2,3,"run027"
"5400","GRG","GRR",0,1,1,0,1,"run027"
"5401","GRG","RBG",0,1,1,1,0,"run027"
"5402","GRG","RBR",0,1,1,0,1,"run027"
"5403","GRG","RGR",1,2,3,2,1,"run027"
"5404","GRG","RRG",2,4,6,3,3,"run027"
"5405","GRR","BBB",0,1,1,0,1,"run027"
"5406","GRR","BBR",0,1,1,0,1,"run027"
"5407","GRR","BGB",1,2,3,3,0,"run027"
"5408","GRR","BGG",0,2,2,2,0,"run027"
"5409","GRR","BRB",0,1,1,0,1,"run027"
"5410","GRR","BRR",0,2,2,2,0,"run027"
"5411","GRR","GGG",0,1,1,1,0,"run027"
"5412","GRR","GGR",0,1,1,0,1,"run027"
"5413","RBB","BBB",0,1,1,0,1,"run027"
"5414","RBB","BBR",0,1,1,1,0,"run027"
"5415","RBB","BRB",0,1,1,0,1,"run027"
"5416","RBB","GRR",0,1,1,0,1,"run027"
"5417","RBB","RGG",0,1,1,0,1,"run027"
"5418","RBG","BBB",2,8,10,8,2,"run027"
"5419","RBG","BBG",0,1,1,1,0,"run027"
"5420","RBG","BRR",0,1,1,1,0,"run027"
"5421","RBG","GBB",0,1,1,1,0,"run027"
"5422","RBG","GRR",0,3,3,2,1,"run027"
"5423","RBG","RBB",1,1,2,1,1,"run027"
"5424","RBG","RBR",0,1,1,1,0,"run027"
"5425","RBG","RGR",0,1,1,0,1,"run027"
"5426","RBR","BBB",0,13,13,7,6,"run027"
"5427","RBR","BBR",0,1,1,0,1,"run027"
"5428","RBR","BGB",2,4,6,6,0,"run027"
"5429","RBR","BGG",0,2,2,0,2,"run027"
"5430","RBR","BRB",1,0,1,0,1,"run027"
"5431","RBR","BRR",1,4,5,1,4,"run027"
"5432","RBR","GGB",0,12,12,8,4,"run027"
"5433","RBR","GRR",4,4,8,7,1,"run027"
"5434","RBR","RBB",0,3,3,2,1,"run027"
"5435","RBR","RGG",2,9,11,4,7,"run027"
"5436","RBR","RGR",1,0,1,1,0,"run027"
"5437","RBR","RRR",0,1,1,1,0,"run027"
"5438","RGG","BBB",0,8,8,3,5,"run027"
"5439","RGG","BBR",1,2,3,2,1,"run027"
"5440","RGG","BGB",0,1,1,1,0,"run027"
"5441","RGG","BRR",0,4,4,1,3,"run027"
"5442","RGG","GGG",0,1,1,0,1,"run027"
"5443","RGG","GGR",0,3,3,0,3,"run027"
"5444","RGG","GRR",0,8,8,7,1,"run027"
"5445","RGG","RBB",0,1,1,0,1,"run027"
"5446","RGR","BBB",2,5,7,3,4,"run027"
"5447","RGR","BBR",1,1,2,1,1,"run027"
"5448","RGR","BGB",2,5,7,1,6,"run027"
"5449","RGR","BGG",2,2,4,2,2,"run027"
"5450","RGR","BRR",1,5,6,4,2,"run027"
"5451","RGR","GGB",2,12,14,7,7,"run027"
"5452","RGR","GGG",0,2,2,2,0,"run027"
"5453","RGR","GGR",0,4,4,0,4,"run027"
"5454","RGR","RBB",0,4,4,1,3,"run027"
"5455","RGR","RGG",1,1,2,1,1,"run027"
"5456","RGR","RRG",0,3,3,1,2,"run027"
"5457","RRG","BBB",2,33,35,6,29,"run027"
"5458","RRG","BBR",0,5,5,5,0,"run027"
"5459","RRG","BGB",1,10,11,11,0,"run027"
"5460","RRG","BGG",0,2,2,0,2,"run027"
"5461","RRG","BRB",2,40,42,39,3,"run027"
"5462","RRG","BRR",1,16,17,13,4,"run027"
"5463","RRG","GGG",2,14,16,2,14,"run027"
"5464","RRG","GGR",0,5,5,2,3,"run027"
"5465","RRG","GRG",1,0,1,1,0,"run027"
"5466","RRG","GRR",3,8,11,9,2,"run027"
"5467","RRG","RBB",1,1,2,0,2,"run027"
"5468","RRG","RGG",0,1,1,1,0,"run027"
"5469","RRG","RGR",0,1,1,1,0,"run027"
"5470","RRR","BBR",1,0,1,1,0,"run027"
"5471","RRR","BGB",2,1,3,2,1,"run027"
"5472","RRR","BGG",1,0,1,0,1,"run027"
"5473","RRR","BRB",1,1,2,2,0,"run027"
"5474","RRR","BRR",1,1,2,2,0,"run027"
"5475","RRR","GGR",0,1,1,1,0,"run027"
"5476","RRR","GRR",0,3,3,3,0,"run027"
"5477","RRR","RBB",1,2,3,2,1,"run027"
"5478","RRR","RBR",0,2,2,1,1,"run027"
"5479","RRR","RGG",0,1,1,1,0,"run027"
"5480","RRR","RGR",1,2,3,0,3,"run027"
"5481","RRR","RRG",2,2,4,2,2,"run027"
"5482","BBB","BRB",0,1,1,0,1,"run028"
"5483","BBB","GGG",1,2,3,3,0,"run028"
"5484","BBB","GRR",0,2,2,0,2,"run028"
"5485","BBB","RBG",0,1,1,0,1,"run028"
"5486","BBB","RRG",1,3,4,0,4,"run028"
"5487","BBB","RRR",0,2,2,1,1,"run028"
"5488","BBG","BBB",1,4,5,5,0,"run028"
"5489","BBG","BGB",0,1,1,0,1,"run028"
"5490","BBG","BGG",0,1,1,0,1,"run028"
"5491","BBG","BRB",1,16,17,0,17,"run028"
"5492","BBG","GBB",0,1,1,0,1,"run028"
"5493","BBG","GBG",2,7,9,8,1,"run028"
"5494","BBG","GGB",2,25,27,24,3,"run028"
"5495","BBG","GGG",4,38,42,26,16,"run028"
"5496","BBG","GRG",1,9,10,7,3,"run028"
"5497","BBG","GRR",0,1,1,1,0,"run028"
"5498","BBG","RBB",0,1,1,1,0,"run028"
"5499","BBG","RBG",0,4,4,4,0,"run028"
"5500","BBG","RBR",0,1,1,0,1,"run028"
"5501","BBG","RGR",0,1,1,0,1,"run028"
"5502","BBG","RRG",1,2,3,3,0,"run028"
"5503","BBG","RRR",0,7,7,7,0,"run028"
"5504","BGB","BBB",0,2,2,2,0,"run028"
"5505","BGB","RRG",0,1,1,1,0,"run028"
"5506","BGG","BBB",0,3,3,0,3,"run028"
"5507","BGG","BBR",0,1,1,1,0,"run028"
"5508","BGG","GRG",0,1,1,0,1,"run028"
"5509","BGG","RBG",1,1,2,2,0,"run028"
"5510","BGG","RGG",0,3,3,0,3,"run028"
"5511","BGG","RGR",0,1,1,0,1,"run028"
"5512","BGG","RRR",1,1,2,2,0,"run028"
"5513","BRB","BBB",0,13,13,5,8,"run028"
"5514","BRB","BBR",0,1,1,0,1,"run028"
"5515","BRB","BRR",0,3,3,1,2,"run028"
"5516","BRB","GGG",0,1,1,0,1,"run028"
"5517","BRB","GGR",0,1,1,1,0,"run028"
"5518","BRB","RBB",0,1,1,1,0,"run028"
"5519","BRB","RBG",0,1,1,0,1,"run028"
"5520","BRB","RGR",0,1,1,1,0,"run028"
"5521","BRB","RRR",0,1,1,1,0,"run028"
"5522","BRR","BBB",0,11,11,7,4,"run028"
"5523","BRR","BGB",1,1,2,1,1,"run028"
"5524","BRR","BGG",0,1,1,0,1,"run028"
"5525","BRR","BRB",0,1,1,0,1,"run028"
"5526","BRR","RBB",0,2,2,1,1,"run028"
"5527","GBB","BBB",12,38,50,37,13,"run028"
"5528","GBB","BGG",0,1,1,1,0,"run028"
"5529","GBB","BRB",1,9,10,4,6,"run028"
"5530","GBB","BRR",1,3,4,1,3,"run028"
"5531","GBB","GBG",0,4,4,4,0,"run028"
"5532","GBB","GGB",0,21,21,6,15,"run028"
"5533","GBB","GGG",7,86,93,93,0,"run028"
"5534","GBB","GGR",1,3,4,0,4,"run028"
"5535","GBB","GRG",0,6,6,6,0,"run028"
"5536","GBB","GRR",0,1,1,0,1,"run028"
"5537","GBB","RBB",0,2,2,2,0,"run028"
"5538","GBB","RBG",3,9,12,5,7,"run028"
"5539","GBB","RBR",1,0,1,1,0,"run028"
"5540","GBB","RGG",1,0,1,0,1,"run028"
"5541","GBB","RGR",2,1,3,3,0,"run028"
"5542","GBB","RRG",0,2,2,1,1,"run028"
"5543","GBB","RRR",1,9,10,4,6,"run028"
"5544","GBG","BBB",0,5,5,1,4,"run028"
"5545","GBG","BBR",0,1,1,0,1,"run028"
"5546","GBG","BRB",1,4,5,1,4,"run028"
"5547","GBG","BRR",1,0,1,1,0,"run028"
"5548","GBG","GGB",0,4,4,1,3,"run028"
"5549","GBG","GGG",4,11,15,7,8,"run028"
"5550","GBG","RBB",1,0,1,1,0,"run028"
"5551","GBG","RBG",0,1,1,1,0,"run028"
"5552","GBG","RGG",0,1,1,1,0,"run028"
"5553","GBG","RGR",1,3,4,2,2,"run028"
"5554","GBG","RRG",1,3,4,4,0,"run028"
"5555","GGB","BBB",3,16,19,7,12,"run028"
"5556","GGB","BBR",1,4,5,3,2,"run028"
"5557","GGB","BGB",0,3,3,1,2,"run028"
"5558","GGB","BGG",0,4,4,4,0,"run028"
"5559","GGB","BRB",0,1,1,0,1,"run028"
"5560","GGB","BRR",1,15,16,9,7,"run028"
"5561","GGB","GBB",0,1,1,0,1,"run028"
"5562","GGB","GBG",1,0,1,1,0,"run028"
"5563","GGB","GGG",13,48,61,17,44,"run028"
"5564","GGB","GGR",0,7,7,5,2,"run028"
"5565","GGB","GRR",0,4,4,4,0,"run028"
"5566","GGB","RBB",0,5,5,2,3,"run028"
"5567","GGB","RBG",0,4,4,2,2,"run028"
"5568","GGB","RBR",0,5,5,5,0,"run028"
"5569","GGB","RGG",1,5,6,0,6,"run028"
"5570","GGB","RGR",0,2,2,2,0,"run028"
"5571","GGB","RRG",1,5,6,3,3,"run028"
"5572","GGB","RRR",1,5,6,1,5,"run028"
"5573","GGG","BBB",8,31,39,39,0,"run028"
"5574","GGG","BGB",0,2,2,2,0,"run028"
"5575","GGG","BGG",1,7,8,5,3,"run028"
"5576","GGG","BRB",1,3,4,3,1,"run028"
"5577","GGG","BRR",0,6,6,5,1,"run028"
"5578","GGG","GGB",5,1,6,1,5,"run028"
"5579","GGG","GGR",1,9,10,5,5,"run028"
"5580","GGG","GRR",0,2,2,2,0,"run028"
"5581","GGG","RBB",1,8,9,3,6,"run028"
"5582","GGG","RBG",0,6,6,0,6,"run028"
"5583","GGG","RBR",0,21,21,1,20,"run028"
"5584","GGG","RGG",0,3,3,2,1,"run028"
"5585","GGG","RGR",1,12,13,12,1,"run028"
"5586","GGG","RRG",1,23,24,8,16,"run028"
"5587","GGG","RRR",0,3,3,3,0,"run028"
"5588","GGR","BBB",0,2,2,0,2,"run028"
"5589","GGR","BBR",0,2,2,1,1,"run028"
"5590","GGR","BGG",0,1,1,0,1,"run028"
"5591","GGR","BRR",1,0,1,1,0,"run028"
"5592","GGR","GRR",1,0,1,0,1,"run028"
"5593","GGR","RBB",0,2,2,0,2,"run028"
"5594","GRG","BBB",3,8,11,5,6,"run028"
"5595","GRG","BBR",0,1,1,0,1,"run028"
"5596","GRG","BGG",0,1,1,1,0,"run028"
"5597","GRG","BRB",0,3,3,2,1,"run028"
"5598","GRG","BRR",0,1,1,0,1,"run028"
"5599","GRG","GBG",0,1,1,1,0,"run028"
"5600","GRG","GGB",2,15,17,4,13,"run028"
"5601","GRG","GGG",3,12,15,2,13,"run028"
"5602","GRG","GGR",0,5,5,2,3,"run028"
"5603","GRG","GRR",0,1,1,0,1,"run028"
"5604","GRG","RBG",0,1,1,1,0,"run028"
"5605","GRG","RBR",0,1,1,1,0,"run028"
"5606","GRG","RGR",1,2,3,3,0,"run028"
"5607","GRG","RRG",2,4,6,5,1,"run028"
"5608","GRR","BBB",0,1,1,0,1,"run028"
"5609","GRR","BBR",0,1,1,1,0,"run028"
"5610","GRR","BGB",1,2,3,0,3,"run028"
"5611","GRR","BGG",0,2,2,1,1,"run028"
"5612","GRR","BRB",0,1,1,0,1,"run028"
"5613","GRR","BRR",0,2,2,1,1,"run028"
"5614","GRR","GGG",0,1,1,0,1,"run028"
"5615","GRR","GGR",0,1,1,0,1,"run028"
"5616","RBB","BBB",0,1,1,1,0,"run028"
"5617","RBB","BBR",0,1,1,1,0,"run028"
"5618","RBB","BRB",0,1,1,1,0,"run028"
"5619","RBB","GRR",0,1,1,0,1,"run028"
"5620","RBB","RGG",0,1,1,1,0,"run028"
"5621","RBG","BBB",2,8,10,5,5,"run028"
"5622","RBG","BBG",0,1,1,1,0,"run028"
"5623","RBG","BRR",0,1,1,1,0,"run028"
"5624","RBG","GBB",0,1,1,1,0,"run028"
"5625","RBG","GRR",0,3,3,2,1,"run028"
"5626","RBG","RBB",1,1,2,2,0,"run028"
"5627","RBG","RBR",0,1,1,0,1,"run028"
"5628","RBG","RGR",0,1,1,0,1,"run028"
"5629","RBR","BBB",0,13,13,9,4,"run028"
"5630","RBR","BBR",0,1,1,1,0,"run028"
"5631","RBR","BGB",2,4,6,0,6,"run028"
"5632","RBR","BGG",0,2,2,2,0,"run028"
"5633","RBR","BRB",1,0,1,0,1,"run028"
"5634","RBR","BRR",1,4,5,3,2,"run028"
"5635","RBR","GGB",0,12,12,6,6,"run028"
"5636","RBR","GRR",4,4,8,3,5,"run028"
"5637","RBR","RBB",0,3,3,3,0,"run028"
"5638","RBR","RGG",2,9,11,2,9,"run028"
"5639","RBR","RGR",1,0,1,1,0,"run028"
"5640","RBR","RRR",0,1,1,0,1,"run028"
"5641","RGG","BBB",0,8,8,6,2,"run028"
"5642","RGG","BBR",1,2,3,1,2,"run028"
"5643","RGG","BGB",0,1,1,1,0,"run028"
"5644","RGG","BRR",0,4,4,3,1,"run028"
"5645","RGG","GGG",0,1,1,0,1,"run028"
"5646","RGG","GGR",0,3,3,1,2,"run028"
"5647","RGG","GRR",0,8,8,0,8,"run028"
"5648","RGG","RBB",0,1,1,0,1,"run028"
"5649","RGR","BBB",2,5,7,5,2,"run028"
"5650","RGR","BBR",1,1,2,2,0,"run028"
"5651","RGR","BGB",2,5,7,0,7,"run028"
"5652","RGR","BGG",2,2,4,4,0,"run028"
"5653","RGR","BRR",1,5,6,6,0,"run028"
"5654","RGR","GGB",2,12,14,7,7,"run028"
"5655","RGR","GGG",0,2,2,0,2,"run028"
"5656","RGR","GGR",0,4,4,1,3,"run028"
"5657","RGR","RBB",0,4,4,3,1,"run028"
"5658","RGR","RGG",1,1,2,1,1,"run028"
"5659","RGR","RRG",0,3,3,3,0,"run028"
"5660","RRG","BBB",2,33,35,21,14,"run028"
"5661","RRG","BBR",0,5,5,2,3,"run028"
"5662","RRG","BGB",1,10,11,11,0,"run028"
"5663","RRG","BGG",0,2,2,0,2,"run028"
"5664","RRG","BRB",2,40,42,29,13,"run028"
"5665","RRG","BRR",1,16,17,6,11,"run028"
"5666","RRG","GGG",2,14,16,1,15,"run028"
"5667","RRG","GGR",0,5,5,5,0,"run028"
"5668","RRG","GRG",1,0,1,0,1,"run028"
"5669","RRG","GRR",3,8,11,8,3,"run028"
"5670","RRG","RBB",1,1,2,1,1,"run028"
"5671","RRG","RGG",0,1,1,0,1,"run028"
"5672","RRG","RGR",0,1,1,0,1,"run028"
"5673","RRR","BBR",1,0,1,1,0,"run028"
"5674","RRR","BGB",2,1,3,3,0,"run028"
"5675","RRR","BGG",1,0,1,1,0,"run028"
"5676","RRR","BRB",1,1,2,2,0,"run028"
"5677","RRR","BRR",1,1,2,2,0,"run028"
"5678","RRR","GGR",0,1,1,0,1,"run028"
"5679","RRR","GRR",0,3,3,1,2,"run028"
"5680","RRR","RBB",1,2,3,3,0,"run028"
"5681","RRR","RBR",0,2,2,1,1,"run028"
"5682","RRR","RGG",0,1,1,1,0,"run028"
"5683","RRR","RGR",1,2,3,3,0,"run028"
"5684","RRR","RRG",2,2,4,1,3,"run028"
"5685","BBB","BRB",0,1,1,0,1,"run029"
"5686","BBB","GGG",1,2,3,3,0,"run029"
"5687","BBB","GRR",0,2,2,0,2,"run029"
"5688","BBB","RBG",0,1,1,1,0,"run029"
"5689","BBB","RRG",1,3,4,1,3,"run029"
"5690","BBB","RRR",0,2,2,0,2,"run029"
"5691","BBG","BBB",1,4,5,2,3,"run029"
"5692","BBG","BGB",0,1,1,0,1,"run029"
"5693","BBG","BGG",0,1,1,1,0,"run029"
"5694","BBG","BRB",1,16,17,15,2,"run029"
"5695","BBG","GBB",0,1,1,1,0,"run029"
"5696","BBG","GBG",2,7,9,1,8,"run029"
"5697","BBG","GGB",2,25,27,16,11,"run029"
"5698","BBG","GGG",4,38,42,39,3,"run029"
"5699","BBG","GRG",1,9,10,9,1,"run029"
"5700","BBG","GRR",0,1,1,1,0,"run029"
"5701","BBG","RBB",0,1,1,1,0,"run029"
"5702","BBG","RBG",0,4,4,3,1,"run029"
"5703","BBG","RBR",0,1,1,1,0,"run029"
"5704","BBG","RGR",0,1,1,1,0,"run029"
"5705","BBG","RRG",1,2,3,3,0,"run029"
"5706","BBG","RRR",0,7,7,1,6,"run029"
"5707","BGB","BBB",0,2,2,2,0,"run029"
"5708","BGB","RRG",0,1,1,0,1,"run029"
"5709","BGG","BBB",0,3,3,3,0,"run029"
"5710","BGG","BBR",0,1,1,0,1,"run029"
"5711","BGG","GRG",0,1,1,0,1,"run029"
"5712","BGG","RBG",1,1,2,2,0,"run029"
"5713","BGG","RGG",0,3,3,2,1,"run029"
"5714","BGG","RGR",0,1,1,1,0,"run029"
"5715","BGG","RRR",1,1,2,1,1,"run029"
"5716","BRB","BBB",0,13,13,0,13,"run029"
"5717","BRB","BBR",0,1,1,0,1,"run029"
"5718","BRB","BRR",0,3,3,0,3,"run029"
"5719","BRB","GGG",0,1,1,1,0,"run029"
"5720","BRB","GGR",0,1,1,0,1,"run029"
"5721","BRB","RBB",0,1,1,1,0,"run029"
"5722","BRB","RBG",0,1,1,0,1,"run029"
"5723","BRB","RGR",0,1,1,0,1,"run029"
"5724","BRB","RRR",0,1,1,0,1,"run029"
"5725","BRR","BBB",0,11,11,6,5,"run029"
"5726","BRR","BGB",1,1,2,2,0,"run029"
"5727","BRR","BGG",0,1,1,0,1,"run029"
"5728","BRR","BRB",0,1,1,0,1,"run029"
"5729","BRR","RBB",0,2,2,2,0,"run029"
"5730","GBB","BBB",12,38,50,11,39,"run029"
"5731","GBB","BGG",0,1,1,0,1,"run029"
"5732","GBB","BRB",1,9,10,8,2,"run029"
"5733","GBB","BRR",1,3,4,3,1,"run029"
"5734","GBB","GBG",0,4,4,3,1,"run029"
"5735","GBB","GGB",0,21,21,16,5,"run029"
"5736","GBB","GGG",7,86,93,82,11,"run029"
"5737","GBB","GGR",1,3,4,1,3,"run029"
"5738","GBB","GRG",0,6,6,5,1,"run029"
"5739","GBB","GRR",0,1,1,1,0,"run029"
"5740","GBB","RBB",0,2,2,0,2,"run029"
"5741","GBB","RBG",3,9,12,5,7,"run029"
"5742","GBB","RBR",1,0,1,0,1,"run029"
"5743","GBB","RGG",1,0,1,0,1,"run029"
"5744","GBB","RGR",2,1,3,0,3,"run029"
"5745","GBB","RRG",0,2,2,2,0,"run029"
"5746","GBB","RRR",1,9,10,3,7,"run029"
"5747","GBG","BBB",0,5,5,2,3,"run029"
"5748","GBG","BBR",0,1,1,1,0,"run029"
"5749","GBG","BRB",1,4,5,1,4,"run029"
"5750","GBG","BRR",1,0,1,1,0,"run029"
"5751","GBG","GGB",0,4,4,2,2,"run029"
"5752","GBG","GGG",4,11,15,15,0,"run029"
"5753","GBG","RBB",1,0,1,0,1,"run029"
"5754","GBG","RBG",0,1,1,0,1,"run029"
"5755","GBG","RGG",0,1,1,1,0,"run029"
"5756","GBG","RGR",1,3,4,3,1,"run029"
"5757","GBG","RRG",1,3,4,3,1,"run029"
"5758","GGB","BBB",3,16,19,9,10,"run029"
"5759","GGB","BBR",1,4,5,3,2,"run029"
"5760","GGB","BGB",0,3,3,3,0,"run029"
"5761","GGB","BGG",0,4,4,2,2,"run029"
"5762","GGB","BRB",0,1,1,0,1,"run029"
"5763","GGB","BRR",1,15,16,13,3,"run029"
"5764","GGB","GBB",0,1,1,0,1,"run029"
"5765","GGB","GBG",1,0,1,0,1,"run029"
"5766","GGB","GGG",13,48,61,57,4,"run029"
"5767","GGB","GGR",0,7,7,6,1,"run029"
"5768","GGB","GRR",0,4,4,2,2,"run029"
"5769","GGB","RBB",0,5,5,1,4,"run029"
"5770","GGB","RBG",0,4,4,2,2,"run029"
"5771","GGB","RBR",0,5,5,5,0,"run029"
"5772","GGB","RGG",1,5,6,1,5,"run029"
"5773","GGB","RGR",0,2,2,2,0,"run029"
"5774","GGB","RRG",1,5,6,6,0,"run029"
"5775","GGB","RRR",1,5,6,0,6,"run029"
"5776","GGG","BBB",8,31,39,8,31,"run029"
"5777","GGG","BGB",0,2,2,0,2,"run029"
"5778","GGG","BGG",1,7,8,4,4,"run029"
"5779","GGG","BRB",1,3,4,3,1,"run029"
"5780","GGG","BRR",0,6,6,0,6,"run029"
"5781","GGG","GGB",5,1,6,2,4,"run029"
"5782","GGG","GGR",1,9,10,3,7,"run029"
"5783","GGG","GRR",0,2,2,0,2,"run029"
"5784","GGG","RBB",1,8,9,2,7,"run029"
"5785","GGG","RBG",0,6,6,1,5,"run029"
"5786","GGG","RBR",0,21,21,10,11,"run029"
"5787","GGG","RGG",0,3,3,1,2,"run029"
"5788","GGG","RGR",1,12,13,3,10,"run029"
"5789","GGG","RRG",1,23,24,1,23,"run029"
"5790","GGG","RRR",0,3,3,0,3,"run029"
"5791","GGR","BBB",0,2,2,2,0,"run029"
"5792","GGR","BBR",0,2,2,1,1,"run029"
"5793","GGR","BGG",0,1,1,0,1,"run029"
"5794","GGR","BRR",1,0,1,0,1,"run029"
"5795","GGR","GRR",1,0,1,1,0,"run029"
"5796","GGR","RBB",0,2,2,2,0,"run029"
"5797","GRG","BBB",3,8,11,2,9,"run029"
"5798","GRG","BBR",0,1,1,0,1,"run029"
"5799","GRG","BGG",0,1,1,0,1,"run029"
"5800","GRG","BRB",0,3,3,3,0,"run029"
"5801","GRG","BRR",0,1,1,0,1,"run029"
"5802","GRG","GBG",0,1,1,1,0,"run029"
"5803","GRG","GGB",2,15,17,5,12,"run029"
"5804","GRG","GGG",3,12,15,6,9,"run029"
"5805","GRG","GGR",0,5,5,1,4,"run029"
"5806","GRG","GRR",0,1,1,1,0,"run029"
"5807","GRG","RBG",0,1,1,0,1,"run029"
"5808","GRG","RBR",0,1,1,0,1,"run029"
"5809","GRG","RGR",1,2,3,3,0,"run029"
"5810","GRG","RRG",2,4,6,6,0,"run029"
"5811","GRR","BBB",0,1,1,1,0,"run029"
"5812","GRR","BBR",0,1,1,1,0,"run029"
"5813","GRR","BGB",1,2,3,2,1,"run029"
"5814","GRR","BGG",0,2,2,2,0,"run029"
"5815","GRR","BRB",0,1,1,1,0,"run029"
"5816","GRR","BRR",0,2,2,2,0,"run029"
"5817","GRR","GGG",0,1,1,1,0,"run029"
"5818","GRR","GGR",0,1,1,1,0,"run029"
"5819","RBB","BBB",0,1,1,0,1,"run029"
"5820","RBB","BBR",0,1,1,0,1,"run029"
"5821","RBB","BRB",0,1,1,1,0,"run029"
"5822","RBB","GRR",0,1,1,1,0,"run029"
"5823","RBB","RGG",0,1,1,0,1,"run029"
"5824","RBG","BBB",2,8,10,8,2,"run029"
"5825","RBG","BBG",0,1,1,1,0,"run029"
"5826","RBG","BRR",0,1,1,0,1,"run029"
"5827","RBG","GBB",0,1,1,1,0,"run029"
"5828","RBG","GRR",0,3,3,0,3,"run029"
"5829","RBG","RBB",1,1,2,2,0,"run029"
"5830","RBG","RBR",0,1,1,1,0,"run029"
"5831","RBG","RGR",0,1,1,0,1,"run029"
"5832","RBR","BBB",0,13,13,8,5,"run029"
"5833","RBR","BBR",0,1,1,0,1,"run029"
"5834","RBR","BGB",2,4,6,0,6,"run029"
"5835","RBR","BGG",0,2,2,1,1,"run029"
"5836","RBR","BRB",1,0,1,1,0,"run029"
"5837","RBR","BRR",1,4,5,1,4,"run029"
"5838","RBR","GGB",0,12,12,6,6,"run029"
"5839","RBR","GRR",4,4,8,1,7,"run029"
"5840","RBR","RBB",0,3,3,1,2,"run029"
"5841","RBR","RGG",2,9,11,9,2,"run029"
"5842","RBR","RGR",1,0,1,0,1,"run029"
"5843","RBR","RRR",0,1,1,1,0,"run029"
"5844","RGG","BBB",0,8,8,6,2,"run029"
"5845","RGG","BBR",1,2,3,0,3,"run029"
"5846","RGG","BGB",0,1,1,0,1,"run029"
"5847","RGG","BRR",0,4,4,3,1,"run029"
"5848","RGG","GGG",0,1,1,1,0,"run029"
"5849","RGG","GGR",0,3,3,3,0,"run029"
"5850","RGG","GRR",0,8,8,6,2,"run029"
"5851","RGG","RBB",0,1,1,0,1,"run029"
"5852","RGR","BBB",2,5,7,1,6,"run029"
"5853","RGR","BBR",1,1,2,1,1,"run029"
"5854","RGR","BGB",2,5,7,1,6,"run029"
"5855","RGR","BGG",2,2,4,4,0,"run029"
"5856","RGR","BRR",1,5,6,0,6,"run029"
"5857","RGR","GGB",2,12,14,7,7,"run029"
"5858","RGR","GGG",0,2,2,2,0,"run029"
"5859","RGR","GGR",0,4,4,2,2,"run029"
"5860","RGR","RBB",0,4,4,1,3,"run029"
"5861","RGR","RGG",1,1,2,1,1,"run029"
"5862","RGR","RRG",0,3,3,0,3,"run029"
"5863","RRG","BBB",2,33,35,1,34,"run029"
"5864","RRG","BBR",0,5,5,4,1,"run029"
"5865","RRG","BGB",1,10,11,6,5,"run029"
"5866","RRG","BGG",0,2,2,2,0,"run029"
"5867","RRG","BRB",2,40,42,18,24,"run029"
"5868","RRG","BRR",1,16,17,13,4,"run029"
"5869","RRG","GGG",2,14,16,15,1,"run029"
"5870","RRG","GGR",0,5,5,5,0,"run029"
"5871","RRG","GRG",1,0,1,1,0,"run029"
"5872","RRG","GRR",3,8,11,9,2,"run029"
"5873","RRG","RBB",1,1,2,2,0,"run029"
"5874","RRG","RGG",0,1,1,1,0,"run029"
"5875","RRG","RGR",0,1,1,0,1,"run029"
"5876","RRR","BBR",1,0,1,0,1,"run029"
"5877","RRR","BGB",2,1,3,1,2,"run029"
"5878","RRR","BGG",1,0,1,1,0,"run029"
"5879","RRR","BRB",1,1,2,2,0,"run029"
"5880","RRR","BRR",1,1,2,0,2,"run029"
"5881","RRR","GGR",0,1,1,1,0,"run029"
"5882","RRR","GRR",0,3,3,1,2,"run029"
"5883","RRR","RBB",1,2,3,3,0,"run029"
"5884","RRR","RBR",0,2,2,0,2,"run029"
"5885","RRR","RGG",0,1,1,0,1,"run029"
"5886","RRR","RGR",1,2,3,0,3,"run029"
"5887","RRR","RRG",2,2,4,3,1,"run029"
"5888","BBB","BRB",0,1,1,1,0,"run030"
"5889","BBB","GGG",1,2,3,0,3,"run030"
"5890","BBB","GRR",0,2,2,1,1,"run030"
"5891","BBB","RBG",0,1,1,1,0,"run030"
"5892","BBB","RRG",1,3,4,4,0,"run030"
"5893","BBB","RRR",0,2,2,1,1,"run030"
"5894","BBG","BBB",1,4,5,2,3,"run030"
"5895","BBG","BGB",0,1,1,1,0,"run030"
"5896","BBG","BGG",0,1,1,0,1,"run030"
"5897","BBG","BRB",1,16,17,3,14,"run030"
"5898","BBG","GBB",0,1,1,1,0,"run030"
"5899","BBG","GBG",2,7,9,0,9,"run030"
"5900","BBG","GGB",2,25,27,2,25,"run030"
"5901","BBG","GGG",4,38,42,31,11,"run030"
"5902","BBG","GRG",1,9,10,9,1,"run030"
"5903","BBG","GRR",0,1,1,0,1,"run030"
"5904","BBG","RBB",0,1,1,1,0,"run030"
"5905","BBG","RBG",0,4,4,0,4,"run030"
"5906","BBG","RBR",0,1,1,1,0,"run030"
"5907","BBG","RGR",0,1,1,0,1,"run030"
"5908","BBG","RRG",1,2,3,3,0,"run030"
"5909","BBG","RRR",0,7,7,3,4,"run030"
"5910","BGB","BBB",0,2,2,2,0,"run030"
"5911","BGB","RRG",0,1,1,0,1,"run030"
"5912","BGG","BBB",0,3,3,0,3,"run030"
"5913","BGG","BBR",0,1,1,0,1,"run030"
"5914","BGG","GRG",0,1,1,0,1,"run030"
"5915","BGG","RBG",1,1,2,0,2,"run030"
"5916","BGG","RGG",0,3,3,3,0,"run030"
"5917","BGG","RGR",0,1,1,0,1,"run030"
"5918","BGG","RRR",1,1,2,0,2,"run030"
"5919","BRB","BBB",0,13,13,12,1,"run030"
"5920","BRB","BBR",0,1,1,1,0,"run030"
"5921","BRB","BRR",0,3,3,2,1,"run030"
"5922","BRB","GGG",0,1,1,0,1,"run030"
"5923","BRB","GGR",0,1,1,1,0,"run030"
"5924","BRB","RBB",0,1,1,0,1,"run030"
"5925","BRB","RBG",0,1,1,1,0,"run030"
"5926","BRB","RGR",0,1,1,0,1,"run030"
"5927","BRB","RRR",0,1,1,1,0,"run030"
"5928","BRR","BBB",0,11,11,2,9,"run030"
"5929","BRR","BGB",1,1,2,2,0,"run030"
"5930","BRR","BGG",0,1,1,0,1,"run030"
"5931","BRR","BRB",0,1,1,1,0,"run030"
"5932","BRR","RBB",0,2,2,2,0,"run030"
"5933","GBB","BBB",12,38,50,20,30,"run030"
"5934","GBB","BGG",0,1,1,1,0,"run030"
"5935","GBB","BRB",1,9,10,5,5,"run030"
"5936","GBB","BRR",1,3,4,2,2,"run030"
"5937","GBB","GBG",0,4,4,3,1,"run030"
"5938","GBB","GGB",0,21,21,16,5,"run030"
"5939","GBB","GGG",7,86,93,13,80,"run030"
"5940","GBB","GGR",1,3,4,1,3,"run030"
"5941","GBB","GRG",0,6,6,3,3,"run030"
"5942","GBB","GRR",0,1,1,0,1,"run030"
"5943","GBB","RBB",0,2,2,0,2,"run030"
"5944","GBB","RBG",3,9,12,1,11,"run030"
"5945","GBB","RBR",1,0,1,0,1,"run030"
"5946","GBB","RGG",1,0,1,0,1,"run030"
"5947","GBB","RGR",2,1,3,0,3,"run030"
"5948","GBB","RRG",0,2,2,1,1,"run030"
"5949","GBB","RRR",1,9,10,7,3,"run030"
"5950","GBG","BBB",0,5,5,2,3,"run030"
"5951","GBG","BBR",0,1,1,1,0,"run030"
"5952","GBG","BRB",1,4,5,2,3,"run030"
"5953","GBG","BRR",1,0,1,0,1,"run030"
"5954","GBG","GGB",0,4,4,0,4,"run030"
"5955","GBG","GGG",4,11,15,0,15,"run030"
"5956","GBG","RBB",1,0,1,0,1,"run030"
"5957","GBG","RBG",0,1,1,1,0,"run030"
"5958","GBG","RGG",0,1,1,0,1,"run030"
"5959","GBG","RGR",1,3,4,2,2,"run030"
"5960","GBG","RRG",1,3,4,1,3,"run030"
"5961","GGB","BBB",3,16,19,19,0,"run030"
"5962","GGB","BBR",1,4,5,4,1,"run030"
"5963","GGB","BGB",0,3,3,1,2,"run030"
"5964","GGB","BGG",0,4,4,0,4,"run030"
"5965","GGB","BRB",0,1,1,0,1,"run030"
"5966","GGB","BRR",1,15,16,14,2,"run030"
"5967","GGB","GBB",0,1,1,0,1,"run030"
"5968","GGB","GBG",1,0,1,0,1,"run030"
"5969","GGB","GGG",13,48,61,13,48,"run030"
"5970","GGB","GGR",0,7,7,5,2,"run030"
"5971","GGB","GRR",0,4,4,2,2,"run030"
"5972","GGB","RBB",0,5,5,0,5,"run030"
"5973","GGB","RBG",0,4,4,0,4,"run030"
"5974","GGB","RBR",0,5,5,5,0,"run030"
"5975","GGB","RGG",1,5,6,1,5,"run030"
"5976","GGB","RGR",0,2,2,1,1,"run030"
"5977","GGB","RRG",1,5,6,0,6,"run030"
"5978","GGB","RRR",1,5,6,1,5,"run030"
"5979","GGG","BBB",8,31,39,34,5,"run030"
"5980","GGG","BGB",0,2,2,2,0,"run030"
"5981","GGG","BGG",1,7,8,0,8,"run030"
"5982","GGG","BRB",1,3,4,4,0,"run030"
"5983","GGG","BRR",0,6,6,0,6,"run030"
"5984","GGG","GGB",5,1,6,1,5,"run030"
"5985","GGG","GGR",1,9,10,9,1,"run030"
"5986","GGG","GRR",0,2,2,2,0,"run030"
"5987","GGG","RBB",1,8,9,5,4,"run030"
"5988","GGG","RBG",0,6,6,3,3,"run030"
"5989","GGG","RBR",0,21,21,2,19,"run030"
"5990","GGG","RGG",0,3,3,0,3,"run030"
"5991","GGG","RGR",1,12,13,3,10,"run030"
"5992","GGG","RRG",1,23,24,23,1,"run030"
"5993","GGG","RRR",0,3,3,1,2,"run030"
"5994","GGR","BBB",0,2,2,2,0,"run030"
"5995","GGR","BBR",0,2,2,2,0,"run030"
"5996","GGR","BGG",0,1,1,1,0,"run030"
"5997","GGR","BRR",1,0,1,0,1,"run030"
"5998","GGR","GRR",1,0,1,0,1,"run030"
"5999","GGR","RBB",0,2,2,1,1,"run030"
"6000","GRG","BBB",3,8,11,3,8,"run030"
"6001","GRG","BBR",0,1,1,1,0,"run030"
"6002","GRG","BGG",0,1,1,0,1,"run030"
"6003","GRG","BRB",0,3,3,2,1,"run030"
"6004","GRG","BRR",0,1,1,0,1,"run030"
"6005","GRG","GBG",0,1,1,1,0,"run030"
"6006","GRG","GGB",2,15,17,8,9,"run030"
"6007","GRG","GGG",3,12,15,5,10,"run030"
"6008","GRG","GGR",0,5,5,2,3,"run030"
"6009","GRG","GRR",0,1,1,1,0,"run030"
"6010","GRG","RBG",0,1,1,1,0,"run030"
"6011","GRG","RBR",0,1,1,1,0,"run030"
"6012","GRG","RGR",1,2,3,1,2,"run030"
"6013","GRG","RRG",2,4,6,0,6,"run030"
"6014","GRR","BBB",0,1,1,1,0,"run030"
"6015","GRR","BBR",0,1,1,0,1,"run030"
"6016","GRR","BGB",1,2,3,1,2,"run030"
"6017","GRR","BGG",0,2,2,1,1,"run030"
"6018","GRR","BRB",0,1,1,1,0,"run030"
"6019","GRR","BRR",0,2,2,0,2,"run030"
"6020","GRR","GGG",0,1,1,0,1,"run030"
"6021","GRR","GGR",0,1,1,1,0,"run030"
"6022","RBB","BBB",0,1,1,0,1,"run030"
"6023","RBB","BBR",0,1,1,0,1,"run030"
"6024","RBB","BRB",0,1,1,1,0,"run030"
"6025","RBB","GRR",0,1,1,0,1,"run030"
"6026","RBB","RGG",0,1,1,0,1,"run030"
"6027","RBG","BBB",2,8,10,9,1,"run030"
"6028","RBG","BBG",0,1,1,1,0,"run030"
"6029","RBG","BRR",0,1,1,0,1,"run030"
"6030","RBG","GBB",0,1,1,0,1,"run030"
"6031","RBG","GRR",0,3,3,0,3,"run030"
"6032","RBG","RBB",1,1,2,0,2,"run030"
"6033","RBG","RBR",0,1,1,1,0,"run030"
"6034","RBG","RGR",0,1,1,0,1,"run030"
"6035","RBR","BBB",0,13,13,8,5,"run030"
"6036","RBR","BBR",0,1,1,0,1,"run030"
"6037","RBR","BGB",2,4,6,5,1,"run030"
"6038","RBR","BGG",0,2,2,1,1,"run030"
"6039","RBR","BRB",1,0,1,1,0,"run030"
"6040","RBR","BRR",1,4,5,5,0,"run030"
"6041","RBR","GGB",0,12,12,4,8,"run030"
"6042","RBR","GRR",4,4,8,8,0,"run030"
"6043","RBR","RBB",0,3,3,3,0,"run030"
"6044","RBR","RGG",2,9,11,11,0,"run030"
"6045","RBR","RGR",1,0,1,0,1,"run030"
"6046","RBR","RRR",0,1,1,0,1,"run030"
"6047","RGG","BBB",0,8,8,3,5,"run030"
"6048","RGG","BBR",1,2,3,3,0,"run030"
"6049","RGG","BGB",0,1,1,1,0,"run030"
"6050","RGG","BRR",0,4,4,4,0,"run030"
"6051","RGG","GGG",0,1,1,0,1,"run030"
"6052","RGG","GGR",0,3,3,1,2,"run030"
"6053","RGG","GRR",0,8,8,0,8,"run030"
"6054","RGG","RBB",0,1,1,1,0,"run030"
"6055","RGR","BBB",2,5,7,4,3,"run030"
"6056","RGR","BBR",1,1,2,0,2,"run030"
"6057","RGR","BGB",2,5,7,6,1,"run030"
"6058","RGR","BGG",2,2,4,4,0,"run030"
"6059","RGR","BRR",1,5,6,6,0,"run030"
"6060","RGR","GGB",2,12,14,0,14,"run030"
"6061","RGR","GGG",0,2,2,1,1,"run030"
"6062","RGR","GGR",0,4,4,1,3,"run030"
"6063","RGR","RBB",0,4,4,2,2,"run030"
"6064","RGR","RGG",1,1,2,0,2,"run030"
"6065","RGR","RRG",0,3,3,1,2,"run030"
"6066","RRG","BBB",2,33,35,28,7,"run030"
"6067","RRG","BBR",0,5,5,0,5,"run030"
"6068","RRG","BGB",1,10,11,0,11,"run030"
"6069","RRG","BGG",0,2,2,2,0,"run030"
"6070","RRG","BRB",2,40,42,35,7,"run030"
"6071","RRG","BRR",1,16,17,1,16,"run030"
"6072","RRG","GGG",2,14,16,5,11,"run030"
"6073","RRG","GGR",0,5,5,5,0,"run030"
"6074","RRG","GRG",1,0,1,1,0,"run030"
"6075","RRG","GRR",3,8,11,1,10,"run030"
"6076","RRG","RBB",1,1,2,2,0,"run030"
"6077","RRG","RGG",0,1,1,0,1,"run030"
"6078","RRG","RGR",0,1,1,1,0,"run030"
"6079","RRR","BBR",1,0,1,1,0,"run030"
"6080","RRR","BGB",2,1,3,0,3,"run030"
"6081","RRR","BGG",1,0,1,1,0,"run030"
"6082","RRR","BRB",1,1,2,1,1,"run030"
"6083","RRR","BRR",1,1,2,1,1,"run030"
"6084","RRR","GGR",0,1,1,1,0,"run030"
"6085","RRR","GRR",0,3,3,1,2,"run030"
"6086","RRR","RBB",1,2,3,3,0,"run030"
"6087","RRR","RBR",0,2,2,2,0,"run030"
"6088","RRR","RGG",0,1,1,1,0,"run030"
"6089","RRR","RGR",1,2,3,2,1,"run030"
"6090","RRR","RRG",2,2,4,1,3,"run030"
"6091","BBB","BRB",0,1,1,0,1,"run031"
"6092","BBB","GGG",1,2,3,0,3,"run031"
"6093","BBB","GRR",0,2,2,2,0,"run031"
"6094","BBB","RBG",0,1,1,1,0,"run031"
"6095","BBB","RRG",1,3,4,1,3,"run031"
"6096","BBB","RRR",0,2,2,2,0,"run031"
"6097","BBG","BBB",1,4,5,2,3,"run031"
"6098","BBG","BGB",0,1,1,1,0,"run031"
"6099","BBG","BGG",0,1,1,0,1,"run031"
"6100","BBG","BRB",1,16,17,10,7,"run031"
"6101","BBG","GBB",0,1,1,0,1,"run031"
"6102","BBG","GBG",2,7,9,9,0,"run031"
"6103","BBG","GGB",2,25,27,11,16,"run031"
"6104","BBG","GGG",4,38,42,19,23,"run031"
"6105","BBG","GRG",1,9,10,1,9,"run031"
"6106","BBG","GRR",0,1,1,0,1,"run031"
"6107","BBG","RBB",0,1,1,1,0,"run031"
"6108","BBG","RBG",0,4,4,4,0,"run031"
"6109","BBG","RBR",0,1,1,0,1,"run031"
"6110","BBG","RGR",0,1,1,1,0,"run031"
"6111","BBG","RRG",1,2,3,3,0,"run031"
"6112","BBG","RRR",0,7,7,4,3,"run031"
"6113","BGB","BBB",0,2,2,2,0,"run031"
"6114","BGB","RRG",0,1,1,0,1,"run031"
"6115","BGG","BBB",0,3,3,1,2,"run031"
"6116","BGG","BBR",0,1,1,1,0,"run031"
"6117","BGG","GRG",0,1,1,1,0,"run031"
"6118","BGG","RBG",1,1,2,1,1,"run031"
"6119","BGG","RGG",0,3,3,1,2,"run031"
"6120","BGG","RGR",0,1,1,0,1,"run031"
"6121","BGG","RRR",1,1,2,2,0,"run031"
"6122","BRB","BBB",0,13,13,3,10,"run031"
"6123","BRB","BBR",0,1,1,1,0,"run031"
"6124","BRB","BRR",0,3,3,1,2,"run031"
"6125","BRB","GGG",0,1,1,1,0,"run031"
"6126","BRB","GGR",0,1,1,0,1,"run031"
"6127","BRB","RBB",0,1,1,1,0,"run031"
"6128","BRB","RBG",0,1,1,0,1,"run031"
"6129","BRB","RGR",0,1,1,0,1,"run031"
"6130","BRB","RRR",0,1,1,0,1,"run031"
"6131","BRR","BBB",0,11,11,9,2,"run031"
"6132","BRR","BGB",1,1,2,0,2,"run031"
"6133","BRR","BGG",0,1,1,1,0,"run031"
"6134","BRR","BRB",0,1,1,1,0,"run031"
"6135","BRR","RBB",0,2,2,2,0,"run031"
"6136","GBB","BBB",12,38,50,38,12,"run031"
"6137","GBB","BGG",0,1,1,1,0,"run031"
"6138","GBB","BRB",1,9,10,3,7,"run031"
"6139","GBB","BRR",1,3,4,4,0,"run031"
"6140","GBB","GBG",0,4,4,0,4,"run031"
"6141","GBB","GGB",0,21,21,12,9,"run031"
"6142","GBB","GGG",7,86,93,81,12,"run031"
"6143","GBB","GGR",1,3,4,0,4,"run031"
"6144","GBB","GRG",0,6,6,5,1,"run031"
"6145","GBB","GRR",0,1,1,0,1,"run031"
"6146","GBB","RBB",0,2,2,0,2,"run031"
"6147","GBB","RBG",3,9,12,11,1,"run031"
"6148","GBB","RBR",1,0,1,0,1,"run031"
"6149","GBB","RGG",1,0,1,0,1,"run031"
"6150","GBB","RGR",2,1,3,3,0,"run031"
"6151","GBB","RRG",0,2,2,0,2,"run031"
"6152","GBB","RRR",1,9,10,2,8,"run031"
"6153","GBG","BBB",0,5,5,2,3,"run031"
"6154","GBG","BBR",0,1,1,0,1,"run031"
"6155","GBG","BRB",1,4,5,3,2,"run031"
"6156","GBG","BRR",1,0,1,0,1,"run031"
"6157","GBG","GGB",0,4,4,4,0,"run031"
"6158","GBG","GGG",4,11,15,4,11,"run031"
"6159","GBG","RBB",1,0,1,0,1,"run031"
"6160","GBG","RBG",0,1,1,1,0,"run031"
"6161","GBG","RGG",0,1,1,0,1,"run031"
"6162","GBG","RGR",1,3,4,0,4,"run031"
"6163","GBG","RRG",1,3,4,0,4,"run031"
"6164","GGB","BBB",3,16,19,11,8,"run031"
"6165","GGB","BBR",1,4,5,4,1,"run031"
"6166","GGB","BGB",0,3,3,1,2,"run031"
"6167","GGB","BGG",0,4,4,2,2,"run031"
"6168","GGB","BRB",0,1,1,1,0,"run031"
"6169","GGB","BRR",1,15,16,10,6,"run031"
"6170","GGB","GBB",0,1,1,0,1,"run031"
"6171","GGB","GBG",1,0,1,1,0,"run031"
"6172","GGB","GGG",13,48,61,1,60,"run031"
"6173","GGB","GGR",0,7,7,7,0,"run031"
"6174","GGB","GRR",0,4,4,4,0,"run031"
"6175","GGB","RBB",0,5,5,4,1,"run031"
"6176","GGB","RBG",0,4,4,1,3,"run031"
"6177","GGB","RBR",0,5,5,3,2,"run031"
"6178","GGB","RGG",1,5,6,0,6,"run031"
"6179","GGB","RGR",0,2,2,1,1,"run031"
"6180","GGB","RRG",1,5,6,1,5,"run031"
"6181","GGB","RRR",1,5,6,0,6,"run031"
"6182","GGG","BBB",8,31,39,18,21,"run031"
"6183","GGG","BGB",0,2,2,2,0,"run031"
"6184","GGG","BGG",1,7,8,8,0,"run031"
"6185","GGG","BRB",1,3,4,4,0,"run031"
"6186","GGG","BRR",0,6,6,6,0,"run031"
"6187","GGG","GGB",5,1,6,3,3,"run031"
"6188","GGG","GGR",1,9,10,6,4,"run031"
"6189","GGG","GRR",0,2,2,1,1,"run031"
"6190","GGG","RBB",1,8,9,5,4,"run031"
"6191","GGG","RBG",0,6,6,1,5,"run031"
"6192","GGG","RBR",0,21,21,21,0,"run031"
"6193","GGG","RGG",0,3,3,2,1,"run031"
"6194","GGG","RGR",1,12,13,6,7,"run031"
"6195","GGG","RRG",1,23,24,2,22,"run031"
"6196","GGG","RRR",0,3,3,2,1,"run031"
"6197","GGR","BBB",0,2,2,1,1,"run031"
"6198","GGR","BBR",0,2,2,1,1,"run031"
"6199","GGR","BGG",0,1,1,0,1,"run031"
"6200","GGR","BRR",1,0,1,1,0,"run031"
"6201","GGR","GRR",1,0,1,0,1,"run031"
"6202","GGR","RBB",0,2,2,2,0,"run031"
"6203","GRG","BBB",3,8,11,9,2,"run031"
"6204","GRG","BBR",0,1,1,1,0,"run031"
"6205","GRG","BGG",0,1,1,1,0,"run031"
"6206","GRG","BRB",0,3,3,2,1,"run031"
"6207","GRG","BRR",0,1,1,1,0,"run031"
"6208","GRG","GBG",0,1,1,0,1,"run031"
"6209","GRG","GGB",2,15,17,16,1,"run031"
"6210","GRG","GGG",3,12,15,13,2,"run031"
"6211","GRG","GGR",0,5,5,2,3,"run031"
"6212","GRG","GRR",0,1,1,0,1,"run031"
"6213","GRG","RBG",0,1,1,0,1,"run031"
"6214","GRG","RBR",0,1,1,0,1,"run031"
"6215","GRG","RGR",1,2,3,2,1,"run031"
"6216","GRG","RRG",2,4,6,0,6,"run031"
"6217","GRR","BBB",0,1,1,1,0,"run031"
"6218","GRR","BBR",0,1,1,0,1,"run031"
"6219","GRR","BGB",1,2,3,1,2,"run031"
"6220","GRR","BGG",0,2,2,1,1,"run031"
"6221","GRR","BRB",0,1,1,0,1,"run031"
"6222","GRR","BRR",0,2,2,2,0,"run031"
"6223","GRR","GGG",0,1,1,0,1,"run031"
"6224","GRR","GGR",0,1,1,1,0,"run031"
"6225","RBB","BBB",0,1,1,1,0,"run031"
"6226","RBB","BBR",0,1,1,0,1,"run031"
"6227","RBB","BRB",0,1,1,0,1,"run031"
"6228","RBB","GRR",0,1,1,0,1,"run031"
"6229","RBB","RGG",0,1,1,0,1,"run031"
"6230","RBG","BBB",2,8,10,5,5,"run031"
"6231","RBG","BBG",0,1,1,0,1,"run031"
"6232","RBG","BRR",0,1,1,1,0,"run031"
"6233","RBG","GBB",0,1,1,1,0,"run031"
"6234","RBG","GRR",0,3,3,0,3,"run031"
"6235","RBG","RBB",1,1,2,1,1,"run031"
"6236","RBG","RBR",0,1,1,0,1,"run031"
"6237","RBG","RGR",0,1,1,1,0,"run031"
"6238","RBR","BBB",0,13,13,11,2,"run031"
"6239","RBR","BBR",0,1,1,1,0,"run031"
"6240","RBR","BGB",2,4,6,4,2,"run031"
"6241","RBR","BGG",0,2,2,0,2,"run031"
"6242","RBR","BRB",1,0,1,1,0,"run031"
"6243","RBR","BRR",1,4,5,5,0,"run031"
"6244","RBR","GGB",0,12,12,12,0,"run031"
"6245","RBR","GRR",4,4,8,7,1,"run031"
"6246","RBR","RBB",0,3,3,2,1,"run031"
"6247","RBR","RGG",2,9,11,7,4,"run031"
"6248","RBR","RGR",1,0,1,1,0,"run031"
"6249","RBR","RRR",0,1,1,1,0,"run031"
"6250","RGG","BBB",0,8,8,3,5,"run031"
"6251","RGG","BBR",1,2,3,1,2,"run031"
"6252","RGG","BGB",0,1,1,0,1,"run031"
"6253","RGG","BRR",0,4,4,0,4,"run031"
"6254","RGG","GGG",0,1,1,1,0,"run031"
"6255","RGG","GGR",0,3,3,3,0,"run031"
"6256","RGG","GRR",0,8,8,3,5,"run031"
"6257","RGG","RBB",0,1,1,1,0,"run031"
"6258","RGR","BBB",2,5,7,0,7,"run031"
"6259","RGR","BBR",1,1,2,1,1,"run031"
"6260","RGR","BGB",2,5,7,7,0,"run031"
"6261","RGR","BGG",2,2,4,2,2,"run031"
"6262","RGR","BRR",1,5,6,0,6,"run031"
"6263","RGR","GGB",2,12,14,13,1,"run031"
"6264","RGR","GGG",0,2,2,0,2,"run031"
"6265","RGR","GGR",0,4,4,3,1,"run031"
"6266","RGR","RBB",0,4,4,3,1,"run031"
"6267","RGR","RGG",1,1,2,0,2,"run031"
"6268","RGR","RRG",0,3,3,0,3,"run031"
"6269","RRG","BBB",2,33,35,18,17,"run031"
"6270","RRG","BBR",0,5,5,0,5,"run031"
"6271","RRG","BGB",1,10,11,9,2,"run031"
"6272","RRG","BGG",0,2,2,1,1,"run031"
"6273","RRG","BRB",2,40,42,33,9,"run031"
"6274","RRG","BRR",1,16,17,15,2,"run031"
"6275","RRG","GGG",2,14,16,8,8,"run031"
"6276","RRG","GGR",0,5,5,4,1,"run031"
"6277","RRG","GRG",1,0,1,0,1,"run031"
"6278","RRG","GRR",3,8,11,6,5,"run031"
"6279","RRG","RBB",1,1,2,0,2,"run031"
"6280","RRG","RGG",0,1,1,0,1,"run031"
"6281","RRG","RGR",0,1,1,0,1,"run031"
"6282","RRR","BBR",1,0,1,0,1,"run031"
"6283","RRR","BGB",2,1,3,3,0,"run031"
"6284","RRR","BGG",1,0,1,1,0,"run031"
"6285","RRR","BRB",1,1,2,1,1,"run031"
"6286","RRR","BRR",1,1,2,1,1,"run031"
"6287","RRR","GGR",0,1,1,1,0,"run031"
"6288","RRR","GRR",0,3,3,2,1,"run031"
"6289","RRR","RBB",1,2,3,0,3,"run031"
"6290","RRR","RBR",0,2,2,0,2,"run031"
"6291","RRR","RGG",0,1,1,1,0,"run031"
"6292","RRR","RGR",1,2,3,0,3,"run031"
"6293","RRR","RRG",2,2,4,2,2,"run031"
"6294","BBB","BRB",0,1,1,0,1,"run032"
"6295","BBB","GGG",1,2,3,1,2,"run032"
"6296","BBB","GRR",0,2,2,2,0,"run032"
"6297","BBB","RBG",0,1,1,1,0,"run032"
"6298","BBB","RRG",1,3,4,0,4,"run032"
"6299","BBB","RRR",0,2,2,0,2,"run032"
"6300","BBG","BBB",1,4,5,0,5,"run032"
"6301","BBG","BGB",0,1,1,0,1,"run032"
"6302","BBG","BGG",0,1,1,0,1,"run032"
"6303","BBG","BRB",1,16,17,5,12,"run032"
"6304","BBG","GBB",0,1,1,0,1,"run032"
"6305","BBG","GBG",2,7,9,6,3,"run032"
"6306","BBG","GGB",2,25,27,17,10,"run032"
"6307","BBG","GGG",4,38,42,40,2,"run032"
"6308","BBG","GRG",1,9,10,2,8,"run032"
"6309","BBG","GRR",0,1,1,0,1,"run032"
"6310","BBG","RBB",0,1,1,0,1,"run032"
"6311","BBG","RBG",0,4,4,3,1,"run032"
"6312","BBG","RBR",0,1,1,1,0,"run032"
"6313","BBG","RGR",0,1,1,0,1,"run032"
"6314","BBG","RRG",1,2,3,2,1,"run032"
"6315","BBG","RRR",0,7,7,7,0,"run032"
"6316","BGB","BBB",0,2,2,0,2,"run032"
"6317","BGB","RRG",0,1,1,0,1,"run032"
"6318","BGG","BBB",0,3,3,1,2,"run032"
"6319","BGG","BBR",0,1,1,0,1,"run032"
"6320","BGG","GRG",0,1,1,1,0,"run032"
"6321","BGG","RBG",1,1,2,2,0,"run032"
"6322","BGG","RGG",0,3,3,1,2,"run032"
"6323","BGG","RGR",0,1,1,1,0,"run032"
"6324","BGG","RRR",1,1,2,0,2,"run032"
"6325","BRB","BBB",0,13,13,4,9,"run032"
"6326","BRB","BBR",0,1,1,1,0,"run032"
"6327","BRB","BRR",0,3,3,3,0,"run032"
"6328","BRB","GGG",0,1,1,1,0,"run032"
"6329","BRB","GGR",0,1,1,0,1,"run032"
"6330","BRB","RBB",0,1,1,1,0,"run032"
"6331","BRB","RBG",0,1,1,0,1,"run032"
"6332","BRB","RGR",0,1,1,1,0,"run032"
"6333","BRB","RRR",0,1,1,1,0,"run032"
"6334","BRR","BBB",0,11,11,0,11,"run032"
"6335","BRR","BGB",1,1,2,0,2,"run032"
"6336","BRR","BGG",0,1,1,1,0,"run032"
"6337","BRR","BRB",0,1,1,1,0,"run032"
"6338","BRR","RBB",0,2,2,0,2,"run032"
"6339","GBB","BBB",12,38,50,23,27,"run032"
"6340","GBB","BGG",0,1,1,1,0,"run032"
"6341","GBB","BRB",1,9,10,10,0,"run032"
"6342","GBB","BRR",1,3,4,0,4,"run032"
"6343","GBB","GBG",0,4,4,3,1,"run032"
"6344","GBB","GGB",0,21,21,8,13,"run032"
"6345","GBB","GGG",7,86,93,68,25,"run032"
"6346","GBB","GGR",1,3,4,2,2,"run032"
"6347","GBB","GRG",0,6,6,0,6,"run032"
"6348","GBB","GRR",0,1,1,1,0,"run032"
"6349","GBB","RBB",0,2,2,2,0,"run032"
"6350","GBB","RBG",3,9,12,1,11,"run032"
"6351","GBB","RBR",1,0,1,1,0,"run032"
"6352","GBB","RGG",1,0,1,0,1,"run032"
"6353","GBB","RGR",2,1,3,3,0,"run032"
"6354","GBB","RRG",0,2,2,1,1,"run032"
"6355","GBB","RRR",1,9,10,2,8,"run032"
"6356","GBG","BBB",0,5,5,5,0,"run032"
"6357","GBG","BBR",0,1,1,1,0,"run032"
"6358","GBG","BRB",1,4,5,0,5,"run032"
"6359","GBG","BRR",1,0,1,1,0,"run032"
"6360","GBG","GGB",0,4,4,3,1,"run032"
"6361","GBG","GGG",4,11,15,13,2,"run032"
"6362","GBG","RBB",1,0,1,0,1,"run032"
"6363","GBG","RBG",0,1,1,0,1,"run032"
"6364","GBG","RGG",0,1,1,1,0,"run032"
"6365","GBG","RGR",1,3,4,0,4,"run032"
"6366","GBG","RRG",1,3,4,0,4,"run032"
"6367","GGB","BBB",3,16,19,8,11,"run032"
"6368","GGB","BBR",1,4,5,3,2,"run032"
"6369","GGB","BGB",0,3,3,0,3,"run032"
"6370","GGB","BGG",0,4,4,1,3,"run032"
"6371","GGB","BRB",0,1,1,1,0,"run032"
"6372","GGB","BRR",1,15,16,4,12,"run032"
"6373","GGB","GBB",0,1,1,0,1,"run032"
"6374","GGB","GBG",1,0,1,0,1,"run032"
"6375","GGB","GGG",13,48,61,43,18,"run032"
"6376","GGB","GGR",0,7,7,4,3,"run032"
"6377","GGB","GRR",0,4,4,4,0,"run032"
"6378","GGB","RBB",0,5,5,2,3,"run032"
"6379","GGB","RBG",0,4,4,1,3,"run032"
"6380","GGB","RBR",0,5,5,0,5,"run032"
"6381","GGB","RGG",1,5,6,5,1,"run032"
"6382","GGB","RGR",0,2,2,0,2,"run032"
"6383","GGB","RRG",1,5,6,6,0,"run032"
"6384","GGB","RRR",1,5,6,1,5,"run032"
"6385","GGG","BBB",8,31,39,30,9,"run032"
"6386","GGG","BGB",0,2,2,0,2,"run032"
"6387","GGG","BGG",1,7,8,7,1,"run032"
"6388","GGG","BRB",1,3,4,2,2,"run032"
"6389","GGG","BRR",0,6,6,6,0,"run032"
"6390","GGG","GGB",5,1,6,5,1,"run032"
"6391","GGG","GGR",1,9,10,0,10,"run032"
"6392","GGG","GRR",0,2,2,0,2,"run032"
"6393","GGG","RBB",1,8,9,8,1,"run032"
"6394","GGG","RBG",0,6,6,6,0,"run032"
"6395","GGG","RBR",0,21,21,19,2,"run032"
"6396","GGG","RGG",0,3,3,1,2,"run032"
"6397","GGG","RGR",1,12,13,0,13,"run032"
"6398","GGG","RRG",1,23,24,18,6,"run032"
"6399","GGG","RRR",0,3,3,0,3,"run032"
"6400","GGR","BBB",0,2,2,2,0,"run032"
"6401","GGR","BBR",0,2,2,1,1,"run032"
"6402","GGR","BGG",0,1,1,1,0,"run032"
"6403","GGR","BRR",1,0,1,0,1,"run032"
"6404","GGR","GRR",1,0,1,0,1,"run032"
"6405","GGR","RBB",0,2,2,0,2,"run032"
"6406","GRG","BBB",3,8,11,9,2,"run032"
"6407","GRG","BBR",0,1,1,1,0,"run032"
"6408","GRG","BGG",0,1,1,1,0,"run032"
"6409","GRG","BRB",0,3,3,2,1,"run032"
"6410","GRG","BRR",0,1,1,0,1,"run032"
"6411","GRG","GBG",0,1,1,1,0,"run032"
"6412","GRG","GGB",2,15,17,8,9,"run032"
"6413","GRG","GGG",3,12,15,4,11,"run032"
"6414","GRG","GGR",0,5,5,5,0,"run032"
"6415","GRG","GRR",0,1,1,1,0,"run032"
"6416","GRG","RBG",0,1,1,0,1,"run032"
"6417","GRG","RBR",0,1,1,1,0,"run032"
"6418","GRG","RGR",1,2,3,2,1,"run032"
"6419","GRG","RRG",2,4,6,4,2,"run032"
"6420","GRR","BBB",0,1,1,1,0,"run032"
"6421","GRR","BBR",0,1,1,1,0,"run032"
"6422","GRR","BGB",1,2,3,3,0,"run032"
"6423","GRR","BGG",0,2,2,2,0,"run032"
"6424","GRR","BRB",0,1,1,1,0,"run032"
"6425","GRR","BRR",0,2,2,1,1,"run032"
"6426","GRR","GGG",0,1,1,1,0,"run032"
"6427","GRR","GGR",0,1,1,1,0,"run032"
"6428","RBB","BBB",0,1,1,1,0,"run032"
"6429","RBB","BBR",0,1,1,0,1,"run032"
"6430","RBB","BRB",0,1,1,0,1,"run032"
"6431","RBB","GRR",0,1,1,1,0,"run032"
"6432","RBB","RGG",0,1,1,1,0,"run032"
"6433","RBG","BBB",2,8,10,7,3,"run032"
"6434","RBG","BBG",0,1,1,0,1,"run032"
"6435","RBG","BRR",0,1,1,0,1,"run032"
"6436","RBG","GBB",0,1,1,0,1,"run032"
"6437","RBG","GRR",0,3,3,0,3,"run032"
"6438","RBG","RBB",1,1,2,0,2,"run032"
"6439","RBG","RBR",0,1,1,1,0,"run032"
"6440","RBG","RGR",0,1,1,1,0,"run032"
"6441","RBR","BBB",0,13,13,11,2,"run032"
"6442","RBR","BBR",0,1,1,0,1,"run032"
"6443","RBR","BGB",2,4,6,5,1,"run032"
"6444","RBR","BGG",0,2,2,0,2,"run032"
"6445","RBR","BRB",1,0,1,0,1,"run032"
"6446","RBR","BRR",1,4,5,0,5,"run032"
"6447","RBR","GGB",0,12,12,7,5,"run032"
"6448","RBR","GRR",4,4,8,0,8,"run032"
"6449","RBR","RBB",0,3,3,1,2,"run032"
"6450","RBR","RGG",2,9,11,5,6,"run032"
"6451","RBR","RGR",1,0,1,1,0,"run032"
"6452","RBR","RRR",0,1,1,0,1,"run032"
"6453","RGG","BBB",0,8,8,1,7,"run032"
"6454","RGG","BBR",1,2,3,1,2,"run032"
"6455","RGG","BGB",0,1,1,0,1,"run032"
"6456","RGG","BRR",0,4,4,1,3,"run032"
"6457","RGG","GGG",0,1,1,1,0,"run032"
"6458","RGG","GGR",0,3,3,1,2,"run032"
"6459","RGG","GRR",0,8,8,8,0,"run032"
"6460","RGG","RBB",0,1,1,1,0,"run032"
"6461","RGR","BBB",2,5,7,7,0,"run032"
"6462","RGR","BBR",1,1,2,0,2,"run032"
"6463","RGR","BGB",2,5,7,5,2,"run032"
"6464","RGR","BGG",2,2,4,1,3,"run032"
"6465","RGR","BRR",1,5,6,3,3,"run032"
"6466","RGR","GGB",2,12,14,7,7,"run032"
"6467","RGR","GGG",0,2,2,1,1,"run032"
"6468","RGR","GGR",0,4,4,3,1,"run032"
"6469","RGR","RBB",0,4,4,1,3,"run032"
"6470","RGR","RGG",1,1,2,2,0,"run032"
"6471","RGR","RRG",0,3,3,2,1,"run032"
"6472","RRG","BBB",2,33,35,30,5,"run032"
"6473","RRG","BBR",0,5,5,5,0,"run032"
"6474","RRG","BGB",1,10,11,0,11,"run032"
"6475","RRG","BGG",0,2,2,0,2,"run032"
"6476","RRG","BRB",2,40,42,41,1,"run032"
"6477","RRG","BRR",1,16,17,9,8,"run032"
"6478","RRG","GGG",2,14,16,10,6,"run032"
"6479","RRG","GGR",0,5,5,4,1,"run032"
"6480","RRG","GRG",1,0,1,1,0,"run032"
"6481","RRG","GRR",3,8,11,3,8,"run032"
"6482","RRG","RBB",1,1,2,0,2,"run032"
"6483","RRG","RGG",0,1,1,1,0,"run032"
"6484","RRG","RGR",0,1,1,1,0,"run032"
"6485","RRR","BBR",1,0,1,0,1,"run032"
"6486","RRR","BGB",2,1,3,3,0,"run032"
"6487","RRR","BGG",1,0,1,1,0,"run032"
"6488","RRR","BRB",1,1,2,0,2,"run032"
"6489","RRR","BRR",1,1,2,1,1,"run032"
"6490","RRR","GGR",0,1,1,0,1,"run032"
"6491","RRR","GRR",0,3,3,2,1,"run032"
"6492","RRR","RBB",1,2,3,0,3,"run032"
"6493","RRR","RBR",0,2,2,0,2,"run032"
"6494","RRR","RGG",0,1,1,1,0,"run032"
"6495","RRR","RGR",1,2,3,2,1,"run032"
"6496","RRR","RRG",2,2,4,1,3,"run032"
"6497","BBB","BRB",0,1,1,1,0,"run033"
"6498","BBB","GGG",1,2,3,3,0,"run033"
"6499","BBB","GRR",0,2,2,1,1,"run033"
"6500","BBB","RBG",0,1,1,1,0,"run033"
"6501","BBB","RRG",1,3,4,0,4,"run033"
"6502","BBB","RRR",0,2,2,1,1,"run033"
"6503","BBG","BBB",1,4,5,3,2,"run033"
"6504","BBG","BGB",0,1,1,0,1,"run033"
"6505","BBG","BGG",0,1,1,0,1,"run033"
"6506","BBG","BRB",1,16,17,4,13,"run033"
"6507","BBG","GBB",0,1,1,1,0,"run033"
"6508","BBG","GBG",2,7,9,6,3,"run033"
"6509","BBG","GGB",2,25,27,9,18,"run033"
"6510","BBG","GGG",4,38,42,31,11,"run033"
"6511","BBG","GRG",1,9,10,5,5,"run033"
"6512","BBG","GRR",0,1,1,1,0,"run033"
"6513","BBG","RBB",0,1,1,1,0,"run033"
"6514","BBG","RBG",0,4,4,3,1,"run033"
"6515","BBG","RBR",0,1,1,0,1,"run033"
"6516","BBG","RGR",0,1,1,0,1,"run033"
"6517","BBG","RRG",1,2,3,1,2,"run033"
"6518","BBG","RRR",0,7,7,3,4,"run033"
"6519","BGB","BBB",0,2,2,1,1,"run033"
"6520","BGB","RRG",0,1,1,0,1,"run033"
"6521","BGG","BBB",0,3,3,2,1,"run033"
"6522","BGG","BBR",0,1,1,0,1,"run033"
"6523","BGG","GRG",0,1,1,0,1,"run033"
"6524","BGG","RBG",1,1,2,1,1,"run033"
"6525","BGG","RGG",0,3,3,3,0,"run033"
"6526","BGG","RGR",0,1,1,0,1,"run033"
"6527","BGG","RRR",1,1,2,0,2,"run033"
"6528","BRB","BBB",0,13,13,2,11,"run033"
"6529","BRB","BBR",0,1,1,1,0,"run033"
"6530","BRB","BRR",0,3,3,2,1,"run033"
"6531","BRB","GGG",0,1,1,1,0,"run033"
"6532","BRB","GGR",0,1,1,0,1,"run033"
"6533","BRB","RBB",0,1,1,1,0,"run033"
"6534","BRB","RBG",0,1,1,0,1,"run033"
"6535","BRB","RGR",0,1,1,0,1,"run033"
"6536","BRB","RRR",0,1,1,1,0,"run033"
"6537","BRR","BBB",0,11,11,5,6,"run033"
"6538","BRR","BGB",1,1,2,2,0,"run033"
"6539","BRR","BGG",0,1,1,0,1,"run033"
"6540","BRR","BRB",0,1,1,0,1,"run033"
"6541","BRR","RBB",0,2,2,1,1,"run033"
"6542","GBB","BBB",12,38,50,15,35,"run033"
"6543","GBB","BGG",0,1,1,0,1,"run033"
"6544","GBB","BRB",1,9,10,1,9,"run033"
"6545","GBB","BRR",1,3,4,1,3,"run033"
"6546","GBB","GBG",0,4,4,0,4,"run033"
"6547","GBB","GGB",0,21,21,14,7,"run033"
"6548","GBB","GGG",7,86,93,57,36,"run033"
"6549","GBB","GGR",1,3,4,2,2,"run033"
"6550","GBB","GRG",0,6,6,2,4,"run033"
"6551","GBB","GRR",0,1,1,0,1,"run033"
"6552","GBB","RBB",0,2,2,1,1,"run033"
"6553","GBB","RBG",3,9,12,12,0,"run033"
"6554","GBB","RBR",1,0,1,1,0,"run033"
"6555","GBB","RGG",1,0,1,0,1,"run033"
"6556","GBB","RGR",2,1,3,0,3,"run033"
"6557","GBB","RRG",0,2,2,1,1,"run033"
"6558","GBB","RRR",1,9,10,6,4,"run033"
"6559","GBG","BBB",0,5,5,4,1,"run033"
"6560","GBG","BBR",0,1,1,0,1,"run033"
"6561","GBG","BRB",1,4,5,2,3,"run033"
"6562","GBG","BRR",1,0,1,1,0,"run033"
"6563","GBG","GGB",0,4,4,4,0,"run033"
"6564","GBG","GGG",4,11,15,9,6,"run033"
"6565","GBG","RBB",1,0,1,1,0,"run033"
"6566","GBG","RBG",0,1,1,1,0,"run033"
"6567","GBG","RGG",0,1,1,0,1,"run033"
"6568","GBG","RGR",1,3,4,3,1,"run033"
"6569","GBG","RRG",1,3,4,0,4,"run033"
"6570","GGB","BBB",3,16,19,3,16,"run033"
"6571","GGB","BBR",1,4,5,1,4,"run033"
"6572","GGB","BGB",0,3,3,0,3,"run033"
"6573","GGB","BGG",0,4,4,3,1,"run033"
"6574","GGB","BRB",0,1,1,1,0,"run033"
"6575","GGB","BRR",1,15,16,11,5,"run033"
"6576","GGB","GBB",0,1,1,0,1,"run033"
"6577","GGB","GBG",1,0,1,0,1,"run033"
"6578","GGB","GGG",13,48,61,55,6,"run033"
"6579","GGB","GGR",0,7,7,5,2,"run033"
"6580","GGB","GRR",0,4,4,3,1,"run033"
"6581","GGB","RBB",0,5,5,4,1,"run033"
"6582","GGB","RBG",0,4,4,1,3,"run033"
"6583","GGB","RBR",0,5,5,3,2,"run033"
"6584","GGB","RGG",1,5,6,5,1,"run033"
"6585","GGB","RGR",0,2,2,1,1,"run033"
"6586","GGB","RRG",1,5,6,1,5,"run033"
"6587","GGB","RRR",1,5,6,6,0,"run033"
"6588","GGG","BBB",8,31,39,4,35,"run033"
"6589","GGG","BGB",0,2,2,2,0,"run033"
"6590","GGG","BGG",1,7,8,8,0,"run033"
"6591","GGG","BRB",1,3,4,2,2,"run033"
"6592","GGG","BRR",0,6,6,6,0,"run033"
"6593","GGG","GGB",5,1,6,0,6,"run033"
"6594","GGG","GGR",1,9,10,7,3,"run033"
"6595","GGG","GRR",0,2,2,1,1,"run033"
"6596","GGG","RBB",1,8,9,6,3,"run033"
"6597","GGG","RBG",0,6,6,1,5,"run033"
"6598","GGG","RBR",0,21,21,5,16,"run033"
"6599","GGG","RGG",0,3,3,1,2,"run033"
"6600","GGG","RGR",1,12,13,3,10,"run033"
"6601","GGG","RRG",1,23,24,18,6,"run033"
"6602","GGG","RRR",0,3,3,3,0,"run033"
"6603","GGR","BBB",0,2,2,1,1,"run033"
"6604","GGR","BBR",0,2,2,1,1,"run033"
"6605","GGR","BGG",0,1,1,0,1,"run033"
"6606","GGR","BRR",1,0,1,0,1,"run033"
"6607","GGR","GRR",1,0,1,1,0,"run033"
"6608","GGR","RBB",0,2,2,2,0,"run033"
"6609","GRG","BBB",3,8,11,3,8,"run033"
"6610","GRG","BBR",0,1,1,0,1,"run033"
"6611","GRG","BGG",0,1,1,0,1,"run033"
"6612","GRG","BRB",0,3,3,0,3,"run033"
"6613","GRG","BRR",0,1,1,0,1,"run033"
"6614","GRG","GBG",0,1,1,1,0,"run033"
"6615","GRG","GGB",2,15,17,7,10,"run033"
"6616","GRG","GGG",3,12,15,8,7,"run033"
"6617","GRG","GGR",0,5,5,2,3,"run033"
"6618","GRG","GRR",0,1,1,0,1,"run033"
"6619","GRG","RBG",0,1,1,1,0,"run033"
"6620","GRG","RBR",0,1,1,1,0,"run033"
"6621","GRG","RGR",1,2,3,2,1,"run033"
"6622","GRG","RRG",2,4,6,0,6,"run033"
"6623","GRR","BBB",0,1,1,1,0,"run033"
"6624","GRR","BBR",0,1,1,0,1,"run033"
"6625","GRR","BGB",1,2,3,2,1,"run033"
"6626","GRR","BGG",0,2,2,2,0,"run033"
"6627","GRR","BRB",0,1,1,1,0,"run033"
"6628","GRR","BRR",0,2,2,1,1,"run033"
"6629","GRR","GGG",0,1,1,1,0,"run033"
"6630","GRR","GGR",0,1,1,0,1,"run033"
"6631","RBB","BBB",0,1,1,0,1,"run033"
"6632","RBB","BBR",0,1,1,1,0,"run033"
"6633","RBB","BRB",0,1,1,1,0,"run033"
"6634","RBB","GRR",0,1,1,0,1,"run033"
"6635","RBB","RGG",0,1,1,0,1,"run033"
"6636","RBG","BBB",2,8,10,3,7,"run033"
"6637","RBG","BBG",0,1,1,0,1,"run033"
"6638","RBG","BRR",0,1,1,1,0,"run033"
"6639","RBG","GBB",0,1,1,1,0,"run033"
"6640","RBG","GRR",0,3,3,3,0,"run033"
"6641","RBG","RBB",1,1,2,1,1,"run033"
"6642","RBG","RBR",0,1,1,0,1,"run033"
"6643","RBG","RGR",0,1,1,1,0,"run033"
"6644","RBR","BBB",0,13,13,9,4,"run033"
"6645","RBR","BBR",0,1,1,1,0,"run033"
"6646","RBR","BGB",2,4,6,1,5,"run033"
"6647","RBR","BGG",0,2,2,2,0,"run033"
"6648","RBR","BRB",1,0,1,1,0,"run033"
"6649","RBR","BRR",1,4,5,3,2,"run033"
"6650","RBR","GGB",0,12,12,4,8,"run033"
"6651","RBR","GRR",4,4,8,7,1,"run033"
"6652","RBR","RBB",0,3,3,0,3,"run033"
"6653","RBR","RGG",2,9,11,1,10,"run033"
"6654","RBR","RGR",1,0,1,0,1,"run033"
"6655","RBR","RRR",0,1,1,1,0,"run033"
"6656","RGG","BBB",0,8,8,3,5,"run033"
"6657","RGG","BBR",1,2,3,3,0,"run033"
"6658","RGG","BGB",0,1,1,0,1,"run033"
"6659","RGG","BRR",0,4,4,3,1,"run033"
"6660","RGG","GGG",0,1,1,0,1,"run033"
"6661","RGG","GGR",0,3,3,1,2,"run033"
"6662","RGG","GRR",0,8,8,6,2,"run033"
"6663","RGG","RBB",0,1,1,0,1,"run033"
"6664","RGR","BBB",2,5,7,4,3,"run033"
"6665","RGR","BBR",1,1,2,1,1,"run033"
"6666","RGR","BGB",2,5,7,6,1,"run033"
"6667","RGR","BGG",2,2,4,4,0,"run033"
"6668","RGR","BRR",1,5,6,5,1,"run033"
"6669","RGR","GGB",2,12,14,7,7,"run033"
"6670","RGR","GGG",0,2,2,2,0,"run033"
"6671","RGR","GGR",0,4,4,2,2,"run033"
"6672","RGR","RBB",0,4,4,0,4,"run033"
"6673","RGR","RGG",1,1,2,2,0,"run033"
"6674","RGR","RRG",0,3,3,1,2,"run033"
"6675","RRG","BBB",2,33,35,6,29,"run033"
"6676","RRG","BBR",0,5,5,5,0,"run033"
"6677","RRG","BGB",1,10,11,7,4,"run033"
"6678","RRG","BGG",0,2,2,1,1,"run033"
"6679","RRG","BRB",2,40,42,34,8,"run033"
"6680","RRG","BRR",1,16,17,1,16,"run033"
"6681","RRG","GGG",2,14,16,9,7,"run033"
"6682","RRG","GGR",0,5,5,0,5,"run033"
"6683","RRG","GRG",1,0,1,1,0,"run033"
"6684","RRG","GRR",3,8,11,8,3,"run033"
"6685","RRG","RBB",1,1,2,1,1,"run033"
"6686","RRG","RGG",0,1,1,0,1,"run033"
"6687","RRG","RGR",0,1,1,1,0,"run033"
"6688","RRR","BBR",1,0,1,0,1,"run033"
"6689","RRR","BGB",2,1,3,0,3,"run033"
"6690","RRR","BGG",1,0,1,1,0,"run033"
"6691","RRR","BRB",1,1,2,0,2,"run033"
"6692","RRR","BRR",1,1,2,0,2,"run033"
"6693","RRR","GGR",0,1,1,1,0,"run033"
"6694","RRR","GRR",0,3,3,3,0,"run033"
"6695","RRR","RBB",1,2,3,3,0,"run033"
"6696","RRR","RBR",0,2,2,0,2,"run033"
"6697","RRR","RGG",0,1,1,1,0,"run033"
"6698","RRR","RGR",1,2,3,3,0,"run033"
"6699","RRR","RRG",2,2,4,2,2,"run033"
"6700","BBB","BRB",0,1,1,0,1,"run034"
"6701","BBB","GGG",1,2,3,0,3,"run034"
"6702","BBB","GRR",0,2,2,0,2,"run034"
"6703","BBB","RBG",0,1,1,1,0,"run034"
"6704","BBB","RRG",1,3,4,1,3,"run034"
"6705","BBB","RRR",0,2,2,1,1,"run034"
"6706","BBG","BBB",1,4,5,5,0,"run034"
"6707","BBG","BGB",0,1,1,1,0,"run034"
"6708","BBG","BGG",0,1,1,0,1,"run034"
"6709","BBG","BRB",1,16,17,10,7,"run034"
"6710","BBG","GBB",0,1,1,1,0,"run034"
"6711","BBG","GBG",2,7,9,2,7,"run034"
"6712","BBG","GGB",2,25,27,2,25,"run034"
"6713","BBG","GGG",4,38,42,42,0,"run034"
"6714","BBG","GRG",1,9,10,3,7,"run034"
"6715","BBG","GRR",0,1,1,0,1,"run034"
"6716","BBG","RBB",0,1,1,1,0,"run034"
"6717","BBG","RBG",0,4,4,2,2,"run034"
"6718","BBG","RBR",0,1,1,1,0,"run034"
"6719","BBG","RGR",0,1,1,0,1,"run034"
"6720","BBG","RRG",1,2,3,3,0,"run034"
"6721","BBG","RRR",0,7,7,2,5,"run034"
"6722","BGB","BBB",0,2,2,2,0,"run034"
"6723","BGB","RRG",0,1,1,0,1,"run034"
"6724","BGG","BBB",0,3,3,2,1,"run034"
"6725","BGG","BBR",0,1,1,0,1,"run034"
"6726","BGG","GRG",0,1,1,1,0,"run034"
"6727","BGG","RBG",1,1,2,0,2,"run034"
"6728","BGG","RGG",0,3,3,2,1,"run034"
"6729","BGG","RGR",0,1,1,1,0,"run034"
"6730","BGG","RRR",1,1,2,0,2,"run034"
"6731","BRB","BBB",0,13,13,3,10,"run034"
"6732","BRB","BBR",0,1,1,1,0,"run034"
"6733","BRB","BRR",0,3,3,3,0,"run034"
"6734","BRB","GGG",0,1,1,1,0,"run034"
"6735","BRB","GGR",0,1,1,0,1,"run034"
"6736","BRB","RBB",0,1,1,1,0,"run034"
"6737","BRB","RBG",0,1,1,1,0,"run034"
"6738","BRB","RGR",0,1,1,1,0,"run034"
"6739","BRB","RRR",0,1,1,0,1,"run034"
"6740","BRR","BBB",0,11,11,1,10,"run034"
"6741","BRR","BGB",1,1,2,1,1,"run034"
"6742","BRR","BGG",0,1,1,1,0,"run034"
"6743","BRR","BRB",0,1,1,0,1,"run034"
"6744","BRR","RBB",0,2,2,0,2,"run034"
"6745","GBB","BBB",12,38,50,35,15,"run034"
"6746","GBB","BGG",0,1,1,1,0,"run034"
"6747","GBB","BRB",1,9,10,8,2,"run034"
"6748","GBB","BRR",1,3,4,0,4,"run034"
"6749","GBB","GBG",0,4,4,3,1,"run034"
"6750","GBB","GGB",0,21,21,21,0,"run034"
"6751","GBB","GGG",7,86,93,51,42,"run034"
"6752","GBB","GGR",1,3,4,2,2,"run034"
"6753","GBB","GRG",0,6,6,3,3,"run034"
"6754","GBB","GRR",0,1,1,1,0,"run034"
"6755","GBB","RBB",0,2,2,0,2,"run034"
"6756","GBB","RBG",3,9,12,10,2,"run034"
"6757","GBB","RBR",1,0,1,1,0,"run034"
"6758","GBB","RGG",1,0,1,0,1,"run034"
"6759","GBB","RGR",2,1,3,2,1,"run034"
"6760","GBB","RRG",0,2,2,2,0,"run034"
"6761","GBB","RRR",1,9,10,2,8,"run034"
"6762","GBG","BBB",0,5,5,0,5,"run034"
"6763","GBG","BBR",0,1,1,0,1,"run034"
"6764","GBG","BRB",1,4,5,0,5,"run034"
"6765","GBG","BRR",1,0,1,1,0,"run034"
"6766","GBG","GGB",0,4,4,1,3,"run034"
"6767","GBG","GGG",4,11,15,5,10,"run034"
"6768","GBG","RBB",1,0,1,1,0,"run034"
"6769","GBG","RBG",0,1,1,0,1,"run034"
"6770","GBG","RGG",0,1,1,0,1,"run034"
"6771","GBG","RGR",1,3,4,4,0,"run034"
"6772","GBG","RRG",1,3,4,0,4,"run034"
"6773","GGB","BBB",3,16,19,2,17,"run034"
"6774","GGB","BBR",1,4,5,5,0,"run034"
"6775","GGB","BGB",0,3,3,3,0,"run034"
"6776","GGB","BGG",0,4,4,0,4,"run034"
"6777","GGB","BRB",0,1,1,0,1,"run034"
"6778","GGB","BRR",1,15,16,13,3,"run034"
"6779","GGB","GBB",0,1,1,1,0,"run034"
"6780","GGB","GBG",1,0,1,1,0,"run034"
"6781","GGB","GGG",13,48,61,37,24,"run034"
"6782","GGB","GGR",0,7,7,1,6,"run034"
"6783","GGB","GRR",0,4,4,2,2,"run034"
"6784","GGB","RBB",0,5,5,2,3,"run034"
"6785","GGB","RBG",0,4,4,4,0,"run034"
"6786","GGB","RBR",0,5,5,4,1,"run034"
"6787","GGB","RGG",1,5,6,1,5,"run034"
"6788","GGB","RGR",0,2,2,1,1,"run034"
"6789","GGB","RRG",1,5,6,4,2,"run034"
"6790","GGB","RRR",1,5,6,1,5,"run034"
"6791","GGG","BBB",8,31,39,14,25,"run034"
"6792","GGG","BGB",0,2,2,1,1,"run034"
"6793","GGG","BGG",1,7,8,3,5,"run034"
"6794","GGG","BRB",1,3,4,1,3,"run034"
"6795","GGG","BRR",0,6,6,0,6,"run034"
"6796","GGG","GGB",5,1,6,0,6,"run034"
"6797","GGG","GGR",1,9,10,1,9,"run034"
"6798","GGG","GRR",0,2,2,0,2,"run034"
"6799","GGG","RBB",1,8,9,5,4,"run034"
"6800","GGG","RBG",0,6,6,4,2,"run034"
"6801","GGG","RBR",0,21,21,12,9,"run034"
"6802","GGG","RGG",0,3,3,1,2,"run034"
"6803","GGG","RGR",1,12,13,5,8,"run034"
"6804","GGG","RRG",1,23,24,23,1,"run034"
"6805","GGG","RRR",0,3,3,0,3,"run034"
"6806","GGR","BBB",0,2,2,1,1,"run034"
"6807","GGR","BBR",0,2,2,0,2,"run034"
"6808","GGR","BGG",0,1,1,1,0,"run034"
"6809","GGR","BRR",1,0,1,1,0,"run034"
"6810","GGR","GRR",1,0,1,0,1,"run034"
"6811","GGR","RBB",0,2,2,2,0,"run034"
"6812","GRG","BBB",3,8,11,11,0,"run034"
"6813","GRG","BBR",0,1,1,0,1,"run034"
"6814","GRG","BGG",0,1,1,1,0,"run034"
"6815","GRG","BRB",0,3,3,2,1,"run034"
"6816","GRG","BRR",0,1,1,0,1,"run034"
"6817","GRG","GBG",0,1,1,1,0,"run034"
"6818","GRG","GGB",2,15,17,4,13,"run034"
"6819","GRG","GGG",3,12,15,14,1,"run034"
"6820","GRG","GGR",0,5,5,4,1,"run034"
"6821","GRG","GRR",0,1,1,0,1,"run034"
"6822","GRG","RBG",0,1,1,0,1,"run034"
"6823","GRG","RBR",0,1,1,0,1,"run034"
"6824","GRG","RGR",1,2,3,1,2,"run034"
"6825","GRG","RRG",2,4,6,4,2,"run034"
"6826","GRR","BBB",0,1,1,1,0,"run034"
"6827","GRR","BBR",0,1,1,0,1,"run034"
"6828","GRR","BGB",1,2,3,0,3,"run034"
"6829","GRR","BGG",0,2,2,0,2,"run034"
"6830","GRR","BRB",0,1,1,1,0,"run034"
"6831","GRR","BRR",0,2,2,2,0,"run034"
"6832","GRR","GGG",0,1,1,0,1,"run034"
"6833","GRR","GGR",0,1,1,1,0,"run034"
"6834","RBB","BBB",0,1,1,1,0,"run034"
"6835","RBB","BBR",0,1,1,1,0,"run034"
"6836","RBB","BRB",0,1,1,0,1,"run034"
"6837","RBB","GRR",0,1,1,1,0,"run034"
"6838","RBB","RGG",0,1,1,1,0,"run034"
"6839","RBG","BBB",2,8,10,9,1,"run034"
"6840","RBG","BBG",0,1,1,1,0,"run034"
"6841","RBG","BRR",0,1,1,0,1,"run034"
"6842","RBG","GBB",0,1,1,0,1,"run034"
"6843","RBG","GRR",0,3,3,0,3,"run034"
"6844","RBG","RBB",1,1,2,1,1,"run034"
"6845","RBG","RBR",0,1,1,1,0,"run034"
"6846","RBG","RGR",0,1,1,1,0,"run034"
"6847","RBR","BBB",0,13,13,3,10,"run034"
"6848","RBR","BBR",0,1,1,1,0,"run034"
"6849","RBR","BGB",2,4,6,5,1,"run034"
"6850","RBR","BGG",0,2,2,0,2,"run034"
"6851","RBR","BRB",1,0,1,1,0,"run034"
"6852","RBR","BRR",1,4,5,0,5,"run034"
"6853","RBR","GGB",0,12,12,6,6,"run034"
"6854","RBR","GRR",4,4,8,1,7,"run034"
"6855","RBR","RBB",0,3,3,1,2,"run034"
"6856","RBR","RGG",2,9,11,11,0,"run034"
"6857","RBR","RGR",1,0,1,0,1,"run034"
"6858","RBR","RRR",0,1,1,1,0,"run034"
"6859","RGG","BBB",0,8,8,8,0,"run034"
"6860","RGG","BBR",1,2,3,1,2,"run034"
"6861","RGG","BGB",0,1,1,0,1,"run034"
"6862","RGG","BRR",0,4,4,3,1,"run034"
"6863","RGG","GGG",0,1,1,1,0,"run034"
"6864","RGG","GGR",0,3,3,0,3,"run034"
"6865","RGG","GRR",0,8,8,6,2,"run034"
"6866","RGG","RBB",0,1,1,1,0,"run034"
"6867","RGR","BBB",2,5,7,0,7,"run034"
"6868","RGR","BBR",1,1,2,0,2,"run034"
"6869","RGR","BGB",2,5,7,5,2,"run034"
"6870","RGR","BGG",2,2,4,2,2,"run034"
"6871","RGR","BRR",1,5,6,0,6,"run034"
"6872","RGR","GGB",2,12,14,2,12,"run034"
"6873","RGR","GGG",0,2,2,0,2,"run034"
"6874","RGR","GGR",0,4,4,4,0,"run034"
"6875","RGR","RBB",0,4,4,2,2,"run034"
"6876","RGR","RGG",1,1,2,0,2,"run034"
"6877","RGR","RRG",0,3,3,1,2,"run034"
"6878","RRG","BBB",2,33,35,1,34,"run034"
"6879","RRG","BBR",0,5,5,5,0,"run034"
"6880","RRG","BGB",1,10,11,5,6,"run034"
"6881","RRG","BGG",0,2,2,1,1,"run034"
"6882","RRG","BRB",2,40,42,5,37,"run034"
"6883","RRG","BRR",1,16,17,14,3,"run034"
"6884","RRG","GGG",2,14,16,7,9,"run034"
"6885","RRG","GGR",0,5,5,0,5,"run034"
"6886","RRG","GRG",1,0,1,0,1,"run034"
"6887","RRG","GRR",3,8,11,7,4,"run034"
"6888","RRG","RBB",1,1,2,1,1,"run034"
"6889","RRG","RGG",0,1,1,0,1,"run034"
"6890","RRG","RGR",0,1,1,1,0,"run034"
"6891","RRR","BBR",1,0,1,1,0,"run034"
"6892","RRR","BGB",2,1,3,3,0,"run034"
"6893","RRR","BGG",1,0,1,0,1,"run034"
"6894","RRR","BRB",1,1,2,1,1,"run034"
"6895","RRR","BRR",1,1,2,0,2,"run034"
"6896","RRR","GGR",0,1,1,0,1,"run034"
"6897","RRR","GRR",0,3,3,2,1,"run034"
"6898","RRR","RBB",1,2,3,0,3,"run034"
"6899","RRR","RBR",0,2,2,0,2,"run034"
"6900","RRR","RGG",0,1,1,0,1,"run034"
"6901","RRR","RGR",1,2,3,0,3,"run034"
"6902","RRR","RRG",2,2,4,3,1,"run034"
"6903","BBB","BRB",0,1,1,1,0,"run035"
"6904","BBB","GGG",1,2,3,1,2,"run035"
"6905","BBB","GRR",0,2,2,0,2,"run035"
"6906","BBB","RBG",0,1,1,0,1,"run035"
"6907","BBB","RRG",1,3,4,2,2,"run035"
"6908","BBB","RRR",0,2,2,0,2,"run035"
"6909","BBG","BBB",1,4,5,5,0,"run035"
"6910","BBG","BGB",0,1,1,0,1,"run035"
"6911","BBG","BGG",0,1,1,1,0,"run035"
"6912","BBG","BRB",1,16,17,1,16,"run035"
"6913","BBG","GBB",0,1,1,1,0,"run035"
"6914","BBG","GBG",2,7,9,8,1,"run035"
"6915","BBG","GGB",2,25,27,9,18,"run035"
"6916","BBG","GGG",4,38,42,24,18,"run035"
"6917","BBG","GRG",1,9,10,10,0,"run035"
"6918","BBG","GRR",0,1,1,0,1,"run035"
"6919","BBG","RBB",0,1,1,0,1,"run035"
"6920","BBG","RBG",0,4,4,2,2,"run035"
"6921","BBG","RBR",0,1,1,1,0,"run035"
"6922","BBG","RGR",0,1,1,0,1,"run035"
"6923","BBG","RRG",1,2,3,1,2,"run035"
"6924","BBG","RRR",0,7,7,6,1,"run035"
"6925","BGB","BBB",0,2,2,0,2,"run035"
"6926","BGB","RRG",0,1,1,0,1,"run035"
"6927","BGG","BBB",0,3,3,2,1,"run035"
"6928","BGG","BBR",0,1,1,0,1,"run035"
"6929","BGG","GRG",0,1,1,1,0,"run035"
"6930","BGG","RBG",1,1,2,0,2,"run035"
"6931","BGG","RGG",0,3,3,3,0,"run035"
"6932","BGG","RGR",0,1,1,1,0,"run035"
"6933","BGG","RRR",1,1,2,0,2,"run035"
"6934","BRB","BBB",0,13,13,8,5,"run035"
"6935","BRB","BBR",0,1,1,1,0,"run035"
"6936","BRB","BRR",0,3,3,3,0,"run035"
"6937","BRB","GGG",0,1,1,0,1,"run035"
"6938","BRB","GGR",0,1,1,0,1,"run035"
"6939","BRB","RBB",0,1,1,1,0,"run035"
"6940","BRB","RBG",0,1,1,1,0,"run035"
"6941","BRB","RGR",0,1,1,0,1,"run035"
"6942","BRB","RRR",0,1,1,0,1,"run035"
"6943","BRR","BBB",0,11,11,9,2,"run035"
"6944","BRR","BGB",1,1,2,0,2,"run035"
"6945","BRR","BGG",0,1,1,0,1,"run035"
"6946","BRR","BRB",0,1,1,1,0,"run035"
"6947","BRR","RBB",0,2,2,1,1,"run035"
"6948","GBB","BBB",12,38,50,16,34,"run035"
"6949","GBB","BGG",0,1,1,0,1,"run035"
"6950","GBB","BRB",1,9,10,10,0,"run035"
"6951","GBB","BRR",1,3,4,1,3,"run035"
"6952","GBB","GBG",0,4,4,1,3,"run035"
"6953","GBB","GGB",0,21,21,16,5,"run035"
"6954","GBB","GGG",7,86,93,54,39,"run035"
"6955","GBB","GGR",1,3,4,2,2,"run035"
"6956","GBB","GRG",0,6,6,2,4,"run035"
"6957","GBB","GRR",0,1,1,0,1,"run035"
"6958","GBB","RBB",0,2,2,0,2,"run035"
"6959","GBB","RBG",3,9,12,6,6,"run035"
"6960","GBB","RBR",1,0,1,0,1,"run035"
"6961","GBB","RGG",1,0,1,1,0,"run035"
"6962","GBB","RGR",2,1,3,2,1,"run035"
"6963","GBB","RRG",0,2,2,0,2,"run035"
"6964","GBB","RRR",1,9,10,5,5,"run035"
"6965","GBG","BBB",0,5,5,5,0,"run035"
"6966","GBG","BBR",0,1,1,0,1,"run035"
"6967","GBG","BRB",1,4,5,3,2,"run035"
"6968","GBG","BRR",1,0,1,1,0,"run035"
"6969","GBG","GGB",0,4,4,0,4,"run035"
"6970","GBG","GGG",4,11,15,7,8,"run035"
"6971","GBG","RBB",1,0,1,1,0,"run035"
"6972","GBG","RBG",0,1,1,0,1,"run035"
"6973","GBG","RGG",0,1,1,1,0,"run035"
"6974","GBG","RGR",1,3,4,3,1,"run035"
"6975","GBG","RRG",1,3,4,0,4,"run035"
"6976","GGB","BBB",3,16,19,12,7,"run035"
"6977","GGB","BBR",1,4,5,1,4,"run035"
"6978","GGB","BGB",0,3,3,0,3,"run035"
"6979","GGB","BGG",0,4,4,0,4,"run035"
"6980","GGB","BRB",0,1,1,0,1,"run035"
"6981","GGB","BRR",1,15,16,16,0,"run035"
"6982","GGB","GBB",0,1,1,1,0,"run035"
"6983","GGB","GBG",1,0,1,1,0,"run035"
"6984","GGB","GGG",13,48,61,49,12,"run035"
"6985","GGB","GGR",0,7,7,1,6,"run035"
"6986","GGB","GRR",0,4,4,2,2,"run035"
"6987","GGB","RBB",0,5,5,2,3,"run035"
"6988","GGB","RBG",0,4,4,4,0,"run035"
"6989","GGB","RBR",0,5,5,1,4,"run035"
"6990","GGB","RGG",1,5,6,0,6,"run035"
"6991","GGB","RGR",0,2,2,2,0,"run035"
"6992","GGB","RRG",1,5,6,2,4,"run035"
"6993","GGB","RRR",1,5,6,1,5,"run035"
"6994","GGG","BBB",8,31,39,26,13,"run035"
"6995","GGG","BGB",0,2,2,1,1,"run035"
"6996","GGG","BGG",1,7,8,4,4,"run035"
"6997","GGG","BRB",1,3,4,1,3,"run035"
"6998","GGG","BRR",0,6,6,6,0,"run035"
"6999","GGG","GGB",5,1,6,4,2,"run035"
"7000","GGG","GGR",1,9,10,4,6,"run035"
"7001","GGG","GRR",0,2,2,2,0,"run035"
"7002","GGG","RBB",1,8,9,1,8,"run035"
"7003","GGG","RBG",0,6,6,2,4,"run035"
"7004","GGG","RBR",0,21,21,6,15,"run035"
"7005","GGG","RGG",0,3,3,2,1,"run035"
"7006","GGG","RGR",1,12,13,2,11,"run035"
"7007","GGG","RRG",1,23,24,4,20,"run035"
"7008","GGG","RRR",0,3,3,3,0,"run035"
"7009","GGR","BBB",0,2,2,2,0,"run035"
"7010","GGR","BBR",0,2,2,1,1,"run035"
"7011","GGR","BGG",0,1,1,0,1,"run035"
"7012","GGR","BRR",1,0,1,1,0,"run035"
"7013","GGR","GRR",1,0,1,0,1,"run035"
"7014","GGR","RBB",0,2,2,1,1,"run035"
"7015","GRG","BBB",3,8,11,2,9,"run035"
"7016","GRG","BBR",0,1,1,1,0,"run035"
"7017","GRG","BGG",0,1,1,1,0,"run035"
"7018","GRG","BRB",0,3,3,3,0,"run035"
"7019","GRG","BRR",0,1,1,1,0,"run035"
"7020","GRG","GBG",0,1,1,1,0,"run035"
"7021","GRG","GGB",2,15,17,7,10,"run035"
"7022","GRG","GGG",3,12,15,14,1,"run035"
"7023","GRG","GGR",0,5,5,2,3,"run035"
"7024","GRG","GRR",0,1,1,0,1,"run035"
"7025","GRG","RBG",0,1,1,0,1,"run035"
"7026","GRG","RBR",0,1,1,0,1,"run035"
"7027","GRG","RGR",1,2,3,3,0,"run035"
"7028","GRG","RRG",2,4,6,6,0,"run035"
"7029","GRR","BBB",0,1,1,1,0,"run035"
"7030","GRR","BBR",0,1,1,1,0,"run035"
"7031","GRR","BGB",1,2,3,1,2,"run035"
"7032","GRR","BGG",0,2,2,0,2,"run035"
"7033","GRR","BRB",0,1,1,0,1,"run035"
"7034","GRR","BRR",0,2,2,1,1,"run035"
"7035","GRR","GGG",0,1,1,1,0,"run035"
"7036","GRR","GGR",0,1,1,0,1,"run035"
"7037","RBB","BBB",0,1,1,0,1,"run035"
"7038","RBB","BBR",0,1,1,1,0,"run035"
"7039","RBB","BRB",0,1,1,0,1,"run035"
"7040","RBB","GRR",0,1,1,0,1,"run035"
"7041","RBB","RGG",0,1,1,1,0,"run035"
"7042","RBG","BBB",2,8,10,3,7,"run035"
"7043","RBG","BBG",0,1,1,0,1,"run035"
"7044","RBG","BRR",0,1,1,0,1,"run035"
"7045","RBG","GBB",0,1,1,1,0,"run035"
"7046","RBG","GRR",0,3,3,2,1,"run035"
"7047","RBG","RBB",1,1,2,0,2,"run035"
"7048","RBG","RBR",0,1,1,1,0,"run035"
"7049","RBG","RGR",0,1,1,1,0,"run035"
"7050","RBR","BBB",0,13,13,6,7,"run035"
"7051","RBR","BBR",0,1,1,1,0,"run035"
"7052","RBR","BGB",2,4,6,0,6,"run035"
"7053","RBR","BGG",0,2,2,0,2,"run035"
"7054","RBR","BRB",1,0,1,1,0,"run035"
"7055","RBR","BRR",1,4,5,3,2,"run035"
"7056","RBR","GGB",0,12,12,10,2,"run035"
"7057","RBR","GRR",4,4,8,7,1,"run035"
"7058","RBR","RBB",0,3,3,2,1,"run035"
"7059","RBR","RGG",2,9,11,10,1,"run035"
"7060","RBR","RGR",1,0,1,1,0,"run035"
"7061","RBR","RRR",0,1,1,0,1,"run035"
"7062","RGG","BBB",0,8,8,8,0,"run035"
"7063","RGG","BBR",1,2,3,3,0,"run035"
"7064","RGG","BGB",0,1,1,0,1,"run035"
"7065","RGG","BRR",0,4,4,4,0,"run035"
"7066","RGG","GGG",0,1,1,1,0,"run035"
"7067","RGG","GGR",0,3,3,1,2,"run035"
"7068","RGG","GRR",0,8,8,4,4,"run035"
"7069","RGG","RBB",0,1,1,1,0,"run035"
"7070","RGR","BBB",2,5,7,6,1,"run035"
"7071","RGR","BBR",1,1,2,0,2,"run035"
"7072","RGR","BGB",2,5,7,2,5,"run035"
"7073","RGR","BGG",2,2,4,2,2,"run035"
"7074","RGR","BRR",1,5,6,0,6,"run035"
"7075","RGR","GGB",2,12,14,12,2,"run035"
"7076","RGR","GGG",0,2,2,0,2,"run035"
"7077","RGR","GGR",0,4,4,1,3,"run035"
"7078","RGR","RBB",0,4,4,0,4,"run035"
"7079","RGR","RGG",1,1,2,1,1,"run035"
"7080","RGR","RRG",0,3,3,2,1,"run035"
"7081","RRG","BBB",2,33,35,24,11,"run035"
"7082","RRG","BBR",0,5,5,4,1,"run035"
"7083","RRG","BGB",1,10,11,0,11,"run035"
"7084","RRG","BGG",0,2,2,1,1,"run035"
"7085","RRG","BRB",2,40,42,35,7,"run035"
"7086","RRG","BRR",1,16,17,5,12,"run035"
"7087","RRG","GGG",2,14,16,3,13,"run035"
"7088","RRG","GGR",0,5,5,2,3,"run035"
"7089","RRG","GRG",1,0,1,0,1,"run035"
"7090","RRG","GRR",3,8,11,4,7,"run035"
"7091","RRG","RBB",1,1,2,1,1,"run035"
"7092","RRG","RGG",0,1,1,1,0,"run035"
"7093","RRG","RGR",0,1,1,0,1,"run035"
"7094","RRR","BBR",1,0,1,0,1,"run035"
"7095","RRR","BGB",2,1,3,0,3,"run035"
"7096","RRR","BGG",1,0,1,0,1,"run035"
"7097","RRR","BRB",1,1,2,2,0,"run035"
"7098","RRR","BRR",1,1,2,0,2,"run035"
"7099","RRR","GGR",0,1,1,0,1,"run035"
"7100","RRR","GRR",0,3,3,0,3,"run035"
"7101","RRR","RBB",1,2,3,3,0,"run035"
"7102","RRR","RBR",0,2,2,1,1,"run035"
"7103","RRR","RGG",0,1,1,1,0,"run035"
"7104","RRR","RGR",1,2,3,3,0,"run035"
"7105","RRR","RRG",2,2,4,0,4,"run035"
"7106","BBB","BRB",0,1,1,0,1,"run036"
"7107","BBB","GGG",1,2,3,1,2,"run036"
"7108","BBB","GRR",0,2,2,2,0,"run036"
"7109","BBB","RBG",0,1,1,1,0,"run036"
"7110","BBB","RRG",1,3,4,0,4,"run036"
"7111","BBB","RRR",0,2,2,2,0,"run036"
"7112","BBG","BBB",1,4,5,1,4,"run036"
"7113","BBG","BGB",0,1,1,1,0,"run036"
"7114","BBG","BGG",0,1,1,1,0,"run036"
"7115","BBG","BRB",1,16,17,14,3,"run036"
"7116","BBG","GBB",0,1,1,0,1,"run036"
"7117","BBG","GBG",2,7,9,4,5,"run036"
"7118","BBG","GGB",2,25,27,11,16,"run036"
"7119","BBG","GGG",4,38,42,12,30,"run036"
"7120","BBG","GRG",1,9,10,4,6,"run036"
"7121","BBG","GRR",0,1,1,1,0,"run036"
"7122","BBG","RBB",0,1,1,1,0,"run036"
"7123","BBG","RBG",0,4,4,1,3,"run036"
"7124","BBG","RBR",0,1,1,0,1,"run036"
"7125","BBG","RGR",0,1,1,0,1,"run036"
"7126","BBG","RRG",1,2,3,1,2,"run036"
"7127","BBG","RRR",0,7,7,0,7,"run036"
"7128","BGB","BBB",0,2,2,1,1,"run036"
"7129","BGB","RRG",0,1,1,1,0,"run036"
"7130","BGG","BBB",0,3,3,0,3,"run036"
"7131","BGG","BBR",0,1,1,1,0,"run036"
"7132","BGG","GRG",0,1,1,0,1,"run036"
"7133","BGG","RBG",1,1,2,1,1,"run036"
"7134","BGG","RGG",0,3,3,0,3,"run036"
"7135","BGG","RGR",0,1,1,1,0,"run036"
"7136","BGG","RRR",1,1,2,0,2,"run036"
"7137","BRB","BBB",0,13,13,0,13,"run036"
"7138","BRB","BBR",0,1,1,0,1,"run036"
"7139","BRB","BRR",0,3,3,2,1,"run036"
"7140","BRB","GGG",0,1,1,1,0,"run036"
"7141","BRB","GGR",0,1,1,1,0,"run036"
"7142","BRB","RBB",0,1,1,1,0,"run036"
"7143","BRB","RBG",0,1,1,0,1,"run036"
"7144","BRB","RGR",0,1,1,1,0,"run036"
"7145","BRB","RRR",0,1,1,0,1,"run036"
"7146","BRR","BBB",0,11,11,7,4,"run036"
"7147","BRR","BGB",1,1,2,1,1,"run036"
"7148","BRR","BGG",0,1,1,1,0,"run036"
"7149","BRR","BRB",0,1,1,1,0,"run036"
"7150","BRR","RBB",0,2,2,1,1,"run036"
"7151","GBB","BBB",12,38,50,30,20,"run036"
"7152","GBB","BGG",0,1,1,1,0,"run036"
"7153","GBB","BRB",1,9,10,10,0,"run036"
"7154","GBB","BRR",1,3,4,3,1,"run036"
"7155","GBB","GBG",0,4,4,0,4,"run036"
"7156","GBB","GGB",0,21,21,4,17,"run036"
"7157","GBB","GGG",7,86,93,26,67,"run036"
"7158","GBB","GGR",1,3,4,0,4,"run036"
"7159","GBB","GRG",0,6,6,1,5,"run036"
"7160","GBB","GRR",0,1,1,1,0,"run036"
"7161","GBB","RBB",0,2,2,2,0,"run036"
"7162","GBB","RBG",3,9,12,1,11,"run036"
"7163","GBB","RBR",1,0,1,1,0,"run036"
"7164","GBB","RGG",1,0,1,1,0,"run036"
"7165","GBB","RGR",2,1,3,1,2,"run036"
"7166","GBB","RRG",0,2,2,1,1,"run036"
"7167","GBB","RRR",1,9,10,1,9,"run036"
"7168","GBG","BBB",0,5,5,1,4,"run036"
"7169","GBG","BBR",0,1,1,0,1,"run036"
"7170","GBG","BRB",1,4,5,5,0,"run036"
"7171","GBG","BRR",1,0,1,0,1,"run036"
"7172","GBG","GGB",0,4,4,4,0,"run036"
"7173","GBG","GGG",4,11,15,6,9,"run036"
"7174","GBG","RBB",1,0,1,1,0,"run036"
"7175","GBG","RBG",0,1,1,0,1,"run036"
"7176","GBG","RGG",0,1,1,1,0,"run036"
"7177","GBG","RGR",1,3,4,3,1,"run036"
"7178","GBG","RRG",1,3,4,4,0,"run036"
"7179","GGB","BBB",3,16,19,7,12,"run036"
"7180","GGB","BBR",1,4,5,2,3,"run036"
"7181","GGB","BGB",0,3,3,0,3,"run036"
"7182","GGB","BGG",0,4,4,4,0,"run036"
"7183","GGB","BRB",0,1,1,1,0,"run036"
"7184","GGB","BRR",1,15,16,7,9,"run036"
"7185","GGB","GBB",0,1,1,1,0,"run036"
"7186","GGB","GBG",1,0,1,1,0,"run036"
"7187","GGB","GGG",13,48,61,35,26,"run036"
"7188","GGB","GGR",0,7,7,5,2,"run036"
"7189","GGB","GRR",0,4,4,1,3,"run036"
"7190","GGB","RBB",0,5,5,5,0,"run036"
"7191","GGB","RBG",0,4,4,2,2,"run036"
"7192","GGB","RBR",0,5,5,0,5,"run036"
"7193","GGB","RGG",1,5,6,1,5,"run036"
"7194","GGB","RGR",0,2,2,2,0,"run036"
"7195","GGB","RRG",1,5,6,2,4,"run036"
"7196","GGB","RRR",1,5,6,6,0,"run036"
"7197","GGG","BBB",8,31,39,32,7,"run036"
"7198","GGG","BGB",0,2,2,2,0,"run036"
"7199","GGG","BGG",1,7,8,4,4,"run036"
"7200","GGG","BRB",1,3,4,4,0,"run036"
"7201","GGG","BRR",0,6,6,1,5,"run036"
"7202","GGG","GGB",5,1,6,5,1,"run036"
"7203","GGG","GGR",1,9,10,5,5,"run036"
"7204","GGG","GRR",0,2,2,1,1,"run036"
"7205","GGG","RBB",1,8,9,1,8,"run036"
"7206","GGG","RBG",0,6,6,4,2,"run036"
"7207","GGG","RBR",0,21,21,19,2,"run036"
"7208","GGG","RGG",0,3,3,2,1,"run036"
"7209","GGG","RGR",1,12,13,7,6,"run036"
"7210","GGG","RRG",1,23,24,9,15,"run036"
"7211","GGG","RRR",0,3,3,2,1,"run036"
"7212","GGR","BBB",0,2,2,0,2,"run036"
"7213","GGR","BBR",0,2,2,1,1,"run036"
"7214","GGR","BGG",0,1,1,1,0,"run036"
"7215","GGR","BRR",1,0,1,1,0,"run036"
"7216","GGR","GRR",1,0,1,1,0,"run036"
"7217","GGR","RBB",0,2,2,2,0,"run036"
"7218","GRG","BBB",3,8,11,4,7,"run036"
"7219","GRG","BBR",0,1,1,0,1,"run036"
"7220","GRG","BGG",0,1,1,0,1,"run036"
"7221","GRG","BRB",0,3,3,1,2,"run036"
"7222","GRG","BRR",0,1,1,0,1,"run036"
"7223","GRG","GBG",0,1,1,0,1,"run036"
"7224","GRG","GGB",2,15,17,16,1,"run036"
"7225","GRG","GGG",3,12,15,4,11,"run036"
"7226","GRG","GGR",0,5,5,3,2,"run036"
"7227","GRG","GRR",0,1,1,1,0,"run036"
"7228","GRG","RBG",0,1,1,1,0,"run036"
"7229","GRG","RBR",0,1,1,1,0,"run036"
"7230","GRG","RGR",1,2,3,1,2,"run036"
"7231","GRG","RRG",2,4,6,3,3,"run036"
"7232","GRR","BBB",0,1,1,1,0,"run036"
"7233","GRR","BBR",0,1,1,0,1,"run036"
"7234","GRR","BGB",1,2,3,3,0,"run036"
"7235","GRR","BGG",0,2,2,2,0,"run036"
"7236","GRR","BRB",0,1,1,0,1,"run036"
"7237","GRR","BRR",0,2,2,0,2,"run036"
"7238","GRR","GGG",0,1,1,0,1,"run036"
"7239","GRR","GGR",0,1,1,1,0,"run036"
"7240","RBB","BBB",0,1,1,0,1,"run036"
"7241","RBB","BBR",0,1,1,0,1,"run036"
"7242","RBB","BRB",0,1,1,0,1,"run036"
"7243","RBB","GRR",0,1,1,0,1,"run036"
"7244","RBB","RGG",0,1,1,1,0,"run036"
"7245","RBG","BBB",2,8,10,3,7,"run036"
"7246","RBG","BBG",0,1,1,0,1,"run036"
"7247","RBG","BRR",0,1,1,0,1,"run036"
"7248","RBG","GBB",0,1,1,1,0,"run036"
"7249","RBG","GRR",0,3,3,0,3,"run036"
"7250","RBG","RBB",1,1,2,1,1,"run036"
"7251","RBG","RBR",0,1,1,0,1,"run036"
"7252","RBG","RGR",0,1,1,1,0,"run036"
"7253","RBR","BBB",0,13,13,5,8,"run036"
"7254","RBR","BBR",0,1,1,1,0,"run036"
"7255","RBR","BGB",2,4,6,1,5,"run036"
"7256","RBR","BGG",0,2,2,0,2,"run036"
"7257","RBR","BRB",1,0,1,0,1,"run036"
"7258","RBR","BRR",1,4,5,0,5,"run036"
"7259","RBR","GGB",0,12,12,6,6,"run036"
"7260","RBR","GRR",4,4,8,2,6,"run036"
"7261","RBR","RBB",0,3,3,3,0,"run036"
"7262","RBR","RGG",2,9,11,3,8,"run036"
"7263","RBR","RGR",1,0,1,1,0,"run036"
"7264","RBR","RRR",0,1,1,0,1,"run036"
"7265","RGG","BBB",0,8,8,1,7,"run036"
"7266","RGG","BBR",1,2,3,2,1,"run036"
"7267","RGG","BGB",0,1,1,0,1,"run036"
"7268","RGG","BRR",0,4,4,0,4,"run036"
"7269","RGG","GGG",0,1,1,0,1,"run036"
"7270","RGG","GGR",0,3,3,2,1,"run036"
"7271","RGG","GRR",0,8,8,7,1,"run036"
"7272","RGG","RBB",0,1,1,1,0,"run036"
"7273","RGR","BBB",2,5,7,2,5,"run036"
"7274","RGR","BBR",1,1,2,0,2,"run036"
"7275","RGR","BGB",2,5,7,3,4,"run036"
"7276","RGR","BGG",2,2,4,3,1,"run036"
"7277","RGR","BRR",1,5,6,4,2,"run036"
"7278","RGR","GGB",2,12,14,6,8,"run036"
"7279","RGR","GGG",0,2,2,1,1,"run036"
"7280","RGR","GGR",0,4,4,1,3,"run036"
"7281","RGR","RBB",0,4,4,2,2,"run036"
"7282","RGR","RGG",1,1,2,1,1,"run036"
"7283","RGR","RRG",0,3,3,2,1,"run036"
"7284","RRG","BBB",2,33,35,14,21,"run036"
"7285","RRG","BBR",0,5,5,3,2,"run036"
"7286","RRG","BGB",1,10,11,9,2,"run036"
"7287","RRG","BGG",0,2,2,2,0,"run036"
"7288","RRG","BRB",2,40,42,27,15,"run036"
"7289","RRG","BRR",1,16,17,14,3,"run036"
"7290","RRG","GGG",2,14,16,16,0,"run036"
"7291","RRG","GGR",0,5,5,3,2,"run036"
"7292","RRG","GRG",1,0,1,1,0,"run036"
"7293","RRG","GRR",3,8,11,2,9,"run036"
"7294","RRG","RBB",1,1,2,1,1,"run036"
"7295","RRG","RGG",0,1,1,1,0,"run036"
"7296","RRG","RGR",0,1,1,1,0,"run036"
"7297","RRR","BBR",1,0,1,0,1,"run036"
"7298","RRR","BGB",2,1,3,0,3,"run036"
"7299","RRR","BGG",1,0,1,0,1,"run036"
"7300","RRR","BRB",1,1,2,1,1,"run036"
"7301","RRR","BRR",1,1,2,1,1,"run036"
"7302","RRR","GGR",0,1,1,0,1,"run036"
"7303","RRR","GRR",0,3,3,2,1,"run036"
"7304","RRR","RBB",1,2,3,1,2,"run036"
"7305","RRR","RBR",0,2,2,2,0,"run036"
"7306","RRR","RGG",0,1,1,1,0,"run036"
"7307","RRR","RGR",1,2,3,3,0,"run036"
"7308","RRR","RRG",2,2,4,3,1,"run036"
"7309","BBB","BRB",0,1,1,1,0,"run037"
"7310","BBB","GGG",1,2,3,2,1,"run037"
"7311","BBB","GRR",0,2,2,1,1,"run037"
"7312","BBB","RBG",0,1,1,0,1,"run037"
"7313","BBB","RRG",1,3,4,4,0,"run037"
"7314","BBB","RRR",0,2,2,0,2,"run037"
"7315","BBG","BBB",1,4,5,3,2,"run037"
"7316","BBG","BGB",0,1,1,1,0,"run037"
"7317","BBG","BGG",0,1,1,0,1,"run037"
"7318","BBG","BRB",1,16,17,17,0,"run037"
"7319","BBG","GBB",0,1,1,0,1,"run037"
"7320","BBG","GBG",2,7,9,2,7,"run037"
"7321","BBG","GGB",2,25,27,16,11,"run037"
"7322","BBG","GGG",4,38,42,35,7,"run037"
"7323","BBG","GRG",1,9,10,2,8,"run037"
"7324","BBG","GRR",0,1,1,0,1,"run037"
"7325","BBG","RBB",0,1,1,1,0,"run037"
"7326","BBG","RBG",0,4,4,3,1,"run037"
"7327","BBG","RBR",0,1,1,0,1,"run037"
"7328","BBG","RGR",0,1,1,0,1,"run037"
"7329","BBG","RRG",1,2,3,3,0,"run037"
"7330","BBG","RRR",0,7,7,7,0,"run037"
"7331","BGB","BBB",0,2,2,0,2,"run037"
"7332","BGB","RRG",0,1,1,0,1,"run037"
"7333","BGG","BBB",0,3,3,2,1,"run037"
"7334","BGG","BBR",0,1,1,1,0,"run037"
"7335","BGG","GRG",0,1,1,1,0,"run037"
"7336","BGG","RBG",1,1,2,1,1,"run037"
"7337","BGG","RGG",0,3,3,0,3,"run037"
"7338","BGG","RGR",0,1,1,0,1,"run037"
"7339","BGG","RRR",1,1,2,0,2,"run037"
"7340","BRB","BBB",0,13,13,8,5,"run037"
"7341","BRB","BBR",0,1,1,1,0,"run037"
"7342","BRB","BRR",0,3,3,3,0,"run037"
"7343","BRB","GGG",0,1,1,0,1,"run037"
"7344","BRB","GGR",0,1,1,1,0,"run037"
"7345","BRB","RBB",0,1,1,0,1,"run037"
"7346","BRB","RBG",0,1,1,1,0,"run037"
"7347","BRB","RGR",0,1,1,1,0,"run037"
"7348","BRB","RRR",0,1,1,0,1,"run037"
"7349","BRR","BBB",0,11,11,6,5,"run037"
"7350","BRR","BGB",1,1,2,1,1,"run037"
"7351","BRR","BGG",0,1,1,1,0,"run037"
"7352","BRR","BRB",0,1,1,0,1,"run037"
"7353","BRR","RBB",0,2,2,0,2,"run037"
"7354","GBB","BBB",12,38,50,23,27,"run037"
"7355","GBB","BGG",0,1,1,0,1,"run037"
"7356","GBB","BRB",1,9,10,6,4,"run037"
"7357","GBB","BRR",1,3,4,4,0,"run037"
"7358","GBB","GBG",0,4,4,4,0,"run037"
"7359","GBB","GGB",0,21,21,3,18,"run037"
"7360","GBB","GGG",7,86,93,17,76,"run037"
"7361","GBB","GGR",1,3,4,4,0,"run037"
"7362","GBB","GRG",0,6,6,0,6,"run037"
"7363","GBB","GRR",0,1,1,0,1,"run037"
"7364","GBB","RBB",0,2,2,1,1,"run037"
"7365","GBB","RBG",3,9,12,12,0,"run037"
"7366","GBB","RBR",1,0,1,1,0,"run037"
"7367","GBB","RGG",1,0,1,0,1,"run037"
"7368","GBB","RGR",2,1,3,3,0,"run037"
"7369","GBB","RRG",0,2,2,2,0,"run037"
"7370","GBB","RRR",1,9,10,2,8,"run037"
"7371","GBG","BBB",0,5,5,1,4,"run037"
"7372","GBG","BBR",0,1,1,0,1,"run037"
"7373","GBG","BRB",1,4,5,0,5,"run037"
"7374","GBG","BRR",1,0,1,0,1,"run037"
"7375","GBG","GGB",0,4,4,1,3,"run037"
"7376","GBG","GGG",4,11,15,10,5,"run037"
"7377","GBG","RBB",1,0,1,0,1,"run037"
"7378","GBG","RBG",0,1,1,0,1,"run037"
"7379","GBG","RGG",0,1,1,0,1,"run037"
"7380","GBG","RGR",1,3,4,2,2,"run037"
"7381","GBG","RRG",1,3,4,0,4,"run037"
"7382","GGB","BBB",3,16,19,6,13,"run037"
"7383","GGB","BBR",1,4,5,5,0,"run037"
"7384","GGB","BGB",0,3,3,0,3,"run037"
"7385","GGB","BGG",0,4,4,2,2,"run037"
"7386","GGB","BRB",0,1,1,1,0,"run037"
"7387","GGB","BRR",1,15,16,14,2,"run037"
"7388","GGB","GBB",0,1,1,1,0,"run037"
"7389","GGB","GBG",1,0,1,0,1,"run037"
"7390","GGB","GGG",13,48,61,38,23,"run037"
"7391","GGB","GGR",0,7,7,3,4,"run037"
"7392","GGB","GRR",0,4,4,1,3,"run037"
"7393","GGB","RBB",0,5,5,0,5,"run037"
"7394","GGB","RBG",0,4,4,0,4,"run037"
"7395","GGB","RBR",0,5,5,3,2,"run037"
"7396","GGB","RGG",1,5,6,0,6,"run037"
"7397","GGB","RGR",0,2,2,0,2,"run037"
"7398","GGB","RRG",1,5,6,6,0,"run037"
"7399","GGB","RRR",1,5,6,3,3,"run037"
"7400","GGG","BBB",8,31,39,10,29,"run037"
"7401","GGG","BGB",0,2,2,0,2,"run037"
"7402","GGG","BGG",1,7,8,8,0,"run037"
"7403","GGG","BRB",1,3,4,4,0,"run037"
"7404","GGG","BRR",0,6,6,3,3,"run037"
"7405","GGG","GGB",5,1,6,3,3,"run037"
"7406","GGG","GGR",1,9,10,10,0,"run037"
"7407","GGG","GRR",0,2,2,2,0,"run037"
"7408","GGG","RBB",1,8,9,8,1,"run037"
"7409","GGG","RBG",0,6,6,0,6,"run037"
"7410","GGG","RBR",0,21,21,21,0,"run037"
"7411","GGG","RGG",0,3,3,1,2,"run037"
"7412","GGG","RGR",1,12,13,5,8,"run037"
"7413","GGG","RRG",1,23,24,23,1,"run037"
"7414","GGG","RRR",0,3,3,3,0,"run037"
"7415","GGR","BBB",0,2,2,2,0,"run037"
"7416","GGR","BBR",0,2,2,0,2,"run037"
"7417","GGR","BGG",0,1,1,0,1,"run037"
"7418","GGR","BRR",1,0,1,1,0,"run037"
"7419","GGR","GRR",1,0,1,0,1,"run037"
"7420","GGR","RBB",0,2,2,0,2,"run037"
"7421","GRG","BBB",3,8,11,6,5,"run037"
"7422","GRG","BBR",0,1,1,0,1,"run037"
"7423","GRG","BGG",0,1,1,0,1,"run037"
"7424","GRG","BRB",0,3,3,1,2,"run037"
"7425","GRG","BRR",0,1,1,0,1,"run037"
"7426","GRG","GBG",0,1,1,1,0,"run037"
"7427","GRG","GGB",2,15,17,16,1,"run037"
"7428","GRG","GGG",3,12,15,9,6,"run037"
"7429","GRG","GGR",0,5,5,5,0,"run037"
"7430","GRG","GRR",0,1,1,0,1,"run037"
"7431","GRG","RBG",0,1,1,1,0,"run037"
"7432","GRG","RBR",0,1,1,0,1,"run037"
"7433","GRG","RGR",1,2,3,2,1,"run037"
"7434","GRG","RRG",2,4,6,4,2,"run037"
"7435","GRR","BBB",0,1,1,1,0,"run037"
"7436","GRR","BBR",0,1,1,1,0,"run037"
"7437","GRR","BGB",1,2,3,0,3,"run037"
"7438","GRR","BGG",0,2,2,2,0,"run037"
"7439","GRR","BRB",0,1,1,1,0,"run037"
"7440","GRR","BRR",0,2,2,2,0,"run037"
"7441","GRR","GGG",0,1,1,1,0,"run037"
"7442","GRR","GGR",0,1,1,0,1,"run037"
"7443","RBB","BBB",0,1,1,0,1,"run037"
"7444","RBB","BBR",0,1,1,1,0,"run037"
"7445","RBB","BRB",0,1,1,0,1,"run037"
"7446","RBB","GRR",0,1,1,0,1,"run037"
"7447","RBB","RGG",0,1,1,0,1,"run037"
"7448","RBG","BBB",2,8,10,5,5,"run037"
"7449","RBG","BBG",0,1,1,1,0,"run037"
"7450","RBG","BRR",0,1,1,1,0,"run037"
"7451","RBG","GBB",0,1,1,0,1,"run037"
"7452","RBG","GRR",0,3,3,2,1,"run037"
"7453","RBG","RBB",1,1,2,0,2,"run037"
"7454","RBG","RBR",0,1,1,0,1,"run037"
"7455","RBG","RGR",0,1,1,0,1,"run037"
"7456","RBR","BBB",0,13,13,6,7,"run037"
"7457","RBR","BBR",0,1,1,1,0,"run037"
"7458","RBR","BGB",2,4,6,1,5,"run037"
"7459","RBR","BGG",0,2,2,0,2,"run037"
"7460","RBR","BRB",1,0,1,1,0,"run037"
"7461","RBR","BRR",1,4,5,0,5,"run037"
"7462","RBR","GGB",0,12,12,4,8,"run037"
"7463","RBR","GRR",4,4,8,4,4,"run037"
"7464","RBR","RBB",0,3,3,1,2,"run037"
"7465","RBR","RGG",2,9,11,1,10,"run037"
"7466","RBR","RGR",1,0,1,1,0,"run037"
"7467","RBR","RRR",0,1,1,1,0,"run037"
"7468","RGG","BBB",0,8,8,1,7,"run037"
"7469","RGG","BBR",1,2,3,2,1,"run037"
"7470","RGG","BGB",0,1,1,1,0,"run037"
"7471","RGG","BRR",0,4,4,2,2,"run037"
"7472","RGG","GGG",0,1,1,0,1,"run037"
"7473","RGG","GGR",0,3,3,0,3,"run037"
"7474","RGG","GRR",0,8,8,7,1,"run037"
"7475","RGG","RBB",0,1,1,1,0,"run037"
"7476","RGR","BBB",2,5,7,0,7,"run037"
"7477","RGR","BBR",1,1,2,0,2,"run037"
"7478","RGR","BGB",2,5,7,2,5,"run037"
"7479","RGR","BGG",2,2,4,4,0,"run037"
"7480","RGR","BRR",1,5,6,0,6,"run037"
"7481","RGR","GGB",2,12,14,11,3,"run037"
"7482","RGR","GGG",0,2,2,1,1,"run037"
"7483","RGR","GGR",0,4,4,3,1,"run037"
"7484","RGR","RBB",0,4,4,0,4,"run037"
"7485","RGR","RGG",1,1,2,0,2,"run037"
"7486","RGR","RRG",0,3,3,3,0,"run037"
"7487","RRG","BBB",2,33,35,5,30,"run037"
"7488","RRG","BBR",0,5,5,5,0,"run037"
"7489","RRG","BGB",1,10,11,9,2,"run037"
"7490","RRG","BGG",0,2,2,0,2,"run037"
"7491","RRG","BRB",2,40,42,17,25,"run037"
"7492","RRG","BRR",1,16,17,10,7,"run037"
"7493","RRG","GGG",2,14,16,11,5,"run037"
"7494","RRG","GGR",0,5,5,2,3,"run037"
"7495","RRG","GRG",1,0,1,0,1,"run037"
"7496","RRG","GRR",3,8,11,5,6,"run037"
"7497","RRG","RBB",1,1,2,2,0,"run037"
"7498","RRG","RGG",0,1,1,0,1,"run037"
"7499","RRG","RGR",0,1,1,0,1,"run037"
"7500","RRR","BBR",1,0,1,0,1,"run037"
"7501","RRR","BGB",2,1,3,2,1,"run037"
"7502","RRR","BGG",1,0,1,0,1,"run037"
"7503","RRR","BRB",1,1,2,0,2,"run037"
"7504","RRR","BRR",1,1,2,0,2,"run037"
"7505","RRR","GGR",0,1,1,0,1,"run037"
"7506","RRR","GRR",0,3,3,3,0,"run037"
"7507","RRR","RBB",1,2,3,2,1,"run037"
"7508","RRR","RBR",0,2,2,1,1,"run037"
"7509","RRR","RGG",0,1,1,0,1,"run037"
"7510","RRR","RGR",1,2,3,2,1,"run037"
"7511","RRR","RRG",2,2,4,2,2,"run037"
"7512","BBB","BRB",0,1,1,0,1,"run038"
"7513","BBB","GGG",1,2,3,0,3,"run038"
"7514","BBB","GRR",0,2,2,0,2,"run038"
"7515","BBB","RBG",0,1,1,0,1,"run038"
"7516","BBB","RRG",1,3,4,1,3,"run038"
"7517","BBB","RRR",0,2,2,1,1,"run038"
"7518","BBG","BBB",1,4,5,3,2,"run038"
"7519","BBG","BGB",0,1,1,0,1,"run038"
"7520","BBG","BGG",0,1,1,0,1,"run038"
"7521","BBG","BRB",1,16,17,7,10,"run038"
"7522","BBG","GBB",0,1,1,0,1,"run038"
"7523","BBG","GBG",2,7,9,3,6,"run038"
"7524","BBG","GGB",2,25,27,21,6,"run038"
"7525","BBG","GGG",4,38,42,15,27,"run038"
"7526","BBG","GRG",1,9,10,7,3,"run038"
"7527","BBG","GRR",0,1,1,0,1,"run038"
"7528","BBG","RBB",0,1,1,1,0,"run038"
"7529","BBG","RBG",0,4,4,4,0,"run038"
"7530","BBG","RBR",0,1,1,0,1,"run038"
"7531","BBG","RGR",0,1,1,1,0,"run038"
"7532","BBG","RRG",1,2,3,0,3,"run038"
"7533","BBG","RRR",0,7,7,6,1,"run038"
"7534","BGB","BBB",0,2,2,2,0,"run038"
"7535","BGB","RRG",0,1,1,0,1,"run038"
"7536","BGG","BBB",0,3,3,3,0,"run038"
"7537","BGG","BBR",0,1,1,1,0,"run038"
"7538","BGG","GRG",0,1,1,0,1,"run038"
"7539","BGG","RBG",1,1,2,1,1,"run038"
"7540","BGG","RGG",0,3,3,2,1,"run038"
"7541","BGG","RGR",0,1,1,0,1,"run038"
"7542","BGG","RRR",1,1,2,0,2,"run038"
"7543","BRB","BBB",0,13,13,1,12,"run038"
"7544","BRB","BBR",0,1,1,1,0,"run038"
"7545","BRB","BRR",0,3,3,2,1,"run038"
"7546","BRB","GGG",0,1,1,0,1,"run038"
"7547","BRB","GGR",0,1,1,0,1,"run038"
"7548","BRB","RBB",0,1,1,0,1,"run038"
"7549","BRB","RBG",0,1,1,0,1,"run038"
"7550","BRB","RGR",0,1,1,0,1,"run038"
"7551","BRB","RRR",0,1,1,1,0,"run038"
"7552","BRR","BBB",0,11,11,8,3,"run038"
"7553","BRR","BGB",1,1,2,0,2,"run038"
"7554","BRR","BGG",0,1,1,1,0,"run038"
"7555","BRR","BRB",0,1,1,0,1,"run038"
"7556","BRR","RBB",0,2,2,0,2,"run038"
"7557","GBB","BBB",12,38,50,29,21,"run038"
"7558","GBB","BGG",0,1,1,1,0,"run038"
"7559","GBB","BRB",1,9,10,9,1,"run038"
"7560","GBB","BRR",1,3,4,0,4,"run038"
"7561","GBB","GBG",0,4,4,1,3,"run038"
"7562","GBB","GGB",0,21,21,2,19,"run038"
"7563","GBB","GGG",7,86,93,16,77,"run038"
"7564","GBB","GGR",1,3,4,2,2,"run038"
"7565","GBB","GRG",0,6,6,0,6,"run038"
"7566","GBB","GRR",0,1,1,1,0,"run038"
"7567","GBB","RBB",0,2,2,1,1,"run038"
"7568","GBB","RBG",3,9,12,9,3,"run038"
"7569","GBB","RBR",1,0,1,0,1,"run038"
"7570","GBB","RGG",1,0,1,1,0,"run038"
"7571","GBB","RGR",2,1,3,2,1,"run038"
"7572","GBB","RRG",0,2,2,2,0,"run038"
"7573","GBB","RRR",1,9,10,8,2,"run038"
"7574","GBG","BBB",0,5,5,1,4,"run038"
"7575","GBG","BBR",0,1,1,1,0,"run038"
"7576","GBG","BRB",1,4,5,1,4,"run038"
"7577","GBG","BRR",1,0,1,1,0,"run038"
"7578","GBG","GGB",0,4,4,4,0,"run038"
"7579","GBG","GGG",4,11,15,3,12,"run038"
"7580","GBG","RBB",1,0,1,1,0,"run038"
"7581","GBG","RBG",0,1,1,0,1,"run038"
"7582","GBG","RGG",0,1,1,1,0,"run038"
"7583","GBG","RGR",1,3,4,3,1,"run038"
"7584","GBG","RRG",1,3,4,1,3,"run038"
"7585","GGB","BBB",3,16,19,0,19,"run038"
"7586","GGB","BBR",1,4,5,5,0,"run038"
"7587","GGB","BGB",0,3,3,1,2,"run038"
"7588","GGB","BGG",0,4,4,4,0,"run038"
"7589","GGB","BRB",0,1,1,1,0,"run038"
"7590","GGB","BRR",1,15,16,11,5,"run038"
"7591","GGB","GBB",0,1,1,0,1,"run038"
"7592","GGB","GBG",1,0,1,0,1,"run038"
"7593","GGB","GGG",13,48,61,22,39,"run038"
"7594","GGB","GGR",0,7,7,3,4,"run038"
"7595","GGB","GRR",0,4,4,2,2,"run038"
"7596","GGB","RBB",0,5,5,4,1,"run038"
"7597","GGB","RBG",0,4,4,0,4,"run038"
"7598","GGB","RBR",0,5,5,1,4,"run038"
"7599","GGB","RGG",1,5,6,4,2,"run038"
"7600","GGB","RGR",0,2,2,2,0,"run038"
"7601","GGB","RRG",1,5,6,0,6,"run038"
"7602","GGB","RRR",1,5,6,1,5,"run038"
"7603","GGG","BBB",8,31,39,17,22,"run038"
"7604","GGG","BGB",0,2,2,1,1,"run038"
"7605","GGG","BGG",1,7,8,0,8,"run038"
"7606","GGG","BRB",1,3,4,0,4,"run038"
"7607","GGG","BRR",0,6,6,3,3,"run038"
"7608","GGG","GGB",5,1,6,5,1,"run038"
"7609","GGG","GGR",1,9,10,6,4,"run038"
"7610","GGG","GRR",0,2,2,1,1,"run038"
"7611","GGG","RBB",1,8,9,7,2,"run038"
"7612","GGG","RBG",0,6,6,1,5,"run038"
"7613","GGG","RBR",0,21,21,2,19,"run038"
"7614","GGG","RGG",0,3,3,2,1,"run038"
"7615","GGG","RGR",1,12,13,9,4,"run038"
"7616","GGG","RRG",1,23,24,17,7,"run038"
"7617","GGG","RRR",0,3,3,1,2,"run038"
"7618","GGR","BBB",0,2,2,1,1,"run038"
"7619","GGR","BBR",0,2,2,1,1,"run038"
"7620","GGR","BGG",0,1,1,1,0,"run038"
"7621","GGR","BRR",1,0,1,1,0,"run038"
"7622","GGR","GRR",1,0,1,0,1,"run038"
"7623","GGR","RBB",0,2,2,1,1,"run038"
"7624","GRG","BBB",3,8,11,1,10,"run038"
"7625","GRG","BBR",0,1,1,0,1,"run038"
"7626","GRG","BGG",0,1,1,1,0,"run038"
"7627","GRG","BRB",0,3,3,0,3,"run038"
"7628","GRG","BRR",0,1,1,1,0,"run038"
"7629","GRG","GBG",0,1,1,0,1,"run038"
"7630","GRG","GGB",2,15,17,11,6,"run038"
"7631","GRG","GGG",3,12,15,5,10,"run038"
"7632","GRG","GGR",0,5,5,3,2,"run038"
"7633","GRG","GRR",0,1,1,0,1,"run038"
"7634","GRG","RBG",0,1,1,1,0,"run038"
"7635","GRG","RBR",0,1,1,1,0,"run038"
"7636","GRG","RGR",1,2,3,1,2,"run038"
"7637","GRG","RRG",2,4,6,5,1,"run038"
"7638","GRR","BBB",0,1,1,1,0,"run038"
"7639","GRR","BBR",0,1,1,0,1,"run038"
"7640","GRR","BGB",1,2,3,3,0,"run038"
"7641","GRR","BGG",0,2,2,0,2,"run038"
"7642","GRR","BRB",0,1,1,1,0,"run038"
"7643","GRR","BRR",0,2,2,0,2,"run038"
"7644","GRR","GGG",0,1,1,1,0,"run038"
"7645","GRR","GGR",0,1,1,0,1,"run038"
"7646","RBB","BBB",0,1,1,1,0,"run038"
"7647","RBB","BBR",0,1,1,0,1,"run038"
"7648","RBB","BRB",0,1,1,0,1,"run038"
"7649","RBB","GRR",0,1,1,0,1,"run038"
"7650","RBB","RGG",0,1,1,1,0,"run038"
"7651","RBG","BBB",2,8,10,1,9,"run038"
"7652","RBG","BBG",0,1,1,0,1,"run038"
"7653","RBG","BRR",0,1,1,0,1,"run038"
"7654","RBG","GBB",0,1,1,1,0,"run038"
"7655","RBG","GRR",0,3,3,3,0,"run038"
"7656","RBG","RBB",1,1,2,2,0,"run038"
"7657","RBG","RBR",0,1,1,0,1,"run038"
"7658","RBG","RGR",0,1,1,0,1,"run038"
"7659","RBR","BBB",0,13,13,6,7,"run038"
"7660","RBR","BBR",0,1,1,0,1,"run038"
"7661","RBR","BGB",2,4,6,5,1,"run038"
"7662","RBR","BGG",0,2,2,2,0,"run038"
"7663","RBR","BRB",1,0,1,1,0,"run038"
"7664","RBR","BRR",1,4,5,1,4,"run038"
"7665","RBR","GGB",0,12,12,8,4,"run038"
"7666","RBR","GRR",4,4,8,3,5,"run038"
"7667","RBR","RBB",0,3,3,1,2,"run038"
"7668","RBR","RGG",2,9,11,0,11,"run038"
"7669","RBR","RGR",1,0,1,0,1,"run038"
"7670","RBR","RRR",0,1,1,0,1,"run038"
"7671","RGG","BBB",0,8,8,8,0,"run038"
"7672","RGG","BBR",1,2,3,0,3,"run038"
"7673","RGG","BGB",0,1,1,1,0,"run038"
"7674","RGG","BRR",0,4,4,2,2,"run038"
"7675","RGG","GGG",0,1,1,0,1,"run038"
"7676","RGG","GGR",0,3,3,1,2,"run038"
"7677","RGG","GRR",0,8,8,8,0,"run038"
"7678","RGG","RBB",0,1,1,1,0,"run038"
"7679","RGR","BBB",2,5,7,5,2,"run038"
"7680","RGR","BBR",1,1,2,1,1,"run038"
"7681","RGR","BGB",2,5,7,3,4,"run038"
"7682","RGR","BGG",2,2,4,3,1,"run038"
"7683","RGR","BRR",1,5,6,3,3,"run038"
"7684","RGR","GGB",2,12,14,14,0,"run038"
"7685","RGR","GGG",0,2,2,1,1,"run038"
"7686","RGR","GGR",0,4,4,4,0,"run038"
"7687","RGR","RBB",0,4,4,1,3,"run038"
"7688","RGR","RGG",1,1,2,2,0,"run038"
"7689","RGR","RRG",0,3,3,2,1,"run038"
"7690","RRG","BBB",2,33,35,34,1,"run038"
"7691","RRG","BBR",0,5,5,2,3,"run038"
"7692","RRG","BGB",1,10,11,10,1,"run038"
"7693","RRG","BGG",0,2,2,0,2,"run038"
"7694","RRG","BRB",2,40,42,37,5,"run038"
"7695","RRG","BRR",1,16,17,6,11,"run038"
"7696","RRG","GGG",2,14,16,13,3,"run038"
"7697","RRG","GGR",0,5,5,0,5,"run038"
"7698","RRG","GRG",1,0,1,0,1,"run038"
"7699","RRG","GRR",3,8,11,2,9,"run038"
"7700","RRG","RBB",1,1,2,1,1,"run038"
"7701","RRG","RGG",0,1,1,1,0,"run038"
"7702","RRG","RGR",0,1,1,0,1,"run038"
"7703","RRR","BBR",1,0,1,0,1,"run038"
"7704","RRR","BGB",2,1,3,1,2,"run038"
"7705","RRR","BGG",1,0,1,1,0,"run038"
"7706","RRR","BRB",1,1,2,0,2,"run038"
"7707","RRR","BRR",1,1,2,0,2,"run038"
"7708","RRR","GGR",0,1,1,1,0,"run038"
"7709","RRR","GRR",0,3,3,1,2,"run038"
"7710","RRR","RBB",1,2,3,0,3,"run038"
"7711","RRR","RBR",0,2,2,1,1,"run038"
"7712","RRR","RGG",0,1,1,1,0,"run038"
"7713","RRR","RGR",1,2,3,1,2,"run038"
"7714","RRR","RRG",2,2,4,1,3,"run038"
"7715","BBB","BRB",0,1,1,0,1,"run039"
"7716","BBB","GGG",1,2,3,2,1,"run039"
"7717","BBB","GRR",0,2,2,1,1,"run039"
"7718","BBB","RBG",0,1,1,0,1,"run039"
"7719","BBB","RRG",1,3,4,3,1,"run039"
"7720","BBB","RRR",0,2,2,0,2,"run039"
"7721","BBG","BBB",1,4,5,1,4,"run039"
"7722","BBG","BGB",0,1,1,1,0,"run039"
"7723","BBG","BGG",0,1,1,1,0,"run039"
"7724","BBG","BRB",1,16,17,12,5,"run039"
"7725","BBG","GBB",0,1,1,1,0,"run039"
"7726","BBG","GBG",2,7,9,7,2,"run039"
"7727","BBG","GGB",2,25,27,23,4,"run039"
"7728","BBG","GGG",4,38,42,29,13,"run039"
"7729","BBG","GRG",1,9,10,0,10,"run039"
"7730","BBG","GRR",0,1,1,1,0,"run039"
"7731","BBG","RBB",0,1,1,1,0,"run039"
"7732","BBG","RBG",0,4,4,4,0,"run039"
"7733","BBG","RBR",0,1,1,0,1,"run039"
"7734","BBG","RGR",0,1,1,0,1,"run039"
"7735","BBG","RRG",1,2,3,2,1,"run039"
"7736","BBG","RRR",0,7,7,7,0,"run039"
"7737","BGB","BBB",0,2,2,1,1,"run039"
"7738","BGB","RRG",0,1,1,0,1,"run039"
"7739","BGG","BBB",0,3,3,3,0,"run039"
"7740","BGG","BBR",0,1,1,1,0,"run039"
"7741","BGG","GRG",0,1,1,0,1,"run039"
"7742","BGG","RBG",1,1,2,1,1,"run039"
"7743","BGG","RGG",0,3,3,1,2,"run039"
"7744","BGG","RGR",0,1,1,0,1,"run039"
"7745","BGG","RRR",1,1,2,0,2,"run039"
"7746","BRB","BBB",0,13,13,1,12,"run039"
"7747","BRB","BBR",0,1,1,0,1,"run039"
"7748","BRB","BRR",0,3,3,1,2,"run039"
"7749","BRB","GGG",0,1,1,0,1,"run039"
"7750","BRB","GGR",0,1,1,1,0,"run039"
"7751","BRB","RBB",0,1,1,0,1,"run039"
"7752","BRB","RBG",0,1,1,0,1,"run039"
"7753","BRB","RGR",0,1,1,1,0,"run039"
"7754","BRB","RRR",0,1,1,0,1,"run039"
"7755","BRR","BBB",0,11,11,10,1,"run039"
"7756","BRR","BGB",1,1,2,1,1,"run039"
"7757","BRR","BGG",0,1,1,1,0,"run039"
"7758","BRR","BRB",0,1,1,1,0,"run039"
"7759","BRR","RBB",0,2,2,0,2,"run039"
"7760","GBB","BBB",12,38,50,3,47,"run039"
"7761","GBB","BGG",0,1,1,1,0,"run039"
"7762","GBB","BRB",1,9,10,2,8,"run039"
"7763","GBB","BRR",1,3,4,4,0,"run039"
"7764","GBB","GBG",0,4,4,2,2,"run039"
"7765","GBB","GGB",0,21,21,20,1,"run039"
"7766","GBB","GGG",7,86,93,78,15,"run039"
"7767","GBB","GGR",1,3,4,3,1,"run039"
"7768","GBB","GRG",0,6,6,6,0,"run039"
"7769","GBB","GRR",0,1,1,1,0,"run039"
"7770","GBB","RBB",0,2,2,0,2,"run039"
"7771","GBB","RBG",3,9,12,11,1,"run039"
"7772","GBB","RBR",1,0,1,0,1,"run039"
"7773","GBB","RGG",1,0,1,0,1,"run039"
"7774","GBB","RGR",2,1,3,3,0,"run039"
"7775","GBB","RRG",0,2,2,0,2,"run039"
"7776","GBB","RRR",1,9,10,7,3,"run039"
"7777","GBG","BBB",0,5,5,0,5,"run039"
"7778","GBG","BBR",0,1,1,0,1,"run039"
"7779","GBG","BRB",1,4,5,4,1,"run039"
"7780","GBG","BRR",1,0,1,1,0,"run039"
"7781","GBG","GGB",0,4,4,4,0,"run039"
"7782","GBG","GGG",4,11,15,14,1,"run039"
"7783","GBG","RBB",1,0,1,0,1,"run039"
"7784","GBG","RBG",0,1,1,0,1,"run039"
"7785","GBG","RGG",0,1,1,0,1,"run039"
"7786","GBG","RGR",1,3,4,1,3,"run039"
"7787","GBG","RRG",1,3,4,0,4,"run039"
"7788","GGB","BBB",3,16,19,19,0,"run039"
"7789","GGB","BBR",1,4,5,1,4,"run039"
"7790","GGB","BGB",0,3,3,0,3,"run039"
"7791","GGB","BGG",0,4,4,3,1,"run039"
"7792","GGB","BRB",0,1,1,1,0,"run039"
"7793","GGB","BRR",1,15,16,2,14,"run039"
"7794","GGB","GBB",0,1,1,1,0,"run039"
"7795","GGB","GBG",1,0,1,0,1,"run039"
"7796","GGB","GGG",13,48,61,40,21,"run039"
"7797","GGB","GGR",0,7,7,4,3,"run039"
"7798","GGB","GRR",0,4,4,4,0,"run039"
"7799","GGB","RBB",0,5,5,2,3,"run039"
"7800","GGB","RBG",0,4,4,2,2,"run039"
"7801","GGB","RBR",0,5,5,1,4,"run039"
"7802","GGB","RGG",1,5,6,2,4,"run039"
"7803","GGB","RGR",0,2,2,0,2,"run039"
"7804","GGB","RRG",1,5,6,3,3,"run039"
"7805","GGB","RRR",1,5,6,0,6,"run039"
"7806","GGG","BBB",8,31,39,18,21,"run039"
"7807","GGG","BGB",0,2,2,2,0,"run039"
"7808","GGG","BGG",1,7,8,1,7,"run039"
"7809","GGG","BRB",1,3,4,0,4,"run039"
"7810","GGG","BRR",0,6,6,3,3,"run039"
"7811","GGG","GGB",5,1,6,3,3,"run039"
"7812","GGG","GGR",1,9,10,0,10,"run039"
"7813","GGG","GRR",0,2,2,1,1,"run039"
"7814","GGG","RBB",1,8,9,8,1,"run039"
"7815","GGG","RBG",0,6,6,3,3,"run039"
"7816","GGG","RBR",0,21,21,6,15,"run039"
"7817","GGG","RGG",0,3,3,3,0,"run039"
"7818","GGG","RGR",1,12,13,9,4,"run039"
"7819","GGG","RRG",1,23,24,22,2,"run039"
"7820","GGG","RRR",0,3,3,3,0,"run039"
"7821","GGR","BBB",0,2,2,2,0,"run039"
"7822","GGR","BBR",0,2,2,0,2,"run039"
"7823","GGR","BGG",0,1,1,1,0,"run039"
"7824","GGR","BRR",1,0,1,0,1,"run039"
"7825","GGR","GRR",1,0,1,1,0,"run039"
"7826","GGR","RBB",0,2,2,0,2,"run039"
"7827","GRG","BBB",3,8,11,6,5,"run039"
"7828","GRG","BBR",0,1,1,1,0,"run039"
"7829","GRG","BGG",0,1,1,1,0,"run039"
"7830","GRG","BRB",0,3,3,2,1,"run039"
"7831","GRG","BRR",0,1,1,1,0,"run039"
"7832","GRG","GBG",0,1,1,0,1,"run039"
"7833","GRG","GGB",2,15,17,15,2,"run039"
"7834","GRG","GGG",3,12,15,0,15,"run039"
"7835","GRG","GGR",0,5,5,5,0,"run039"
"7836","GRG","GRR",0,1,1,0,1,"run039"
"7837","GRG","RBG",0,1,1,0,1,"run039"
"7838","GRG","RBR",0,1,1,1,0,"run039"
"7839","GRG","RGR",1,2,3,3,0,"run039"
"7840","GRG","RRG",2,4,6,4,2,"run039"
"7841","GRR","BBB",0,1,1,0,1,"run039"
"7842","GRR","BBR",0,1,1,0,1,"run039"
"7843","GRR","BGB",1,2,3,2,1,"run039"
"7844","GRR","BGG",0,2,2,0,2,"run039"
"7845","GRR","BRB",0,1,1,0,1,"run039"
"7846","GRR","BRR",0,2,2,1,1,"run039"
"7847","GRR","GGG",0,1,1,0,1,"run039"
"7848","GRR","GGR",0,1,1,0,1,"run039"
"7849","RBB","BBB",0,1,1,0,1,"run039"
"7850","RBB","BBR",0,1,1,1,0,"run039"
"7851","RBB","BRB",0,1,1,1,0,"run039"
"7852","RBB","GRR",0,1,1,1,0,"run039"
"7853","RBB","RGG",0,1,1,0,1,"run039"
"7854","RBG","BBB",2,8,10,6,4,"run039"
"7855","RBG","BBG",0,1,1,1,0,"run039"
"7856","RBG","BRR",0,1,1,1,0,"run039"
"7857","RBG","GBB",0,1,1,1,0,"run039"
"7858","RBG","GRR",0,3,3,3,0,"run039"
"7859","RBG","RBB",1,1,2,2,0,"run039"
"7860","RBG","RBR",0,1,1,1,0,"run039"
"7861","RBG","RGR",0,1,1,0,1,"run039"
"7862","RBR","BBB",0,13,13,7,6,"run039"
"7863","RBR","BBR",0,1,1,0,1,"run039"
"7864","RBR","BGB",2,4,6,0,6,"run039"
"7865","RBR","BGG",0,2,2,1,1,"run039"
"7866","RBR","BRB",1,0,1,1,0,"run039"
"7867","RBR","BRR",1,4,5,4,1,"run039"
"7868","RBR","GGB",0,12,12,0,12,"run039"
"7869","RBR","GRR",4,4,8,8,0,"run039"
"7870","RBR","RBB",0,3,3,2,1,"run039"
"7871","RBR","RGG",2,9,11,8,3,"run039"
"7872","RBR","RGR",1,0,1,0,1,"run039"
"7873","RBR","RRR",0,1,1,1,0,"run039"
"7874","RGG","BBB",0,8,8,6,2,"run039"
"7875","RGG","BBR",1,2,3,1,2,"run039"
"7876","RGG","BGB",0,1,1,0,1,"run039"
"7877","RGG","BRR",0,4,4,1,3,"run039"
"7878","RGG","GGG",0,1,1,0,1,"run039"
"7879","RGG","GGR",0,3,3,0,3,"run039"
"7880","RGG","GRR",0,8,8,2,6,"run039"
"7881","RGG","RBB",0,1,1,1,0,"run039"
"7882","RGR","BBB",2,5,7,4,3,"run039"
"7883","RGR","BBR",1,1,2,2,0,"run039"
"7884","RGR","BGB",2,5,7,1,6,"run039"
"7885","RGR","BGG",2,2,4,4,0,"run039"
"7886","RGR","BRR",1,5,6,4,2,"run039"
"7887","RGR","GGB",2,12,14,6,8,"run039"
"7888","RGR","GGG",0,2,2,0,2,"run039"
"7889","RGR","GGR",0,4,4,1,3,"run039"
"7890","RGR","RBB",0,4,4,2,2,"run039"
"7891","RGR","RGG",1,1,2,0,2,"run039"
"7892","RGR","RRG",0,3,3,2,1,"run039"
"7893","RRG","BBB",2,33,35,28,7,"run039"
"7894","RRG","BBR",0,5,5,4,1,"run039"
"7895","RRG","BGB",1,10,11,6,5,"run039"
"7896","RRG","BGG",0,2,2,2,0,"run039"
"7897","RRG","BRB",2,40,42,12,30,"run039"
"7898","RRG","BRR",1,16,17,16,1,"run039"
"7899","RRG","GGG",2,14,16,6,10,"run039"
"7900","RRG","GGR",0,5,5,5,0,"run039"
"7901","RRG","GRG",1,0,1,0,1,"run039"
"7902","RRG","GRR",3,8,11,11,0,"run039"
"7903","RRG","RBB",1,1,2,1,1,"run039"
"7904","RRG","RGG",0,1,1,0,1,"run039"
"7905","RRG","RGR",0,1,1,1,0,"run039"
"7906","RRR","BBR",1,0,1,1,0,"run039"
"7907","RRR","BGB",2,1,3,3,0,"run039"
"7908","RRR","BGG",1,0,1,0,1,"run039"
"7909","RRR","BRB",1,1,2,2,0,"run039"
"7910","RRR","BRR",1,1,2,1,1,"run039"
"7911","RRR","GGR",0,1,1,0,1,"run039"
"7912","RRR","GRR",0,3,3,2,1,"run039"
"7913","RRR","RBB",1,2,3,2,1,"run039"
"7914","RRR","RBR",0,2,2,1,1,"run039"
"7915","RRR","RGG",0,1,1,1,0,"run039"
"7916","RRR","RGR",1,2,3,2,1,"run039"
"7917","RRR","RRG",2,2,4,3,1,"run039"
"7918","BBB","BRB",0,1,1,1,0,"run040"
"7919","BBB","GGG",1,2,3,2,1,"run040"
"7920","BBB","GRR",0,2,2,1,1,"run040"
"7921","BBB","RBG",0,1,1,0,1,"run040"
"7922","BBB","RRG",1,3,4,1,3,"run040"
"7923","BBB","RRR",0,2,2,2,0,"run040"
"7924","BBG","BBB",1,4,5,1,4,"run040"
"7925","BBG","BGB",0,1,1,1,0,"run040"
"7926","BBG","BGG",0,1,1,0,1,"run040"
"7927","BBG","BRB",1,16,17,15,2,"run040"
"7928","BBG","GBB",0,1,1,0,1,"run040"
"7929","BBG","GBG",2,7,9,2,7,"run040"
"7930","BBG","GGB",2,25,27,1,26,"run040"
"7931","BBG","GGG",4,38,42,11,31,"run040"
"7932","BBG","GRG",1,9,10,6,4,"run040"
"7933","BBG","GRR",0,1,1,0,1,"run040"
"7934","BBG","RBB",0,1,1,0,1,"run040"
"7935","BBG","RBG",0,4,4,1,3,"run040"
"7936","BBG","RBR",0,1,1,0,1,"run040"
"7937","BBG","RGR",0,1,1,0,1,"run040"
"7938","BBG","RRG",1,2,3,2,1,"run040"
"7939","BBG","RRR",0,7,7,6,1,"run040"
"7940","BGB","BBB",0,2,2,0,2,"run040"
"7941","BGB","RRG",0,1,1,1,0,"run040"
"7942","BGG","BBB",0,3,3,1,2,"run040"
"7943","BGG","BBR",0,1,1,1,0,"run040"
"7944","BGG","GRG",0,1,1,1,0,"run040"
"7945","BGG","RBG",1,1,2,0,2,"run040"
"7946","BGG","RGG",0,3,3,2,1,"run040"
"7947","BGG","RGR",0,1,1,0,1,"run040"
"7948","BGG","RRR",1,1,2,0,2,"run040"
"7949","BRB","BBB",0,13,13,5,8,"run040"
"7950","BRB","BBR",0,1,1,0,1,"run040"
"7951","BRB","BRR",0,3,3,0,3,"run040"
"7952","BRB","GGG",0,1,1,0,1,"run040"
"7953","BRB","GGR",0,1,1,1,0,"run040"
"7954","BRB","RBB",0,1,1,0,1,"run040"
"7955","BRB","RBG",0,1,1,0,1,"run040"
"7956","BRB","RGR",0,1,1,0,1,"run040"
"7957","BRB","RRR",0,1,1,0,1,"run040"
"7958","BRR","BBB",0,11,11,6,5,"run040"
"7959","BRR","BGB",1,1,2,1,1,"run040"
"7960","BRR","BGG",0,1,1,1,0,"run040"
"7961","BRR","BRB",0,1,1,1,0,"run040"
"7962","BRR","RBB",0,2,2,2,0,"run040"
"7963","GBB","BBB",12,38,50,4,46,"run040"
"7964","GBB","BGG",0,1,1,1,0,"run040"
"7965","GBB","BRB",1,9,10,1,9,"run040"
"7966","GBB","BRR",1,3,4,4,0,"run040"
"7967","GBB","GBG",0,4,4,4,0,"run040"
"7968","GBB","GGB",0,21,21,17,4,"run040"
"7969","GBB","GGG",7,86,93,3,90,"run040"
"7970","GBB","GGR",1,3,4,2,2,"run040"
"7971","GBB","GRG",0,6,6,2,4,"run040"
"7972","GBB","GRR",0,1,1,1,0,"run040"
"7973","GBB","RBB",0,2,2,1,1,"run040"
"7974","GBB","RBG",3,9,12,9,3,"run040"
"7975","GBB","RBR",1,0,1,1,0,"run040"
"7976","GBB","RGG",1,0,1,1,0,"run040"
"7977","GBB","RGR",2,1,3,0,3,"run040"
"7978","GBB","RRG",0,2,2,1,1,"run040"
"7979","GBB","RRR",1,9,10,0,10,"run040"
"7980","GBG","BBB",0,5,5,5,0,"run040"
"7981","GBG","BBR",0,1,1,0,1,"run040"
"7982","GBG","BRB",1,4,5,0,5,"run040"
"7983","GBG","BRR",1,0,1,0,1,"run040"
"7984","GBG","GGB",0,4,4,1,3,"run040"
"7985","GBG","GGG",4,11,15,2,13,"run040"
"7986","GBG","RBB",1,0,1,1,0,"run040"
"7987","GBG","RBG",0,1,1,1,0,"run040"
"7988","GBG","RGG",0,1,1,0,1,"run040"
"7989","GBG","RGR",1,3,4,0,4,"run040"
"7990","GBG","RRG",1,3,4,2,2,"run040"
"7991","GGB","BBB",3,16,19,4,15,"run040"
"7992","GGB","BBR",1,4,5,3,2,"run040"
"7993","GGB","BGB",0,3,3,1,2,"run040"
"7994","GGB","BGG",0,4,4,4,0,"run040"
"7995","GGB","BRB",0,1,1,0,1,"run040"
"7996","GGB","BRR",1,15,16,13,3,"run040"
"7997","GGB","GBB",0,1,1,1,0,"run040"
"7998","GGB","GBG",1,0,1,0,1,"run040"
"7999","GGB","GGG",13,48,61,22,39,"run040"
"8000","GGB","GGR",0,7,7,7,0,"run040"
"8001","GGB","GRR",0,4,4,2,2,"run040"
"8002","GGB","RBB",0,5,5,4,1,"run040"
"8003","GGB","RBG",0,4,4,4,0,"run040"
"8004","GGB","RBR",0,5,5,2,3,"run040"
"8005","GGB","RGG",1,5,6,1,5,"run040"
"8006","GGB","RGR",0,2,2,2,0,"run040"
"8007","GGB","RRG",1,5,6,6,0,"run040"
"8008","GGB","RRR",1,5,6,4,2,"run040"
"8009","GGG","BBB",8,31,39,27,12,"run040"
"8010","GGG","BGB",0,2,2,0,2,"run040"
"8011","GGG","BGG",1,7,8,2,6,"run040"
"8012","GGG","BRB",1,3,4,2,2,"run040"
"8013","GGG","BRR",0,6,6,4,2,"run040"
"8014","GGG","GGB",5,1,6,3,3,"run040"
"8015","GGG","GGR",1,9,10,0,10,"run040"
"8016","GGG","GRR",0,2,2,0,2,"run040"
"8017","GGG","RBB",1,8,9,5,4,"run040"
"8018","GGG","RBG",0,6,6,2,4,"run040"
"8019","GGG","RBR",0,21,21,5,16,"run040"
"8020","GGG","RGG",0,3,3,3,0,"run040"
"8021","GGG","RGR",1,12,13,8,5,"run040"
"8022","GGG","RRG",1,23,24,19,5,"run040"
"8023","GGG","RRR",0,3,3,3,0,"run040"
"8024","GGR","BBB",0,2,2,2,0,"run040"
"8025","GGR","BBR",0,2,2,0,2,"run040"
"8026","GGR","BGG",0,1,1,1,0,"run040"
"8027","GGR","BRR",1,0,1,0,1,"run040"
"8028","GGR","GRR",1,0,1,1,0,"run040"
"8029","GGR","RBB",0,2,2,2,0,"run040"
"8030","GRG","BBB",3,8,11,2,9,"run040"
"8031","GRG","BBR",0,1,1,0,1,"run040"
"8032","GRG","BGG",0,1,1,0,1,"run040"
"8033","GRG","BRB",0,3,3,0,3,"run040"
"8034","GRG","BRR",0,1,1,1,0,"run040"
"8035","GRG","GBG",0,1,1,0,1,"run040"
"8036","GRG","GGB",2,15,17,1,16,"run040"
"8037","GRG","GGG",3,12,15,12,3,"run040"
"8038","GRG","GGR",0,5,5,5,0,"run040"
"8039","GRG","GRR",0,1,1,0,1,"run040"
"8040","GRG","RBG",0,1,1,0,1,"run040"
"8041","GRG","RBR",0,1,1,0,1,"run040"
"8042","GRG","RGR",1,2,3,3,0,"run040"
"8043","GRG","RRG",2,4,6,6,0,"run040"
"8044","GRR","BBB",0,1,1,0,1,"run040"
"8045","GRR","BBR",0,1,1,0,1,"run040"
"8046","GRR","BGB",1,2,3,3,0,"run040"
"8047","GRR","BGG",0,2,2,0,2,"run040"
"8048","GRR","BRB",0,1,1,1,0,"run040"
"8049","GRR","BRR",0,2,2,2,0,"run040"
"8050","GRR","GGG",0,1,1,0,1,"run040"
"8051","GRR","GGR",0,1,1,1,0,"run040"
"8052","RBB","BBB",0,1,1,1,0,"run040"
"8053","RBB","BBR",0,1,1,0,1,"run040"
"8054","RBB","BRB",0,1,1,1,0,"run040"
"8055","RBB","GRR",0,1,1,1,0,"run040"
"8056","RBB","RGG",0,1,1,0,1,"run040"
"8057","RBG","BBB",2,8,10,7,3,"run040"
"8058","RBG","BBG",0,1,1,1,0,"run040"
"8059","RBG","BRR",0,1,1,1,0,"run040"
"8060","RBG","GBB",0,1,1,0,1,"run040"
"8061","RBG","GRR",0,3,3,1,2,"run040"
"8062","RBG","RBB",1,1,2,1,1,"run040"
"8063","RBG","RBR",0,1,1,0,1,"run040"
"8064","RBG","RGR",0,1,1,0,1,"run040"
"8065","RBR","BBB",0,13,13,6,7,"run040"
"8066","RBR","BBR",0,1,1,0,1,"run040"
"8067","RBR","BGB",2,4,6,3,3,"run040"
"8068","RBR","BGG",0,2,2,1,1,"run040"
"8069","RBR","BRB",1,0,1,0,1,"run040"
"8070","RBR","BRR",1,4,5,2,3,"run040"
"8071","RBR","GGB",0,12,12,5,7,"run040"
"8072","RBR","GRR",4,4,8,8,0,"run040"
"8073","RBR","RBB",0,3,3,2,1,"run040"
"8074","RBR","RGG",2,9,11,8,3,"run040"
"8075","RBR","RGR",1,0,1,1,0,"run040"
"8076","RBR","RRR",0,1,1,1,0,"run040"
"8077","RGG","BBB",0,8,8,4,4,"run040"
"8078","RGG","BBR",1,2,3,0,3,"run040"
"8079","RGG","BGB",0,1,1,0,1,"run040"
"8080","RGG","BRR",0,4,4,4,0,"run040"
"8081","RGG","GGG",0,1,1,0,1,"run040"
"8082","RGG","GGR",0,3,3,3,0,"run040"
"8083","RGG","GRR",0,8,8,2,6,"run040"
"8084","RGG","RBB",0,1,1,1,0,"run040"
"8085","RGR","BBB",2,5,7,3,4,"run040"
"8086","RGR","BBR",1,1,2,1,1,"run040"
"8087","RGR","BGB",2,5,7,5,2,"run040"
"8088","RGR","BGG",2,2,4,0,4,"run040"
"8089","RGR","BRR",1,5,6,3,3,"run040"
"8090","RGR","GGB",2,12,14,9,5,"run040"
"8091","RGR","GGG",0,2,2,2,0,"run040"
"8092","RGR","GGR",0,4,4,3,1,"run040"
"8093","RGR","RBB",0,4,4,0,4,"run040"
"8094","RGR","RGG",1,1,2,0,2,"run040"
"8095","RGR","RRG",0,3,3,2,1,"run040"
"8096","RRG","BBB",2,33,35,30,5,"run040"
"8097","RRG","BBR",0,5,5,1,4,"run040"
"8098","RRG","BGB",1,10,11,6,5,"run040"
"8099","RRG","BGG",0,2,2,1,1,"run040"
"8100","RRG","BRB",2,40,42,10,32,"run040"
"8101","RRG","BRR",1,16,17,0,17,"run040"
"8102","RRG","GGG",2,14,16,6,10,"run040"
"8103","RRG","GGR",0,5,5,3,2,"run040"
"8104","RRG","GRG",1,0,1,0,1,"run040"
"8105","RRG","GRR",3,8,11,3,8,"run040"
"8106","RRG","RBB",1,1,2,0,2,"run040"
"8107","RRG","RGG",0,1,1,0,1,"run040"
"8108","RRG","RGR",0,1,1,0,1,"run040"
"8109","RRR","BBR",1,0,1,0,1,"run040"
"8110","RRR","BGB",2,1,3,0,3,"run040"
"8111","RRR","BGG",1,0,1,1,0,"run040"
"8112","RRR","BRB",1,1,2,2,0,"run040"
"8113","RRR","BRR",1,1,2,1,1,"run040"
"8114","RRR","GGR",0,1,1,1,0,"run040"
"8115","RRR","GRR",0,3,3,2,1,"run040"
"8116","RRR","RBB",1,2,3,2,1,"run040"
"8117","RRR","RBR",0,2,2,1,1,"run040"
"8118","RRR","RGG",0,1,1,0,1,"run040"
"8119","RRR","RGR",1,2,3,0,3,"run040"
"8120","RRR","RRG",2,2,4,3,1,"run040"
"8121","BBB","BRB",0,1,1,1,0,"run041"
"8122","BBB","GGG",1,2,3,2,1,"run041"
"8123","BBB","GRR",0,2,2,0,2,"run041"
"8124","BBB","RBG",0,1,1,1,0,"run041"
"8125","BBB","RRG",1,3,4,1,3,"run041"
"8126","BBB","RRR",0,2,2,0,2,"run041"
"8127","BBG","BBB",1,4,5,5,0,"run041"
"8128","BBG","BGB",0,1,1,1,0,"run041"
"8129","BBG","BGG",0,1,1,1,0,"run041"
"8130","BBG","BRB",1,16,17,1,16,"run041"
"8131","BBG","GBB",0,1,1,0,1,"run041"
"8132","BBG","GBG",2,7,9,5,4,"run041"
"8133","BBG","GGB",2,25,27,12,15,"run041"
"8134","BBG","GGG",4,38,42,17,25,"run041"
"8135","BBG","GRG",1,9,10,4,6,"run041"
"8136","BBG","GRR",0,1,1,1,0,"run041"
"8137","BBG","RBB",0,1,1,1,0,"run041"
"8138","BBG","RBG",0,4,4,4,0,"run041"
"8139","BBG","RBR",0,1,1,1,0,"run041"
"8140","BBG","RGR",0,1,1,0,1,"run041"
"8141","BBG","RRG",1,2,3,3,0,"run041"
"8142","BBG","RRR",0,7,7,0,7,"run041"
"8143","BGB","BBB",0,2,2,1,1,"run041"
"8144","BGB","RRG",0,1,1,0,1,"run041"
"8145","BGG","BBB",0,3,3,1,2,"run041"
"8146","BGG","BBR",0,1,1,1,0,"run041"
"8147","BGG","GRG",0,1,1,1,0,"run041"
"8148","BGG","RBG",1,1,2,1,1,"run041"
"8149","BGG","RGG",0,3,3,1,2,"run041"
"8150","BGG","RGR",0,1,1,1,0,"run041"
"8151","BGG","RRR",1,1,2,0,2,"run041"
"8152","BRB","BBB",0,13,13,2,11,"run041"
"8153","BRB","BBR",0,1,1,0,1,"run041"
"8154","BRB","BRR",0,3,3,1,2,"run041"
"8155","BRB","GGG",0,1,1,0,1,"run041"
"8156","BRB","GGR",0,1,1,1,0,"run041"
"8157","BRB","RBB",0,1,1,0,1,"run041"
"8158","BRB","RBG",0,1,1,0,1,"run041"
"8159","BRB","RGR",0,1,1,1,0,"run041"
"8160","BRB","RRR",0,1,1,1,0,"run041"
"8161","BRR","BBB",0,11,11,0,11,"run041"
"8162","BRR","BGB",1,1,2,1,1,"run041"
"8163","BRR","BGG",0,1,1,1,0,"run041"
"8164","BRR","BRB",0,1,1,0,1,"run041"
"8165","BRR","RBB",0,2,2,1,1,"run041"
"8166","GBB","BBB",12,38,50,44,6,"run041"
"8167","GBB","BGG",0,1,1,0,1,"run041"
"8168","GBB","BRB",1,9,10,4,6,"run041"
"8169","GBB","BRR",1,3,4,3,1,"run041"
"8170","GBB","GBG",0,4,4,3,1,"run041"
"8171","GBB","GGB",0,21,21,20,1,"run041"
"8172","GBB","GGG",7,86,93,60,33,"run041"
"8173","GBB","GGR",1,3,4,2,2,"run041"
"8174","GBB","GRG",0,6,6,1,5,"run041"
"8175","GBB","GRR",0,1,1,0,1,"run041"
"8176","GBB","RBB",0,2,2,2,0,"run041"
"8177","GBB","RBG",3,9,12,1,11,"run041"
"8178","GBB","RBR",1,0,1,0,1,"run041"
"8179","GBB","RGG",1,0,1,1,0,"run041"
"8180","GBB","RGR",2,1,3,0,3,"run041"
"8181","GBB","RRG",0,2,2,2,0,"run041"
"8182","GBB","RRR",1,9,10,5,5,"run041"
"8183","GBG","BBB",0,5,5,0,5,"run041"
"8184","GBG","BBR",0,1,1,1,0,"run041"
"8185","GBG","BRB",1,4,5,2,3,"run041"
"8186","GBG","BRR",1,0,1,0,1,"run041"
"8187","GBG","GGB",0,4,4,3,1,"run041"
"8188","GBG","GGG",4,11,15,7,8,"run041"
"8189","GBG","RBB",1,0,1,1,0,"run041"
"8190","GBG","RBG",0,1,1,0,1,"run041"
"8191","GBG","RGG",0,1,1,1,0,"run041"
"8192","GBG","RGR",1,3,4,1,3,"run041"
"8193","GBG","RRG",1,3,4,0,4,"run041"
"8194","GGB","BBB",3,16,19,4,15,"run041"
"8195","GGB","BBR",1,4,5,5,0,"run041"
"8196","GGB","BGB",0,3,3,2,1,"run041"
"8197","GGB","BGG",0,4,4,2,2,"run041"
"8198","GGB","BRB",0,1,1,0,1,"run041"
"8199","GGB","BRR",1,15,16,11,5,"run041"
"8200","GGB","GBB",0,1,1,0,1,"run041"
"8201","GGB","GBG",1,0,1,0,1,"run041"
"8202","GGB","GGG",13,48,61,19,42,"run041"
"8203","GGB","GGR",0,7,7,3,4,"run041"
"8204","GGB","GRR",0,4,4,1,3,"run041"
"8205","GGB","RBB",0,5,5,5,0,"run041"
"8206","GGB","RBG",0,4,4,1,3,"run041"
"8207","GGB","RBR",0,5,5,2,3,"run041"
"8208","GGB","RGG",1,5,6,0,6,"run041"
"8209","GGB","RGR",0,2,2,2,0,"run041"
"8210","GGB","RRG",1,5,6,2,4,"run041"
"8211","GGB","RRR",1,5,6,2,4,"run041"
"8212","GGG","BBB",8,31,39,23,16,"run041"
"8213","GGG","BGB",0,2,2,2,0,"run041"
"8214","GGG","BGG",1,7,8,5,3,"run041"
"8215","GGG","BRB",1,3,4,4,0,"run041"
"8216","GGG","BRR",0,6,6,2,4,"run041"
"8217","GGG","GGB",5,1,6,2,4,"run041"
"8218","GGG","GGR",1,9,10,1,9,"run041"
"8219","GGG","GRR",0,2,2,1,1,"run041"
"8220","GGG","RBB",1,8,9,1,8,"run041"
"8221","GGG","RBG",0,6,6,6,0,"run041"
"8222","GGG","RBR",0,21,21,14,7,"run041"
"8223","GGG","RGG",0,3,3,1,2,"run041"
"8224","GGG","RGR",1,12,13,6,7,"run041"
"8225","GGG","RRG",1,23,24,23,1,"run041"
"8226","GGG","RRR",0,3,3,1,2,"run041"
"8227","GGR","BBB",0,2,2,2,0,"run041"
"8228","GGR","BBR",0,2,2,2,0,"run041"
"8229","GGR","BGG",0,1,1,1,0,"run041"
"8230","GGR","BRR",1,0,1,1,0,"run041"
"8231","GGR","GRR",1,0,1,0,1,"run041"
"8232","GGR","RBB",0,2,2,2,0,"run041"
"8233","GRG","BBB",3,8,11,5,6,"run041"
"8234","GRG","BBR",0,1,1,1,0,"run041"
"8235","GRG","BGG",0,1,1,0,1,"run041"
"8236","GRG","BRB",0,3,3,1,2,"run041"
"8237","GRG","BRR",0,1,1,0,1,"run041"
"8238","GRG","GBG",0,1,1,0,1,"run041"
"8239","GRG","GGB",2,15,17,8,9,"run041"
"8240","GRG","GGG",3,12,15,5,10,"run041"
"8241","GRG","GGR",0,5,5,4,1,"run041"
"8242","GRG","GRR",0,1,1,0,1,"run041"
"8243","GRG","RBG",0,1,1,0,1,"run041"
"8244","GRG","RBR",0,1,1,1,0,"run041"
"8245","GRG","RGR",1,2,3,2,1,"run041"
"8246","GRG","RRG",2,4,6,3,3,"run041"
"8247","GRR","BBB",0,1,1,1,0,"run041"
"8248","GRR","BBR",0,1,1,0,1,"run041"
"8249","GRR","BGB",1,2,3,2,1,"run041"
"8250","GRR","BGG",0,2,2,0,2,"run041"
"8251","GRR","BRB",0,1,1,1,0,"run041"
"8252","GRR","BRR",0,2,2,2,0,"run041"
"8253","GRR","GGG",0,1,1,1,0,"run041"
"8254","GRR","GGR",0,1,1,1,0,"run041"
"8255","RBB","BBB",0,1,1,0,1,"run041"
"8256","RBB","BBR",0,1,1,1,0,"run041"
"8257","RBB","BRB",0,1,1,0,1,"run041"
"8258","RBB","GRR",0,1,1,0,1,"run041"
"8259","RBB","RGG",0,1,1,1,0,"run041"
"8260","RBG","BBB",2,8,10,9,1,"run041"
"8261","RBG","BBG",0,1,1,0,1,"run041"
"8262","RBG","BRR",0,1,1,0,1,"run041"
"8263","RBG","GBB",0,1,1,1,0,"run041"
"8264","RBG","GRR",0,3,3,1,2,"run041"
"8265","RBG","RBB",1,1,2,1,1,"run041"
"8266","RBG","RBR",0,1,1,0,1,"run041"
"8267","RBG","RGR",0,1,1,0,1,"run041"
"8268","RBR","BBB",0,13,13,8,5,"run041"
"8269","RBR","BBR",0,1,1,1,0,"run041"
"8270","RBR","BGB",2,4,6,4,2,"run041"
"8271","RBR","BGG",0,2,2,1,1,"run041"
"8272","RBR","BRB",1,0,1,0,1,"run041"
"8273","RBR","BRR",1,4,5,2,3,"run041"
"8274","RBR","GGB",0,12,12,0,12,"run041"
"8275","RBR","GRR",4,4,8,2,6,"run041"
"8276","RBR","RBB",0,3,3,2,1,"run041"
"8277","RBR","RGG",2,9,11,8,3,"run041"
"8278","RBR","RGR",1,0,1,0,1,"run041"
"8279","RBR","RRR",0,1,1,0,1,"run041"
"8280","RGG","BBB",0,8,8,5,3,"run041"
"8281","RGG","BBR",1,2,3,1,2,"run041"
"8282","RGG","BGB",0,1,1,0,1,"run041"
"8283","RGG","BRR",0,4,4,1,3,"run041"
"8284","RGG","GGG",0,1,1,1,0,"run041"
"8285","RGG","GGR",0,3,3,1,2,"run041"
"8286","RGG","GRR",0,8,8,0,8,"run041"
"8287","RGG","RBB",0,1,1,0,1,"run041"
"8288","RGR","BBB",2,5,7,4,3,"run041"
"8289","RGR","BBR",1,1,2,1,1,"run041"
"8290","RGR","BGB",2,5,7,1,6,"run041"
"8291","RGR","BGG",2,2,4,3,1,"run041"
"8292","RGR","BRR",1,5,6,4,2,"run041"
"8293","RGR","GGB",2,12,14,1,13,"run041"
"8294","RGR","GGG",0,2,2,1,1,"run041"
"8295","RGR","GGR",0,4,4,4,0,"run041"
"8296","RGR","RBB",0,4,4,3,1,"run041"
"8297","RGR","RGG",1,1,2,0,2,"run041"
"8298","RGR","RRG",0,3,3,0,3,"run041"
"8299","RRG","BBB",2,33,35,15,20,"run041"
"8300","RRG","BBR",0,5,5,5,0,"run041"
"8301","RRG","BGB",1,10,11,4,7,"run041"
"8302","RRG","BGG",0,2,2,2,0,"run041"
"8303","RRG","BRB",2,40,42,29,13,"run041"
"8304","RRG","BRR",1,16,17,16,1,"run041"
"8305","RRG","GGG",2,14,16,6,10,"run041"
"8306","RRG","GGR",0,5,5,5,0,"run041"
"8307","RRG","GRG",1,0,1,1,0,"run041"
"8308","RRG","GRR",3,8,11,3,8,"run041"
"8309","RRG","RBB",1,1,2,2,0,"run041"
"8310","RRG","RGG",0,1,1,0,1,"run041"
"8311","RRG","RGR",0,1,1,0,1,"run041"
"8312","RRR","BBR",1,0,1,1,0,"run041"
"8313","RRR","BGB",2,1,3,0,3,"run041"
"8314","RRR","BGG",1,0,1,1,0,"run041"
"8315","RRR","BRB",1,1,2,1,1,"run041"
"8316","RRR","BRR",1,1,2,0,2,"run041"
"8317","RRR","GGR",0,1,1,0,1,"run041"
"8318","RRR","GRR",0,3,3,1,2,"run041"
"8319","RRR","RBB",1,2,3,0,3,"run041"
"8320","RRR","RBR",0,2,2,1,1,"run041"
"8321","RRR","RGG",0,1,1,0,1,"run041"
"8322","RRR","RGR",1,2,3,3,0,"run041"
"8323","RRR","RRG",2,2,4,4,0,"run041"
"8324","BBB","BRB",0,1,1,0,1,"run042"
"8325","BBB","GGG",1,2,3,0,3,"run042"
"8326","BBB","GRR",0,2,2,0,2,"run042"
"8327","BBB","RBG",0,1,1,0,1,"run042"
"8328","BBB","RRG",1,3,4,1,3,"run042"
"8329","BBB","RRR",0,2,2,1,1,"run042"
"8330","BBG","BBB",1,4,5,1,4,"run042"
"8331","BBG","BGB",0,1,1,0,1,"run042"
"8332","BBG","BGG",0,1,1,1,0,"run042"
"8333","BBG","BRB",1,16,17,14,3,"run042"
"8334","BBG","GBB",0,1,1,1,0,"run042"
"8335","BBG","GBG",2,7,9,6,3,"run042"
"8336","BBG","GGB",2,25,27,3,24,"run042"
"8337","BBG","GGG",4,38,42,24,18,"run042"
"8338","BBG","GRG",1,9,10,4,6,"run042"
"8339","BBG","GRR",0,1,1,1,0,"run042"
"8340","BBG","RBB",0,1,1,1,0,"run042"
"8341","BBG","RBG",0,4,4,1,3,"run042"
"8342","BBG","RBR",0,1,1,1,0,"run042"
"8343","BBG","RGR",0,1,1,0,1,"run042"
"8344","BBG","RRG",1,2,3,2,1,"run042"
"8345","BBG","RRR",0,7,7,0,7,"run042"
"8346","BGB","BBB",0,2,2,0,2,"run042"
"8347","BGB","RRG",0,1,1,0,1,"run042"
"8348","BGG","BBB",0,3,3,3,0,"run042"
"8349","BGG","BBR",0,1,1,0,1,"run042"
"8350","BGG","GRG",0,1,1,0,1,"run042"
"8351","BGG","RBG",1,1,2,0,2,"run042"
"8352","BGG","RGG",0,3,3,0,3,"run042"
"8353","BGG","RGR",0,1,1,1,0,"run042"
"8354","BGG","RRR",1,1,2,1,1,"run042"
"8355","BRB","BBB",0,13,13,11,2,"run042"
"8356","BRB","BBR",0,1,1,1,0,"run042"
"8357","BRB","BRR",0,3,3,2,1,"run042"
"8358","BRB","GGG",0,1,1,1,0,"run042"
"8359","BRB","GGR",0,1,1,0,1,"run042"
"8360","BRB","RBB",0,1,1,1,0,"run042"
"8361","BRB","RBG",0,1,1,1,0,"run042"
"8362","BRB","RGR",0,1,1,1,0,"run042"
"8363","BRB","RRR",0,1,1,0,1,"run042"
"8364","BRR","BBB",0,11,11,5,6,"run042"
"8365","BRR","BGB",1,1,2,1,1,"run042"
"8366","BRR","BGG",0,1,1,1,0,"run042"
"8367","BRR","BRB",0,1,1,1,0,"run042"
"8368","BRR","RBB",0,2,2,1,1,"run042"
"8369","GBB","BBB",12,38,50,17,33,"run042"
"8370","GBB","BGG",0,1,1,0,1,"run042"
"8371","GBB","BRB",1,9,10,4,6,"run042"
"8372","GBB","BRR",1,3,4,3,1,"run042"
"8373","GBB","GBG",0,4,4,1,3,"run042"
"8374","GBB","GGB",0,21,21,17,4,"run042"
"8375","GBB","GGG",7,86,93,87,6,"run042"
"8376","GBB","GGR",1,3,4,0,4,"run042"
"8377","GBB","GRG",0,6,6,4,2,"run042"
"8378","GBB","GRR",0,1,1,1,0,"run042"
"8379","GBB","RBB",0,2,2,1,1,"run042"
"8380","GBB","RBG",3,9,12,5,7,"run042"
"8381","GBB","RBR",1,0,1,1,0,"run042"
"8382","GBB","RGG",1,0,1,1,0,"run042"
"8383","GBB","RGR",2,1,3,3,0,"run042"
"8384","GBB","RRG",0,2,2,2,0,"run042"
"8385","GBB","RRR",1,9,10,5,5,"run042"
"8386","GBG","BBB",0,5,5,4,1,"run042"
"8387","GBG","BBR",0,1,1,1,0,"run042"
"8388","GBG","BRB",1,4,5,5,0,"run042"
"8389","GBG","BRR",1,0,1,1,0,"run042"
"8390","GBG","GGB",0,4,4,1,3,"run042"
"8391","GBG","GGG",4,11,15,7,8,"run042"
"8392","GBG","RBB",1,0,1,0,1,"run042"
"8393","GBG","RBG",0,1,1,0,1,"run042"
"8394","GBG","RGG",0,1,1,0,1,"run042"
"8395","GBG","RGR",1,3,4,3,1,"run042"
"8396","GBG","RRG",1,3,4,4,0,"run042"
"8397","GGB","BBB",3,16,19,9,10,"run042"
"8398","GGB","BBR",1,4,5,0,5,"run042"
"8399","GGB","BGB",0,3,3,0,3,"run042"
"8400","GGB","BGG",0,4,4,3,1,"run042"
"8401","GGB","BRB",0,1,1,1,0,"run042"
"8402","GGB","BRR",1,15,16,8,8,"run042"
"8403","GGB","GBB",0,1,1,0,1,"run042"
"8404","GGB","GBG",1,0,1,0,1,"run042"
"8405","GGB","GGG",13,48,61,28,33,"run042"
"8406","GGB","GGR",0,7,7,7,0,"run042"
"8407","GGB","GRR",0,4,4,4,0,"run042"
"8408","GGB","RBB",0,5,5,3,2,"run042"
"8409","GGB","RBG",0,4,4,4,0,"run042"
"8410","GGB","RBR",0,5,5,3,2,"run042"
"8411","GGB","RGG",1,5,6,5,1,"run042"
"8412","GGB","RGR",0,2,2,1,1,"run042"
"8413","GGB","RRG",1,5,6,1,5,"run042"
"8414","GGB","RRR",1,5,6,0,6,"run042"
"8415","GGG","BBB",8,31,39,17,22,"run042"
"8416","GGG","BGB",0,2,2,0,2,"run042"
"8417","GGG","BGG",1,7,8,7,1,"run042"
"8418","GGG","BRB",1,3,4,4,0,"run042"
"8419","GGG","BRR",0,6,6,3,3,"run042"
"8420","GGG","GGB",5,1,6,0,6,"run042"
"8421","GGG","GGR",1,9,10,3,7,"run042"
"8422","GGG","GRR",0,2,2,2,0,"run042"
"8423","GGG","RBB",1,8,9,9,0,"run042"
"8424","GGG","RBG",0,6,6,1,5,"run042"
"8425","GGG","RBR",0,21,21,12,9,"run042"
"8426","GGG","RGG",0,3,3,0,3,"run042"
"8427","GGG","RGR",1,12,13,5,8,"run042"
"8428","GGG","RRG",1,23,24,18,6,"run042"
"8429","GGG","RRR",0,3,3,3,0,"run042"
"8430","GGR","BBB",0,2,2,1,1,"run042"
"8431","GGR","BBR",0,2,2,0,2,"run042"
"8432","GGR","BGG",0,1,1,0,1,"run042"
"8433","GGR","BRR",1,0,1,1,0,"run042"
"8434","GGR","GRR",1,0,1,0,1,"run042"
"8435","GGR","RBB",0,2,2,0,2,"run042"
"8436","GRG","BBB",3,8,11,4,7,"run042"
"8437","GRG","BBR",0,1,1,1,0,"run042"
"8438","GRG","BGG",0,1,1,0,1,"run042"
"8439","GRG","BRB",0,3,3,0,3,"run042"
"8440","GRG","BRR",0,1,1,1,0,"run042"
"8441","GRG","GBG",0,1,1,1,0,"run042"
"8442","GRG","GGB",2,15,17,7,10,"run042"
"8443","GRG","GGG",3,12,15,12,3,"run042"
"8444","GRG","GGR",0,5,5,5,0,"run042"
"8445","GRG","GRR",0,1,1,0,1,"run042"
"8446","GRG","RBG",0,1,1,0,1,"run042"
"8447","GRG","RBR",0,1,1,1,0,"run042"
"8448","GRG","RGR",1,2,3,0,3,"run042"
"8449","GRG","RRG",2,4,6,0,6,"run042"
"8450","GRR","BBB",0,1,1,0,1,"run042"
"8451","GRR","BBR",0,1,1,1,0,"run042"
"8452","GRR","BGB",1,2,3,1,2,"run042"
"8453","GRR","BGG",0,2,2,2,0,"run042"
"8454","GRR","BRB",0,1,1,1,0,"run042"
"8455","GRR","BRR",0,2,2,1,1,"run042"
"8456","GRR","GGG",0,1,1,1,0,"run042"
"8457","GRR","GGR",0,1,1,0,1,"run042"
"8458","RBB","BBB",0,1,1,0,1,"run042"
"8459","RBB","BBR",0,1,1,0,1,"run042"
"8460","RBB","BRB",0,1,1,0,1,"run042"
"8461","RBB","GRR",0,1,1,0,1,"run042"
"8462","RBB","RGG",0,1,1,0,1,"run042"
"8463","RBG","BBB",2,8,10,0,10,"run042"
"8464","RBG","BBG",0,1,1,1,0,"run042"
"8465","RBG","BRR",0,1,1,1,0,"run042"
"8466","RBG","GBB",0,1,1,0,1,"run042"
"8467","RBG","GRR",0,3,3,1,2,"run042"
"8468","RBG","RBB",1,1,2,2,0,"run042"
"8469","RBG","RBR",0,1,1,0,1,"run042"
"8470","RBG","RGR",0,1,1,1,0,"run042"
"8471","RBR","BBB",0,13,13,4,9,"run042"
"8472","RBR","BBR",0,1,1,1,0,"run042"
"8473","RBR","BGB",2,4,6,0,6,"run042"
"8474","RBR","BGG",0,2,2,1,1,"run042"
"8475","RBR","BRB",1,0,1,0,1,"run042"
"8476","RBR","BRR",1,4,5,1,4,"run042"
"8477","RBR","GGB",0,12,12,1,11,"run042"
"8478","RBR","GRR",4,4,8,5,3,"run042"
"8479","RBR","RBB",0,3,3,1,2,"run042"
"8480","RBR","RGG",2,9,11,5,6,"run042"
"8481","RBR","RGR",1,0,1,0,1,"run042"
"8482","RBR","RRR",0,1,1,1,0,"run042"
"8483","RGG","BBB",0,8,8,3,5,"run042"
"8484","RGG","BBR",1,2,3,3,0,"run042"
"8485","RGG","BGB",0,1,1,0,1,"run042"
"8486","RGG","BRR",0,4,4,1,3,"run042"
"8487","RGG","GGG",0,1,1,1,0,"run042"
"8488","RGG","GGR",0,3,3,2,1,"run042"
"8489","RGG","GRR",0,8,8,8,0,"run042"
"8490","RGG","RBB",0,1,1,0,1,"run042"
"8491","RGR","BBB",2,5,7,1,6,"run042"
"8492","RGR","BBR",1,1,2,1,1,"run042"
"8493","RGR","BGB",2,5,7,0,7,"run042"
"8494","RGR","BGG",2,2,4,3,1,"run042"
"8495","RGR","BRR",1,5,6,2,4,"run042"
"8496","RGR","GGB",2,12,14,12,2,"run042"
"8497","RGR","GGG",0,2,2,1,1,"run042"
"8498","RGR","GGR",0,4,4,1,3,"run042"
"8499","RGR","RBB",0,4,4,3,1,"run042"
"8500","RGR","RGG",1,1,2,1,1,"run042"
"8501","RGR","RRG",0,3,3,2,1,"run042"
"8502","RRG","BBB",2,33,35,31,4,"run042"
"8503","RRG","BBR",0,5,5,2,3,"run042"
"8504","RRG","BGB",1,10,11,9,2,"run042"
"8505","RRG","BGG",0,2,2,0,2,"run042"
"8506","RRG","BRB",2,40,42,27,15,"run042"
"8507","RRG","BRR",1,16,17,4,13,"run042"
"8508","RRG","GGG",2,14,16,9,7,"run042"
"8509","RRG","GGR",0,5,5,0,5,"run042"
"8510","RRG","GRG",1,0,1,0,1,"run042"
"8511","RRG","GRR",3,8,11,4,7,"run042"
"8512","RRG","RBB",1,1,2,2,0,"run042"
"8513","RRG","RGG",0,1,1,1,0,"run042"
"8514","RRG","RGR",0,1,1,1,0,"run042"
"8515","RRR","BBR",1,0,1,1,0,"run042"
"8516","RRR","BGB",2,1,3,1,2,"run042"
"8517","RRR","BGG",1,0,1,0,1,"run042"
"8518","RRR","BRB",1,1,2,0,2,"run042"
"8519","RRR","BRR",1,1,2,2,0,"run042"
"8520","RRR","GGR",0,1,1,1,0,"run042"
"8521","RRR","GRR",0,3,3,1,2,"run042"
"8522","RRR","RBB",1,2,3,2,1,"run042"
"8523","RRR","RBR",0,2,2,2,0,"run042"
"8524","RRR","RGG",0,1,1,0,1,"run042"
"8525","RRR","RGR",1,2,3,2,1,"run042"
"8526","RRR","RRG",2,2,4,3,1,"run042"
"8527","BBB","BRB",0,1,1,1,0,"run043"
"8528","BBB","GGG",1,2,3,3,0,"run043"
"8529","BBB","GRR",0,2,2,0,2,"run043"
"8530","BBB","RBG",0,1,1,1,0,"run043"
"8531","BBB","RRG",1,3,4,4,0,"run043"
"8532","BBB","RRR",0,2,2,1,1,"run043"
"8533","BBG","BBB",1,4,5,4,1,"run043"
"8534","BBG","BGB",0,1,1,0,1,"run043"
"8535","BBG","BGG",0,1,1,0,1,"run043"
"8536","BBG","BRB",1,16,17,1,16,"run043"
"8537","BBG","GBB",0,1,1,0,1,"run043"
"8538","BBG","GBG",2,7,9,5,4,"run043"
"8539","BBG","GGB",2,25,27,6,21,"run043"
"8540","BBG","GGG",4,38,42,13,29,"run043"
"8541","BBG","GRG",1,9,10,8,2,"run043"
"8542","BBG","GRR",0,1,1,1,0,"run043"
"8543","BBG","RBB",0,1,1,0,1,"run043"
"8544","BBG","RBG",0,4,4,0,4,"run043"
"8545","BBG","RBR",0,1,1,0,1,"run043"
"8546","BBG","RGR",0,1,1,1,0,"run043"
"8547","BBG","RRG",1,2,3,2,1,"run043"
"8548","BBG","RRR",0,7,7,4,3,"run043"
"8549","BGB","BBB",0,2,2,1,1,"run043"
"8550","BGB","RRG",0,1,1,1,0,"run043"
"8551","BGG","BBB",0,3,3,1,2,"run043"
"8552","BGG","BBR",0,1,1,1,0,"run043"
"8553","BGG","GRG",0,1,1,0,1,"run043"
"8554","BGG","RBG",1,1,2,2,0,"run043"
"8555","BGG","RGG",0,3,3,1,2,"run043"
"8556","BGG","RGR",0,1,1,0,1,"run043"
"8557","BGG","RRR",1,1,2,0,2,"run043"
"8558","BRB","BBB",0,13,13,0,13,"run043"
"8559","BRB","BBR",0,1,1,0,1,"run043"
"8560","BRB","BRR",0,3,3,1,2,"run043"
"8561","BRB","GGG",0,1,1,1,0,"run043"
"8562","BRB","GGR",0,1,1,1,0,"run043"
"8563","BRB","RBB",0,1,1,1,0,"run043"
"8564","BRB","RBG",0,1,1,1,0,"run043"
"8565","BRB","RGR",0,1,1,1,0,"run043"
"8566","BRB","RRR",0,1,1,1,0,"run043"
"8567","BRR","BBB",0,11,11,6,5,"run043"
"8568","BRR","BGB",1,1,2,2,0,"run043"
"8569","BRR","BGG",0,1,1,0,1,"run043"
"8570","BRR","BRB",0,1,1,0,1,"run043"
"8571","BRR","RBB",0,2,2,1,1,"run043"
"8572","GBB","BBB",12,38,50,16,34,"run043"
"8573","GBB","BGG",0,1,1,1,0,"run043"
"8574","GBB","BRB",1,9,10,8,2,"run043"
"8575","GBB","BRR",1,3,4,3,1,"run043"
"8576","GBB","GBG",0,4,4,1,3,"run043"
"8577","GBB","GGB",0,21,21,18,3,"run043"
"8578","GBB","GGG",7,86,93,54,39,"run043"
"8579","GBB","GGR",1,3,4,1,3,"run043"
"8580","GBB","GRG",0,6,6,5,1,"run043"
"8581","GBB","GRR",0,1,1,1,0,"run043"
"8582","GBB","RBB",0,2,2,2,0,"run043"
"8583","GBB","RBG",3,9,12,5,7,"run043"
"8584","GBB","RBR",1,0,1,1,0,"run043"
"8585","GBB","RGG",1,0,1,1,0,"run043"
"8586","GBB","RGR",2,1,3,0,3,"run043"
"8587","GBB","RRG",0,2,2,0,2,"run043"
"8588","GBB","RRR",1,9,10,4,6,"run043"
"8589","GBG","BBB",0,5,5,2,3,"run043"
"8590","GBG","BBR",0,1,1,1,0,"run043"
"8591","GBG","BRB",1,4,5,5,0,"run043"
"8592","GBG","BRR",1,0,1,1,0,"run043"
"8593","GBG","GGB",0,4,4,3,1,"run043"
"8594","GBG","GGG",4,11,15,3,12,"run043"
"8595","GBG","RBB",1,0,1,0,1,"run043"
"8596","GBG","RBG",0,1,1,1,0,"run043"
"8597","GBG","RGG",0,1,1,0,1,"run043"
"8598","GBG","RGR",1,3,4,1,3,"run043"
"8599","GBG","RRG",1,3,4,0,4,"run043"
"8600","GGB","BBB",3,16,19,0,19,"run043"
"8601","GGB","BBR",1,4,5,1,4,"run043"
"8602","GGB","BGB",0,3,3,2,1,"run043"
"8603","GGB","BGG",0,4,4,2,2,"run043"
"8604","GGB","BRB",0,1,1,0,1,"run043"
"8605","GGB","BRR",1,15,16,11,5,"run043"
"8606","GGB","GBB",0,1,1,1,0,"run043"
"8607","GGB","GBG",1,0,1,0,1,"run043"
"8608","GGB","GGG",13,48,61,41,20,"run043"
"8609","GGB","GGR",0,7,7,2,5,"run043"
"8610","GGB","GRR",0,4,4,2,2,"run043"
"8611","GGB","RBB",0,5,5,0,5,"run043"
"8612","GGB","RBG",0,4,4,4,0,"run043"
"8613","GGB","RBR",0,5,5,4,1,"run043"
"8614","GGB","RGG",1,5,6,2,4,"run043"
"8615","GGB","RGR",0,2,2,0,2,"run043"
"8616","GGB","RRG",1,5,6,4,2,"run043"
"8617","GGB","RRR",1,5,6,1,5,"run043"
"8618","GGG","BBB",8,31,39,23,16,"run043"
"8619","GGG","BGB",0,2,2,0,2,"run043"
"8620","GGG","BGG",1,7,8,4,4,"run043"
"8621","GGG","BRB",1,3,4,1,3,"run043"
"8622","GGG","BRR",0,6,6,4,2,"run043"
"8623","GGG","GGB",5,1,6,5,1,"run043"
"8624","GGG","GGR",1,9,10,7,3,"run043"
"8625","GGG","GRR",0,2,2,0,2,"run043"
"8626","GGG","RBB",1,8,9,9,0,"run043"
"8627","GGG","RBG",0,6,6,4,2,"run043"
"8628","GGG","RBR",0,21,21,6,15,"run043"
"8629","GGG","RGG",0,3,3,1,2,"run043"
"8630","GGG","RGR",1,12,13,11,2,"run043"
"8631","GGG","RRG",1,23,24,13,11,"run043"
"8632","GGG","RRR",0,3,3,1,2,"run043"
"8633","GGR","BBB",0,2,2,0,2,"run043"
"8634","GGR","BBR",0,2,2,0,2,"run043"
"8635","GGR","BGG",0,1,1,1,0,"run043"
"8636","GGR","BRR",1,0,1,1,0,"run043"
"8637","GGR","GRR",1,0,1,0,1,"run043"
"8638","GGR","RBB",0,2,2,1,1,"run043"
"8639","GRG","BBB",3,8,11,9,2,"run043"
"8640","GRG","BBR",0,1,1,1,0,"run043"
"8641","GRG","BGG",0,1,1,0,1,"run043"
"8642","GRG","BRB",0,3,3,2,1,"run043"
"8643","GRG","BRR",0,1,1,1,0,"run043"
"8644","GRG","GBG",0,1,1,1,0,"run043"
"8645","GRG","GGB",2,15,17,7,10,"run043"
"8646","GRG","GGG",3,12,15,2,13,"run043"
"8647","GRG","GGR",0,5,5,4,1,"run043"
"8648","GRG","GRR",0,1,1,1,0,"run043"
"8649","GRG","RBG",0,1,1,0,1,"run043"
"8650","GRG","RBR",0,1,1,1,0,"run043"
"8651","GRG","RGR",1,2,3,1,2,"run043"
"8652","GRG","RRG",2,4,6,5,1,"run043"
"8653","GRR","BBB",0,1,1,1,0,"run043"
"8654","GRR","BBR",0,1,1,1,0,"run043"
"8655","GRR","BGB",1,2,3,3,0,"run043"
"8656","GRR","BGG",0,2,2,0,2,"run043"
"8657","GRR","BRB",0,1,1,0,1,"run043"
"8658","GRR","BRR",0,2,2,1,1,"run043"
"8659","GRR","GGG",0,1,1,1,0,"run043"
"8660","GRR","GGR",0,1,1,1,0,"run043"
"8661","RBB","BBB",0,1,1,1,0,"run043"
"8662","RBB","BBR",0,1,1,0,1,"run043"
"8663","RBB","BRB",0,1,1,0,1,"run043"
"8664","RBB","GRR",0,1,1,1,0,"run043"
"8665","RBB","RGG",0,1,1,0,1,"run043"
"8666","RBG","BBB",2,8,10,9,1,"run043"
"8667","RBG","BBG",0,1,1,1,0,"run043"
"8668","RBG","BRR",0,1,1,1,0,"run043"
"8669","RBG","GBB",0,1,1,1,0,"run043"
"8670","RBG","GRR",0,3,3,0,3,"run043"
"8671","RBG","RBB",1,1,2,2,0,"run043"
"8672","RBG","RBR",0,1,1,0,1,"run043"
"8673","RBG","RGR",0,1,1,0,1,"run043"
"8674","RBR","BBB",0,13,13,8,5,"run043"
"8675","RBR","BBR",0,1,1,0,1,"run043"
"8676","RBR","BGB",2,4,6,5,1,"run043"
"8677","RBR","BGG",0,2,2,1,1,"run043"
"8678","RBR","BRB",1,0,1,0,1,"run043"
"8679","RBR","BRR",1,4,5,0,5,"run043"
"8680","RBR","GGB",0,12,12,3,9,"run043"
"8681","RBR","GRR",4,4,8,1,7,"run043"
"8682","RBR","RBB",0,3,3,3,0,"run043"
"8683","RBR","RGG",2,9,11,1,10,"run043"
"8684","RBR","RGR",1,0,1,1,0,"run043"
"8685","RBR","RRR",0,1,1,0,1,"run043"
"8686","RGG","BBB",0,8,8,1,7,"run043"
"8687","RGG","BBR",1,2,3,3,0,"run043"
"8688","RGG","BGB",0,1,1,0,1,"run043"
"8689","RGG","BRR",0,4,4,2,2,"run043"
"8690","RGG","GGG",0,1,1,1,0,"run043"
"8691","RGG","GGR",0,3,3,0,3,"run043"
"8692","RGG","GRR",0,8,8,0,8,"run043"
"8693","RGG","RBB",0,1,1,1,0,"run043"
"8694","RGR","BBB",2,5,7,2,5,"run043"
"8695","RGR","BBR",1,1,2,1,1,"run043"
"8696","RGR","BGB",2,5,7,7,0,"run043"
"8697","RGR","BGG",2,2,4,4,0,"run043"
"8698","RGR","BRR",1,5,6,3,3,"run043"
"8699","RGR","GGB",2,12,14,11,3,"run043"
"8700","RGR","GGG",0,2,2,1,1,"run043"
"8701","RGR","GGR",0,4,4,3,1,"run043"
"8702","RGR","RBB",0,4,4,2,2,"run043"
"8703","RGR","RGG",1,1,2,2,0,"run043"
"8704","RGR","RRG",0,3,3,1,2,"run043"
"8705","RRG","BBB",2,33,35,1,34,"run043"
"8706","RRG","BBR",0,5,5,1,4,"run043"
"8707","RRG","BGB",1,10,11,9,2,"run043"
"8708","RRG","BGG",0,2,2,1,1,"run043"
"8709","RRG","BRB",2,40,42,21,21,"run043"
"8710","RRG","BRR",1,16,17,5,12,"run043"
"8711","RRG","GGG",2,14,16,7,9,"run043"
"8712","RRG","GGR",0,5,5,4,1,"run043"
"8713","RRG","GRG",1,0,1,1,0,"run043"
"8714","RRG","GRR",3,8,11,5,6,"run043"
"8715","RRG","RBB",1,1,2,1,1,"run043"
"8716","RRG","RGG",0,1,1,0,1,"run043"
"8717","RRG","RGR",0,1,1,1,0,"run043"
"8718","RRR","BBR",1,0,1,0,1,"run043"
"8719","RRR","BGB",2,1,3,3,0,"run043"
"8720","RRR","BGG",1,0,1,0,1,"run043"
"8721","RRR","BRB",1,1,2,2,0,"run043"
"8722","RRR","BRR",1,1,2,0,2,"run043"
"8723","RRR","GGR",0,1,1,1,0,"run043"
"8724","RRR","GRR",0,3,3,1,2,"run043"
"8725","RRR","RBB",1,2,3,1,2,"run043"
"8726","RRR","RBR",0,2,2,2,0,"run043"
"8727","RRR","RGG",0,1,1,1,0,"run043"
"8728","RRR","RGR",1,2,3,0,3,"run043"
"8729","RRR","RRG",2,2,4,3,1,"run043"
"8730","BBB","BRB",0,1,1,0,1,"run044"
"8731","BBB","GGG",1,2,3,2,1,"run044"
"8732","BBB","GRR",0,2,2,2,0,"run044"
"8733","BBB","RBG",0,1,1,0,1,"run044"
"8734","BBB","RRG",1,3,4,3,1,"run044"
"8735","BBB","RRR",0,2,2,0,2,"run044"
"8736","BBG","BBB",1,4,5,4,1,"run044"
"8737","BBG","BGB",0,1,1,1,0,"run044"
"8738","BBG","BGG",0,1,1,0,1,"run044"
"8739","BBG","BRB",1,16,17,8,9,"run044"
"8740","BBG","GBB",0,1,1,0,1,"run044"
"8741","BBG","GBG",2,7,9,1,8,"run044"
"8742","BBG","GGB",2,25,27,14,13,"run044"
"8743","BBG","GGG",4,38,42,29,13,"run044"
"8744","BBG","GRG",1,9,10,7,3,"run044"
"8745","BBG","GRR",0,1,1,1,0,"run044"
"8746","BBG","RBB",0,1,1,1,0,"run044"
"8747","BBG","RBG",0,4,4,4,0,"run044"
"8748","BBG","RBR",0,1,1,0,1,"run044"
"8749","BBG","RGR",0,1,1,0,1,"run044"
"8750","BBG","RRG",1,2,3,0,3,"run044"
"8751","BBG","RRR",0,7,7,4,3,"run044"
"8752","BGB","BBB",0,2,2,1,1,"run044"
"8753","BGB","RRG",0,1,1,1,0,"run044"
"8754","BGG","BBB",0,3,3,2,1,"run044"
"8755","BGG","BBR",0,1,1,1,0,"run044"
"8756","BGG","GRG",0,1,1,0,1,"run044"
"8757","BGG","RBG",1,1,2,0,2,"run044"
"8758","BGG","RGG",0,3,3,1,2,"run044"
"8759","BGG","RGR",0,1,1,0,1,"run044"
"8760","BGG","RRR",1,1,2,0,2,"run044"
"8761","BRB","BBB",0,13,13,7,6,"run044"
"8762","BRB","BBR",0,1,1,0,1,"run044"
"8763","BRB","BRR",0,3,3,1,2,"run044"
"8764","BRB","GGG",0,1,1,0,1,"run044"
"8765","BRB","GGR",0,1,1,1,0,"run044"
"8766","BRB","RBB",0,1,1,0,1,"run044"
"8767","BRB","RBG",0,1,1,0,1,"run044"
"8768","BRB","RGR",0,1,1,0,1,"run044"
"8769","BRB","RRR",0,1,1,0,1,"run044"
"8770","BRR","BBB",0,11,11,4,7,"run044"
"8771","BRR","BGB",1,1,2,2,0,"run044"
"8772","BRR","BGG",0,1,1,1,0,"run044"
"8773","BRR","BRB",0,1,1,0,1,"run044"
"8774","BRR","RBB",0,2,2,1,1,"run044"
"8775","GBB","BBB",12,38,50,37,13,"run044"
"8776","GBB","BGG",0,1,1,0,1,"run044"
"8777","GBB","BRB",1,9,10,1,9,"run044"
"8778","GBB","BRR",1,3,4,2,2,"run044"
"8779","GBB","GBG",0,4,4,0,4,"run044"
"8780","GBB","GGB",0,21,21,4,17,"run044"
"8781","GBB","GGG",7,86,93,31,62,"run044"
"8782","GBB","GGR",1,3,4,4,0,"run044"
"8783","GBB","GRG",0,6,6,1,5,"run044"
"8784","GBB","GRR",0,1,1,1,0,"run044"
"8785","GBB","RBB",0,2,2,2,0,"run044"
"8786","GBB","RBG",3,9,12,11,1,"run044"
"8787","GBB","RBR",1,0,1,1,0,"run044"
"8788","GBB","RGG",1,0,1,1,0,"run044"
"8789","GBB","RGR",2,1,3,3,0,"run044"
"8790","GBB","RRG",0,2,2,1,1,"run044"
"8791","GBB","RRR",1,9,10,4,6,"run044"
"8792","GBG","BBB",0,5,5,2,3,"run044"
"8793","GBG","BBR",0,1,1,1,0,"run044"
"8794","GBG","BRB",1,4,5,1,4,"run044"
"8795","GBG","BRR",1,0,1,0,1,"run044"
"8796","GBG","GGB",0,4,4,0,4,"run044"
"8797","GBG","GGG",4,11,15,2,13,"run044"
"8798","GBG","RBB",1,0,1,1,0,"run044"
"8799","GBG","RBG",0,1,1,1,0,"run044"
"8800","GBG","RGG",0,1,1,0,1,"run044"
"8801","GBG","RGR",1,3,4,1,3,"run044"
"8802","GBG","RRG",1,3,4,2,2,"run044"
"8803","GGB","BBB",3,16,19,19,0,"run044"
"8804","GGB","BBR",1,4,5,1,4,"run044"
"8805","GGB","BGB",0,3,3,3,0,"run044"
"8806","GGB","BGG",0,4,4,2,2,"run044"
"8807","GGB","BRB",0,1,1,0,1,"run044"
"8808","GGB","BRR",1,15,16,7,9,"run044"
"8809","GGB","GBB",0,1,1,1,0,"run044"
"8810","GGB","GBG",1,0,1,0,1,"run044"
"8811","GGB","GGG",13,48,61,2,59,"run044"
"8812","GGB","GGR",0,7,7,6,1,"run044"
"8813","GGB","GRR",0,4,4,4,0,"run044"
"8814","GGB","RBB",0,5,5,4,1,"run044"
"8815","GGB","RBG",0,4,4,0,4,"run044"
"8816","GGB","RBR",0,5,5,3,2,"run044"
"8817","GGB","RGG",1,5,6,3,3,"run044"
"8818","GGB","RGR",0,2,2,0,2,"run044"
"8819","GGB","RRG",1,5,6,1,5,"run044"
"8820","GGB","RRR",1,5,6,5,1,"run044"
"8821","GGG","BBB",8,31,39,9,30,"run044"
"8822","GGG","BGB",0,2,2,2,0,"run044"
"8823","GGG","BGG",1,7,8,2,6,"run044"
"8824","GGG","BRB",1,3,4,3,1,"run044"
"8825","GGG","BRR",0,6,6,0,6,"run044"
"8826","GGG","GGB",5,1,6,5,1,"run044"
"8827","GGG","GGR",1,9,10,6,4,"run044"
"8828","GGG","GRR",0,2,2,0,2,"run044"
"8829","GGG","RBB",1,8,9,8,1,"run044"
"8830","GGG","RBG",0,6,6,2,4,"run044"
"8831","GGG","RBR",0,21,21,21,0,"run044"
"8832","GGG","RGG",0,3,3,0,3,"run044"
"8833","GGG","RGR",1,12,13,7,6,"run044"
"8834","GGG","RRG",1,23,24,15,9,"run044"
"8835","GGG","RRR",0,3,3,3,0,"run044"
"8836","GGR","BBB",0,2,2,2,0,"run044"
"8837","GGR","BBR",0,2,2,0,2,"run044"
"8838","GGR","BGG",0,1,1,1,0,"run044"
"8839","GGR","BRR",1,0,1,0,1,"run044"
"8840","GGR","GRR",1,0,1,1,0,"run044"
"8841","GGR","RBB",0,2,2,2,0,"run044"
"8842","GRG","BBB",3,8,11,0,11,"run044"
"8843","GRG","BBR",0,1,1,0,1,"run044"
"8844","GRG","BGG",0,1,1,0,1,"run044"
"8845","GRG","BRB",0,3,3,0,3,"run044"
"8846","GRG","BRR",0,1,1,1,0,"run044"
"8847","GRG","GBG",0,1,1,1,0,"run044"
"8848","GRG","GGB",2,15,17,6,11,"run044"
"8849","GRG","GGG",3,12,15,10,5,"run044"
"8850","GRG","GGR",0,5,5,2,3,"run044"
"8851","GRG","GRR",0,1,1,0,1,"run044"
"8852","GRG","RBG",0,1,1,1,0,"run044"
"8853","GRG","RBR",0,1,1,1,0,"run044"
"8854","GRG","RGR",1,2,3,3,0,"run044"
"8855","GRG","RRG",2,4,6,2,4,"run044"
"8856","GRR","BBB",0,1,1,1,0,"run044"
"8857","GRR","BBR",0,1,1,0,1,"run044"
"8858","GRR","BGB",1,2,3,2,1,"run044"
"8859","GRR","BGG",0,2,2,0,2,"run044"
"8860","GRR","BRB",0,1,1,0,1,"run044"
"8861","GRR","BRR",0,2,2,0,2,"run044"
"8862","GRR","GGG",0,1,1,1,0,"run044"
"8863","GRR","GGR",0,1,1,1,0,"run044"
"8864","RBB","BBB",0,1,1,0,1,"run044"
"8865","RBB","BBR",0,1,1,0,1,"run044"
"8866","RBB","BRB",0,1,1,1,0,"run044"
"8867","RBB","GRR",0,1,1,1,0,"run044"
"8868","RBB","RGG",0,1,1,1,0,"run044"
"8869","RBG","BBB",2,8,10,1,9,"run044"
"8870","RBG","BBG",0,1,1,1,0,"run044"
"8871","RBG","BRR",0,1,1,0,1,"run044"
"8872","RBG","GBB",0,1,1,1,0,"run044"
"8873","RBG","GRR",0,3,3,1,2,"run044"
"8874","RBG","RBB",1,1,2,1,1,"run044"
"8875","RBG","RBR",0,1,1,1,0,"run044"
"8876","RBG","RGR",0,1,1,1,0,"run044"
"8877","RBR","BBB",0,13,13,1,12,"run044"
"8878","RBR","BBR",0,1,1,1,0,"run044"
"8879","RBR","BGB",2,4,6,2,4,"run044"
"8880","RBR","BGG",0,2,2,1,1,"run044"
"8881","RBR","BRB",1,0,1,0,1,"run044"
"8882","RBR","BRR",1,4,5,3,2,"run044"
"8883","RBR","GGB",0,12,12,9,3,"run044"
"8884","RBR","GRR",4,4,8,7,1,"run044"
"8885","RBR","RBB",0,3,3,2,1,"run044"
"8886","RBR","RGG",2,9,11,6,5,"run044"
"8887","RBR","RGR",1,0,1,0,1,"run044"
"8888","RBR","RRR",0,1,1,1,0,"run044"
"8889","RGG","BBB",0,8,8,0,8,"run044"
"8890","RGG","BBR",1,2,3,3,0,"run044"
"8891","RGG","BGB",0,1,1,0,1,"run044"
"8892","RGG","BRR",0,4,4,1,3,"run044"
"8893","RGG","GGG",0,1,1,1,0,"run044"
"8894","RGG","GGR",0,3,3,0,3,"run044"
"8895","RGG","GRR",0,8,8,3,5,"run044"
"8896","RGG","RBB",0,1,1,0,1,"run044"
"8897","RGR","BBB",2,5,7,5,2,"run044"
"8898","RGR","BBR",1,1,2,1,1,"run044"
"8899","RGR","BGB",2,5,7,5,2,"run044"
"8900","RGR","BGG",2,2,4,0,4,"run044"
"8901","RGR","BRR",1,5,6,4,2,"run044"
"8902","RGR","GGB",2,12,14,1,13,"run044"
"8903","RGR","GGG",0,2,2,1,1,"run044"
"8904","RGR","GGR",0,4,4,4,0,"run044"
"8905","RGR","RBB",0,4,4,2,2,"run044"
"8906","RGR","RGG",1,1,2,1,1,"run044"
"8907","RGR","RRG",0,3,3,0,3,"run044"
"8908","RRG","BBB",2,33,35,22,13,"run044"
"8909","RRG","BBR",0,5,5,4,1,"run044"
"8910","RRG","BGB",1,10,11,10,1,"run044"
"8911","RRG","BGG",0,2,2,2,0,"run044"
"8912","RRG","BRB",2,40,42,23,19,"run044"
"8913","RRG","BRR",1,16,17,3,14,"run044"
"8914","RRG","GGG",2,14,16,0,16,"run044"
"8915","RRG","GGR",0,5,5,4,1,"run044"
"8916","RRG","GRG",1,0,1,0,1,"run044"
"8917","RRG","GRR",3,8,11,7,4,"run044"
"8918","RRG","RBB",1,1,2,2,0,"run044"
"8919","RRG","RGG",0,1,1,0,1,"run044"
"8920","RRG","RGR",0,1,1,1,0,"run044"
"8921","RRR","BBR",1,0,1,1,0,"run044"
"8922","RRR","BGB",2,1,3,2,1,"run044"
"8923","RRR","BGG",1,0,1,0,1,"run044"
"8924","RRR","BRB",1,1,2,0,2,"run044"
"8925","RRR","BRR",1,1,2,2,0,"run044"
"8926","RRR","GGR",0,1,1,1,0,"run044"
"8927","RRR","GRR",0,3,3,1,2,"run044"
"8928","RRR","RBB",1,2,3,3,0,"run044"
"8929","RRR","RBR",0,2,2,2,0,"run044"
"8930","RRR","RGG",0,1,1,0,1,"run044"
"8931","RRR","RGR",1,2,3,3,0,"run044"
"8932","RRR","RRG",2,2,4,1,3,"run044"
"8933","BBB","BRB",0,1,1,0,1,"run045"
"8934","BBB","GGG",1,2,3,2,1,"run045"
"8935","BBB","GRR",0,2,2,1,1,"run045"
"8936","BBB","RBG",0,1,1,1,0,"run045"
"8937","BBB","RRG",1,3,4,1,3,"run045"
"8938","BBB","RRR",0,2,2,2,0,"run045"
"8939","BBG","BBB",1,4,5,2,3,"run045"
"8940","BBG","BGB",0,1,1,1,0,"run045"
"8941","BBG","BGG",0,1,1,0,1,"run045"
"8942","BBG","BRB",1,16,17,15,2,"run045"
"8943","BBG","GBB",0,1,1,0,1,"run045"
"8944","BBG","GBG",2,7,9,5,4,"run045"
"8945","BBG","GGB",2,25,27,3,24,"run045"
"8946","BBG","GGG",4,38,42,27,15,"run045"
"8947","BBG","GRG",1,9,10,0,10,"run045"
"8948","BBG","GRR",0,1,1,0,1,"run045"
"8949","BBG","RBB",0,1,1,0,1,"run045"
"8950","BBG","RBG",0,4,4,3,1,"run045"
"8951","BBG","RBR",0,1,1,1,0,"run045"
"8952","BBG","RGR",0,1,1,0,1,"run045"
"8953","BBG","RRG",1,2,3,1,2,"run045"
"8954","BBG","RRR",0,7,7,7,0,"run045"
"8955","BGB","BBB",0,2,2,0,2,"run045"
"8956","BGB","RRG",0,1,1,1,0,"run045"
"8957","BGG","BBB",0,3,3,3,0,"run045"
"8958","BGG","BBR",0,1,1,0,1,"run045"
"8959","BGG","GRG",0,1,1,0,1,"run045"
"8960","BGG","RBG",1,1,2,1,1,"run045"
"8961","BGG","RGG",0,3,3,2,1,"run045"
"8962","BGG","RGR",0,1,1,1,0,"run045"
"8963","BGG","RRR",1,1,2,0,2,"run045"
"8964","BRB","BBB",0,13,13,13,0,"run045"
"8965","BRB","BBR",0,1,1,0,1,"run045"
"8966","BRB","BRR",0,3,3,1,2,"run045"
"8967","BRB","GGG",0,1,1,1,0,"run045"
"8968","BRB","GGR",0,1,1,0,1,"run045"
"8969","BRB","RBB",0,1,1,0,1,"run045"
"8970","BRB","RBG",0,1,1,1,0,"run045"
"8971","BRB","RGR",0,1,1,1,0,"run045"
"8972","BRB","RRR",0,1,1,0,1,"run045"
"8973","BRR","BBB",0,11,11,1,10,"run045"
"8974","BRR","BGB",1,1,2,0,2,"run045"
"8975","BRR","BGG",0,1,1,0,1,"run045"
"8976","BRR","BRB",0,1,1,0,1,"run045"
"8977","BRR","RBB",0,2,2,1,1,"run045"
"8978","GBB","BBB",12,38,50,45,5,"run045"
"8979","GBB","BGG",0,1,1,1,0,"run045"
"8980","GBB","BRB",1,9,10,7,3,"run045"
"8981","GBB","BRR",1,3,4,0,4,"run045"
"8982","GBB","GBG",0,4,4,1,3,"run045"
"8983","GBB","GGB",0,21,21,10,11,"run045"
"8984","GBB","GGG",7,86,93,85,8,"run045"
"8985","GBB","GGR",1,3,4,0,4,"run045"
"8986","GBB","GRG",0,6,6,5,1,"run045"
"8987","GBB","GRR",0,1,1,0,1,"run045"
"8988","GBB","RBB",0,2,2,2,0,"run045"
"8989","GBB","RBG",3,9,12,10,2,"run045"
"8990","GBB","RBR",1,0,1,1,0,"run045"
"8991","GBB","RGG",1,0,1,0,1,"run045"
"8992","GBB","RGR",2,1,3,1,2,"run045"
"8993","GBB","RRG",0,2,2,1,1,"run045"
"8994","GBB","RRR",1,9,10,2,8,"run045"
"8995","GBG","BBB",0,5,5,0,5,"run045"
"8996","GBG","BBR",0,1,1,0,1,"run045"
"8997","GBG","BRB",1,4,5,3,2,"run045"
"8998","GBG","BRR",1,0,1,0,1,"run045"
"8999","GBG","GGB",0,4,4,3,1,"run045"
"9000","GBG","GGG",4,11,15,15,0,"run045"
"9001","GBG","RBB",1,0,1,0,1,"run045"
"9002","GBG","RBG",0,1,1,1,0,"run045"
"9003","GBG","RGG",0,1,1,0,1,"run045"
"9004","GBG","RGR",1,3,4,2,2,"run045"
"9005","GBG","RRG",1,3,4,1,3,"run045"
"9006","GGB","BBB",3,16,19,6,13,"run045"
"9007","GGB","BBR",1,4,5,5,0,"run045"
"9008","GGB","BGB",0,3,3,0,3,"run045"
"9009","GGB","BGG",0,4,4,0,4,"run045"
"9010","GGB","BRB",0,1,1,0,1,"run045"
"9011","GGB","BRR",1,15,16,14,2,"run045"
"9012","GGB","GBB",0,1,1,1,0,"run045"
"9013","GGB","GBG",1,0,1,0,1,"run045"
"9014","GGB","GGG",13,48,61,11,50,"run045"
"9015","GGB","GGR",0,7,7,0,7,"run045"
"9016","GGB","GRR",0,4,4,1,3,"run045"
"9017","GGB","RBB",0,5,5,5,0,"run045"
"9018","GGB","RBG",0,4,4,0,4,"run045"
"9019","GGB","RBR",0,5,5,4,1,"run045"
"9020","GGB","RGG",1,5,6,5,1,"run045"
"9021","GGB","RGR",0,2,2,1,1,"run045"
"9022","GGB","RRG",1,5,6,4,2,"run045"
"9023","GGB","RRR",1,5,6,6,0,"run045"
"9024","GGG","BBB",8,31,39,32,7,"run045"
"9025","GGG","BGB",0,2,2,1,1,"run045"
"9026","GGG","BGG",1,7,8,2,6,"run045"
"9027","GGG","BRB",1,3,4,2,2,"run045"
"9028","GGG","BRR",0,6,6,1,5,"run045"
"9029","GGG","GGB",5,1,6,0,6,"run045"
"9030","GGG","GGR",1,9,10,9,1,"run045"
"9031","GGG","GRR",0,2,2,2,0,"run045"
"9032","GGG","RBB",1,8,9,4,5,"run045"
"9033","GGG","RBG",0,6,6,0,6,"run045"
"9034","GGG","RBR",0,21,21,15,6,"run045"
"9035","GGG","RGG",0,3,3,1,2,"run045"
"9036","GGG","RGR",1,12,13,4,9,"run045"
"9037","GGG","RRG",1,23,24,7,17,"run045"
"9038","GGG","RRR",0,3,3,3,0,"run045"
"9039","GGR","BBB",0,2,2,0,2,"run045"
"9040","GGR","BBR",0,2,2,1,1,"run045"
"9041","GGR","BGG",0,1,1,1,0,"run045"
"9042","GGR","BRR",1,0,1,0,1,"run045"
"9043","GGR","GRR",1,0,1,0,1,"run045"
"9044","GGR","RBB",0,2,2,0,2,"run045"
"9045","GRG","BBB",3,8,11,2,9,"run045"
"9046","GRG","BBR",0,1,1,0,1,"run045"
"9047","GRG","BGG",0,1,1,0,1,"run045"
"9048","GRG","BRB",0,3,3,0,3,"run045"
"9049","GRG","BRR",0,1,1,1,0,"run045"
"9050","GRG","GBG",0,1,1,0,1,"run045"
"9051","GRG","GGB",2,15,17,16,1,"run045"
"9052","GRG","GGG",3,12,15,12,3,"run045"
"9053","GRG","GGR",0,5,5,5,0,"run045"
"9054","GRG","GRR",0,1,1,0,1,"run045"
"9055","GRG","RBG",0,1,1,0,1,"run045"
"9056","GRG","RBR",0,1,1,0,1,"run045"
"9057","GRG","RGR",1,2,3,3,0,"run045"
"9058","GRG","RRG",2,4,6,4,2,"run045"
"9059","GRR","BBB",0,1,1,1,0,"run045"
"9060","GRR","BBR",0,1,1,0,1,"run045"
"9061","GRR","BGB",1,2,3,0,3,"run045"
"9062","GRR","BGG",0,2,2,1,1,"run045"
"9063","GRR","BRB",0,1,1,0,1,"run045"
"9064","GRR","BRR",0,2,2,2,0,"run045"
"9065","GRR","GGG",0,1,1,0,1,"run045"
"9066","GRR","GGR",0,1,1,0,1,"run045"
"9067","RBB","BBB",0,1,1,0,1,"run045"
"9068","RBB","BBR",0,1,1,1,0,"run045"
"9069","RBB","BRB",0,1,1,0,1,"run045"
"9070","RBB","GRR",0,1,1,1,0,"run045"
"9071","RBB","RGG",0,1,1,0,1,"run045"
"9072","RBG","BBB",2,8,10,2,8,"run045"
"9073","RBG","BBG",0,1,1,0,1,"run045"
"9074","RBG","BRR",0,1,1,1,0,"run045"
"9075","RBG","GBB",0,1,1,1,0,"run045"
"9076","RBG","GRR",0,3,3,0,3,"run045"
"9077","RBG","RBB",1,1,2,2,0,"run045"
"9078","RBG","RBR",0,1,1,1,0,"run045"
"9079","RBG","RGR",0,1,1,0,1,"run045"
"9080","RBR","BBB",0,13,13,5,8,"run045"
"9081","RBR","BBR",0,1,1,1,0,"run045"
"9082","RBR","BGB",2,4,6,0,6,"run045"
"9083","RBR","BGG",0,2,2,2,0,"run045"
"9084","RBR","BRB",1,0,1,1,0,"run045"
"9085","RBR","BRR",1,4,5,1,4,"run045"
"9086","RBR","GGB",0,12,12,2,10,"run045"
"9087","RBR","GRR",4,4,8,3,5,"run045"
"9088","RBR","RBB",0,3,3,1,2,"run045"
"9089","RBR","RGG",2,9,11,1,10,"run045"
"9090","RBR","RGR",1,0,1,0,1,"run045"
"9091","RBR","RRR",0,1,1,0,1,"run045"
"9092","RGG","BBB",0,8,8,0,8,"run045"
"9093","RGG","BBR",1,2,3,3,0,"run045"
"9094","RGG","BGB",0,1,1,0,1,"run045"
"9095","RGG","BRR",0,4,4,2,2,"run045"
"9096","RGG","GGG",0,1,1,1,0,"run045"
"9097","RGG","GGR",0,3,3,1,2,"run045"
"9098","RGG","GRR",0,8,8,1,7,"run045"
"9099","RGG","RBB",0,1,1,0,1,"run045"
"9100","RGR","BBB",2,5,7,0,7,"run045"
"9101","RGR","BBR",1,1,2,0,2,"run045"
"9102","RGR","BGB",2,5,7,7,0,"run045"
"9103","RGR","BGG",2,2,4,4,0,"run045"
"9104","RGR","BRR",1,5,6,4,2,"run045"
"9105","RGR","GGB",2,12,14,10,4,"run045"
"9106","RGR","GGG",0,2,2,2,0,"run045"
"9107","RGR","GGR",0,4,4,4,0,"run045"
"9108","RGR","RBB",0,4,4,1,3,"run045"
"9109","RGR","RGG",1,1,2,1,1,"run045"
"9110","RGR","RRG",0,3,3,1,2,"run045"
"9111","RRG","BBB",2,33,35,6,29,"run045"
"9112","RRG","BBR",0,5,5,4,1,"run045"
"9113","RRG","BGB",1,10,11,9,2,"run045"
"9114","RRG","BGG",0,2,2,1,1,"run045"
"9115","RRG","BRB",2,40,42,41,1,"run045"
"9116","RRG","BRR",1,16,17,0,17,"run045"
"9117","RRG","GGG",2,14,16,5,11,"run045"
"9118","RRG","GGR",0,5,5,1,4,"run045"
"9119","RRG","GRG",1,0,1,0,1,"run045"
"9120","RRG","GRR",3,8,11,6,5,"run045"
"9121","RRG","RBB",1,1,2,0,2,"run045"
"9122","RRG","RGG",0,1,1,0,1,"run045"
"9123","RRG","RGR",0,1,1,0,1,"run045"
"9124","RRR","BBR",1,0,1,0,1,"run045"
"9125","RRR","BGB",2,1,3,2,1,"run045"
"9126","RRR","BGG",1,0,1,1,0,"run045"
"9127","RRR","BRB",1,1,2,0,2,"run045"
"9128","RRR","BRR",1,1,2,2,0,"run045"
"9129","RRR","GGR",0,1,1,0,1,"run045"
"9130","RRR","GRR",0,3,3,0,3,"run045"
"9131","RRR","RBB",1,2,3,3,0,"run045"
"9132","RRR","RBR",0,2,2,0,2,"run045"
"9133","RRR","RGG",0,1,1,0,1,"run045"
"9134","RRR","RGR",1,2,3,3,0,"run045"
"9135","RRR","RRG",2,2,4,1,3,"run045"
"9136","BBB","BRB",0,1,1,1,0,"run046"
"9137","BBB","GGG",1,2,3,1,2,"run046"
"9138","BBB","GRR",0,2,2,0,2,"run046"
"9139","BBB","RBG",0,1,1,1,0,"run046"
"9140","BBB","RRG",1,3,4,3,1,"run046"
"9141","BBB","RRR",0,2,2,1,1,"run046"
"9142","BBG","BBB",1,4,5,0,5,"run046"
"9143","BBG","BGB",0,1,1,0,1,"run046"
"9144","BBG","BGG",0,1,1,1,0,"run046"
"9145","BBG","BRB",1,16,17,13,4,"run046"
"9146","BBG","GBB",0,1,1,0,1,"run046"
"9147","BBG","GBG",2,7,9,6,3,"run046"
"9148","BBG","GGB",2,25,27,26,1,"run046"
"9149","BBG","GGG",4,38,42,11,31,"run046"
"9150","BBG","GRG",1,9,10,3,7,"run046"
"9151","BBG","GRR",0,1,1,1,0,"run046"
"9152","BBG","RBB",0,1,1,1,0,"run046"
"9153","BBG","RBG",0,4,4,2,2,"run046"
"9154","BBG","RBR",0,1,1,1,0,"run046"
"9155","BBG","RGR",0,1,1,0,1,"run046"
"9156","BBG","RRG",1,2,3,2,1,"run046"
"9157","BBG","RRR",0,7,7,7,0,"run046"
"9158","BGB","BBB",0,2,2,2,0,"run046"
"9159","BGB","RRG",0,1,1,0,1,"run046"
"9160","BGG","BBB",0,3,3,2,1,"run046"
"9161","BGG","BBR",0,1,1,0,1,"run046"
"9162","BGG","GRG",0,1,1,1,0,"run046"
"9163","BGG","RBG",1,1,2,1,1,"run046"
"9164","BGG","RGG",0,3,3,2,1,"run046"
"9165","BGG","RGR",0,1,1,1,0,"run046"
"9166","BGG","RRR",1,1,2,2,0,"run046"
"9167","BRB","BBB",0,13,13,6,7,"run046"
"9168","BRB","BBR",0,1,1,1,0,"run046"
"9169","BRB","BRR",0,3,3,0,3,"run046"
"9170","BRB","GGG",0,1,1,0,1,"run046"
"9171","BRB","GGR",0,1,1,0,1,"run046"
"9172","BRB","RBB",0,1,1,0,1,"run046"
"9173","BRB","RBG",0,1,1,1,0,"run046"
"9174","BRB","RGR",0,1,1,0,1,"run046"
"9175","BRB","RRR",0,1,1,0,1,"run046"
"9176","BRR","BBB",0,11,11,5,6,"run046"
"9177","BRR","BGB",1,1,2,2,0,"run046"
"9178","BRR","BGG",0,1,1,0,1,"run046"
"9179","BRR","BRB",0,1,1,0,1,"run046"
"9180","BRR","RBB",0,2,2,2,0,"run046"
"9181","GBB","BBB",12,38,50,32,18,"run046"
"9182","GBB","BGG",0,1,1,0,1,"run046"
"9183","GBB","BRB",1,9,10,9,1,"run046"
"9184","GBB","BRR",1,3,4,2,2,"run046"
"9185","GBB","GBG",0,4,4,4,0,"run046"
"9186","GBB","GGB",0,21,21,9,12,"run046"
"9187","GBB","GGG",7,86,93,76,17,"run046"
"9188","GBB","GGR",1,3,4,3,1,"run046"
"9189","GBB","GRG",0,6,6,0,6,"run046"
"9190","GBB","GRR",0,1,1,1,0,"run046"
"9191","GBB","RBB",0,2,2,2,0,"run046"
"9192","GBB","RBG",3,9,12,0,12,"run046"
"9193","GBB","RBR",1,0,1,1,0,"run046"
"9194","GBB","RGG",1,0,1,0,1,"run046"
"9195","GBB","RGR",2,1,3,1,2,"run046"
"9196","GBB","RRG",0,2,2,2,0,"run046"
"9197","GBB","RRR",1,9,10,6,4,"run046"
"9198","GBG","BBB",0,5,5,3,2,"run046"
"9199","GBG","BBR",0,1,1,1,0,"run046"
"9200","GBG","BRB",1,4,5,2,3,"run046"
"9201","GBG","BRR",1,0,1,1,0,"run046"
"9202","GBG","GGB",0,4,4,2,2,"run046"
"9203","GBG","GGG",4,11,15,10,5,"run046"
"9204","GBG","RBB",1,0,1,1,0,"run046"
"9205","GBG","RBG",0,1,1,1,0,"run046"
"9206","GBG","RGG",0,1,1,0,1,"run046"
"9207","GBG","RGR",1,3,4,4,0,"run046"
"9208","GBG","RRG",1,3,4,3,1,"run046"
"9209","GGB","BBB",3,16,19,13,6,"run046"
"9210","GGB","BBR",1,4,5,3,2,"run046"
"9211","GGB","BGB",0,3,3,0,3,"run046"
"9212","GGB","BGG",0,4,4,3,1,"run046"
"9213","GGB","BRB",0,1,1,0,1,"run046"
"9214","GGB","BRR",1,15,16,2,14,"run046"
"9215","GGB","GBB",0,1,1,0,1,"run046"
"9216","GGB","GBG",1,0,1,0,1,"run046"
"9217","GGB","GGG",13,48,61,3,58,"run046"
"9218","GGB","GGR",0,7,7,6,1,"run046"
"9219","GGB","GRR",0,4,4,2,2,"run046"
"9220","GGB","RBB",0,5,5,4,1,"run046"
"9221","GGB","RBG",0,4,4,2,2,"run046"
"9222","GGB","RBR",0,5,5,5,0,"run046"
"9223","GGB","RGG",1,5,6,6,0,"run046"
"9224","GGB","RGR",0,2,2,0,2,"run046"
"9225","GGB","RRG",1,5,6,5,1,"run046"
"9226","GGB","RRR",1,5,6,4,2,"run046"
"9227","GGG","BBB",8,31,39,31,8,"run046"
"9228","GGG","BGB",0,2,2,1,1,"run046"
"9229","GGG","BGG",1,7,8,0,8,"run046"
"9230","GGG","BRB",1,3,4,0,4,"run046"
"9231","GGG","BRR",0,6,6,3,3,"run046"
"9232","GGG","GGB",5,1,6,1,5,"run046"
"9233","GGG","GGR",1,9,10,10,0,"run046"
"9234","GGG","GRR",0,2,2,0,2,"run046"
"9235","GGG","RBB",1,8,9,1,8,"run046"
"9236","GGG","RBG",0,6,6,1,5,"run046"
"9237","GGG","RBR",0,21,21,10,11,"run046"
"9238","GGG","RGG",0,3,3,0,3,"run046"
"9239","GGG","RGR",1,12,13,0,13,"run046"
"9240","GGG","RRG",1,23,24,8,16,"run046"
"9241","GGG","RRR",0,3,3,3,0,"run046"
"9242","GGR","BBB",0,2,2,2,0,"run046"
"9243","GGR","BBR",0,2,2,1,1,"run046"
"9244","GGR","BGG",0,1,1,1,0,"run046"
"9245","GGR","BRR",1,0,1,0,1,"run046"
"9246","GGR","GRR",1,0,1,0,1,"run046"
"9247","GGR","RBB",0,2,2,1,1,"run046"
"9248","GRG","BBB",3,8,11,9,2,"run046"
"9249","GRG","BBR",0,1,1,1,0,"run046"
"9250","GRG","BGG",0,1,1,1,0,"run046"
"9251","GRG","BRB",0,3,3,3,0,"run046"
"9252","GRG","BRR",0,1,1,1,0,"run046"
"9253","GRG","GBG",0,1,1,1,0,"run046"
"9254","GRG","GGB",2,15,17,7,10,"run046"
"9255","GRG","GGG",3,12,15,7,8,"run046"
"9256","GRG","GGR",0,5,5,4,1,"run046"
"9257","GRG","GRR",0,1,1,1,0,"run046"
"9258","GRG","RBG",0,1,1,1,0,"run046"
"9259","GRG","RBR",0,1,1,0,1,"run046"
"9260","GRG","RGR",1,2,3,3,0,"run046"
"9261","GRG","RRG",2,4,6,2,4,"run046"
"9262","GRR","BBB",0,1,1,1,0,"run046"
"9263","GRR","BBR",0,1,1,0,1,"run046"
"9264","GRR","BGB",1,2,3,2,1,"run046"
"9265","GRR","BGG",0,2,2,2,0,"run046"
"9266","GRR","BRB",0,1,1,0,1,"run046"
"9267","GRR","BRR",0,2,2,1,1,"run046"
"9268","GRR","GGG",0,1,1,0,1,"run046"
"9269","GRR","GGR",0,1,1,0,1,"run046"
"9270","RBB","BBB",0,1,1,0,1,"run046"
"9271","RBB","BBR",0,1,1,1,0,"run046"
"9272","RBB","BRB",0,1,1,0,1,"run046"
"9273","RBB","GRR",0,1,1,0,1,"run046"
"9274","RBB","RGG",0,1,1,1,0,"run046"
"9275","RBG","BBB",2,8,10,0,10,"run046"
"9276","RBG","BBG",0,1,1,1,0,"run046"
"9277","RBG","BRR",0,1,1,0,1,"run046"
"9278","RBG","GBB",0,1,1,1,0,"run046"
"9279","RBG","GRR",0,3,3,1,2,"run046"
"9280","RBG","RBB",1,1,2,0,2,"run046"
"9281","RBG","RBR",0,1,1,0,1,"run046"
"9282","RBG","RGR",0,1,1,0,1,"run046"
"9283","RBR","BBB",0,13,13,3,10,"run046"
"9284","RBR","BBR",0,1,1,0,1,"run046"
"9285","RBR","BGB",2,4,6,0,6,"run046"
"9286","RBR","BGG",0,2,2,2,0,"run046"
"9287","RBR","BRB",1,0,1,1,0,"run046"
"9288","RBR","BRR",1,4,5,0,5,"run046"
"9289","RBR","GGB",0,12,12,12,0,"run046"
"9290","RBR","GRR",4,4,8,1,7,"run046"
"9291","RBR","RBB",0,3,3,1,2,"run046"
"9292","RBR","RGG",2,9,11,6,5,"run046"
"9293","RBR","RGR",1,0,1,0,1,"run046"
"9294","RBR","RRR",0,1,1,0,1,"run046"
"9295","RGG","BBB",0,8,8,8,0,"run046"
"9296","RGG","BBR",1,2,3,3,0,"run046"
"9297","RGG","BGB",0,1,1,0,1,"run046"
"9298","RGG","BRR",0,4,4,4,0,"run046"
"9299","RGG","GGG",0,1,1,0,1,"run046"
"9300","RGG","GGR",0,3,3,0,3,"run046"
"9301","RGG","GRR",0,8,8,3,5,"run046"
"9302","RGG","RBB",0,1,1,0,1,"run046"
"9303","RGR","BBB",2,5,7,4,3,"run046"
"9304","RGR","BBR",1,1,2,2,0,"run046"
"9305","RGR","BGB",2,5,7,2,5,"run046"
"9306","RGR","BGG",2,2,4,1,3,"run046"
"9307","RGR","BRR",1,5,6,6,0,"run046"
"9308","RGR","GGB",2,12,14,8,6,"run046"
"9309","RGR","GGG",0,2,2,1,1,"run046"
"9310","RGR","GGR",0,4,4,0,4,"run046"
"9311","RGR","RBB",0,4,4,2,2,"run046"
"9312","RGR","RGG",1,1,2,2,0,"run046"
"9313","RGR","RRG",0,3,3,1,2,"run046"
"9314","RRG","BBB",2,33,35,5,30,"run046"
"9315","RRG","BBR",0,5,5,0,5,"run046"
"9316","RRG","BGB",1,10,11,5,6,"run046"
"9317","RRG","BGG",0,2,2,0,2,"run046"
"9318","RRG","BRB",2,40,42,29,13,"run046"
"9319","RRG","BRR",1,16,17,10,7,"run046"
"9320","RRG","GGG",2,14,16,13,3,"run046"
"9321","RRG","GGR",0,5,5,1,4,"run046"
"9322","RRG","GRG",1,0,1,0,1,"run046"
"9323","RRG","GRR",3,8,11,4,7,"run046"
"9324","RRG","RBB",1,1,2,1,1,"run046"
"9325","RRG","RGG",0,1,1,1,0,"run046"
"9326","RRG","RGR",0,1,1,1,0,"run046"
"9327","RRR","BBR",1,0,1,0,1,"run046"
"9328","RRR","BGB",2,1,3,2,1,"run046"
"9329","RRR","BGG",1,0,1,0,1,"run046"
"9330","RRR","BRB",1,1,2,2,0,"run046"
"9331","RRR","BRR",1,1,2,1,1,"run046"
"9332","RRR","GGR",0,1,1,1,0,"run046"
"9333","RRR","GRR",0,3,3,1,2,"run046"
"9334","RRR","RBB",1,2,3,1,2,"run046"
"9335","RRR","RBR",0,2,2,0,2,"run046"
"9336","RRR","RGG",0,1,1,1,0,"run046"
"9337","RRR","RGR",1,2,3,2,1,"run046"
"9338","RRR","RRG",2,2,4,2,2,"run046"
"9339","BBB","BRB",0,1,1,0,1,"run047"
"9340","BBB","GGG",1,2,3,0,3,"run047"
"9341","BBB","GRR",0,2,2,1,1,"run047"
"9342","BBB","RBG",0,1,1,0,1,"run047"
"9343","BBB","RRG",1,3,4,3,1,"run047"
"9344","BBB","RRR",0,2,2,0,2,"run047"
"9345","BBG","BBB",1,4,5,1,4,"run047"
"9346","BBG","BGB",0,1,1,0,1,"run047"
"9347","BBG","BGG",0,1,1,0,1,"run047"
"9348","BBG","BRB",1,16,17,5,12,"run047"
"9349","BBG","GBB",0,1,1,0,1,"run047"
"9350","BBG","GBG",2,7,9,5,4,"run047"
"9351","BBG","GGB",2,25,27,5,22,"run047"
"9352","BBG","GGG",4,38,42,11,31,"run047"
"9353","BBG","GRG",1,9,10,7,3,"run047"
"9354","BBG","GRR",0,1,1,1,0,"run047"
"9355","BBG","RBB",0,1,1,0,1,"run047"
"9356","BBG","RBG",0,4,4,4,0,"run047"
"9357","BBG","RBR",0,1,1,1,0,"run047"
"9358","BBG","RGR",0,1,1,0,1,"run047"
"9359","BBG","RRG",1,2,3,2,1,"run047"
"9360","BBG","RRR",0,7,7,3,4,"run047"
"9361","BGB","BBB",0,2,2,0,2,"run047"
"9362","BGB","RRG",0,1,1,0,1,"run047"
"9363","BGG","BBB",0,3,3,1,2,"run047"
"9364","BGG","BBR",0,1,1,0,1,"run047"
"9365","BGG","GRG",0,1,1,1,0,"run047"
"9366","BGG","RBG",1,1,2,0,2,"run047"
"9367","BGG","RGG",0,3,3,3,0,"run047"
"9368","BGG","RGR",0,1,1,0,1,"run047"
"9369","BGG","RRR",1,1,2,1,1,"run047"
"9370","BRB","BBB",0,13,13,10,3,"run047"
"9371","BRB","BBR",0,1,1,0,1,"run047"
"9372","BRB","BRR",0,3,3,1,2,"run047"
"9373","BRB","GGG",0,1,1,1,0,"run047"
"9374","BRB","GGR",0,1,1,0,1,"run047"
"9375","BRB","RBB",0,1,1,0,1,"run047"
"9376","BRB","RBG",0,1,1,1,0,"run047"
"9377","BRB","RGR",0,1,1,0,1,"run047"
"9378","BRB","RRR",0,1,1,0,1,"run047"
"9379","BRR","BBB",0,11,11,4,7,"run047"
"9380","BRR","BGB",1,1,2,0,2,"run047"
"9381","BRR","BGG",0,1,1,0,1,"run047"
"9382","BRR","BRB",0,1,1,1,0,"run047"
"9383","BRR","RBB",0,2,2,1,1,"run047"
"9384","GBB","BBB",12,38,50,41,9,"run047"
"9385","GBB","BGG",0,1,1,0,1,"run047"
"9386","GBB","BRB",1,9,10,10,0,"run047"
"9387","GBB","BRR",1,3,4,4,0,"run047"
"9388","GBB","GBG",0,4,4,2,2,"run047"
"9389","GBB","GGB",0,21,21,10,11,"run047"
"9390","GBB","GGG",7,86,93,79,14,"run047"
"9391","GBB","GGR",1,3,4,4,0,"run047"
"9392","GBB","GRG",0,6,6,2,4,"run047"
"9393","GBB","GRR",0,1,1,0,1,"run047"
"9394","GBB","RBB",0,2,2,1,1,"run047"
"9395","GBB","RBG",3,9,12,12,0,"run047"
"9396","GBB","RBR",1,0,1,1,0,"run047"
"9397","GBB","RGG",1,0,1,1,0,"run047"
"9398","GBB","RGR",2,1,3,2,1,"run047"
"9399","GBB","RRG",0,2,2,0,2,"run047"
"9400","GBB","RRR",1,9,10,1,9,"run047"
"9401","GBG","BBB",0,5,5,5,0,"run047"
"9402","GBG","BBR",0,1,1,1,0,"run047"
"9403","GBG","BRB",1,4,5,2,3,"run047"
"9404","GBG","BRR",1,0,1,0,1,"run047"
"9405","GBG","GGB",0,4,4,1,3,"run047"
"9406","GBG","GGG",4,11,15,14,1,"run047"
"9407","GBG","RBB",1,0,1,0,1,"run047"
"9408","GBG","RBG",0,1,1,1,0,"run047"
"9409","GBG","RGG",0,1,1,1,0,"run047"
"9410","GBG","RGR",1,3,4,3,1,"run047"
"9411","GBG","RRG",1,3,4,2,2,"run047"
"9412","GGB","BBB",3,16,19,0,19,"run047"
"9413","GGB","BBR",1,4,5,5,0,"run047"
"9414","GGB","BGB",0,3,3,2,1,"run047"
"9415","GGB","BGG",0,4,4,4,0,"run047"
"9416","GGB","BRB",0,1,1,0,1,"run047"
"9417","GGB","BRR",1,15,16,11,5,"run047"
"9418","GGB","GBB",0,1,1,0,1,"run047"
"9419","GGB","GBG",1,0,1,1,0,"run047"
"9420","GGB","GGG",13,48,61,26,35,"run047"
"9421","GGB","GGR",0,7,7,5,2,"run047"
"9422","GGB","GRR",0,4,4,4,0,"run047"
"9423","GGB","RBB",0,5,5,2,3,"run047"
"9424","GGB","RBG",0,4,4,2,2,"run047"
"9425","GGB","RBR",0,5,5,4,1,"run047"
"9426","GGB","RGG",1,5,6,3,3,"run047"
"9427","GGB","RGR",0,2,2,2,0,"run047"
"9428","GGB","RRG",1,5,6,2,4,"run047"
"9429","GGB","RRR",1,5,6,1,5,"run047"
"9430","GGG","BBB",8,31,39,0,39,"run047"
"9431","GGG","BGB",0,2,2,2,0,"run047"
"9432","GGG","BGG",1,7,8,7,1,"run047"
"9433","GGG","BRB",1,3,4,3,1,"run047"
"9434","GGG","BRR",0,6,6,0,6,"run047"
"9435","GGG","GGB",5,1,6,2,4,"run047"
"9436","GGG","GGR",1,9,10,8,2,"run047"
"9437","GGG","GRR",0,2,2,2,0,"run047"
"9438","GGG","RBB",1,8,9,6,3,"run047"
"9439","GGG","RBG",0,6,6,2,4,"run047"
"9440","GGG","RBR",0,21,21,3,18,"run047"
"9441","GGG","RGG",0,3,3,3,0,"run047"
"9442","GGG","RGR",1,12,13,8,5,"run047"
"9443","GGG","RRG",1,23,24,15,9,"run047"
"9444","GGG","RRR",0,3,3,1,2,"run047"
"9445","GGR","BBB",0,2,2,0,2,"run047"
"9446","GGR","BBR",0,2,2,0,2,"run047"
"9447","GGR","BGG",0,1,1,0,1,"run047"
"9448","GGR","BRR",1,0,1,0,1,"run047"
"9449","GGR","GRR",1,0,1,1,0,"run047"
"9450","GGR","RBB",0,2,2,0,2,"run047"
"9451","GRG","BBB",3,8,11,11,0,"run047"
"9452","GRG","BBR",0,1,1,1,0,"run047"
"9453","GRG","BGG",0,1,1,1,0,"run047"
"9454","GRG","BRB",0,3,3,2,1,"run047"
"9455","GRG","BRR",0,1,1,0,1,"run047"
"9456","GRG","GBG",0,1,1,1,0,"run047"
"9457","GRG","GGB",2,15,17,8,9,"run047"
"9458","GRG","GGG",3,12,15,1,14,"run047"
"9459","GRG","GGR",0,5,5,2,3,"run047"
"9460","GRG","GRR",0,1,1,0,1,"run047"
"9461","GRG","RBG",0,1,1,0,1,"run047"
"9462","GRG","RBR",0,1,1,0,1,"run047"
"9463","GRG","RGR",1,2,3,0,3,"run047"
"9464","GRG","RRG",2,4,6,3,3,"run047"
"9465","GRR","BBB",0,1,1,0,1,"run047"
"9466","GRR","BBR",0,1,1,0,1,"run047"
"9467","GRR","BGB",1,2,3,1,2,"run047"
"9468","GRR","BGG",0,2,2,0,2,"run047"
"9469","GRR","BRB",0,1,1,1,0,"run047"
"9470","GRR","BRR",0,2,2,0,2,"run047"
"9471","GRR","GGG",0,1,1,0,1,"run047"
"9472","GRR","GGR",0,1,1,1,0,"run047"
"9473","RBB","BBB",0,1,1,1,0,"run047"
"9474","RBB","BBR",0,1,1,1,0,"run047"
"9475","RBB","BRB",0,1,1,1,0,"run047"
"9476","RBB","GRR",0,1,1,0,1,"run047"
"9477","RBB","RGG",0,1,1,0,1,"run047"
"9478","RBG","BBB",2,8,10,7,3,"run047"
"9479","RBG","BBG",0,1,1,0,1,"run047"
"9480","RBG","BRR",0,1,1,0,1,"run047"
"9481","RBG","GBB",0,1,1,0,1,"run047"
"9482","RBG","GRR",0,3,3,2,1,"run047"
"9483","RBG","RBB",1,1,2,2,0,"run047"
"9484","RBG","RBR",0,1,1,1,0,"run047"
"9485","RBG","RGR",0,1,1,1,0,"run047"
"9486","RBR","BBB",0,13,13,11,2,"run047"
"9487","RBR","BBR",0,1,1,0,1,"run047"
"9488","RBR","BGB",2,4,6,4,2,"run047"
"9489","RBR","BGG",0,2,2,1,1,"run047"
"9490","RBR","BRB",1,0,1,0,1,"run047"
"9491","RBR","BRR",1,4,5,2,3,"run047"
"9492","RBR","GGB",0,12,12,8,4,"run047"
"9493","RBR","GRR",4,4,8,4,4,"run047"
"9494","RBR","RBB",0,3,3,2,1,"run047"
"9495","RBR","RGG",2,9,11,5,6,"run047"
"9496","RBR","RGR",1,0,1,1,0,"run047"
"9497","RBR","RRR",0,1,1,0,1,"run047"
"9498","RGG","BBB",0,8,8,1,7,"run047"
"9499","RGG","BBR",1,2,3,0,3,"run047"
"9500","RGG","BGB",0,1,1,0,1,"run047"
"9501","RGG","BRR",0,4,4,4,0,"run047"
"9502","RGG","GGG",0,1,1,1,0,"run047"
"9503","RGG","GGR",0,3,3,0,3,"run047"
"9504","RGG","GRR",0,8,8,0,8,"run047"
"9505","RGG","RBB",0,1,1,0,1,"run047"
"9506","RGR","BBB",2,5,7,3,4,"run047"
"9507","RGR","BBR",1,1,2,2,0,"run047"
"9508","RGR","BGB",2,5,7,5,2,"run047"
"9509","RGR","BGG",2,2,4,4,0,"run047"
"9510","RGR","BRR",1,5,6,4,2,"run047"
"9511","RGR","GGB",2,12,14,12,2,"run047"
"9512","RGR","GGG",0,2,2,1,1,"run047"
"9513","RGR","GGR",0,4,4,4,0,"run047"
"9514","RGR","RBB",0,4,4,4,0,"run047"
"9515","RGR","RGG",1,1,2,1,1,"run047"
"9516","RGR","RRG",0,3,3,3,0,"run047"
"9517","RRG","BBB",2,33,35,29,6,"run047"
"9518","RRG","BBR",0,5,5,0,5,"run047"
"9519","RRG","BGB",1,10,11,9,2,"run047"
"9520","RRG","BGG",0,2,2,2,0,"run047"
"9521","RRG","BRB",2,40,42,42,0,"run047"
"9522","RRG","BRR",1,16,17,9,8,"run047"
"9523","RRG","GGG",2,14,16,0,16,"run047"
"9524","RRG","GGR",0,5,5,5,0,"run047"
"9525","RRG","GRG",1,0,1,1,0,"run047"
"9526","RRG","GRR",3,8,11,0,11,"run047"
"9527","RRG","RBB",1,1,2,1,1,"run047"
"9528","RRG","RGG",0,1,1,1,0,"run047"
"9529","RRG","RGR",0,1,1,0,1,"run047"
"9530","RRR","BBR",1,0,1,0,1,"run047"
"9531","RRR","BGB",2,1,3,1,2,"run047"
"9532","RRR","BGG",1,0,1,0,1,"run047"
"9533","RRR","BRB",1,1,2,0,2,"run047"
"9534","RRR","BRR",1,1,2,1,1,"run047"
"9535","RRR","GGR",0,1,1,0,1,"run047"
"9536","RRR","GRR",0,3,3,1,2,"run047"
"9537","RRR","RBB",1,2,3,2,1,"run047"
"9538","RRR","RBR",0,2,2,1,1,"run047"
"9539","RRR","RGG",0,1,1,0,1,"run047"
"9540","RRR","RGR",1,2,3,3,0,"run047"
"9541","RRR","RRG",2,2,4,2,2,"run047"
"9542","BBB","BRB",0,1,1,0,1,"run048"
"9543","BBB","GGG",1,2,3,1,2,"run048"
"9544","BBB","GRR",0,2,2,2,0,"run048"
"9545","BBB","RBG",0,1,1,0,1,"run048"
"9546","BBB","RRG",1,3,4,0,4,"run048"
"9547","BBB","RRR",0,2,2,2,0,"run048"
"9548","BBG","BBB",1,4,5,4,1,"run048"
"9549","BBG","BGB",0,1,1,0,1,"run048"
"9550","BBG","BGG",0,1,1,1,0,"run048"
"9551","BBG","BRB",1,16,17,11,6,"run048"
"9552","BBG","GBB",0,1,1,0,1,"run048"
"9553","BBG","GBG",2,7,9,4,5,"run048"
"9554","BBG","GGB",2,25,27,19,8,"run048"
"9555","BBG","GGG",4,38,42,42,0,"run048"
"9556","BBG","GRG",1,9,10,6,4,"run048"
"9557","BBG","GRR",0,1,1,0,1,"run048"
"9558","BBG","RBB",0,1,1,1,0,"run048"
"9559","BBG","RBG",0,4,4,2,2,"run048"
"9560","BBG","RBR",0,1,1,0,1,"run048"
"9561","BBG","RGR",0,1,1,1,0,"run048"
"9562","BBG","RRG",1,2,3,0,3,"run048"
"9563","BBG","RRR",0,7,7,5,2,"run048"
"9564","BGB","BBB",0,2,2,2,0,"run048"
"9565","BGB","RRG",0,1,1,1,0,"run048"
"9566","BGG","BBB",0,3,3,3,0,"run048"
"9567","BGG","BBR",0,1,1,1,0,"run048"
"9568","BGG","GRG",0,1,1,1,0,"run048"
"9569","BGG","RBG",1,1,2,0,2,"run048"
"9570","BGG","RGG",0,3,3,1,2,"run048"
"9571","BGG","RGR",0,1,1,0,1,"run048"
"9572","BGG","RRR",1,1,2,2,0,"run048"
"9573","BRB","BBB",0,13,13,8,5,"run048"
"9574","BRB","BBR",0,1,1,1,0,"run048"
"9575","BRB","BRR",0,3,3,2,1,"run048"
"9576","BRB","GGG",0,1,1,1,0,"run048"
"9577","BRB","GGR",0,1,1,0,1,"run048"
"9578","BRB","RBB",0,1,1,1,0,"run048"
"9579","BRB","RBG",0,1,1,1,0,"run048"
"9580","BRB","RGR",0,1,1,1,0,"run048"
"9581","BRB","RRR",0,1,1,0,1,"run048"
"9582","BRR","BBB",0,11,11,10,1,"run048"
"9583","BRR","BGB",1,1,2,0,2,"run048"
"9584","BRR","BGG",0,1,1,0,1,"run048"
"9585","BRR","BRB",0,1,1,0,1,"run048"
"9586","BRR","RBB",0,2,2,0,2,"run048"
"9587","GBB","BBB",12,38,50,16,34,"run048"
"9588","GBB","BGG",0,1,1,0,1,"run048"
"9589","GBB","BRB",1,9,10,0,10,"run048"
"9590","GBB","BRR",1,3,4,0,4,"run048"
"9591","GBB","GBG",0,4,4,3,1,"run048"
"9592","GBB","GGB",0,21,21,21,0,"run048"
"9593","GBB","GGG",7,86,93,85,8,"run048"
"9594","GBB","GGR",1,3,4,2,2,"run048"
"9595","GBB","GRG",0,6,6,5,1,"run048"
"9596","GBB","GRR",0,1,1,1,0,"run048"
"9597","GBB","RBB",0,2,2,2,0,"run048"
"9598","GBB","RBG",3,9,12,12,0,"run048"
"9599","GBB","RBR",1,0,1,1,0,"run048"
"9600","GBB","RGG",1,0,1,1,0,"run048"
"9601","GBB","RGR",2,1,3,2,1,"run048"
"9602","GBB","RRG",0,2,2,0,2,"run048"
"9603","GBB","RRR",1,9,10,7,3,"run048"
"9604","GBG","BBB",0,5,5,4,1,"run048"
"9605","GBG","BBR",0,1,1,1,0,"run048"
"9606","GBG","BRB",1,4,5,4,1,"run048"
"9607","GBG","BRR",1,0,1,0,1,"run048"
"9608","GBG","GGB",0,4,4,4,0,"run048"
"9609","GBG","GGG",4,11,15,14,1,"run048"
"9610","GBG","RBB",1,0,1,1,0,"run048"
"9611","GBG","RBG",0,1,1,1,0,"run048"
"9612","GBG","RGG",0,1,1,1,0,"run048"
"9613","GBG","RGR",1,3,4,4,0,"run048"
"9614","GBG","RRG",1,3,4,2,2,"run048"
"9615","GGB","BBB",3,16,19,14,5,"run048"
"9616","GGB","BBR",1,4,5,5,0,"run048"
"9617","GGB","BGB",0,3,3,0,3,"run048"
"9618","GGB","BGG",0,4,4,4,0,"run048"
"9619","GGB","BRB",0,1,1,0,1,"run048"
"9620","GGB","BRR",1,15,16,4,12,"run048"
"9621","GGB","GBB",0,1,1,1,0,"run048"
"9622","GGB","GBG",1,0,1,1,0,"run048"
"9623","GGB","GGG",13,48,61,43,18,"run048"
"9624","GGB","GGR",0,7,7,3,4,"run048"
"9625","GGB","GRR",0,4,4,0,4,"run048"
"9626","GGB","RBB",0,5,5,1,4,"run048"
"9627","GGB","RBG",0,4,4,0,4,"run048"
"9628","GGB","RBR",0,5,5,0,5,"run048"
"9629","GGB","RGG",1,5,6,2,4,"run048"
"9630","GGB","RGR",0,2,2,0,2,"run048"
"9631","GGB","RRG",1,5,6,4,2,"run048"
"9632","GGB","RRR",1,5,6,0,6,"run048"
"9633","GGG","BBB",8,31,39,1,38,"run048"
"9634","GGG","BGB",0,2,2,1,1,"run048"
"9635","GGG","BGG",1,7,8,1,7,"run048"
"9636","GGG","BRB",1,3,4,4,0,"run048"
"9637","GGG","BRR",0,6,6,1,5,"run048"
"9638","GGG","GGB",5,1,6,4,2,"run048"
"9639","GGG","GGR",1,9,10,6,4,"run048"
"9640","GGG","GRR",0,2,2,2,0,"run048"
"9641","GGG","RBB",1,8,9,3,6,"run048"
"9642","GGG","RBG",0,6,6,4,2,"run048"
"9643","GGG","RBR",0,21,21,15,6,"run048"
"9644","GGG","RGG",0,3,3,3,0,"run048"
"9645","GGG","RGR",1,12,13,5,8,"run048"
"9646","GGG","RRG",1,23,24,12,12,"run048"
"9647","GGG","RRR",0,3,3,3,0,"run048"
"9648","GGR","BBB",0,2,2,0,2,"run048"
"9649","GGR","BBR",0,2,2,0,2,"run048"
"9650","GGR","BGG",0,1,1,0,1,"run048"
"9651","GGR","BRR",1,0,1,1,0,"run048"
"9652","GGR","GRR",1,0,1,1,0,"run048"
"9653","GGR","RBB",0,2,2,2,0,"run048"
"9654","GRG","BBB",3,8,11,2,9,"run048"
"9655","GRG","BBR",0,1,1,1,0,"run048"
"9656","GRG","BGG",0,1,1,1,0,"run048"
"9657","GRG","BRB",0,3,3,3,0,"run048"
"9658","GRG","BRR",0,1,1,0,1,"run048"
"9659","GRG","GBG",0,1,1,0,1,"run048"
"9660","GRG","GGB",2,15,17,3,14,"run048"
"9661","GRG","GGG",3,12,15,8,7,"run048"
"9662","GRG","GGR",0,5,5,0,5,"run048"
"9663","GRG","GRR",0,1,1,1,0,"run048"
"9664","GRG","RBG",0,1,1,1,0,"run048"
"9665","GRG","RBR",0,1,1,1,0,"run048"
"9666","GRG","RGR",1,2,3,2,1,"run048"
"9667","GRG","RRG",2,4,6,1,5,"run048"
"9668","GRR","BBB",0,1,1,0,1,"run048"
"9669","GRR","BBR",0,1,1,0,1,"run048"
"9670","GRR","BGB",1,2,3,0,3,"run048"
"9671","GRR","BGG",0,2,2,0,2,"run048"
"9672","GRR","BRB",0,1,1,1,0,"run048"
"9673","GRR","BRR",0,2,2,2,0,"run048"
"9674","GRR","GGG",0,1,1,0,1,"run048"
"9675","GRR","GGR",0,1,1,0,1,"run048"
"9676","RBB","BBB",0,1,1,0,1,"run048"
"9677","RBB","BBR",0,1,1,1,0,"run048"
"9678","RBB","BRB",0,1,1,0,1,"run048"
"9679","RBB","GRR",0,1,1,1,0,"run048"
"9680","RBB","RGG",0,1,1,1,0,"run048"
"9681","RBG","BBB",2,8,10,6,4,"run048"
"9682","RBG","BBG",0,1,1,0,1,"run048"
"9683","RBG","BRR",0,1,1,0,1,"run048"
"9684","RBG","GBB",0,1,1,1,0,"run048"
"9685","RBG","GRR",0,3,3,2,1,"run048"
"9686","RBG","RBB",1,1,2,2,0,"run048"
"9687","RBG","RBR",0,1,1,0,1,"run048"
"9688","RBG","RGR",0,1,1,1,0,"run048"
"9689","RBR","BBB",0,13,13,11,2,"run048"
"9690","RBR","BBR",0,1,1,0,1,"run048"
"9691","RBR","BGB",2,4,6,1,5,"run048"
"9692","RBR","BGG",0,2,2,2,0,"run048"
"9693","RBR","BRB",1,0,1,0,1,"run048"
"9694","RBR","BRR",1,4,5,3,2,"run048"
"9695","RBR","GGB",0,12,12,10,2,"run048"
"9696","RBR","GRR",4,4,8,5,3,"run048"
"9697","RBR","RBB",0,3,3,2,1,"run048"
"9698","RBR","RGG",2,9,11,0,11,"run048"
"9699","RBR","RGR",1,0,1,1,0,"run048"
"9700","RBR","RRR",0,1,1,1,0,"run048"
"9701","RGG","BBB",0,8,8,3,5,"run048"
"9702","RGG","BBR",1,2,3,0,3,"run048"
"9703","RGG","BGB",0,1,1,0,1,"run048"
"9704","RGG","BRR",0,4,4,1,3,"run048"
"9705","RGG","GGG",0,1,1,1,0,"run048"
"9706","RGG","GGR",0,3,3,0,3,"run048"
"9707","RGG","GRR",0,8,8,0,8,"run048"
"9708","RGG","RBB",0,1,1,0,1,"run048"
"9709","RGR","BBB",2,5,7,1,6,"run048"
"9710","RGR","BBR",1,1,2,2,0,"run048"
"9711","RGR","BGB",2,5,7,3,4,"run048"
"9712","RGR","BGG",2,2,4,0,4,"run048"
"9713","RGR","BRR",1,5,6,0,6,"run048"
"9714","RGR","GGB",2,12,14,10,4,"run048"
"9715","RGR","GGG",0,2,2,0,2,"run048"
"9716","RGR","GGR",0,4,4,4,0,"run048"
"9717","RGR","RBB",0,4,4,3,1,"run048"
"9718","RGR","RGG",1,1,2,1,1,"run048"
"9719","RGR","RRG",0,3,3,1,2,"run048"
"9720","RRG","BBB",2,33,35,17,18,"run048"
"9721","RRG","BBR",0,5,5,1,4,"run048"
"9722","RRG","BGB",1,10,11,6,5,"run048"
"9723","RRG","BGG",0,2,2,0,2,"run048"
"9724","RRG","BRB",2,40,42,26,16,"run048"
"9725","RRG","BRR",1,16,17,16,1,"run048"
"9726","RRG","GGG",2,14,16,8,8,"run048"
"9727","RRG","GGR",0,5,5,1,4,"run048"
"9728","RRG","GRG",1,0,1,0,1,"run048"
"9729","RRG","GRR",3,8,11,9,2,"run048"
"9730","RRG","RBB",1,1,2,0,2,"run048"
"9731","RRG","RGG",0,1,1,1,0,"run048"
"9732","RRG","RGR",0,1,1,0,1,"run048"
"9733","RRR","BBR",1,0,1,1,0,"run048"
"9734","RRR","BGB",2,1,3,0,3,"run048"
"9735","RRR","BGG",1,0,1,0,1,"run048"
"9736","RRR","BRB",1,1,2,2,0,"run048"
"9737","RRR","BRR",1,1,2,2,0,"run048"
"9738","RRR","GGR",0,1,1,1,0,"run048"
"9739","RRR","GRR",0,3,3,2,1,"run048"
"9740","RRR","RBB",1,2,3,1,2,"run048"
"9741","RRR","RBR",0,2,2,1,1,"run048"
"9742","RRR","RGG",0,1,1,1,0,"run048"
"9743","RRR","RGR",1,2,3,2,1,"run048"
"9744","RRR","RRG",2,2,4,1,3,"run048"
"9745","BBB","BRB",0,1,1,0,1,"run049"
"9746","BBB","GGG",1,2,3,0,3,"run049"
"9747","BBB","GRR",0,2,2,2,0,"run049"
"9748","BBB","RBG",0,1,1,0,1,"run049"
"9749","BBB","RRG",1,3,4,2,2,"run049"
"9750","BBB","RRR",0,2,2,2,0,"run049"
"9751","BBG","BBB",1,4,5,1,4,"run049"
"9752","BBG","BGB",0,1,1,0,1,"run049"
"9753","BBG","BGG",0,1,1,0,1,"run049"
"9754","BBG","BRB",1,16,17,7,10,"run049"
"9755","BBG","GBB",0,1,1,0,1,"run049"
"9756","BBG","GBG",2,7,9,4,5,"run049"
"9757","BBG","GGB",2,25,27,27,0,"run049"
"9758","BBG","GGG",4,38,42,32,10,"run049"
"9759","BBG","GRG",1,9,10,3,7,"run049"
"9760","BBG","GRR",0,1,1,1,0,"run049"
"9761","BBG","RBB",0,1,1,0,1,"run049"
"9762","BBG","RBG",0,4,4,1,3,"run049"
"9763","BBG","RBR",0,1,1,1,0,"run049"
"9764","BBG","RGR",0,1,1,0,1,"run049"
"9765","BBG","RRG",1,2,3,0,3,"run049"
"9766","BBG","RRR",0,7,7,5,2,"run049"
"9767","BGB","BBB",0,2,2,0,2,"run049"
"9768","BGB","RRG",0,1,1,0,1,"run049"
"9769","BGG","BBB",0,3,3,3,0,"run049"
"9770","BGG","BBR",0,1,1,0,1,"run049"
"9771","BGG","GRG",0,1,1,0,1,"run049"
"9772","BGG","RBG",1,1,2,0,2,"run049"
"9773","BGG","RGG",0,3,3,3,0,"run049"
"9774","BGG","RGR",0,1,1,1,0,"run049"
"9775","BGG","RRR",1,1,2,0,2,"run049"
"9776","BRB","BBB",0,13,13,1,12,"run049"
"9777","BRB","BBR",0,1,1,1,0,"run049"
"9778","BRB","BRR",0,3,3,0,3,"run049"
"9779","BRB","GGG",0,1,1,0,1,"run049"
"9780","BRB","GGR",0,1,1,1,0,"run049"
"9781","BRB","RBB",0,1,1,0,1,"run049"
"9782","BRB","RBG",0,1,1,1,0,"run049"
"9783","BRB","RGR",0,1,1,0,1,"run049"
"9784","BRB","RRR",0,1,1,0,1,"run049"
"9785","BRR","BBB",0,11,11,6,5,"run049"
"9786","BRR","BGB",1,1,2,0,2,"run049"
"9787","BRR","BGG",0,1,1,0,1,"run049"
"9788","BRR","BRB",0,1,1,1,0,"run049"
"9789","BRR","RBB",0,2,2,0,2,"run049"
"9790","GBB","BBB",12,38,50,6,44,"run049"
"9791","GBB","BGG",0,1,1,0,1,"run049"
"9792","GBB","BRB",1,9,10,5,5,"run049"
"9793","GBB","BRR",1,3,4,4,0,"run049"
"9794","GBB","GBG",0,4,4,1,3,"run049"
"9795","GBB","GGB",0,21,21,20,1,"run049"
"9796","GBB","GGG",7,86,93,4,89,"run049"
"9797","GBB","GGR",1,3,4,3,1,"run049"
"9798","GBB","GRG",0,6,6,2,4,"run049"
"9799","GBB","GRR",0,1,1,1,0,"run049"
"9800","GBB","RBB",0,2,2,2,0,"run049"
"9801","GBB","RBG",3,9,12,2,10,"run049"
"9802","GBB","RBR",1,0,1,1,0,"run049"
"9803","GBB","RGG",1,0,1,0,1,"run049"
"9804","GBB","RGR",2,1,3,0,3,"run049"
"9805","GBB","RRG",0,2,2,1,1,"run049"
"9806","GBB","RRR",1,9,10,6,4,"run049"
"9807","GBG","BBB",0,5,5,2,3,"run049"
"9808","GBG","BBR",0,1,1,1,0,"run049"
"9809","GBG","BRB",1,4,5,4,1,"run049"
"9810","GBG","BRR",1,0,1,0,1,"run049"
"9811","GBG","GGB",0,4,4,4,0,"run049"
"9812","GBG","GGG",4,11,15,15,0,"run049"
"9813","GBG","RBB",1,0,1,1,0,"run049"
"9814","GBG","RBG",0,1,1,0,1,"run049"
"9815","GBG","RGG",0,1,1,0,1,"run049"
"9816","GBG","RGR",1,3,4,2,2,"run049"
"9817","GBG","RRG",1,3,4,2,2,"run049"
"9818","GGB","BBB",3,16,19,6,13,"run049"
"9819","GGB","BBR",1,4,5,5,0,"run049"
"9820","GGB","BGB",0,3,3,1,2,"run049"
"9821","GGB","BGG",0,4,4,0,4,"run049"
"9822","GGB","BRB",0,1,1,1,0,"run049"
"9823","GGB","BRR",1,15,16,4,12,"run049"
"9824","GGB","GBB",0,1,1,1,0,"run049"
"9825","GGB","GBG",1,0,1,1,0,"run049"
"9826","GGB","GGG",13,48,61,17,44,"run049"
"9827","GGB","GGR",0,7,7,4,3,"run049"
"9828","GGB","GRR",0,4,4,4,0,"run049"
"9829","GGB","RBB",0,5,5,2,3,"run049"
"9830","GGB","RBG",0,4,4,1,3,"run049"
"9831","GGB","RBR",0,5,5,0,5,"run049"
"9832","GGB","RGG",1,5,6,2,4,"run049"
"9833","GGB","RGR",0,2,2,0,2,"run049"
"9834","GGB","RRG",1,5,6,3,3,"run049"
"9835","GGB","RRR",1,5,6,6,0,"run049"
"9836","GGG","BBB",8,31,39,11,28,"run049"
"9837","GGG","BGB",0,2,2,1,1,"run049"
"9838","GGG","BGG",1,7,8,8,0,"run049"
"9839","GGG","BRB",1,3,4,1,3,"run049"
"9840","GGG","BRR",0,6,6,5,1,"run049"
"9841","GGG","GGB",5,1,6,0,6,"run049"
"9842","GGG","GGR",1,9,10,2,8,"run049"
"9843","GGG","GRR",0,2,2,2,0,"run049"
"9844","GGG","RBB",1,8,9,3,6,"run049"
"9845","GGG","RBG",0,6,6,6,0,"run049"
"9846","GGG","RBR",0,21,21,0,21,"run049"
"9847","GGG","RGG",0,3,3,3,0,"run049"
"9848","GGG","RGR",1,12,13,7,6,"run049"
"9849","GGG","RRG",1,23,24,23,1,"run049"
"9850","GGG","RRR",0,3,3,1,2,"run049"
"9851","GGR","BBB",0,2,2,2,0,"run049"
"9852","GGR","BBR",0,2,2,2,0,"run049"
"9853","GGR","BGG",0,1,1,0,1,"run049"
"9854","GGR","BRR",1,0,1,0,1,"run049"
"9855","GGR","GRR",1,0,1,0,1,"run049"
"9856","GGR","RBB",0,2,2,1,1,"run049"
"9857","GRG","BBB",3,8,11,0,11,"run049"
"9858","GRG","BBR",0,1,1,1,0,"run049"
"9859","GRG","BGG",0,1,1,1,0,"run049"
"9860","GRG","BRB",0,3,3,0,3,"run049"
"9861","GRG","BRR",0,1,1,0,1,"run049"
"9862","GRG","GBG",0,1,1,0,1,"run049"
"9863","GRG","GGB",2,15,17,7,10,"run049"
"9864","GRG","GGG",3,12,15,5,10,"run049"
"9865","GRG","GGR",0,5,5,2,3,"run049"
"9866","GRG","GRR",0,1,1,0,1,"run049"
"9867","GRG","RBG",0,1,1,1,0,"run049"
"9868","GRG","RBR",0,1,1,0,1,"run049"
"9869","GRG","RGR",1,2,3,1,2,"run049"
"9870","GRG","RRG",2,4,6,1,5,"run049"
"9871","GRR","BBB",0,1,1,1,0,"run049"
"9872","GRR","BBR",0,1,1,0,1,"run049"
"9873","GRR","BGB",1,2,3,2,1,"run049"
"9874","GRR","BGG",0,2,2,2,0,"run049"
"9875","GRR","BRB",0,1,1,1,0,"run049"
"9876","GRR","BRR",0,2,2,1,1,"run049"
"9877","GRR","GGG",0,1,1,1,0,"run049"
"9878","GRR","GGR",0,1,1,1,0,"run049"
"9879","RBB","BBB",0,1,1,1,0,"run049"
"9880","RBB","BBR",0,1,1,0,1,"run049"
"9881","RBB","BRB",0,1,1,1,0,"run049"
"9882","RBB","GRR",0,1,1,0,1,"run049"
"9883","RBB","RGG",0,1,1,1,0,"run049"
"9884","RBG","BBB",2,8,10,2,8,"run049"
"9885","RBG","BBG",0,1,1,1,0,"run049"
"9886","RBG","BRR",0,1,1,1,0,"run049"
"9887","RBG","GBB",0,1,1,1,0,"run049"
"9888","RBG","GRR",0,3,3,3,0,"run049"
"9889","RBG","RBB",1,1,2,2,0,"run049"
"9890","RBG","RBR",0,1,1,0,1,"run049"
"9891","RBG","RGR",0,1,1,0,1,"run049"
"9892","RBR","BBB",0,13,13,1,12,"run049"
"9893","RBR","BBR",0,1,1,1,0,"run049"
"9894","RBR","BGB",2,4,6,6,0,"run049"
"9895","RBR","BGG",0,2,2,1,1,"run049"
"9896","RBR","BRB",1,0,1,1,0,"run049"
"9897","RBR","BRR",1,4,5,0,5,"run049"
"9898","RBR","GGB",0,12,12,4,8,"run049"
"9899","RBR","GRR",4,4,8,1,7,"run049"
"9900","RBR","RBB",0,3,3,1,2,"run049"
"9901","RBR","RGG",2,9,11,4,7,"run049"
"9902","RBR","RGR",1,0,1,1,0,"run049"
"9903","RBR","RRR",0,1,1,0,1,"run049"
"9904","RGG","BBB",0,8,8,6,2,"run049"
"9905","RGG","BBR",1,2,3,3,0,"run049"
"9906","RGG","BGB",0,1,1,0,1,"run049"
"9907","RGG","BRR",0,4,4,2,2,"run049"
"9908","RGG","GGG",0,1,1,1,0,"run049"
"9909","RGG","GGR",0,3,3,0,3,"run049"
"9910","RGG","GRR",0,8,8,8,0,"run049"
"9911","RGG","RBB",0,1,1,0,1,"run049"
"9912","RGR","BBB",2,5,7,7,0,"run049"
"9913","RGR","BBR",1,1,2,1,1,"run049"
"9914","RGR","BGB",2,5,7,2,5,"run049"
"9915","RGR","BGG",2,2,4,0,4,"run049"
"9916","RGR","BRR",1,5,6,0,6,"run049"
"9917","RGR","GGB",2,12,14,6,8,"run049"
"9918","RGR","GGG",0,2,2,2,0,"run049"
"9919","RGR","GGR",0,4,4,0,4,"run049"
"9920","RGR","RBB",0,4,4,4,0,"run049"
"9921","RGR","RGG",1,1,2,2,0,"run049"
"9922","RGR","RRG",0,3,3,1,2,"run049"
"9923","RRG","BBB",2,33,35,20,15,"run049"
"9924","RRG","BBR",0,5,5,3,2,"run049"
"9925","RRG","BGB",1,10,11,7,4,"run049"
"9926","RRG","BGG",0,2,2,2,0,"run049"
"9927","RRG","BRB",2,40,42,38,4,"run049"
"9928","RRG","BRR",1,16,17,7,10,"run049"
"9929","RRG","GGG",2,14,16,1,15,"run049"
"9930","RRG","GGR",0,5,5,5,0,"run049"
"9931","RRG","GRG",1,0,1,1,0,"run049"
"9932","RRG","GRR",3,8,11,0,11,"run049"
"9933","RRG","RBB",1,1,2,1,1,"run049"
"9934","RRG","RGG",0,1,1,1,0,"run049"
"9935","RRG","RGR",0,1,1,0,1,"run049"
"9936","RRR","BBR",1,0,1,1,0,"run049"
"9937","RRR","BGB",2,1,3,0,3,"run049"
"9938","RRR","BGG",1,0,1,1,0,"run049"
"9939","RRR","BRB",1,1,2,0,2,"run049"
"9940","RRR","BRR",1,1,2,1,1,"run049"
"9941","RRR","GGR",0,1,1,1,0,"run049"
"9942","RRR","GRR",0,3,3,0,3,"run049"
"9943","RRR","RBB",1,2,3,2,1,"run049"
"9944","RRR","RBR",0,2,2,0,2,"run049"
"9945","RRR","RGG",0,1,1,0,1,"run049"
"9946","RRR","RGR",1,2,3,0,3,"run049"
"9947","RRR","RRG",2,2,4,3,1,"run049"
"9948","BBB","BRB",0,1,1,1,0,"run050"
"9949","BBB","GGG",1,2,3,2,1,"run050"
"9950","BBB","GRR",0,2,2,2,0,"run050"
"9951","BBB","RBG",0,1,1,0,1,"run050"
"9952","BBB","RRG",1,3,4,1,3,"run050"
"9953","BBB","RRR",0,2,2,1,1,"run050"
"9954","BBG","BBB",1,4,5,2,3,"run050"
"9955","BBG","BGB",0,1,1,1,0,"run050"
"9956","BBG","BGG",0,1,1,1,0,"run050"
"9957","BBG","BRB",1,16,17,15,2,"run050"
"9958","BBG","GBB",0,1,1,1,0,"run050"
"9959","BBG","GBG",2,7,9,4,5,"run050"
"9960","BBG","GGB",2,25,27,26,1,"run050"
"9961","BBG","GGG",4,38,42,19,23,"run050"
"9962","BBG","GRG",1,9,10,9,1,"run050"
"9963","BBG","GRR",0,1,1,0,1,"run050"
"9964","BBG","RBB",0,1,1,1,0,"run050"
"9965","BBG","RBG",0,4,4,4,0,"run050"
"9966","BBG","RBR",0,1,1,1,0,"run050"
"9967","BBG","RGR",0,1,1,0,1,"run050"
"9968","BBG","RRG",1,2,3,3,0,"run050"
"9969","BBG","RRR",0,7,7,0,7,"run050"
"9970","BGB","BBB",0,2,2,0,2,"run050"
"9971","BGB","RRG",0,1,1,1,0,"run050"
"9972","BGG","BBB",0,3,3,1,2,"run050"
"9973","BGG","BBR",0,1,1,0,1,"run050"
"9974","BGG","GRG",0,1,1,1,0,"run050"
"9975","BGG","RBG",1,1,2,0,2,"run050"
"9976","BGG","RGG",0,3,3,1,2,"run050"
"9977","BGG","RGR",0,1,1,0,1,"run050"
"9978","BGG","RRR",1,1,2,1,1,"run050"
"9979","BRB","BBB",0,13,13,9,4,"run050"
"9980","BRB","BBR",0,1,1,0,1,"run050"
"9981","BRB","BRR",0,3,3,2,1,"run050"
"9982","BRB","GGG",0,1,1,0,1,"run050"
"9983","BRB","GGR",0,1,1,0,1,"run050"
"9984","BRB","RBB",0,1,1,1,0,"run050"
"9985","BRB","RBG",0,1,1,1,0,"run050"
"9986","BRB","RGR",0,1,1,1,0,"run050"
"9987","BRB","RRR",0,1,1,0,1,"run050"
"9988","BRR","BBB",0,11,11,5,6,"run050"
"9989","BRR","BGB",1,1,2,2,0,"run050"
"9990","BRR","BGG",0,1,1,1,0,"run050"
"9991","BRR","BRB",0,1,1,1,0,"run050"
"9992","BRR","RBB",0,2,2,0,2,"run050"
"9993","GBB","BBB",12,38,50,39,11,"run050"
"9994","GBB","BGG",0,1,1,0,1,"run050"
"9995","GBB","BRB",1,9,10,3,7,"run050"
"9996","GBB","BRR",1,3,4,1,3,"run050"
"9997","GBB","GBG",0,4,4,0,4,"run050"
"9998","GBB","GGB",0,21,21,13,8,"run050"
"9999","GBB","GGG",7,86,93,59,34,"run050"
"10000","GBB","GGR",1,3,4,1,3,"run050"
"10001","GBB","GRG",0,6,6,5,1,"run050"
"10002","GBB","GRR",0,1,1,0,1,"run050"
"10003","GBB","RBB",0,2,2,1,1,"run050"
"10004","GBB","RBG",3,9,12,3,9,"run050"
"10005","GBB","RBR",1,0,1,1,0,"run050"
"10006","GBB","RGG",1,0,1,1,0,"run050"
"10007","GBB","RGR",2,1,3,2,1,"run050"
"10008","GBB","RRG",0,2,2,2,0,"run050"
"10009","GBB","RRR",1,9,10,3,7,"run050"
"10010","GBG","BBB",0,5,5,4,1,"run050"
"10011","GBG","BBR",0,1,1,0,1,"run050"
"10012","GBG","BRB",1,4,5,5,0,"run050"
"10013","GBG","BRR",1,0,1,1,0,"run050"
"10014","GBG","GGB",0,4,4,2,2,"run050"
"10015","GBG","GGG",4,11,15,8,7,"run050"
"10016","GBG","RBB",1,0,1,1,0,"run050"
"10017","GBG","RBG",0,1,1,1,0,"run050"
"10018","GBG","RGG",0,1,1,0,1,"run050"
"10019","GBG","RGR",1,3,4,1,3,"run050"
"10020","GBG","RRG",1,3,4,1,3,"run050"
"10021","GGB","BBB",3,16,19,12,7,"run050"
"10022","GGB","BBR",1,4,5,1,4,"run050"
"10023","GGB","BGB",0,3,3,0,3,"run050"
"10024","GGB","BGG",0,4,4,3,1,"run050"
"10025","GGB","BRB",0,1,1,0,1,"run050"
"10026","GGB","BRR",1,15,16,11,5,"run050"
"10027","GGB","GBB",0,1,1,1,0,"run050"
"10028","GGB","GBG",1,0,1,1,0,"run050"
"10029","GGB","GGG",13,48,61,22,39,"run050"
"10030","GGB","GGR",0,7,7,6,1,"run050"
"10031","GGB","GRR",0,4,4,2,2,"run050"
"10032","GGB","RBB",0,5,5,1,4,"run050"
"10033","GGB","RBG",0,4,4,1,3,"run050"
"10034","GGB","RBR",0,5,5,2,3,"run050"
"10035","GGB","RGG",1,5,6,5,1,"run050"
"10036","GGB","RGR",0,2,2,2,0,"run050"
"10037","GGB","RRG",1,5,6,5,1,"run050"
"10038","GGB","RRR",1,5,6,5,1,"run050"
"10039","GGG","BBB",8,31,39,0,39,"run050"
"10040","GGG","BGB",0,2,2,1,1,"run050"
"10041","GGG","BGG",1,7,8,3,5,"run050"
"10042","GGG","BRB",1,3,4,2,2,"run050"
"10043","GGG","BRR",0,6,6,1,5,"run050"
"10044","GGG","GGB",5,1,6,6,0,"run050"
"10045","GGG","GGR",1,9,10,4,6,"run050"
"10046","GGG","GRR",0,2,2,0,2,"run050"
"10047","GGG","RBB",1,8,9,5,4,"run050"
"10048","GGG","RBG",0,6,6,0,6,"run050"
"10049","GGG","RBR",0,21,21,2,19,"run050"
"10050","GGG","RGG",0,3,3,0,3,"run050"
"10051","GGG","RGR",1,12,13,1,12,"run050"
"10052","GGG","RRG",1,23,24,1,23,"run050"
"10053","GGG","RRR",0,3,3,3,0,"run050"
"10054","GGR","BBB",0,2,2,2,0,"run050"
"10055","GGR","BBR",0,2,2,2,0,"run050"
"10056","GGR","BGG",0,1,1,1,0,"run050"
"10057","GGR","BRR",1,0,1,0,1,"run050"
"10058","GGR","GRR",1,0,1,1,0,"run050"
"10059","GGR","RBB",0,2,2,2,0,"run050"
"10060","GRG","BBB",3,8,11,4,7,"run050"
"10061","GRG","BBR",0,1,1,0,1,"run050"
"10062","GRG","BGG",0,1,1,0,1,"run050"
"10063","GRG","BRB",0,3,3,1,2,"run050"
"10064","GRG","BRR",0,1,1,0,1,"run050"
"10065","GRG","GBG",0,1,1,1,0,"run050"
"10066","GRG","GGB",2,15,17,10,7,"run050"
"10067","GRG","GGG",3,12,15,8,7,"run050"
"10068","GRG","GGR",0,5,5,1,4,"run050"
"10069","GRG","GRR",0,1,1,1,0,"run050"
"10070","GRG","RBG",0,1,1,0,1,"run050"
"10071","GRG","RBR",0,1,1,1,0,"run050"
"10072","GRG","RGR",1,2,3,3,0,"run050"
"10073","GRG","RRG",2,4,6,5,1,"run050"
"10074","GRR","BBB",0,1,1,0,1,"run050"
"10075","GRR","BBR",0,1,1,1,0,"run050"
"10076","GRR","BGB",1,2,3,0,3,"run050"
"10077","GRR","BGG",0,2,2,2,0,"run050"
"10078","GRR","BRB",0,1,1,1,0,"run050"
"10079","GRR","BRR",0,2,2,1,1,"run050"
"10080","GRR","GGG",0,1,1,0,1,"run050"
"10081","GRR","GGR",0,1,1,1,0,"run050"
"10082","RBB","BBB",0,1,1,1,0,"run050"
"10083","RBB","BBR",0,1,1,0,1,"run050"
"10084","RBB","BRB",0,1,1,1,0,"run050"
"10085","RBB","GRR",0,1,1,1,0,"run050"
"10086","RBB","RGG",0,1,1,1,0,"run050"
"10087","RBG","BBB",2,8,10,9,1,"run050"
"10088","RBG","BBG",0,1,1,0,1,"run050"
"10089","RBG","BRR",0,1,1,1,0,"run050"
"10090","RBG","GBB",0,1,1,0,1,"run050"
"10091","RBG","GRR",0,3,3,2,1,"run050"
"10092","RBG","RBB",1,1,2,2,0,"run050"
"10093","RBG","RBR",0,1,1,1,0,"run050"
"10094","RBG","RGR",0,1,1,0,1,"run050"
"10095","RBR","BBB",0,13,13,10,3,"run050"
"10096","RBR","BBR",0,1,1,1,0,"run050"
"10097","RBR","BGB",2,4,6,0,6,"run050"
"10098","RBR","BGG",0,2,2,0,2,"run050"
"10099","RBR","BRB",1,0,1,0,1,"run050"
"10100","RBR","BRR",1,4,5,4,1,"run050"
"10101","RBR","GGB",0,12,12,6,6,"run050"
"10102","RBR","GRR",4,4,8,8,0,"run050"
"10103","RBR","RBB",0,3,3,2,1,"run050"
"10104","RBR","RGG",2,9,11,9,2,"run050"
"10105","RBR","RGR",1,0,1,0,1,"run050"
"10106","RBR","RRR",0,1,1,1,0,"run050"
"10107","RGG","BBB",0,8,8,4,4,"run050"
"10108","RGG","BBR",1,2,3,0,3,"run050"
"10109","RGG","BGB",0,1,1,0,1,"run050"
"10110","RGG","BRR",0,4,4,2,2,"run050"
"10111","RGG","GGG",0,1,1,0,1,"run050"
"10112","RGG","GGR",0,3,3,2,1,"run050"
"10113","RGG","GRR",0,8,8,7,1,"run050"
"10114","RGG","RBB",0,1,1,1,0,"run050"
"10115","RGR","BBB",2,5,7,1,6,"run050"
"10116","RGR","BBR",1,1,2,2,0,"run050"
"10117","RGR","BGB",2,5,7,6,1,"run050"
"10118","RGR","BGG",2,2,4,4,0,"run050"
"10119","RGR","BRR",1,5,6,1,5,"run050"
"10120","RGR","GGB",2,12,14,7,7,"run050"
"10121","RGR","GGG",0,2,2,2,0,"run050"
"10122","RGR","GGR",0,4,4,2,2,"run050"
"10123","RGR","RBB",0,4,4,1,3,"run050"
"10124","RGR","RGG",1,1,2,2,0,"run050"
"10125","RGR","RRG",0,3,3,2,1,"run050"
"10126","RRG","BBB",2,33,35,34,1,"run050"
"10127","RRG","BBR",0,5,5,5,0,"run050"
"10128","RRG","BGB",1,10,11,9,2,"run050"
"10129","RRG","BGG",0,2,2,1,1,"run050"
"10130","RRG","BRB",2,40,42,2,40,"run050"
"10131","RRG","BRR",1,16,17,14,3,"run050"
"10132","RRG","GGG",2,14,16,15,1,"run050"
"10133","RRG","GGR",0,5,5,0,5,"run050"
"10134","RRG","GRG",1,0,1,1,0,"run050"
"10135","RRG","GRR",3,8,11,3,8,"run050"
"10136","RRG","RBB",1,1,2,2,0,"run050"
"10137","RRG","RGG",0,1,1,1,0,"run050"
"10138","RRG","RGR",0,1,1,1,0,"run050"
"10139","RRR","BBR",1,0,1,1,0,"run050"
"10140","RRR","BGB",2,1,3,0,3,"run050"
"10141","RRR","BGG",1,0,1,0,1,"run050"
"10142","RRR","BRB",1,1,2,2,0,"run050"
"10143","RRR","BRR",1,1,2,0,2,"run050"
"10144","RRR","GGR",0,1,1,0,1,"run050"
"10145","RRR","GRR",0,3,3,2,1,"run050"
"10146","RRR","RBB",1,2,3,3,0,"run050"
"10147","RRR","RBR",0,2,2,1,1,"run050"
"10148","RRR","RGG",0,1,1,1,0,"run050"
"10149","RRR","RGR",1,2,3,2,1,"run050"
"10150","RRR","RRG",2,2,4,0,4,"run050"
"10151","BBB","BRB",0,1,1,0,1,"run051"
"10152","BBB","GGG",1,2,3,2,1,"run051"
"10153","BBB","GRR",0,2,2,0,2,"run051"
"10154","BBB","RBG",0,1,1,1,0,"run051"
"10155","BBB","RRG",1,3,4,4,0,"run051"
"10156","BBB","RRR",0,2,2,2,0,"run051"
"10157","BBG","BBB",1,4,5,0,5,"run051"
"10158","BBG","BGB",0,1,1,0,1,"run051"
"10159","BBG","BGG",0,1,1,1,0,"run051"
"10160","BBG","BRB",1,16,17,11,6,"run051"
"10161","BBG","GBB",0,1,1,1,0,"run051"
"10162","BBG","GBG",2,7,9,9,0,"run051"
"10163","BBG","GGB",2,25,27,5,22,"run051"
"10164","BBG","GGG",4,38,42,36,6,"run051"
"10165","BBG","GRG",1,9,10,0,10,"run051"
"10166","BBG","GRR",0,1,1,1,0,"run051"
"10167","BBG","RBB",0,1,1,1,0,"run051"
"10168","BBG","RBG",0,4,4,2,2,"run051"
"10169","BBG","RBR",0,1,1,1,0,"run051"
"10170","BBG","RGR",0,1,1,1,0,"run051"
"10171","BBG","RRG",1,2,3,2,1,"run051"
"10172","BBG","RRR",0,7,7,3,4,"run051"
"10173","BGB","BBB",0,2,2,2,0,"run051"
"10174","BGB","RRG",0,1,1,0,1,"run051"
"10175","BGG","BBB",0,3,3,0,3,"run051"
"10176","BGG","BBR",0,1,1,0,1,"run051"
"10177","BGG","GRG",0,1,1,1,0,"run051"
"10178","BGG","RBG",1,1,2,1,1,"run051"
"10179","BGG","RGG",0,3,3,1,2,"run051"
"10180","BGG","RGR",0,1,1,0,1,"run051"
"10181","BGG","RRR",1,1,2,0,2,"run051"
"10182","BRB","BBB",0,13,13,5,8,"run051"
"10183","BRB","BBR",0,1,1,1,0,"run051"
"10184","BRB","BRR",0,3,3,2,1,"run051"
"10185","BRB","GGG",0,1,1,1,0,"run051"
"10186","BRB","GGR",0,1,1,1,0,"run051"
"10187","BRB","RBB",0,1,1,0,1,"run051"
"10188","BRB","RBG",0,1,1,0,1,"run051"
"10189","BRB","RGR",0,1,1,1,0,"run051"
"10190","BRB","RRR",0,1,1,1,0,"run051"
"10191","BRR","BBB",0,11,11,10,1,"run051"
"10192","BRR","BGB",1,1,2,2,0,"run051"
"10193","BRR","BGG",0,1,1,0,1,"run051"
"10194","BRR","BRB",0,1,1,0,1,"run051"
"10195","BRR","RBB",0,2,2,1,1,"run051"
"10196","GBB","BBB",12,38,50,46,4,"run051"
"10197","GBB","BGG",0,1,1,0,1,"run051"
"10198","GBB","BRB",1,9,10,2,8,"run051"
"10199","GBB","BRR",1,3,4,1,3,"run051"
"10200","GBB","GBG",0,4,4,3,1,"run051"
"10201","GBB","GGB",0,21,21,9,12,"run051"
"10202","GBB","GGG",7,86,93,55,38,"run051"
"10203","GBB","GGR",1,3,4,3,1,"run051"
"10204","GBB","GRG",0,6,6,0,6,"run051"
"10205","GBB","GRR",0,1,1,0,1,"run051"
"10206","GBB","RBB",0,2,2,1,1,"run051"
"10207","GBB","RBG",3,9,12,1,11,"run051"
"10208","GBB","RBR",1,0,1,0,1,"run051"
"10209","GBB","RGG",1,0,1,0,1,"run051"
"10210","GBB","RGR",2,1,3,0,3,"run051"
"10211","GBB","RRG",0,2,2,0,2,"run051"
"10212","GBB","RRR",1,9,10,8,2,"run051"
"10213","GBG","BBB",0,5,5,0,5,"run051"
"10214","GBG","BBR",0,1,1,1,0,"run051"
"10215","GBG","BRB",1,4,5,4,1,"run051"
"10216","GBG","BRR",1,0,1,1,0,"run051"
"10217","GBG","GGB",0,4,4,1,3,"run051"
"10218","GBG","GGG",4,11,15,2,13,"run051"
"10219","GBG","RBB",1,0,1,0,1,"run051"
"10220","GBG","RBG",0,1,1,0,1,"run051"
"10221","GBG","RGG",0,1,1,1,0,"run051"
"10222","GBG","RGR",1,3,4,1,3,"run051"
"10223","GBG","RRG",1,3,4,2,2,"run051"
"10224","GGB","BBB",3,16,19,4,15,"run051"
"10225","GGB","BBR",1,4,5,0,5,"run051"
"10226","GGB","BGB",0,3,3,1,2,"run051"
"10227","GGB","BGG",0,4,4,2,2,"run051"
"10228","GGB","BRB",0,1,1,1,0,"run051"
"10229","GGB","BRR",1,15,16,16,0,"run051"
"10230","GGB","GBB",0,1,1,0,1,"run051"
"10231","GGB","GBG",1,0,1,0,1,"run051"
"10232","GGB","GGG",13,48,61,8,53,"run051"
"10233","GGB","GGR",0,7,7,0,7,"run051"
"10234","GGB","GRR",0,4,4,2,2,"run051"
"10235","GGB","RBB",0,5,5,4,1,"run051"
"10236","GGB","RBG",0,4,4,0,4,"run051"
"10237","GGB","RBR",0,5,5,4,1,"run051"
"10238","GGB","RGG",1,5,6,0,6,"run051"
"10239","GGB","RGR",0,2,2,1,1,"run051"
"10240","GGB","RRG",1,5,6,1,5,"run051"
"10241","GGB","RRR",1,5,6,5,1,"run051"
"10242","GGG","BBB",8,31,39,21,18,"run051"
"10243","GGG","BGB",0,2,2,1,1,"run051"
"10244","GGG","BGG",1,7,8,6,2,"run051"
"10245","GGG","BRB",1,3,4,3,1,"run051"
"10246","GGG","BRR",0,6,6,5,1,"run051"
"10247","GGG","GGB",5,1,6,2,4,"run051"
"10248","GGG","GGR",1,9,10,0,10,"run051"
"10249","GGG","GRR",0,2,2,0,2,"run051"
"10250","GGG","RBB",1,8,9,7,2,"run051"
"10251","GGG","RBG",0,6,6,5,1,"run051"
"10252","GGG","RBR",0,21,21,1,20,"run051"
"10253","GGG","RGG",0,3,3,0,3,"run051"
"10254","GGG","RGR",1,12,13,8,5,"run051"
"10255","GGG","RRG",1,23,24,7,17,"run051"
"10256","GGG","RRR",0,3,3,1,2,"run051"
"10257","GGR","BBB",0,2,2,1,1,"run051"
"10258","GGR","BBR",0,2,2,1,1,"run051"
"10259","GGR","BGG",0,1,1,1,0,"run051"
"10260","GGR","BRR",1,0,1,1,0,"run051"
"10261","GGR","GRR",1,0,1,0,1,"run051"
"10262","GGR","RBB",0,2,2,0,2,"run051"
"10263","GRG","BBB",3,8,11,9,2,"run051"
"10264","GRG","BBR",0,1,1,0,1,"run051"
"10265","GRG","BGG",0,1,1,0,1,"run051"
"10266","GRG","BRB",0,3,3,3,0,"run051"
"10267","GRG","BRR",0,1,1,1,0,"run051"
"10268","GRG","GBG",0,1,1,0,1,"run051"
"10269","GRG","GGB",2,15,17,1,16,"run051"
"10270","GRG","GGG",3,12,15,5,10,"run051"
"10271","GRG","GGR",0,5,5,2,3,"run051"
"10272","GRG","GRR",0,1,1,0,1,"run051"
"10273","GRG","RBG",0,1,1,1,0,"run051"
"10274","GRG","RBR",0,1,1,0,1,"run051"
"10275","GRG","RGR",1,2,3,1,2,"run051"
"10276","GRG","RRG",2,4,6,2,4,"run051"
"10277","GRR","BBB",0,1,1,1,0,"run051"
"10278","GRR","BBR",0,1,1,0,1,"run051"
"10279","GRR","BGB",1,2,3,1,2,"run051"
"10280","GRR","BGG",0,2,2,1,1,"run051"
"10281","GRR","BRB",0,1,1,1,0,"run051"
"10282","GRR","BRR",0,2,2,0,2,"run051"
"10283","GRR","GGG",0,1,1,0,1,"run051"
"10284","GRR","GGR",0,1,1,1,0,"run051"
"10285","RBB","BBB",0,1,1,1,0,"run051"
"10286","RBB","BBR",0,1,1,1,0,"run051"
"10287","RBB","BRB",0,1,1,0,1,"run051"
"10288","RBB","GRR",0,1,1,1,0,"run051"
"10289","RBB","RGG",0,1,1,1,0,"run051"
"10290","RBG","BBB",2,8,10,0,10,"run051"
"10291","RBG","BBG",0,1,1,1,0,"run051"
"10292","RBG","BRR",0,1,1,1,0,"run051"
"10293","RBG","GBB",0,1,1,1,0,"run051"
"10294","RBG","GRR",0,3,3,3,0,"run051"
"10295","RBG","RBB",1,1,2,0,2,"run051"
"10296","RBG","RBR",0,1,1,0,1,"run051"
"10297","RBG","RGR",0,1,1,0,1,"run051"
"10298","RBR","BBB",0,13,13,10,3,"run051"
"10299","RBR","BBR",0,1,1,0,1,"run051"
"10300","RBR","BGB",2,4,6,5,1,"run051"
"10301","RBR","BGG",0,2,2,2,0,"run051"
"10302","RBR","BRB",1,0,1,0,1,"run051"
"10303","RBR","BRR",1,4,5,0,5,"run051"
"10304","RBR","GGB",0,12,12,8,4,"run051"
"10305","RBR","GRR",4,4,8,2,6,"run051"
"10306","RBR","RBB",0,3,3,0,3,"run051"
"10307","RBR","RGG",2,9,11,9,2,"run051"
"10308","RBR","RGR",1,0,1,1,0,"run051"
"10309","RBR","RRR",0,1,1,1,0,"run051"
"10310","RGG","BBB",0,8,8,6,2,"run051"
"10311","RGG","BBR",1,2,3,0,3,"run051"
"10312","RGG","BGB",0,1,1,0,1,"run051"
"10313","RGG","BRR",0,4,4,1,3,"run051"
"10314","RGG","GGG",0,1,1,0,1,"run051"
"10315","RGG","GGR",0,3,3,2,1,"run051"
"10316","RGG","GRR",0,8,8,8,0,"run051"
"10317","RGG","RBB",0,1,1,1,0,"run051"
"10318","RGR","BBB",2,5,7,4,3,"run051"
"10319","RGR","BBR",1,1,2,1,1,"run051"
"10320","RGR","BGB",2,5,7,6,1,"run051"
"10321","RGR","BGG",2,2,4,3,1,"run051"
"10322","RGR","BRR",1,5,6,2,4,"run051"
"10323","RGR","GGB",2,12,14,1,13,"run051"
"10324","RGR","GGG",0,2,2,0,2,"run051"
"10325","RGR","GGR",0,4,4,4,0,"run051"
"10326","RGR","RBB",0,4,4,3,1,"run051"
"10327","RGR","RGG",1,1,2,2,0,"run051"
"10328","RGR","RRG",0,3,3,3,0,"run051"
"10329","RRG","BBB",2,33,35,35,0,"run051"
"10330","RRG","BBR",0,5,5,1,4,"run051"
"10331","RRG","BGB",1,10,11,6,5,"run051"
"10332","RRG","BGG",0,2,2,0,2,"run051"
"10333","RRG","BRB",2,40,42,35,7,"run051"
"10334","RRG","BRR",1,16,17,14,3,"run051"
"10335","RRG","GGG",2,14,16,5,11,"run051"
"10336","RRG","GGR",0,5,5,3,2,"run051"
"10337","RRG","GRG",1,0,1,1,0,"run051"
"10338","RRG","GRR",3,8,11,8,3,"run051"
"10339","RRG","RBB",1,1,2,1,1,"run051"
"10340","RRG","RGG",0,1,1,1,0,"run051"
"10341","RRG","RGR",0,1,1,0,1,"run051"
"10342","RRR","BBR",1,0,1,0,1,"run051"
"10343","RRR","BGB",2,1,3,3,0,"run051"
"10344","RRR","BGG",1,0,1,1,0,"run051"
"10345","RRR","BRB",1,1,2,1,1,"run051"
"10346","RRR","BRR",1,1,2,1,1,"run051"
"10347","RRR","GGR",0,1,1,1,0,"run051"
"10348","RRR","GRR",0,3,3,1,2,"run051"
"10349","RRR","RBB",1,2,3,1,2,"run051"
"10350","RRR","RBR",0,2,2,0,2,"run051"
"10351","RRR","RGG",0,1,1,1,0,"run051"
"10352","RRR","RGR",1,2,3,0,3,"run051"
"10353","RRR","RRG",2,2,4,2,2,"run051"
"10354","BBB","BRB",0,1,1,0,1,"run052"
"10355","BBB","GGG",1,2,3,1,2,"run052"
"10356","BBB","GRR",0,2,2,2,0,"run052"
"10357","BBB","RBG",0,1,1,0,1,"run052"
"10358","BBB","RRG",1,3,4,4,0,"run052"
"10359","BBB","RRR",0,2,2,0,2,"run052"
"10360","BBG","BBB",1,4,5,5,0,"run052"
"10361","BBG","BGB",0,1,1,0,1,"run052"
"10362","BBG","BGG",0,1,1,1,0,"run052"
"10363","BBG","BRB",1,16,17,2,15,"run052"
"10364","BBG","GBB",0,1,1,0,1,"run052"
"10365","BBG","GBG",2,7,9,4,5,"run052"
"10366","BBG","GGB",2,25,27,27,0,"run052"
"10367","BBG","GGG",4,38,42,29,13,"run052"
"10368","BBG","GRG",1,9,10,1,9,"run052"
"10369","BBG","GRR",0,1,1,1,0,"run052"
"10370","BBG","RBB",0,1,1,1,0,"run052"
"10371","BBG","RBG",0,4,4,3,1,"run052"
"10372","BBG","RBR",0,1,1,0,1,"run052"
"10373","BBG","RGR",0,1,1,0,1,"run052"
"10374","BBG","RRG",1,2,3,1,2,"run052"
"10375","BBG","RRR",0,7,7,6,1,"run052"
"10376","BGB","BBB",0,2,2,1,1,"run052"
"10377","BGB","RRG",0,1,1,1,0,"run052"
"10378","BGG","BBB",0,3,3,0,3,"run052"
"10379","BGG","BBR",0,1,1,0,1,"run052"
"10380","BGG","GRG",0,1,1,1,0,"run052"
"10381","BGG","RBG",1,1,2,0,2,"run052"
"10382","BGG","RGG",0,3,3,2,1,"run052"
"10383","BGG","RGR",0,1,1,1,0,"run052"
"10384","BGG","RRR",1,1,2,2,0,"run052"
"10385","BRB","BBB",0,13,13,0,13,"run052"
"10386","BRB","BBR",0,1,1,0,1,"run052"
"10387","BRB","BRR",0,3,3,3,0,"run052"
"10388","BRB","GGG",0,1,1,1,0,"run052"
"10389","BRB","GGR",0,1,1,0,1,"run052"
"10390","BRB","RBB",0,1,1,0,1,"run052"
"10391","BRB","RBG",0,1,1,1,0,"run052"
"10392","BRB","RGR",0,1,1,1,0,"run052"
"10393","BRB","RRR",0,1,1,0,1,"run052"
"10394","BRR","BBB",0,11,11,2,9,"run052"
"10395","BRR","BGB",1,1,2,2,0,"run052"
"10396","BRR","BGG",0,1,1,1,0,"run052"
"10397","BRR","BRB",0,1,1,1,0,"run052"
"10398","BRR","RBB",0,2,2,2,0,"run052"
"10399","GBB","BBB",12,38,50,1,49,"run052"
"10400","GBB","BGG",0,1,1,0,1,"run052"
"10401","GBB","BRB",1,9,10,10,0,"run052"
"10402","GBB","BRR",1,3,4,2,2,"run052"
"10403","GBB","GBG",0,4,4,3,1,"run052"
"10404","GBB","GGB",0,21,21,15,6,"run052"
"10405","GBB","GGG",7,86,93,43,50,"run052"
"10406","GBB","GGR",1,3,4,2,2,"run052"
"10407","GBB","GRG",0,6,6,6,0,"run052"
"10408","GBB","GRR",0,1,1,0,1,"run052"
"10409","GBB","RBB",0,2,2,1,1,"run052"
"10410","GBB","RBG",3,9,12,10,2,"run052"
"10411","GBB","RBR",1,0,1,1,0,"run052"
"10412","GBB","RGG",1,0,1,0,1,"run052"
"10413","GBB","RGR",2,1,3,2,1,"run052"
"10414","GBB","RRG",0,2,2,1,1,"run052"
"10415","GBB","RRR",1,9,10,9,1,"run052"
"10416","GBG","BBB",0,5,5,4,1,"run052"
"10417","GBG","BBR",0,1,1,1,0,"run052"
"10418","GBG","BRB",1,4,5,4,1,"run052"
"10419","GBG","BRR",1,0,1,1,0,"run052"
"10420","GBG","GGB",0,4,4,0,4,"run052"
"10421","GBG","GGG",4,11,15,2,13,"run052"
"10422","GBG","RBB",1,0,1,1,0,"run052"
"10423","GBG","RBG",0,1,1,0,1,"run052"
"10424","GBG","RGG",0,1,1,1,0,"run052"
"10425","GBG","RGR",1,3,4,4,0,"run052"
"10426","GBG","RRG",1,3,4,0,4,"run052"
"10427","GGB","BBB",3,16,19,1,18,"run052"
"10428","GGB","BBR",1,4,5,2,3,"run052"
"10429","GGB","BGB",0,3,3,0,3,"run052"
"10430","GGB","BGG",0,4,4,4,0,"run052"
"10431","GGB","BRB",0,1,1,1,0,"run052"
"10432","GGB","BRR",1,15,16,4,12,"run052"
"10433","GGB","GBB",0,1,1,0,1,"run052"
"10434","GGB","GBG",1,0,1,0,1,"run052"
"10435","GGB","GGG",13,48,61,55,6,"run052"
"10436","GGB","GGR",0,7,7,4,3,"run052"
"10437","GGB","GRR",0,4,4,1,3,"run052"
"10438","GGB","RBB",0,5,5,4,1,"run052"
"10439","GGB","RBG",0,4,4,3,1,"run052"
"10440","GGB","RBR",0,5,5,1,4,"run052"
"10441","GGB","RGG",1,5,6,0,6,"run052"
"10442","GGB","RGR",0,2,2,1,1,"run052"
"10443","GGB","RRG",1,5,6,5,1,"run052"
"10444","GGB","RRR",1,5,6,1,5,"run052"
"10445","GGG","BBB",8,31,39,26,13,"run052"
"10446","GGG","BGB",0,2,2,0,2,"run052"
"10447","GGG","BGG",1,7,8,1,7,"run052"
"10448","GGG","BRB",1,3,4,4,0,"run052"
"10449","GGG","BRR",0,6,6,6,0,"run052"
"10450","GGG","GGB",5,1,6,1,5,"run052"
"10451","GGG","GGR",1,9,10,7,3,"run052"
"10452","GGG","GRR",0,2,2,1,1,"run052"
"10453","GGG","RBB",1,8,9,1,8,"run052"
"10454","GGG","RBG",0,6,6,0,6,"run052"
"10455","GGG","RBR",0,21,21,18,3,"run052"
"10456","GGG","RGG",0,3,3,0,3,"run052"
"10457","GGG","RGR",1,12,13,10,3,"run052"
"10458","GGG","RRG",1,23,24,19,5,"run052"
"10459","GGG","RRR",0,3,3,3,0,"run052"
"10460","GGR","BBB",0,2,2,1,1,"run052"
"10461","GGR","BBR",0,2,2,1,1,"run052"
"10462","GGR","BGG",0,1,1,1,0,"run052"
"10463","GGR","BRR",1,0,1,1,0,"run052"
"10464","GGR","GRR",1,0,1,1,0,"run052"
"10465","GGR","RBB",0,2,2,0,2,"run052"
"10466","GRG","BBB",3,8,11,1,10,"run052"
"10467","GRG","BBR",0,1,1,0,1,"run052"
"10468","GRG","BGG",0,1,1,1,0,"run052"
"10469","GRG","BRB",0,3,3,2,1,"run052"
"10470","GRG","BRR",0,1,1,0,1,"run052"
"10471","GRG","GBG",0,1,1,0,1,"run052"
"10472","GRG","GGB",2,15,17,3,14,"run052"
"10473","GRG","GGG",3,12,15,13,2,"run052"
"10474","GRG","GGR",0,5,5,1,4,"run052"
"10475","GRG","GRR",0,1,1,1,0,"run052"
"10476","GRG","RBG",0,1,1,1,0,"run052"
"10477","GRG","RBR",0,1,1,1,0,"run052"
"10478","GRG","RGR",1,2,3,0,3,"run052"
"10479","GRG","RRG",2,4,6,6,0,"run052"
"10480","GRR","BBB",0,1,1,1,0,"run052"
"10481","GRR","BBR",0,1,1,0,1,"run052"
"10482","GRR","BGB",1,2,3,1,2,"run052"
"10483","GRR","BGG",0,2,2,2,0,"run052"
"10484","GRR","BRB",0,1,1,1,0,"run052"
"10485","GRR","BRR",0,2,2,2,0,"run052"
"10486","GRR","GGG",0,1,1,0,1,"run052"
"10487","GRR","GGR",0,1,1,1,0,"run052"
"10488","RBB","BBB",0,1,1,1,0,"run052"
"10489","RBB","BBR",0,1,1,0,1,"run052"
"10490","RBB","BRB",0,1,1,1,0,"run052"
"10491","RBB","GRR",0,1,1,1,0,"run052"
"10492","RBB","RGG",0,1,1,1,0,"run052"
"10493","RBG","BBB",2,8,10,1,9,"run052"
"10494","RBG","BBG",0,1,1,0,1,"run052"
"10495","RBG","BRR",0,1,1,0,1,"run052"
"10496","RBG","GBB",0,1,1,1,0,"run052"
"10497","RBG","GRR",0,3,3,0,3,"run052"
"10498","RBG","RBB",1,1,2,1,1,"run052"
"10499","RBG","RBR",0,1,1,1,0,"run052"
"10500","RBG","RGR",0,1,1,0,1,"run052"
"10501","RBR","BBB",0,13,13,13,0,"run052"
"10502","RBR","BBR",0,1,1,1,0,"run052"
"10503","RBR","BGB",2,4,6,2,4,"run052"
"10504","RBR","BGG",0,2,2,1,1,"run052"
"10505","RBR","BRB",1,0,1,0,1,"run052"
"10506","RBR","BRR",1,4,5,0,5,"run052"
"10507","RBR","GGB",0,12,12,4,8,"run052"
"10508","RBR","GRR",4,4,8,0,8,"run052"
"10509","RBR","RBB",0,3,3,3,0,"run052"
"10510","RBR","RGG",2,9,11,4,7,"run052"
"10511","RBR","RGR",1,0,1,0,1,"run052"
"10512","RBR","RRR",0,1,1,0,1,"run052"
"10513","RGG","BBB",0,8,8,1,7,"run052"
"10514","RGG","BBR",1,2,3,3,0,"run052"
"10515","RGG","BGB",0,1,1,0,1,"run052"
"10516","RGG","BRR",0,4,4,1,3,"run052"
"10517","RGG","GGG",0,1,1,1,0,"run052"
"10518","RGG","GGR",0,3,3,1,2,"run052"
"10519","RGG","GRR",0,8,8,5,3,"run052"
"10520","RGG","RBB",0,1,1,0,1,"run052"
"10521","RGR","BBB",2,5,7,0,7,"run052"
"10522","RGR","BBR",1,1,2,1,1,"run052"
"10523","RGR","BGB",2,5,7,4,3,"run052"
"10524","RGR","BGG",2,2,4,3,1,"run052"
"10525","RGR","BRR",1,5,6,3,3,"run052"
"10526","RGR","GGB",2,12,14,1,13,"run052"
"10527","RGR","GGG",0,2,2,0,2,"run052"
"10528","RGR","GGR",0,4,4,3,1,"run052"
"10529","RGR","RBB",0,4,4,0,4,"run052"
"10530","RGR","RGG",1,1,2,1,1,"run052"
"10531","RGR","RRG",0,3,3,1,2,"run052"
"10532","RRG","BBB",2,33,35,9,26,"run052"
"10533","RRG","BBR",0,5,5,4,1,"run052"
"10534","RRG","BGB",1,10,11,2,9,"run052"
"10535","RRG","BGG",0,2,2,0,2,"run052"
"10536","RRG","BRB",2,40,42,33,9,"run052"
"10537","RRG","BRR",1,16,17,10,7,"run052"
"10538","RRG","GGG",2,14,16,10,6,"run052"
"10539","RRG","GGR",0,5,5,1,4,"run052"
"10540","RRG","GRG",1,0,1,0,1,"run052"
"10541","RRG","GRR",3,8,11,9,2,"run052"
"10542","RRG","RBB",1,1,2,1,1,"run052"
"10543","RRG","RGG",0,1,1,1,0,"run052"
"10544","RRG","RGR",0,1,1,0,1,"run052"
"10545","RRR","BBR",1,0,1,0,1,"run052"
"10546","RRR","BGB",2,1,3,2,1,"run052"
"10547","RRR","BGG",1,0,1,0,1,"run052"
"10548","RRR","BRB",1,1,2,1,1,"run052"
"10549","RRR","BRR",1,1,2,1,1,"run052"
"10550","RRR","GGR",0,1,1,0,1,"run052"
"10551","RRR","GRR",0,3,3,1,2,"run052"
"10552","RRR","RBB",1,2,3,0,3,"run052"
"10553","RRR","RBR",0,2,2,2,0,"run052"
"10554","RRR","RGG",0,1,1,1,0,"run052"
"10555","RRR","RGR",1,2,3,0,3,"run052"
"10556","RRR","RRG",2,2,4,4,0,"run052"
"10557","BBB","BRB",0,1,1,1,0,"run053"
"10558","BBB","GGG",1,2,3,3,0,"run053"
"10559","BBB","GRR",0,2,2,2,0,"run053"
"10560","BBB","RBG",0,1,1,1,0,"run053"
"10561","BBB","RRG",1,3,4,4,0,"run053"
"10562","BBB","RRR",0,2,2,0,2,"run053"
"10563","BBG","BBB",1,4,5,4,1,"run053"
"10564","BBG","BGB",0,1,1,0,1,"run053"
"10565","BBG","BGG",0,1,1,0,1,"run053"
"10566","BBG","BRB",1,16,17,0,17,"run053"
"10567","BBG","GBB",0,1,1,1,0,"run053"
"10568","BBG","GBG",2,7,9,9,0,"run053"
"10569","BBG","GGB",2,25,27,16,11,"run053"
"10570","BBG","GGG",4,38,42,33,9,"run053"
"10571","BBG","GRG",1,9,10,6,4,"run053"
"10572","BBG","GRR",0,1,1,0,1,"run053"
"10573","BBG","RBB",0,1,1,1,0,"run053"
"10574","BBG","RBG",0,4,4,4,0,"run053"
"10575","BBG","RBR",0,1,1,0,1,"run053"
"10576","BBG","RGR",0,1,1,1,0,"run053"
"10577","BBG","RRG",1,2,3,0,3,"run053"
"10578","BBG","RRR",0,7,7,3,4,"run053"
"10579","BGB","BBB",0,2,2,2,0,"run053"
"10580","BGB","RRG",0,1,1,1,0,"run053"
"10581","BGG","BBB",0,3,3,0,3,"run053"
"10582","BGG","BBR",0,1,1,0,1,"run053"
"10583","BGG","GRG",0,1,1,1,0,"run053"
"10584","BGG","RBG",1,1,2,0,2,"run053"
"10585","BGG","RGG",0,3,3,1,2,"run053"
"10586","BGG","RGR",0,1,1,1,0,"run053"
"10587","BGG","RRR",1,1,2,0,2,"run053"
"10588","BRB","BBB",0,13,13,12,1,"run053"
"10589","BRB","BBR",0,1,1,1,0,"run053"
"10590","BRB","BRR",0,3,3,2,1,"run053"
"10591","BRB","GGG",0,1,1,1,0,"run053"
"10592","BRB","GGR",0,1,1,0,1,"run053"
"10593","BRB","RBB",0,1,1,0,1,"run053"
"10594","BRB","RBG",0,1,1,1,0,"run053"
"10595","BRB","RGR",0,1,1,0,1,"run053"
"10596","BRB","RRR",0,1,1,0,1,"run053"
"10597","BRR","BBB",0,11,11,1,10,"run053"
"10598","BRR","BGB",1,1,2,0,2,"run053"
"10599","BRR","BGG",0,1,1,1,0,"run053"
"10600","BRR","BRB",0,1,1,1,0,"run053"
"10601","BRR","RBB",0,2,2,1,1,"run053"
"10602","GBB","BBB",12,38,50,18,32,"run053"
"10603","GBB","BGG",0,1,1,1,0,"run053"
"10604","GBB","BRB",1,9,10,4,6,"run053"
"10605","GBB","BRR",1,3,4,0,4,"run053"
"10606","GBB","GBG",0,4,4,3,1,"run053"
"10607","GBB","GGB",0,21,21,19,2,"run053"
"10608","GBB","GGG",7,86,93,90,3,"run053"
"10609","GBB","GGR",1,3,4,1,3,"run053"
"10610","GBB","GRG",0,6,6,3,3,"run053"
"10611","GBB","GRR",0,1,1,1,0,"run053"
"10612","GBB","RBB",0,2,2,1,1,"run053"
"10613","GBB","RBG",3,9,12,2,10,"run053"
"10614","GBB","RBR",1,0,1,0,1,"run053"
"10615","GBB","RGG",1,0,1,1,0,"run053"
"10616","GBB","RGR",2,1,3,2,1,"run053"
"10617","GBB","RRG",0,2,2,0,2,"run053"
"10618","GBB","RRR",1,9,10,3,7,"run053"
"10619","GBG","BBB",0,5,5,2,3,"run053"
"10620","GBG","BBR",0,1,1,1,0,"run053"
"10621","GBG","BRB",1,4,5,3,2,"run053"
"10622","GBG","BRR",1,0,1,1,0,"run053"
"10623","GBG","GGB",0,4,4,4,0,"run053"
"10624","GBG","GGG",4,11,15,7,8,"run053"
"10625","GBG","RBB",1,0,1,1,0,"run053"
"10626","GBG","RBG",0,1,1,0,1,"run053"
"10627","GBG","RGG",0,1,1,0,1,"run053"
"10628","GBG","RGR",1,3,4,4,0,"run053"
"10629","GBG","RRG",1,3,4,0,4,"run053"
"10630","GGB","BBB",3,16,19,14,5,"run053"
"10631","GGB","BBR",1,4,5,4,1,"run053"
"10632","GGB","BGB",0,3,3,2,1,"run053"
"10633","GGB","BGG",0,4,4,2,2,"run053"
"10634","GGB","BRB",0,1,1,1,0,"run053"
"10635","GGB","BRR",1,15,16,9,7,"run053"
"10636","GGB","GBB",0,1,1,0,1,"run053"
"10637","GGB","GBG",1,0,1,1,0,"run053"
"10638","GGB","GGG",13,48,61,11,50,"run053"
"10639","GGB","GGR",0,7,7,4,3,"run053"
"10640","GGB","GRR",0,4,4,2,2,"run053"
"10641","GGB","RBB",0,5,5,5,0,"run053"
"10642","GGB","RBG",0,4,4,1,3,"run053"
"10643","GGB","RBR",0,5,5,5,0,"run053"
"10644","GGB","RGG",1,5,6,1,5,"run053"
"10645","GGB","RGR",0,2,2,1,1,"run053"
"10646","GGB","RRG",1,5,6,3,3,"run053"
"10647","GGB","RRR",1,5,6,2,4,"run053"
"10648","GGG","BBB",8,31,39,30,9,"run053"
"10649","GGG","BGB",0,2,2,1,1,"run053"
"10650","GGG","BGG",1,7,8,6,2,"run053"
"10651","GGG","BRB",1,3,4,2,2,"run053"
"10652","GGG","BRR",0,6,6,4,2,"run053"
"10653","GGG","GGB",5,1,6,6,0,"run053"
"10654","GGG","GGR",1,9,10,3,7,"run053"
"10655","GGG","GRR",0,2,2,2,0,"run053"
"10656","GGG","RBB",1,8,9,6,3,"run053"
"10657","GGG","RBG",0,6,6,3,3,"run053"
"10658","GGG","RBR",0,21,21,18,3,"run053"
"10659","GGG","RGG",0,3,3,3,0,"run053"
"10660","GGG","RGR",1,12,13,7,6,"run053"
"10661","GGG","RRG",1,23,24,10,14,"run053"
"10662","GGG","RRR",0,3,3,1,2,"run053"
"10663","GGR","BBB",0,2,2,0,2,"run053"
"10664","GGR","BBR",0,2,2,2,0,"run053"
"10665","GGR","BGG",0,1,1,0,1,"run053"
"10666","GGR","BRR",1,0,1,0,1,"run053"
"10667","GGR","GRR",1,0,1,0,1,"run053"
"10668","GGR","RBB",0,2,2,2,0,"run053"
"10669","GRG","BBB",3,8,11,5,6,"run053"
"10670","GRG","BBR",0,1,1,0,1,"run053"
"10671","GRG","BGG",0,1,1,0,1,"run053"
"10672","GRG","BRB",0,3,3,1,2,"run053"
"10673","GRG","BRR",0,1,1,1,0,"run053"
"10674","GRG","GBG",0,1,1,0,1,"run053"
"10675","GRG","GGB",2,15,17,3,14,"run053"
"10676","GRG","GGG",3,12,15,13,2,"run053"
"10677","GRG","GGR",0,5,5,5,0,"run053"
"10678","GRG","GRR",0,1,1,0,1,"run053"
"10679","GRG","RBG",0,1,1,1,0,"run053"
"10680","GRG","RBR",0,1,1,0,1,"run053"
"10681","GRG","RGR",1,2,3,3,0,"run053"
"10682","GRG","RRG",2,4,6,2,4,"run053"
"10683","GRR","BBB",0,1,1,0,1,"run053"
"10684","GRR","BBR",0,1,1,0,1,"run053"
"10685","GRR","BGB",1,2,3,0,3,"run053"
"10686","GRR","BGG",0,2,2,1,1,"run053"
"10687","GRR","BRB",0,1,1,1,0,"run053"
"10688","GRR","BRR",0,2,2,1,1,"run053"
"10689","GRR","GGG",0,1,1,0,1,"run053"
"10690","GRR","GGR",0,1,1,1,0,"run053"
"10691","RBB","BBB",0,1,1,0,1,"run053"
"10692","RBB","BBR",0,1,1,1,0,"run053"
"10693","RBB","BRB",0,1,1,1,0,"run053"
"10694","RBB","GRR",0,1,1,1,0,"run053"
"10695","RBB","RGG",0,1,1,0,1,"run053"
"10696","RBG","BBB",2,8,10,7,3,"run053"
"10697","RBG","BBG",0,1,1,0,1,"run053"
"10698","RBG","BRR",0,1,1,0,1,"run053"
"10699","RBG","GBB",0,1,1,0,1,"run053"
"10700","RBG","GRR",0,3,3,1,2,"run053"
"10701","RBG","RBB",1,1,2,2,0,"run053"
"10702","RBG","RBR",0,1,1,1,0,"run053"
"10703","RBG","RGR",0,1,1,1,0,"run053"
"10704","RBR","BBB",0,13,13,1,12,"run053"
"10705","RBR","BBR",0,1,1,1,0,"run053"
"10706","RBR","BGB",2,4,6,1,5,"run053"
"10707","RBR","BGG",0,2,2,0,2,"run053"
"10708","RBR","BRB",1,0,1,1,0,"run053"
"10709","RBR","BRR",1,4,5,4,1,"run053"
"10710","RBR","GGB",0,12,12,3,9,"run053"
"10711","RBR","GRR",4,4,8,0,8,"run053"
"10712","RBR","RBB",0,3,3,0,3,"run053"
"10713","RBR","RGG",2,9,11,11,0,"run053"
"10714","RBR","RGR",1,0,1,1,0,"run053"
"10715","RBR","RRR",0,1,1,0,1,"run053"
"10716","RGG","BBB",0,8,8,1,7,"run053"
"10717","RGG","BBR",1,2,3,2,1,"run053"
"10718","RGG","BGB",0,1,1,1,0,"run053"
"10719","RGG","BRR",0,4,4,2,2,"run053"
"10720","RGG","GGG",0,1,1,0,1,"run053"
"10721","RGG","GGR",0,3,3,0,3,"run053"
"10722","RGG","GRR",0,8,8,0,8,"run053"
"10723","RGG","RBB",0,1,1,0,1,"run053"
"10724","RGR","BBB",2,5,7,2,5,"run053"
"10725","RGR","BBR",1,1,2,0,2,"run053"
"10726","RGR","BGB",2,5,7,3,4,"run053"
"10727","RGR","BGG",2,2,4,3,1,"run053"
"10728","RGR","BRR",1,5,6,0,6,"run053"
"10729","RGR","GGB",2,12,14,2,12,"run053"
"10730","RGR","GGG",0,2,2,1,1,"run053"
"10731","RGR","GGR",0,4,4,0,4,"run053"
"10732","RGR","RBB",0,4,4,2,2,"run053"
"10733","RGR","RGG",1,1,2,0,2,"run053"
"10734","RGR","RRG",0,3,3,2,1,"run053"
"10735","RRG","BBB",2,33,35,12,23,"run053"
"10736","RRG","BBR",0,5,5,1,4,"run053"
"10737","RRG","BGB",1,10,11,4,7,"run053"
"10738","RRG","BGG",0,2,2,1,1,"run053"
"10739","RRG","BRB",2,40,42,0,42,"run053"
"10740","RRG","BRR",1,16,17,4,13,"run053"
"10741","RRG","GGG",2,14,16,12,4,"run053"
"10742","RRG","GGR",0,5,5,2,3,"run053"
"10743","RRG","GRG",1,0,1,1,0,"run053"
"10744","RRG","GRR",3,8,11,2,9,"run053"
"10745","RRG","RBB",1,1,2,1,1,"run053"
"10746","RRG","RGG",0,1,1,0,1,"run053"
"10747","RRG","RGR",0,1,1,1,0,"run053"
"10748","RRR","BBR",1,0,1,1,0,"run053"
"10749","RRR","BGB",2,1,3,2,1,"run053"
"10750","RRR","BGG",1,0,1,0,1,"run053"
"10751","RRR","BRB",1,1,2,2,0,"run053"
"10752","RRR","BRR",1,1,2,0,2,"run053"
"10753","RRR","GGR",0,1,1,1,0,"run053"
"10754","RRR","GRR",0,3,3,3,0,"run053"
"10755","RRR","RBB",1,2,3,2,1,"run053"
"10756","RRR","RBR",0,2,2,1,1,"run053"
"10757","RRR","RGG",0,1,1,1,0,"run053"
"10758","RRR","RGR",1,2,3,3,0,"run053"
"10759","RRR","RRG",2,2,4,0,4,"run053"
"10760","BBB","BRB",0,1,1,1,0,"run054"
"10761","BBB","GGG",1,2,3,2,1,"run054"
"10762","BBB","GRR",0,2,2,2,0,"run054"
"10763","BBB","RBG",0,1,1,1,0,"run054"
"10764","BBB","RRG",1,3,4,1,3,"run054"
"10765","BBB","RRR",0,2,2,2,0,"run054"
"10766","BBG","BBB",1,4,5,4,1,"run054"
"10767","BBG","BGB",0,1,1,1,0,"run054"
"10768","BBG","BGG",0,1,1,1,0,"run054"
"10769","BBG","BRB",1,16,17,15,2,"run054"
"10770","BBG","GBB",0,1,1,0,1,"run054"
"10771","BBG","GBG",2,7,9,3,6,"run054"
"10772","BBG","GGB",2,25,27,10,17,"run054"
"10773","BBG","GGG",4,38,42,33,9,"run054"
"10774","BBG","GRG",1,9,10,8,2,"run054"
"10775","BBG","GRR",0,1,1,0,1,"run054"
"10776","BBG","RBB",0,1,1,0,1,"run054"
"10777","BBG","RBG",0,4,4,2,2,"run054"
"10778","BBG","RBR",0,1,1,0,1,"run054"
"10779","BBG","RGR",0,1,1,1,0,"run054"
"10780","BBG","RRG",1,2,3,0,3,"run054"
"10781","BBG","RRR",0,7,7,2,5,"run054"
"10782","BGB","BBB",0,2,2,0,2,"run054"
"10783","BGB","RRG",0,1,1,1,0,"run054"
"10784","BGG","BBB",0,3,3,2,1,"run054"
"10785","BGG","BBR",0,1,1,0,1,"run054"
"10786","BGG","GRG",0,1,1,1,0,"run054"
"10787","BGG","RBG",1,1,2,2,0,"run054"
"10788","BGG","RGG",0,3,3,2,1,"run054"
"10789","BGG","RGR",0,1,1,1,0,"run054"
"10790","BGG","RRR",1,1,2,1,1,"run054"
"10791","BRB","BBB",0,13,13,1,12,"run054"
"10792","BRB","BBR",0,1,1,0,1,"run054"
"10793","BRB","BRR",0,3,3,1,2,"run054"
"10794","BRB","GGG",0,1,1,0,1,"run054"
"10795","BRB","GGR",0,1,1,1,0,"run054"
"10796","BRB","RBB",0,1,1,1,0,"run054"
"10797","BRB","RBG",0,1,1,0,1,"run054"
"10798","BRB","RGR",0,1,1,1,0,"run054"
"10799","BRB","RRR",0,1,1,1,0,"run054"
"10800","BRR","BBB",0,11,11,5,6,"run054"
"10801","BRR","BGB",1,1,2,0,2,"run054"
"10802","BRR","BGG",0,1,1,0,1,"run054"
"10803","BRR","BRB",0,1,1,0,1,"run054"
"10804","BRR","RBB",0,2,2,2,0,"run054"
"10805","GBB","BBB",12,38,50,5,45,"run054"
"10806","GBB","BGG",0,1,1,1,0,"run054"
"10807","GBB","BRB",1,9,10,1,9,"run054"
"10808","GBB","BRR",1,3,4,0,4,"run054"
"10809","GBB","GBG",0,4,4,1,3,"run054"
"10810","GBB","GGB",0,21,21,11,10,"run054"
"10811","GBB","GGG",7,86,93,29,64,"run054"
"10812","GBB","GGR",1,3,4,0,4,"run054"
"10813","GBB","GRG",0,6,6,5,1,"run054"
"10814","GBB","GRR",0,1,1,0,1,"run054"
"10815","GBB","RBB",0,2,2,2,0,"run054"
"10816","GBB","RBG",3,9,12,9,3,"run054"
"10817","GBB","RBR",1,0,1,1,0,"run054"
"10818","GBB","RGG",1,0,1,0,1,"run054"
"10819","GBB","RGR",2,1,3,1,2,"run054"
"10820","GBB","RRG",0,2,2,2,0,"run054"
"10821","GBB","RRR",1,9,10,10,0,"run054"
"10822","GBG","BBB",0,5,5,5,0,"run054"
"10823","GBG","BBR",0,1,1,1,0,"run054"
"10824","GBG","BRB",1,4,5,0,5,"run054"
"10825","GBG","BRR",1,0,1,0,1,"run054"
"10826","GBG","GGB",0,4,4,0,4,"run054"
"10827","GBG","GGG",4,11,15,9,6,"run054"
"10828","GBG","RBB",1,0,1,1,0,"run054"
"10829","GBG","RBG",0,1,1,1,0,"run054"
"10830","GBG","RGG",0,1,1,1,0,"run054"
"10831","GBG","RGR",1,3,4,0,4,"run054"
"10832","GBG","RRG",1,3,4,3,1,"run054"
"10833","GGB","BBB",3,16,19,9,10,"run054"
"10834","GGB","BBR",1,4,5,3,2,"run054"
"10835","GGB","BGB",0,3,3,2,1,"run054"
"10836","GGB","BGG",0,4,4,4,0,"run054"
"10837","GGB","BRB",0,1,1,1,0,"run054"
"10838","GGB","BRR",1,15,16,10,6,"run054"
"10839","GGB","GBB",0,1,1,0,1,"run054"
"10840","GGB","GBG",1,0,1,0,1,"run054"
"10841","GGB","GGG",13,48,61,23,38,"run054"
"10842","GGB","GGR",0,7,7,1,6,"run054"
"10843","GGB","GRR",0,4,4,1,3,"run054"
"10844","GGB","RBB",0,5,5,5,0,"run054"
"10845","GGB","RBG",0,4,4,3,1,"run054"
"10846","GGB","RBR",0,5,5,3,2,"run054"
"10847","GGB","RGG",1,5,6,4,2,"run054"
"10848","GGB","RGR",0,2,2,0,2,"run054"
"10849","GGB","RRG",1,5,6,1,5,"run054"
"10850","GGB","RRR",1,5,6,6,0,"run054"
"10851","GGG","BBB",8,31,39,3,36,"run054"
"10852","GGG","BGB",0,2,2,1,1,"run054"
"10853","GGG","BGG",1,7,8,4,4,"run054"
"10854","GGG","BRB",1,3,4,3,1,"run054"
"10855","GGG","BRR",0,6,6,5,1,"run054"
"10856","GGG","GGB",5,1,6,4,2,"run054"
"10857","GGG","GGR",1,9,10,7,3,"run054"
"10858","GGG","GRR",0,2,2,1,1,"run054"
"10859","GGG","RBB",1,8,9,0,9,"run054"
"10860","GGG","RBG",0,6,6,4,2,"run054"
"10861","GGG","RBR",0,21,21,11,10,"run054"
"10862","GGG","RGG",0,3,3,3,0,"run054"
"10863","GGG","RGR",1,12,13,11,2,"run054"
"10864","GGG","RRG",1,23,24,17,7,"run054"
"10865","GGG","RRR",0,3,3,1,2,"run054"
"10866","GGR","BBB",0,2,2,2,0,"run054"
"10867","GGR","BBR",0,2,2,1,1,"run054"
"10868","GGR","BGG",0,1,1,1,0,"run054"
"10869","GGR","BRR",1,0,1,0,1,"run054"
"10870","GGR","GRR",1,0,1,1,0,"run054"
"10871","GGR","RBB",0,2,2,0,2,"run054"
"10872","GRG","BBB",3,8,11,3,8,"run054"
"10873","GRG","BBR",0,1,1,0,1,"run054"
"10874","GRG","BGG",0,1,1,0,1,"run054"
"10875","GRG","BRB",0,3,3,3,0,"run054"
"10876","GRG","BRR",0,1,1,1,0,"run054"
"10877","GRG","GBG",0,1,1,0,1,"run054"
"10878","GRG","GGB",2,15,17,15,2,"run054"
"10879","GRG","GGG",3,12,15,6,9,"run054"
"10880","GRG","GGR",0,5,5,2,3,"run054"
"10881","GRG","GRR",0,1,1,0,1,"run054"
"10882","GRG","RBG",0,1,1,0,1,"run054"
"10883","GRG","RBR",0,1,1,0,1,"run054"
"10884","GRG","RGR",1,2,3,0,3,"run054"
"10885","GRG","RRG",2,4,6,4,2,"run054"
"10886","GRR","BBB",0,1,1,1,0,"run054"
"10887","GRR","BBR",0,1,1,1,0,"run054"
"10888","GRR","BGB",1,2,3,3,0,"run054"
"10889","GRR","BGG",0,2,2,0,2,"run054"
"10890","GRR","BRB",0,1,1,0,1,"run054"
"10891","GRR","BRR",0,2,2,0,2,"run054"
"10892","GRR","GGG",0,1,1,1,0,"run054"
"10893","GRR","GGR",0,1,1,0,1,"run054"
"10894","RBB","BBB",0,1,1,1,0,"run054"
"10895","RBB","BBR",0,1,1,1,0,"run054"
"10896","RBB","BRB",0,1,1,1,0,"run054"
"10897","RBB","GRR",0,1,1,1,0,"run054"
"10898","RBB","RGG",0,1,1,1,0,"run054"
"10899","RBG","BBB",2,8,10,1,9,"run054"
"10900","RBG","BBG",0,1,1,0,1,"run054"
"10901","RBG","BRR",0,1,1,0,1,"run054"
"10902","RBG","GBB",0,1,1,1,0,"run054"
"10903","RBG","GRR",0,3,3,0,3,"run054"
"10904","RBG","RBB",1,1,2,2,0,"run054"
"10905","RBG","RBR",0,1,1,1,0,"run054"
"10906","RBG","RGR",0,1,1,1,0,"run054"
"10907","RBR","BBB",0,13,13,11,2,"run054"
"10908","RBR","BBR",0,1,1,1,0,"run054"
"10909","RBR","BGB",2,4,6,3,3,"run054"
"10910","RBR","BGG",0,2,2,0,2,"run054"
"10911","RBR","BRB",1,0,1,0,1,"run054"
"10912","RBR","BRR",1,4,5,5,0,"run054"
"10913","RBR","GGB",0,12,12,8,4,"run054"
"10914","RBR","GRR",4,4,8,0,8,"run054"
"10915","RBR","RBB",0,3,3,1,2,"run054"
"10916","RBR","RGG",2,9,11,4,7,"run054"
"10917","RBR","RGR",1,0,1,1,0,"run054"
"10918","RBR","RRR",0,1,1,0,1,"run054"
"10919","RGG","BBB",0,8,8,1,7,"run054"
"10920","RGG","BBR",1,2,3,2,1,"run054"
"10921","RGG","BGB",0,1,1,0,1,"run054"
"10922","RGG","BRR",0,4,4,0,4,"run054"
"10923","RGG","GGG",0,1,1,0,1,"run054"
"10924","RGG","GGR",0,3,3,0,3,"run054"
"10925","RGG","GRR",0,8,8,1,7,"run054"
"10926","RGG","RBB",0,1,1,1,0,"run054"
"10927","RGR","BBB",2,5,7,0,7,"run054"
"10928","RGR","BBR",1,1,2,0,2,"run054"
"10929","RGR","BGB",2,5,7,5,2,"run054"
"10930","RGR","BGG",2,2,4,4,0,"run054"
"10931","RGR","BRR",1,5,6,6,0,"run054"
"10932","RGR","GGB",2,12,14,12,2,"run054"
"10933","RGR","GGG",0,2,2,1,1,"run054"
"10934","RGR","GGR",0,4,4,3,1,"run054"
"10935","RGR","RBB",0,4,4,3,1,"run054"
"10936","RGR","RGG",1,1,2,2,0,"run054"
"10937","RGR","RRG",0,3,3,1,2,"run054"
"10938","RRG","BBB",2,33,35,13,22,"run054"
"10939","RRG","BBR",0,5,5,1,4,"run054"
"10940","RRG","BGB",1,10,11,0,11,"run054"
"10941","RRG","BGG",0,2,2,0,2,"run054"
"10942","RRG","BRB",2,40,42,13,29,"run054"
"10943","RRG","BRR",1,16,17,17,0,"run054"
"10944","RRG","GGG",2,14,16,6,10,"run054"
"10945","RRG","GGR",0,5,5,2,3,"run054"
"10946","RRG","GRG",1,0,1,1,0,"run054"
"10947","RRG","GRR",3,8,11,8,3,"run054"
"10948","RRG","RBB",1,1,2,2,0,"run054"
"10949","RRG","RGG",0,1,1,0,1,"run054"
"10950","RRG","RGR",0,1,1,0,1,"run054"
"10951","RRR","BBR",1,0,1,0,1,"run054"
"10952","RRR","BGB",2,1,3,1,2,"run054"
"10953","RRR","BGG",1,0,1,0,1,"run054"
"10954","RRR","BRB",1,1,2,1,1,"run054"
"10955","RRR","BRR",1,1,2,0,2,"run054"
"10956","RRR","GGR",0,1,1,1,0,"run054"
"10957","RRR","GRR",0,3,3,1,2,"run054"
"10958","RRR","RBB",1,2,3,2,1,"run054"
"10959","RRR","RBR",0,2,2,2,0,"run054"
"10960","RRR","RGG",0,1,1,0,1,"run054"
"10961","RRR","RGR",1,2,3,1,2,"run054"
"10962","RRR","RRG",2,2,4,1,3,"run054"
"10963","BBB","BRB",0,1,1,1,0,"run055"
"10964","BBB","GGG",1,2,3,1,2,"run055"
"10965","BBB","GRR",0,2,2,2,0,"run055"
"10966","BBB","RBG",0,1,1,0,1,"run055"
"10967","BBB","RRG",1,3,4,0,4,"run055"
"10968","BBB","RRR",0,2,2,1,1,"run055"
"10969","BBG","BBB",1,4,5,4,1,"run055"
"10970","BBG","BGB",0,1,1,1,0,"run055"
"10971","BBG","BGG",0,1,1,1,0,"run055"
"10972","BBG","BRB",1,16,17,1,16,"run055"
"10973","BBG","GBB",0,1,1,1,0,"run055"
"10974","BBG","GBG",2,7,9,1,8,"run055"
"10975","BBG","GGB",2,25,27,6,21,"run055"
"10976","BBG","GGG",4,38,42,36,6,"run055"
"10977","BBG","GRG",1,9,10,1,9,"run055"
"10978","BBG","GRR",0,1,1,1,0,"run055"
"10979","BBG","RBB",0,1,1,1,0,"run055"
"10980","BBG","RBG",0,4,4,3,1,"run055"
"10981","BBG","RBR",0,1,1,1,0,"run055"
"10982","BBG","RGR",0,1,1,0,1,"run055"
"10983","BBG","RRG",1,2,3,2,1,"run055"
"10984","BBG","RRR",0,7,7,7,0,"run055"
"10985","BGB","BBB",0,2,2,1,1,"run055"
"10986","BGB","RRG",0,1,1,1,0,"run055"
"10987","BGG","BBB",0,3,3,0,3,"run055"
"10988","BGG","BBR",0,1,1,1,0,"run055"
"10989","BGG","GRG",0,1,1,0,1,"run055"
"10990","BGG","RBG",1,1,2,2,0,"run055"
"10991","BGG","RGG",0,3,3,3,0,"run055"
"10992","BGG","RGR",0,1,1,0,1,"run055"
"10993","BGG","RRR",1,1,2,1,1,"run055"
"10994","BRB","BBB",0,13,13,13,0,"run055"
"10995","BRB","BBR",0,1,1,1,0,"run055"
"10996","BRB","BRR",0,3,3,1,2,"run055"
"10997","BRB","GGG",0,1,1,1,0,"run055"
"10998","BRB","GGR",0,1,1,1,0,"run055"
"10999","BRB","RBB",0,1,1,1,0,"run055"
"11000","BRB","RBG",0,1,1,0,1,"run055"
"11001","BRB","RGR",0,1,1,1,0,"run055"
"11002","BRB","RRR",0,1,1,1,0,"run055"
"11003","BRR","BBB",0,11,11,9,2,"run055"
"11004","BRR","BGB",1,1,2,2,0,"run055"
"11005","BRR","BGG",0,1,1,1,0,"run055"
"11006","BRR","BRB",0,1,1,1,0,"run055"
"11007","BRR","RBB",0,2,2,1,1,"run055"
"11008","GBB","BBB",12,38,50,34,16,"run055"
"11009","GBB","BGG",0,1,1,0,1,"run055"
"11010","GBB","BRB",1,9,10,6,4,"run055"
"11011","GBB","BRR",1,3,4,1,3,"run055"
"11012","GBB","GBG",0,4,4,4,0,"run055"
"11013","GBB","GGB",0,21,21,16,5,"run055"
"11014","GBB","GGG",7,86,93,36,57,"run055"
"11015","GBB","GGR",1,3,4,1,3,"run055"
"11016","GBB","GRG",0,6,6,1,5,"run055"
"11017","GBB","GRR",0,1,1,1,0,"run055"
"11018","GBB","RBB",0,2,2,2,0,"run055"
"11019","GBB","RBG",3,9,12,11,1,"run055"
"11020","GBB","RBR",1,0,1,1,0,"run055"
"11021","GBB","RGG",1,0,1,0,1,"run055"
"11022","GBB","RGR",2,1,3,3,0,"run055"
"11023","GBB","RRG",0,2,2,0,2,"run055"
"11024","GBB","RRR",1,9,10,2,8,"run055"
"11025","GBG","BBB",0,5,5,4,1,"run055"
"11026","GBG","BBR",0,1,1,1,0,"run055"
"11027","GBG","BRB",1,4,5,1,4,"run055"
"11028","GBG","BRR",1,0,1,1,0,"run055"
"11029","GBG","GGB",0,4,4,4,0,"run055"
"11030","GBG","GGG",4,11,15,0,15,"run055"
"11031","GBG","RBB",1,0,1,1,0,"run055"
"11032","GBG","RBG",0,1,1,0,1,"run055"
"11033","GBG","RGG",0,1,1,1,0,"run055"
"11034","GBG","RGR",1,3,4,3,1,"run055"
"11035","GBG","RRG",1,3,4,2,2,"run055"
"11036","GGB","BBB",3,16,19,16,3,"run055"
"11037","GGB","BBR",1,4,5,0,5,"run055"
"11038","GGB","BGB",0,3,3,0,3,"run055"
"11039","GGB","BGG",0,4,4,2,2,"run055"
"11040","GGB","BRB",0,1,1,1,0,"run055"
"11041","GGB","BRR",1,15,16,13,3,"run055"
"11042","GGB","GBB",0,1,1,0,1,"run055"
"11043","GGB","GBG",1,0,1,0,1,"run055"
"11044","GGB","GGG",13,48,61,25,36,"run055"
"11045","GGB","GGR",0,7,7,6,1,"run055"
"11046","GGB","GRR",0,4,4,3,1,"run055"
"11047","GGB","RBB",0,5,5,1,4,"run055"
"11048","GGB","RBG",0,4,4,0,4,"run055"
"11049","GGB","RBR",0,5,5,4,1,"run055"
"11050","GGB","RGG",1,5,6,4,2,"run055"
"11051","GGB","RGR",0,2,2,2,0,"run055"
"11052","GGB","RRG",1,5,6,0,6,"run055"
"11053","GGB","RRR",1,5,6,4,2,"run055"
"11054","GGG","BBB",8,31,39,39,0,"run055"
"11055","GGG","BGB",0,2,2,1,1,"run055"
"11056","GGG","BGG",1,7,8,6,2,"run055"
"11057","GGG","BRB",1,3,4,2,2,"run055"
"11058","GGG","BRR",0,6,6,6,0,"run055"
"11059","GGG","GGB",5,1,6,6,0,"run055"
"11060","GGG","GGR",1,9,10,4,6,"run055"
"11061","GGG","GRR",0,2,2,2,0,"run055"
"11062","GGG","RBB",1,8,9,4,5,"run055"
"11063","GGG","RBG",0,6,6,1,5,"run055"
"11064","GGG","RBR",0,21,21,17,4,"run055"
"11065","GGG","RGG",0,3,3,0,3,"run055"
"11066","GGG","RGR",1,12,13,0,13,"run055"
"11067","GGG","RRG",1,23,24,21,3,"run055"
"11068","GGG","RRR",0,3,3,3,0,"run055"
"11069","GGR","BBB",0,2,2,2,0,"run055"
"11070","GGR","BBR",0,2,2,0,2,"run055"
"11071","GGR","BGG",0,1,1,1,0,"run055"
"11072","GGR","BRR",1,0,1,0,1,"run055"
"11073","GGR","GRR",1,0,1,0,1,"run055"
"11074","GGR","RBB",0,2,2,1,1,"run055"
"11075","GRG","BBB",3,8,11,10,1,"run055"
"11076","GRG","BBR",0,1,1,1,0,"run055"
"11077","GRG","BGG",0,1,1,0,1,"run055"
"11078","GRG","BRB",0,3,3,0,3,"run055"
"11079","GRG","BRR",0,1,1,0,1,"run055"
"11080","GRG","GBG",0,1,1,1,0,"run055"
"11081","GRG","GGB",2,15,17,9,8,"run055"
"11082","GRG","GGG",3,12,15,11,4,"run055"
"11083","GRG","GGR",0,5,5,1,4,"run055"
"11084","GRG","GRR",0,1,1,1,0,"run055"
"11085","GRG","RBG",0,1,1,0,1,"run055"
"11086","GRG","RBR",0,1,1,0,1,"run055"
"11087","GRG","RGR",1,2,3,3,0,"run055"
"11088","GRG","RRG",2,4,6,4,2,"run055"
"11089","GRR","BBB",0,1,1,1,0,"run055"
"11090","GRR","BBR",0,1,1,1,0,"run055"
"11091","GRR","BGB",1,2,3,0,3,"run055"
"11092","GRR","BGG",0,2,2,0,2,"run055"
"11093","GRR","BRB",0,1,1,1,0,"run055"
"11094","GRR","BRR",0,2,2,2,0,"run055"
"11095","GRR","GGG",0,1,1,0,1,"run055"
"11096","GRR","GGR",0,1,1,0,1,"run055"
"11097","RBB","BBB",0,1,1,1,0,"run055"
"11098","RBB","BBR",0,1,1,1,0,"run055"
"11099","RBB","BRB",0,1,1,0,1,"run055"
"11100","RBB","GRR",0,1,1,0,1,"run055"
"11101","RBB","RGG",0,1,1,0,1,"run055"
"11102","RBG","BBB",2,8,10,5,5,"run055"
"11103","RBG","BBG",0,1,1,0,1,"run055"
"11104","RBG","BRR",0,1,1,0,1,"run055"
"11105","RBG","GBB",0,1,1,0,1,"run055"
"11106","RBG","GRR",0,3,3,2,1,"run055"
"11107","RBG","RBB",1,1,2,2,0,"run055"
"11108","RBG","RBR",0,1,1,1,0,"run055"
"11109","RBG","RGR",0,1,1,1,0,"run055"
"11110","RBR","BBB",0,13,13,12,1,"run055"
"11111","RBR","BBR",0,1,1,0,1,"run055"
"11112","RBR","BGB",2,4,6,2,4,"run055"
"11113","RBR","BGG",0,2,2,2,0,"run055"
"11114","RBR","BRB",1,0,1,1,0,"run055"
"11115","RBR","BRR",1,4,5,2,3,"run055"
"11116","RBR","GGB",0,12,12,2,10,"run055"
"11117","RBR","GRR",4,4,8,7,1,"run055"
"11118","RBR","RBB",0,3,3,3,0,"run055"
"11119","RBR","RGG",2,9,11,6,5,"run055"
"11120","RBR","RGR",1,0,1,1,0,"run055"
"11121","RBR","RRR",0,1,1,0,1,"run055"
"11122","RGG","BBB",0,8,8,3,5,"run055"
"11123","RGG","BBR",1,2,3,0,3,"run055"
"11124","RGG","BGB",0,1,1,0,1,"run055"
"11125","RGG","BRR",0,4,4,3,1,"run055"
"11126","RGG","GGG",0,1,1,0,1,"run055"
"11127","RGG","GGR",0,3,3,0,3,"run055"
"11128","RGG","GRR",0,8,8,1,7,"run055"
"11129","RGG","RBB",0,1,1,0,1,"run055"
"11130","RGR","BBB",2,5,7,3,4,"run055"
"11131","RGR","BBR",1,1,2,2,0,"run055"
"11132","RGR","BGB",2,5,7,6,1,"run055"
"11133","RGR","BGG",2,2,4,4,0,"run055"
"11134","RGR","BRR",1,5,6,5,1,"run055"
"11135","RGR","GGB",2,12,14,11,3,"run055"
"11136","RGR","GGG",0,2,2,0,2,"run055"
"11137","RGR","GGR",0,4,4,4,0,"run055"
"11138","RGR","RBB",0,4,4,0,4,"run055"
"11139","RGR","RGG",1,1,2,1,1,"run055"
"11140","RGR","RRG",0,3,3,2,1,"run055"
"11141","RRG","BBB",2,33,35,24,11,"run055"
"11142","RRG","BBR",0,5,5,3,2,"run055"
"11143","RRG","BGB",1,10,11,6,5,"run055"
"11144","RRG","BGG",0,2,2,2,0,"run055"
"11145","RRG","BRB",2,40,42,32,10,"run055"
"11146","RRG","BRR",1,16,17,10,7,"run055"
"11147","RRG","GGG",2,14,16,12,4,"run055"
"11148","RRG","GGR",0,5,5,0,5,"run055"
"11149","RRG","GRG",1,0,1,1,0,"run055"
"11150","RRG","GRR",3,8,11,4,7,"run055"
"11151","RRG","RBB",1,1,2,2,0,"run055"
"11152","RRG","RGG",0,1,1,1,0,"run055"
"11153","RRG","RGR",0,1,1,1,0,"run055"
"11154","RRR","BBR",1,0,1,0,1,"run055"
"11155","RRR","BGB",2,1,3,1,2,"run055"
"11156","RRR","BGG",1,0,1,0,1,"run055"
"11157","RRR","BRB",1,1,2,0,2,"run055"
"11158","RRR","BRR",1,1,2,1,1,"run055"
"11159","RRR","GGR",0,1,1,1,0,"run055"
"11160","RRR","GRR",0,3,3,0,3,"run055"
"11161","RRR","RBB",1,2,3,0,3,"run055"
"11162","RRR","RBR",0,2,2,1,1,"run055"
"11163","RRR","RGG",0,1,1,0,1,"run055"
"11164","RRR","RGR",1,2,3,2,1,"run055"
"11165","RRR","RRG",2,2,4,0,4,"run055"
"11166","BBB","BRB",0,1,1,0,1,"run056"
"11167","BBB","GGG",1,2,3,3,0,"run056"
"11168","BBB","GRR",0,2,2,2,0,"run056"
"11169","BBB","RBG",0,1,1,0,1,"run056"
"11170","BBB","RRG",1,3,4,1,3,"run056"
"11171","BBB","RRR",0,2,2,1,1,"run056"
"11172","BBG","BBB",1,4,5,5,0,"run056"
"11173","BBG","BGB",0,1,1,0,1,"run056"
"11174","BBG","BGG",0,1,1,0,1,"run056"
"11175","BBG","BRB",1,16,17,6,11,"run056"
"11176","BBG","GBB",0,1,1,1,0,"run056"
"11177","BBG","GBG",2,7,9,2,7,"run056"
"11178","BBG","GGB",2,25,27,27,0,"run056"
"11179","BBG","GGG",4,38,42,17,25,"run056"
"11180","BBG","GRG",1,9,10,2,8,"run056"
"11181","BBG","GRR",0,1,1,0,1,"run056"
"11182","BBG","RBB",0,1,1,1,0,"run056"
"11183","BBG","RBG",0,4,4,3,1,"run056"
"11184","BBG","RBR",0,1,1,1,0,"run056"
"11185","BBG","RGR",0,1,1,1,0,"run056"
"11186","BBG","RRG",1,2,3,2,1,"run056"
"11187","BBG","RRR",0,7,7,5,2,"run056"
"11188","BGB","BBB",0,2,2,2,0,"run056"
"11189","BGB","RRG",0,1,1,1,0,"run056"
"11190","BGG","BBB",0,3,3,3,0,"run056"
"11191","BGG","BBR",0,1,1,1,0,"run056"
"11192","BGG","GRG",0,1,1,0,1,"run056"
"11193","BGG","RBG",1,1,2,2,0,"run056"
"11194","BGG","RGG",0,3,3,0,3,"run056"
"11195","BGG","RGR",0,1,1,0,1,"run056"
"11196","BGG","RRR",1,1,2,2,0,"run056"
"11197","BRB","BBB",0,13,13,1,12,"run056"
"11198","BRB","BBR",0,1,1,0,1,"run056"
"11199","BRB","BRR",0,3,3,2,1,"run056"
"11200","BRB","GGG",0,1,1,1,0,"run056"
"11201","BRB","GGR",0,1,1,1,0,"run056"
"11202","BRB","RBB",0,1,1,1,0,"run056"
"11203","BRB","RBG",0,1,1,1,0,"run056"
"11204","BRB","RGR",0,1,1,1,0,"run056"
"11205","BRB","RRR",0,1,1,0,1,"run056"
"11206","BRR","BBB",0,11,11,3,8,"run056"
"11207","BRR","BGB",1,1,2,2,0,"run056"
"11208","BRR","BGG",0,1,1,0,1,"run056"
"11209","BRR","BRB",0,1,1,0,1,"run056"
"11210","BRR","RBB",0,2,2,0,2,"run056"
"11211","GBB","BBB",12,38,50,19,31,"run056"
"11212","GBB","BGG",0,1,1,1,0,"run056"
"11213","GBB","BRB",1,9,10,10,0,"run056"
"11214","GBB","BRR",1,3,4,0,4,"run056"
"11215","GBB","GBG",0,4,4,1,3,"run056"
"11216","GBB","GGB",0,21,21,20,1,"run056"
"11217","GBB","GGG",7,86,93,85,8,"run056"
"11218","GBB","GGR",1,3,4,0,4,"run056"
"11219","GBB","GRG",0,6,6,4,2,"run056"
"11220","GBB","GRR",0,1,1,0,1,"run056"
"11221","GBB","RBB",0,2,2,2,0,"run056"
"11222","GBB","RBG",3,9,12,7,5,"run056"
"11223","GBB","RBR",1,0,1,0,1,"run056"
"11224","GBB","RGG",1,0,1,0,1,"run056"
"11225","GBB","RGR",2,1,3,3,0,"run056"
"11226","GBB","RRG",0,2,2,2,0,"run056"
"11227","GBB","RRR",1,9,10,5,5,"run056"
"11228","GBG","BBB",0,5,5,3,2,"run056"
"11229","GBG","BBR",0,1,1,1,0,"run056"
"11230","GBG","BRB",1,4,5,1,4,"run056"
"11231","GBG","BRR",1,0,1,0,1,"run056"
"11232","GBG","GGB",0,4,4,1,3,"run056"
"11233","GBG","GGG",4,11,15,9,6,"run056"
"11234","GBG","RBB",1,0,1,1,0,"run056"
"11235","GBG","RBG",0,1,1,1,0,"run056"
"11236","GBG","RGG",0,1,1,0,1,"run056"
"11237","GBG","RGR",1,3,4,4,0,"run056"
"11238","GBG","RRG",1,3,4,1,3,"run056"
"11239","GGB","BBB",3,16,19,3,16,"run056"
"11240","GGB","BBR",1,4,5,5,0,"run056"
"11241","GGB","BGB",0,3,3,0,3,"run056"
"11242","GGB","BGG",0,4,4,3,1,"run056"
"11243","GGB","BRB",0,1,1,1,0,"run056"
"11244","GGB","BRR",1,15,16,12,4,"run056"
"11245","GGB","GBB",0,1,1,1,0,"run056"
"11246","GGB","GBG",1,0,1,0,1,"run056"
"11247","GGB","GGG",13,48,61,46,15,"run056"
"11248","GGB","GGR",0,7,7,2,5,"run056"
"11249","GGB","GRR",0,4,4,0,4,"run056"
"11250","GGB","RBB",0,5,5,5,0,"run056"
"11251","GGB","RBG",0,4,4,2,2,"run056"
"11252","GGB","RBR",0,5,5,2,3,"run056"
"11253","GGB","RGG",1,5,6,1,5,"run056"
"11254","GGB","RGR",0,2,2,1,1,"run056"
"11255","GGB","RRG",1,5,6,0,6,"run056"
"11256","GGB","RRR",1,5,6,6,0,"run056"
"11257","GGG","BBB",8,31,39,36,3,"run056"
"11258","GGG","BGB",0,2,2,1,1,"run056"
"11259","GGG","BGG",1,7,8,1,7,"run056"
"11260","GGG","BRB",1,3,4,3,1,"run056"
"11261","GGG","BRR",0,6,6,1,5,"run056"
"11262","GGG","GGB",5,1,6,0,6,"run056"
"11263","GGG","GGR",1,9,10,10,0,"run056"
"11264","GGG","GRR",0,2,2,0,2,"run056"
"11265","GGG","RBB",1,8,9,4,5,"run056"
"11266","GGG","RBG",0,6,6,4,2,"run056"
"11267","GGG","RBR",0,21,21,5,16,"run056"
"11268","GGG","RGG",0,3,3,0,3,"run056"
"11269","GGG","RGR",1,12,13,2,11,"run056"
"11270","GGG","RRG",1,23,24,24,0,"run056"
"11271","GGG","RRR",0,3,3,0,3,"run056"
"11272","GGR","BBB",0,2,2,2,0,"run056"
"11273","GGR","BBR",0,2,2,2,0,"run056"
"11274","GGR","BGG",0,1,1,1,0,"run056"
"11275","GGR","BRR",1,0,1,1,0,"run056"
"11276","GGR","GRR",1,0,1,0,1,"run056"
"11277","GGR","RBB",0,2,2,0,2,"run056"
"11278","GRG","BBB",3,8,11,6,5,"run056"
"11279","GRG","BBR",0,1,1,0,1,"run056"
"11280","GRG","BGG",0,1,1,1,0,"run056"
"11281","GRG","BRB",0,3,3,2,1,"run056"
"11282","GRG","BRR",0,1,1,1,0,"run056"
"11283","GRG","GBG",0,1,1,1,0,"run056"
"11284","GRG","GGB",2,15,17,11,6,"run056"
"11285","GRG","GGG",3,12,15,3,12,"run056"
"11286","GRG","GGR",0,5,5,0,5,"run056"
"11287","GRG","GRR",0,1,1,1,0,"run056"
"11288","GRG","RBG",0,1,1,0,1,"run056"
"11289","GRG","RBR",0,1,1,1,0,"run056"
"11290","GRG","RGR",1,2,3,2,1,"run056"
"11291","GRG","RRG",2,4,6,1,5,"run056"
"11292","GRR","BBB",0,1,1,0,1,"run056"
"11293","GRR","BBR",0,1,1,0,1,"run056"
"11294","GRR","BGB",1,2,3,1,2,"run056"
"11295","GRR","BGG",0,2,2,0,2,"run056"
"11296","GRR","BRB",0,1,1,1,0,"run056"
"11297","GRR","BRR",0,2,2,1,1,"run056"
"11298","GRR","GGG",0,1,1,0,1,"run056"
"11299","GRR","GGR",0,1,1,1,0,"run056"
"11300","RBB","BBB",0,1,1,0,1,"run056"
"11301","RBB","BBR",0,1,1,1,0,"run056"
"11302","RBB","BRB",0,1,1,0,1,"run056"
"11303","RBB","GRR",0,1,1,1,0,"run056"
"11304","RBB","RGG",0,1,1,0,1,"run056"
"11305","RBG","BBB",2,8,10,2,8,"run056"
"11306","RBG","BBG",0,1,1,0,1,"run056"
"11307","RBG","BRR",0,1,1,1,0,"run056"
"11308","RBG","GBB",0,1,1,1,0,"run056"
"11309","RBG","GRR",0,3,3,0,3,"run056"
"11310","RBG","RBB",1,1,2,2,0,"run056"
"11311","RBG","RBR",0,1,1,1,0,"run056"
"11312","RBG","RGR",0,1,1,1,0,"run056"
"11313","RBR","BBB",0,13,13,11,2,"run056"
"11314","RBR","BBR",0,1,1,0,1,"run056"
"11315","RBR","BGB",2,4,6,4,2,"run056"
"11316","RBR","BGG",0,2,2,1,1,"run056"
"11317","RBR","BRB",1,0,1,0,1,"run056"
"11318","RBR","BRR",1,4,5,2,3,"run056"
"11319","RBR","GGB",0,12,12,11,1,"run056"
"11320","RBR","GRR",4,4,8,4,4,"run056"
"11321","RBR","RBB",0,3,3,1,2,"run056"
"11322","RBR","RGG",2,9,11,5,6,"run056"
"11323","RBR","RGR",1,0,1,0,1,"run056"
"11324","RBR","RRR",0,1,1,0,1,"run056"
"11325","RGG","BBB",0,8,8,3,5,"run056"
"11326","RGG","BBR",1,2,3,3,0,"run056"
"11327","RGG","BGB",0,1,1,1,0,"run056"
"11328","RGG","BRR",0,4,4,0,4,"run056"
"11329","RGG","GGG",0,1,1,1,0,"run056"
"11330","RGG","GGR",0,3,3,1,2,"run056"
"11331","RGG","GRR",0,8,8,8,0,"run056"
"11332","RGG","RBB",0,1,1,0,1,"run056"
"11333","RGR","BBB",2,5,7,1,6,"run056"
"11334","RGR","BBR",1,1,2,1,1,"run056"
"11335","RGR","BGB",2,5,7,7,0,"run056"
"11336","RGR","BGG",2,2,4,2,2,"run056"
"11337","RGR","BRR",1,5,6,4,2,"run056"
"11338","RGR","GGB",2,12,14,3,11,"run056"
"11339","RGR","GGG",0,2,2,2,0,"run056"
"11340","RGR","GGR",0,4,4,2,2,"run056"
"11341","RGR","RBB",0,4,4,4,0,"run056"
"11342","RGR","RGG",1,1,2,2,0,"run056"
"11343","RGR","RRG",0,3,3,0,3,"run056"
"11344","RRG","BBB",2,33,35,27,8,"run056"
"11345","RRG","BBR",0,5,5,1,4,"run056"
"11346","RRG","BGB",1,10,11,2,9,"run056"
"11347","RRG","BGG",0,2,2,0,2,"run056"
"11348","RRG","BRB",2,40,42,1,41,"run056"
"11349","RRG","BRR",1,16,17,11,6,"run056"
"11350","RRG","GGG",2,14,16,4,12,"run056"
"11351","RRG","GGR",0,5,5,0,5,"run056"
"11352","RRG","GRG",1,0,1,0,1,"run056"
"11353","RRG","GRR",3,8,11,7,4,"run056"
"11354","RRG","RBB",1,1,2,2,0,"run056"
"11355","RRG","RGG",0,1,1,1,0,"run056"
"11356","RRG","RGR",0,1,1,0,1,"run056"
"11357","RRR","BBR",1,0,1,0,1,"run056"
"11358","RRR","BGB",2,1,3,2,1,"run056"
"11359","RRR","BGG",1,0,1,1,0,"run056"
"11360","RRR","BRB",1,1,2,2,0,"run056"
"11361","RRR","BRR",1,1,2,0,2,"run056"
"11362","RRR","GGR",0,1,1,1,0,"run056"
"11363","RRR","GRR",0,3,3,2,1,"run056"
"11364","RRR","RBB",1,2,3,1,2,"run056"
"11365","RRR","RBR",0,2,2,0,2,"run056"
"11366","RRR","RGG",0,1,1,0,1,"run056"
"11367","RRR","RGR",1,2,3,1,2,"run056"
"11368","RRR","RRG",2,2,4,3,1,"run056"
"11369","BBB","BRB",0,1,1,1,0,"run057"
"11370","BBB","GGG",1,2,3,0,3,"run057"
"11371","BBB","GRR",0,2,2,2,0,"run057"
"11372","BBB","RBG",0,1,1,1,0,"run057"
"11373","BBB","RRG",1,3,4,2,2,"run057"
"11374","BBB","RRR",0,2,2,0,2,"run057"
"11375","BBG","BBB",1,4,5,0,5,"run057"
"11376","BBG","BGB",0,1,1,1,0,"run057"
"11377","BBG","BGG",0,1,1,0,1,"run057"
"11378","BBG","BRB",1,16,17,17,0,"run057"
"11379","BBG","GBB",0,1,1,1,0,"run057"
"11380","BBG","GBG",2,7,9,2,7,"run057"
"11381","BBG","GGB",2,25,27,15,12,"run057"
"11382","BBG","GGG",4,38,42,13,29,"run057"
"11383","BBG","GRG",1,9,10,10,0,"run057"
"11384","BBG","GRR",0,1,1,0,1,"run057"
"11385","BBG","RBB",0,1,1,1,0,"run057"
"11386","BBG","RBG",0,4,4,1,3,"run057"
"11387","BBG","RBR",0,1,1,0,1,"run057"
"11388","BBG","RGR",0,1,1,0,1,"run057"
"11389","BBG","RRG",1,2,3,1,2,"run057"
"11390","BBG","RRR",0,7,7,6,1,"run057"
"11391","BGB","BBB",0,2,2,0,2,"run057"
"11392","BGB","RRG",0,1,1,1,0,"run057"
"11393","BGG","BBB",0,3,3,1,2,"run057"
"11394","BGG","BBR",0,1,1,1,0,"run057"
"11395","BGG","GRG",0,1,1,0,1,"run057"
"11396","BGG","RBG",1,1,2,1,1,"run057"
"11397","BGG","RGG",0,3,3,1,2,"run057"
"11398","BGG","RGR",0,1,1,0,1,"run057"
"11399","BGG","RRR",1,1,2,0,2,"run057"
"11400","BRB","BBB",0,13,13,10,3,"run057"
"11401","BRB","BBR",0,1,1,0,1,"run057"
"11402","BRB","BRR",0,3,3,3,0,"run057"
"11403","BRB","GGG",0,1,1,1,0,"run057"
"11404","BRB","GGR",0,1,1,0,1,"run057"
"11405","BRB","RBB",0,1,1,0,1,"run057"
"11406","BRB","RBG",0,1,1,1,0,"run057"
"11407","BRB","RGR",0,1,1,0,1,"run057"
"11408","BRB","RRR",0,1,1,0,1,"run057"
"11409","BRR","BBB",0,11,11,7,4,"run057"
"11410","BRR","BGB",1,1,2,2,0,"run057"
"11411","BRR","BGG",0,1,1,1,0,"run057"
"11412","BRR","BRB",0,1,1,1,0,"run057"
"11413","BRR","RBB",0,2,2,1,1,"run057"
"11414","GBB","BBB",12,38,50,17,33,"run057"
"11415","GBB","BGG",0,1,1,1,0,"run057"
"11416","GBB","BRB",1,9,10,10,0,"run057"
"11417","GBB","BRR",1,3,4,3,1,"run057"
"11418","GBB","GBG",0,4,4,1,3,"run057"
"11419","GBB","GGB",0,21,21,18,3,"run057"
"11420","GBB","GGG",7,86,93,22,71,"run057"
"11421","GBB","GGR",1,3,4,2,2,"run057"
"11422","GBB","GRG",0,6,6,1,5,"run057"
"11423","GBB","GRR",0,1,1,0,1,"run057"
"11424","GBB","RBB",0,2,2,0,2,"run057"
"11425","GBB","RBG",3,9,12,5,7,"run057"
"11426","GBB","RBR",1,0,1,1,0,"run057"
"11427","GBB","RGG",1,0,1,0,1,"run057"
"11428","GBB","RGR",2,1,3,0,3,"run057"
"11429","GBB","RRG",0,2,2,0,2,"run057"
"11430","GBB","RRR",1,9,10,7,3,"run057"
"11431","GBG","BBB",0,5,5,3,2,"run057"
"11432","GBG","BBR",0,1,1,1,0,"run057"
"11433","GBG","BRB",1,4,5,5,0,"run057"
"11434","GBG","BRR",1,0,1,1,0,"run057"
"11435","GBG","GGB",0,4,4,2,2,"run057"
"11436","GBG","GGG",4,11,15,11,4,"run057"
"11437","GBG","RBB",1,0,1,1,0,"run057"
"11438","GBG","RBG",0,1,1,0,1,"run057"
"11439","GBG","RGG",0,1,1,0,1,"run057"
"11440","GBG","RGR",1,3,4,1,3,"run057"
"11441","GBG","RRG",1,3,4,2,2,"run057"
"11442","GGB","BBB",3,16,19,15,4,"run057"
"11443","GGB","BBR",1,4,5,5,0,"run057"
"11444","GGB","BGB",0,3,3,3,0,"run057"
"11445","GGB","BGG",0,4,4,3,1,"run057"
"11446","GGB","BRB",0,1,1,1,0,"run057"
"11447","GGB","BRR",1,15,16,1,15,"run057"
"11448","GGB","GBB",0,1,1,0,1,"run057"
"11449","GGB","GBG",1,0,1,1,0,"run057"
"11450","GGB","GGG",13,48,61,28,33,"run057"
"11451","GGB","GGR",0,7,7,0,7,"run057"
"11452","GGB","GRR",0,4,4,2,2,"run057"
"11453","GGB","RBB",0,5,5,2,3,"run057"
"11454","GGB","RBG",0,4,4,4,0,"run057"
"11455","GGB","RBR",0,5,5,0,5,"run057"
"11456","GGB","RGG",1,5,6,2,4,"run057"
"11457","GGB","RGR",0,2,2,0,2,"run057"
"11458","GGB","RRG",1,5,6,3,3,"run057"
"11459","GGB","RRR",1,5,6,4,2,"run057"
"11460","GGG","BBB",8,31,39,37,2,"run057"
"11461","GGG","BGB",0,2,2,1,1,"run057"
"11462","GGG","BGG",1,7,8,6,2,"run057"
"11463","GGG","BRB",1,3,4,2,2,"run057"
"11464","GGG","BRR",0,6,6,6,0,"run057"
"11465","GGG","GGB",5,1,6,1,5,"run057"
"11466","GGG","GGR",1,9,10,7,3,"run057"
"11467","GGG","GRR",0,2,2,0,2,"run057"
"11468","GGG","RBB",1,8,9,8,1,"run057"
"11469","GGG","RBG",0,6,6,0,6,"run057"
"11470","GGG","RBR",0,21,21,6,15,"run057"
"11471","GGG","RGG",0,3,3,2,1,"run057"
"11472","GGG","RGR",1,12,13,10,3,"run057"
"11473","GGG","RRG",1,23,24,13,11,"run057"
"11474","GGG","RRR",0,3,3,3,0,"run057"
"11475","GGR","BBB",0,2,2,1,1,"run057"
"11476","GGR","BBR",0,2,2,2,0,"run057"
"11477","GGR","BGG",0,1,1,0,1,"run057"
"11478","GGR","BRR",1,0,1,0,1,"run057"
"11479","GGR","GRR",1,0,1,1,0,"run057"
"11480","GGR","RBB",0,2,2,2,0,"run057"
"11481","GRG","BBB",3,8,11,0,11,"run057"
"11482","GRG","BBR",0,1,1,0,1,"run057"
"11483","GRG","BGG",0,1,1,1,0,"run057"
"11484","GRG","BRB",0,3,3,2,1,"run057"
"11485","GRG","BRR",0,1,1,0,1,"run057"
"11486","GRG","GBG",0,1,1,0,1,"run057"
"11487","GRG","GGB",2,15,17,15,2,"run057"
"11488","GRG","GGG",3,12,15,3,12,"run057"
"11489","GRG","GGR",0,5,5,3,2,"run057"
"11490","GRG","GRR",0,1,1,1,0,"run057"
"11491","GRG","RBG",0,1,1,0,1,"run057"
"11492","GRG","RBR",0,1,1,0,1,"run057"
"11493","GRG","RGR",1,2,3,2,1,"run057"
"11494","GRG","RRG",2,4,6,1,5,"run057"
"11495","GRR","BBB",0,1,1,1,0,"run057"
"11496","GRR","BBR",0,1,1,0,1,"run057"
"11497","GRR","BGB",1,2,3,1,2,"run057"
"11498","GRR","BGG",0,2,2,1,1,"run057"
"11499","GRR","BRB",0,1,1,0,1,"run057"
"11500","GRR","BRR",0,2,2,0,2,"run057"
"11501","GRR","GGG",0,1,1,1,0,"run057"
"11502","GRR","GGR",0,1,1,1,0,"run057"
"11503","RBB","BBB",0,1,1,1,0,"run057"
"11504","RBB","BBR",0,1,1,1,0,"run057"
"11505","RBB","BRB",0,1,1,1,0,"run057"
"11506","RBB","GRR",0,1,1,0,1,"run057"
"11507","RBB","RGG",0,1,1,1,0,"run057"
"11508","RBG","BBB",2,8,10,8,2,"run057"
"11509","RBG","BBG",0,1,1,1,0,"run057"
"11510","RBG","BRR",0,1,1,0,1,"run057"
"11511","RBG","GBB",0,1,1,1,0,"run057"
"11512","RBG","GRR",0,3,3,0,3,"run057"
"11513","RBG","RBB",1,1,2,0,2,"run057"
"11514","RBG","RBR",0,1,1,0,1,"run057"
"11515","RBG","RGR",0,1,1,1,0,"run057"
"11516","RBR","BBB",0,13,13,5,8,"run057"
"11517","RBR","BBR",0,1,1,1,0,"run057"
"11518","RBR","BGB",2,4,6,5,1,"run057"
"11519","RBR","BGG",0,2,2,1,1,"run057"
"11520","RBR","BRB",1,0,1,1,0,"run057"
"11521","RBR","BRR",1,4,5,1,4,"run057"
"11522","RBR","GGB",0,12,12,3,9,"run057"
"11523","RBR","GRR",4,4,8,0,8,"run057"
"11524","RBR","RBB",0,3,3,2,1,"run057"
"11525","RBR","RGG",2,9,11,2,9,"run057"
"11526","RBR","RGR",1,0,1,1,0,"run057"
"11527","RBR","RRR",0,1,1,1,0,"run057"
"11528","RGG","BBB",0,8,8,0,8,"run057"
"11529","RGG","BBR",1,2,3,0,3,"run057"
"11530","RGG","BGB",0,1,1,1,0,"run057"
"11531","RGG","BRR",0,4,4,3,1,"run057"
"11532","RGG","GGG",0,1,1,1,0,"run057"
"11533","RGG","GGR",0,3,3,3,0,"run057"
"11534","RGG","GRR",0,8,8,1,7,"run057"
"11535","RGG","RBB",0,1,1,0,1,"run057"
"11536","RGR","BBB",2,5,7,4,3,"run057"
"11537","RGR","BBR",1,1,2,2,0,"run057"
"11538","RGR","BGB",2,5,7,3,4,"run057"
"11539","RGR","BGG",2,2,4,1,3,"run057"
"11540","RGR","BRR",1,5,6,4,2,"run057"
"11541","RGR","GGB",2,12,14,8,6,"run057"
"11542","RGR","GGG",0,2,2,1,1,"run057"
"11543","RGR","GGR",0,4,4,4,0,"run057"
"11544","RGR","RBB",0,4,4,2,2,"run057"
"11545","RGR","RGG",1,1,2,1,1,"run057"
"11546","RGR","RRG",0,3,3,3,0,"run057"
"11547","RRG","BBB",2,33,35,29,6,"run057"
"11548","RRG","BBR",0,5,5,2,3,"run057"
"11549","RRG","BGB",1,10,11,0,11,"run057"
"11550","RRG","BGG",0,2,2,1,1,"run057"
"11551","RRG","BRB",2,40,42,12,30,"run057"
"11552","RRG","BRR",1,16,17,15,2,"run057"
"11553","RRG","GGG",2,14,16,13,3,"run057"
"11554","RRG","GGR",0,5,5,2,3,"run057"
"11555","RRG","GRG",1,0,1,1,0,"run057"
"11556","RRG","GRR",3,8,11,5,6,"run057"
"11557","RRG","RBB",1,1,2,0,2,"run057"
"11558","RRG","RGG",0,1,1,1,0,"run057"
"11559","RRG","RGR",0,1,1,0,1,"run057"
"11560","RRR","BBR",1,0,1,0,1,"run057"
"11561","RRR","BGB",2,1,3,2,1,"run057"
"11562","RRR","BGG",1,0,1,0,1,"run057"
"11563","RRR","BRB",1,1,2,0,2,"run057"
"11564","RRR","BRR",1,1,2,1,1,"run057"
"11565","RRR","GGR",0,1,1,0,1,"run057"
"11566","RRR","GRR",0,3,3,0,3,"run057"
"11567","RRR","RBB",1,2,3,1,2,"run057"
"11568","RRR","RBR",0,2,2,0,2,"run057"
"11569","RRR","RGG",0,1,1,1,0,"run057"
"11570","RRR","RGR",1,2,3,2,1,"run057"
"11571","RRR","RRG",2,2,4,1,3,"run057"
"11572","BBB","BRB",0,1,1,0,1,"run058"
"11573","BBB","GGG",1,2,3,0,3,"run058"
"11574","BBB","GRR",0,2,2,1,1,"run058"
"11575","BBB","RBG",0,1,1,1,0,"run058"
"11576","BBB","RRG",1,3,4,1,3,"run058"
"11577","BBB","RRR",0,2,2,0,2,"run058"
"11578","BBG","BBB",1,4,5,3,2,"run058"
"11579","BBG","BGB",0,1,1,1,0,"run058"
"11580","BBG","BGG",0,1,1,1,0,"run058"
"11581","BBG","BRB",1,16,17,8,9,"run058"
"11582","BBG","GBB",0,1,1,0,1,"run058"
"11583","BBG","GBG",2,7,9,0,9,"run058"
"11584","BBG","GGB",2,25,27,19,8,"run058"
"11585","BBG","GGG",4,38,42,15,27,"run058"
"11586","BBG","GRG",1,9,10,3,7,"run058"
"11587","BBG","GRR",0,1,1,0,1,"run058"
"11588","BBG","RBB",0,1,1,1,0,"run058"
"11589","BBG","RBG",0,4,4,2,2,"run058"
"11590","BBG","RBR",0,1,1,0,1,"run058"
"11591","BBG","RGR",0,1,1,0,1,"run058"
"11592","BBG","RRG",1,2,3,0,3,"run058"
"11593","BBG","RRR",0,7,7,5,2,"run058"
"11594","BGB","BBB",0,2,2,0,2,"run058"
"11595","BGB","RRG",0,1,1,0,1,"run058"
"11596","BGG","BBB",0,3,3,0,3,"run058"
"11597","BGG","BBR",0,1,1,0,1,"run058"
"11598","BGG","GRG",0,1,1,0,1,"run058"
"11599","BGG","RBG",1,1,2,0,2,"run058"
"11600","BGG","RGG",0,3,3,0,3,"run058"
"11601","BGG","RGR",0,1,1,0,1,"run058"
"11602","BGG","RRR",1,1,2,1,1,"run058"
"11603","BRB","BBB",0,13,13,12,1,"run058"
"11604","BRB","BBR",0,1,1,0,1,"run058"
"11605","BRB","BRR",0,3,3,0,3,"run058"
"11606","BRB","GGG",0,1,1,1,0,"run058"
"11607","BRB","GGR",0,1,1,1,0,"run058"
"11608","BRB","RBB",0,1,1,0,1,"run058"
"11609","BRB","RBG",0,1,1,0,1,"run058"
"11610","BRB","RGR",0,1,1,1,0,"run058"
"11611","BRB","RRR",0,1,1,1,0,"run058"
"11612","BRR","BBB",0,11,11,11,0,"run058"
"11613","BRR","BGB",1,1,2,2,0,"run058"
"11614","BRR","BGG",0,1,1,1,0,"run058"
"11615","BRR","BRB",0,1,1,1,0,"run058"
"11616","BRR","RBB",0,2,2,1,1,"run058"
"11617","GBB","BBB",12,38,50,29,21,"run058"
"11618","GBB","BGG",0,1,1,1,0,"run058"
"11619","GBB","BRB",1,9,10,8,2,"run058"
"11620","GBB","BRR",1,3,4,4,0,"run058"
"11621","GBB","GBG",0,4,4,3,1,"run058"
"11622","GBB","GGB",0,21,21,17,4,"run058"
"11623","GBB","GGG",7,86,93,27,66,"run058"
"11624","GBB","GGR",1,3,4,0,4,"run058"
"11625","GBB","GRG",0,6,6,6,0,"run058"
"11626","GBB","GRR",0,1,1,0,1,"run058"
"11627","GBB","RBB",0,2,2,1,1,"run058"
"11628","GBB","RBG",3,9,12,8,4,"run058"
"11629","GBB","RBR",1,0,1,0,1,"run058"
"11630","GBB","RGG",1,0,1,0,1,"run058"
"11631","GBB","RGR",2,1,3,2,1,"run058"
"11632","GBB","RRG",0,2,2,2,0,"run058"
"11633","GBB","RRR",1,9,10,5,5,"run058"
"11634","GBG","BBB",0,5,5,1,4,"run058"
"11635","GBG","BBR",0,1,1,0,1,"run058"
"11636","GBG","BRB",1,4,5,5,0,"run058"
"11637","GBG","BRR",1,0,1,0,1,"run058"
"11638","GBG","GGB",0,4,4,3,1,"run058"
"11639","GBG","GGG",4,11,15,6,9,"run058"
"11640","GBG","RBB",1,0,1,1,0,"run058"
"11641","GBG","RBG",0,1,1,0,1,"run058"
"11642","GBG","RGG",0,1,1,1,0,"run058"
"11643","GBG","RGR",1,3,4,4,0,"run058"
"11644","GBG","RRG",1,3,4,3,1,"run058"
"11645","GGB","BBB",3,16,19,14,5,"run058"
"11646","GGB","BBR",1,4,5,3,2,"run058"
"11647","GGB","BGB",0,3,3,3,0,"run058"
"11648","GGB","BGG",0,4,4,4,0,"run058"
"11649","GGB","BRB",0,1,1,0,1,"run058"
"11650","GGB","BRR",1,15,16,11,5,"run058"
"11651","GGB","GBB",0,1,1,1,0,"run058"
"11652","GGB","GBG",1,0,1,1,0,"run058"
"11653","GGB","GGG",13,48,61,53,8,"run058"
"11654","GGB","GGR",0,7,7,0,7,"run058"
"11655","GGB","GRR",0,4,4,0,4,"run058"
"11656","GGB","RBB",0,5,5,1,4,"run058"
"11657","GGB","RBG",0,4,4,3,1,"run058"
"11658","GGB","RBR",0,5,5,0,5,"run058"
"11659","GGB","RGG",1,5,6,5,1,"run058"
"11660","GGB","RGR",0,2,2,1,1,"run058"
"11661","GGB","RRG",1,5,6,3,3,"run058"
"11662","GGB","RRR",1,5,6,0,6,"run058"
"11663","GGG","BBB",8,31,39,31,8,"run058"
"11664","GGG","BGB",0,2,2,2,0,"run058"
"11665","GGG","BGG",1,7,8,5,3,"run058"
"11666","GGG","BRB",1,3,4,4,0,"run058"
"11667","GGG","BRR",0,6,6,1,5,"run058"
"11668","GGG","GGB",5,1,6,6,0,"run058"
"11669","GGG","GGR",1,9,10,0,10,"run058"
"11670","GGG","GRR",0,2,2,1,1,"run058"
"11671","GGG","RBB",1,8,9,9,0,"run058"
"11672","GGG","RBG",0,6,6,1,5,"run058"
"11673","GGG","RBR",0,21,21,14,7,"run058"
"11674","GGG","RGG",0,3,3,2,1,"run058"
"11675","GGG","RGR",1,12,13,1,12,"run058"
"11676","GGG","RRG",1,23,24,23,1,"run058"
"11677","GGG","RRR",0,3,3,2,1,"run058"
"11678","GGR","BBB",0,2,2,2,0,"run058"
"11679","GGR","BBR",0,2,2,1,1,"run058"
"11680","GGR","BGG",0,1,1,1,0,"run058"
"11681","GGR","BRR",1,0,1,0,1,"run058"
"11682","GGR","GRR",1,0,1,1,0,"run058"
"11683","GGR","RBB",0,2,2,0,2,"run058"
"11684","GRG","BBB",3,8,11,0,11,"run058"
"11685","GRG","BBR",0,1,1,1,0,"run058"
"11686","GRG","BGG",0,1,1,0,1,"run058"
"11687","GRG","BRB",0,3,3,2,1,"run058"
"11688","GRG","BRR",0,1,1,1,0,"run058"
"11689","GRG","GBG",0,1,1,0,1,"run058"
"11690","GRG","GGB",2,15,17,14,3,"run058"
"11691","GRG","GGG",3,12,15,0,15,"run058"
"11692","GRG","GGR",0,5,5,3,2,"run058"
"11693","GRG","GRR",0,1,1,0,1,"run058"
"11694","GRG","RBG",0,1,1,1,0,"run058"
"11695","GRG","RBR",0,1,1,0,1,"run058"
"11696","GRG","RGR",1,2,3,3,0,"run058"
"11697","GRG","RRG",2,4,6,5,1,"run058"
"11698","GRR","BBB",0,1,1,0,1,"run058"
"11699","GRR","BBR",0,1,1,0,1,"run058"
"11700","GRR","BGB",1,2,3,0,3,"run058"
"11701","GRR","BGG",0,2,2,2,0,"run058"
"11702","GRR","BRB",0,1,1,0,1,"run058"
"11703","GRR","BRR",0,2,2,1,1,"run058"
"11704","GRR","GGG",0,1,1,0,1,"run058"
"11705","GRR","GGR",0,1,1,1,0,"run058"
"11706","RBB","BBB",0,1,1,0,1,"run058"
"11707","RBB","BBR",0,1,1,1,0,"run058"
"11708","RBB","BRB",0,1,1,1,0,"run058"
"11709","RBB","GRR",0,1,1,0,1,"run058"
"11710","RBB","RGG",0,1,1,0,1,"run058"
"11711","RBG","BBB",2,8,10,10,0,"run058"
"11712","RBG","BBG",0,1,1,1,0,"run058"
"11713","RBG","BRR",0,1,1,0,1,"run058"
"11714","RBG","GBB",0,1,1,1,0,"run058"
"11715","RBG","GRR",0,3,3,0,3,"run058"
"11716","RBG","RBB",1,1,2,0,2,"run058"
"11717","RBG","RBR",0,1,1,1,0,"run058"
"11718","RBG","RGR",0,1,1,1,0,"run058"
"11719","RBR","BBB",0,13,13,6,7,"run058"
"11720","RBR","BBR",0,1,1,1,0,"run058"
"11721","RBR","BGB",2,4,6,1,5,"run058"
"11722","RBR","BGG",0,2,2,0,2,"run058"
"11723","RBR","BRB",1,0,1,1,0,"run058"
"11724","RBR","BRR",1,4,5,5,0,"run058"
"11725","RBR","GGB",0,12,12,7,5,"run058"
"11726","RBR","GRR",4,4,8,1,7,"run058"
"11727","RBR","RBB",0,3,3,1,2,"run058"
"11728","RBR","RGG",2,9,11,8,3,"run058"
"11729","RBR","RGR",1,0,1,0,1,"run058"
"11730","RBR","RRR",0,1,1,1,0,"run058"
"11731","RGG","BBB",0,8,8,2,6,"run058"
"11732","RGG","BBR",1,2,3,0,3,"run058"
"11733","RGG","BGB",0,1,1,1,0,"run058"
"11734","RGG","BRR",0,4,4,1,3,"run058"
"11735","RGG","GGG",0,1,1,0,1,"run058"
"11736","RGG","GGR",0,3,3,3,0,"run058"
"11737","RGG","GRR",0,8,8,8,0,"run058"
"11738","RGG","RBB",0,1,1,0,1,"run058"
"11739","RGR","BBB",2,5,7,3,4,"run058"
"11740","RGR","BBR",1,1,2,0,2,"run058"
"11741","RGR","BGB",2,5,7,6,1,"run058"
"11742","RGR","BGG",2,2,4,4,0,"run058"
"11743","RGR","BRR",1,5,6,0,6,"run058"
"11744","RGR","GGB",2,12,14,14,0,"run058"
"11745","RGR","GGG",0,2,2,2,0,"run058"
"11746","RGR","GGR",0,4,4,3,1,"run058"
"11747","RGR","RBB",0,4,4,1,3,"run058"
"11748","RGR","RGG",1,1,2,0,2,"run058"
"11749","RGR","RRG",0,3,3,3,0,"run058"
"11750","RRG","BBB",2,33,35,34,1,"run058"
"11751","RRG","BBR",0,5,5,0,5,"run058"
"11752","RRG","BGB",1,10,11,6,5,"run058"
"11753","RRG","BGG",0,2,2,0,2,"run058"
"11754","RRG","BRB",2,40,42,17,25,"run058"
"11755","RRG","BRR",1,16,17,13,4,"run058"
"11756","RRG","GGG",2,14,16,16,0,"run058"
"11757","RRG","GGR",0,5,5,1,4,"run058"
"11758","RRG","GRG",1,0,1,1,0,"run058"
"11759","RRG","GRR",3,8,11,4,7,"run058"
"11760","RRG","RBB",1,1,2,0,2,"run058"
"11761","RRG","RGG",0,1,1,1,0,"run058"
"11762","RRG","RGR",0,1,1,1,0,"run058"
"11763","RRR","BBR",1,0,1,1,0,"run058"
"11764","RRR","BGB",2,1,3,0,3,"run058"
"11765","RRR","BGG",1,0,1,0,1,"run058"
"11766","RRR","BRB",1,1,2,0,2,"run058"
"11767","RRR","BRR",1,1,2,2,0,"run058"
"11768","RRR","GGR",0,1,1,1,0,"run058"
"11769","RRR","GRR",0,3,3,1,2,"run058"
"11770","RRR","RBB",1,2,3,2,1,"run058"
"11771","RRR","RBR",0,2,2,1,1,"run058"
"11772","RRR","RGG",0,1,1,1,0,"run058"
"11773","RRR","RGR",1,2,3,0,3,"run058"
"11774","RRR","RRG",2,2,4,3,1,"run058"
"11775","BBB","BRB",0,1,1,0,1,"run059"
"11776","BBB","GGG",1,2,3,0,3,"run059"
"11777","BBB","GRR",0,2,2,0,2,"run059"
"11778","BBB","RBG",0,1,1,0,1,"run059"
"11779","BBB","RRG",1,3,4,4,0,"run059"
"11780","BBB","RRR",0,2,2,2,0,"run059"
"11781","BBG","BBB",1,4,5,5,0,"run059"
"11782","BBG","BGB",0,1,1,0,1,"run059"
"11783","BBG","BGG",0,1,1,0,1,"run059"
"11784","BBG","BRB",1,16,17,12,5,"run059"
"11785","BBG","GBB",0,1,1,1,0,"run059"
"11786","BBG","GBG",2,7,9,1,8,"run059"
"11787","BBG","GGB",2,25,27,10,17,"run059"
"11788","BBG","GGG",4,38,42,11,31,"run059"
"11789","BBG","GRG",1,9,10,6,4,"run059"
"11790","BBG","GRR",0,1,1,1,0,"run059"
"11791","BBG","RBB",0,1,1,1,0,"run059"
"11792","BBG","RBG",0,4,4,1,3,"run059"
"11793","BBG","RBR",0,1,1,1,0,"run059"
"11794","BBG","RGR",0,1,1,1,0,"run059"
"11795","BBG","RRG",1,2,3,2,1,"run059"
"11796","BBG","RRR",0,7,7,5,2,"run059"
"11797","BGB","BBB",0,2,2,1,1,"run059"
"11798","BGB","RRG",0,1,1,0,1,"run059"
"11799","BGG","BBB",0,3,3,2,1,"run059"
"11800","BGG","BBR",0,1,1,1,0,"run059"
"11801","BGG","GRG",0,1,1,1,0,"run059"
"11802","BGG","RBG",1,1,2,0,2,"run059"
"11803","BGG","RGG",0,3,3,2,1,"run059"
"11804","BGG","RGR",0,1,1,1,0,"run059"
"11805","BGG","RRR",1,1,2,2,0,"run059"
"11806","BRB","BBB",0,13,13,5,8,"run059"
"11807","BRB","BBR",0,1,1,1,0,"run059"
"11808","BRB","BRR",0,3,3,0,3,"run059"
"11809","BRB","GGG",0,1,1,1,0,"run059"
"11810","BRB","GGR",0,1,1,0,1,"run059"
"11811","BRB","RBB",0,1,1,0,1,"run059"
"11812","BRB","RBG",0,1,1,1,0,"run059"
"11813","BRB","RGR",0,1,1,1,0,"run059"
"11814","BRB","RRR",0,1,1,0,1,"run059"
"11815","BRR","BBB",0,11,11,9,2,"run059"
"11816","BRR","BGB",1,1,2,1,1,"run059"
"11817","BRR","BGG",0,1,1,1,0,"run059"
"11818","BRR","BRB",0,1,1,0,1,"run059"
"11819","BRR","RBB",0,2,2,2,0,"run059"
"11820","GBB","BBB",12,38,50,43,7,"run059"
"11821","GBB","BGG",0,1,1,1,0,"run059"
"11822","GBB","BRB",1,9,10,3,7,"run059"
"11823","GBB","BRR",1,3,4,4,0,"run059"
"11824","GBB","GBG",0,4,4,2,2,"run059"
"11825","GBB","GGB",0,21,21,10,11,"run059"
"11826","GBB","GGG",7,86,93,19,74,"run059"
"11827","GBB","GGR",1,3,4,3,1,"run059"
"11828","GBB","GRG",0,6,6,0,6,"run059"
"11829","GBB","GRR",0,1,1,1,0,"run059"
"11830","GBB","RBB",0,2,2,2,0,"run059"
"11831","GBB","RBG",3,9,12,5,7,"run059"
"11832","GBB","RBR",1,0,1,1,0,"run059"
"11833","GBB","RGG",1,0,1,0,1,"run059"
"11834","GBB","RGR",2,1,3,2,1,"run059"
"11835","GBB","RRG",0,2,2,1,1,"run059"
"11836","GBB","RRR",1,9,10,2,8,"run059"
"11837","GBG","BBB",0,5,5,1,4,"run059"
"11838","GBG","BBR",0,1,1,0,1,"run059"
"11839","GBG","BRB",1,4,5,2,3,"run059"
"11840","GBG","BRR",1,0,1,1,0,"run059"
"11841","GBG","GGB",0,4,4,1,3,"run059"
"11842","GBG","GGG",4,11,15,14,1,"run059"
"11843","GBG","RBB",1,0,1,1,0,"run059"
"11844","GBG","RBG",0,1,1,0,1,"run059"
"11845","GBG","RGG",0,1,1,0,1,"run059"
"11846","GBG","RGR",1,3,4,4,0,"run059"
"11847","GBG","RRG",1,3,4,2,2,"run059"
"11848","GGB","BBB",3,16,19,0,19,"run059"
"11849","GGB","BBR",1,4,5,2,3,"run059"
"11850","GGB","BGB",0,3,3,0,3,"run059"
"11851","GGB","BGG",0,4,4,1,3,"run059"
"11852","GGB","BRB",0,1,1,1,0,"run059"
"11853","GGB","BRR",1,15,16,11,5,"run059"
"11854","GGB","GBB",0,1,1,1,0,"run059"
"11855","GGB","GBG",1,0,1,1,0,"run059"
"11856","GGB","GGG",13,48,61,45,16,"run059"
"11857","GGB","GGR",0,7,7,4,3,"run059"
"11858","GGB","GRR",0,4,4,3,1,"run059"
"11859","GGB","RBB",0,5,5,4,1,"run059"
"11860","GGB","RBG",0,4,4,1,3,"run059"
"11861","GGB","RBR",0,5,5,3,2,"run059"
"11862","GGB","RGG",1,5,6,6,0,"run059"
"11863","GGB","RGR",0,2,2,0,2,"run059"
"11864","GGB","RRG",1,5,6,5,1,"run059"
"11865","GGB","RRR",1,5,6,1,5,"run059"
"11866","GGG","BBB",8,31,39,15,24,"run059"
"11867","GGG","BGB",0,2,2,1,1,"run059"
"11868","GGG","BGG",1,7,8,7,1,"run059"
"11869","GGG","BRB",1,3,4,2,2,"run059"
"11870","GGG","BRR",0,6,6,5,1,"run059"
"11871","GGG","GGB",5,1,6,3,3,"run059"
"11872","GGG","GGR",1,9,10,1,9,"run059"
"11873","GGG","GRR",0,2,2,2,0,"run059"
"11874","GGG","RBB",1,8,9,9,0,"run059"
"11875","GGG","RBG",0,6,6,1,5,"run059"
"11876","GGG","RBR",0,21,21,17,4,"run059"
"11877","GGG","RGG",0,3,3,2,1,"run059"
"11878","GGG","RGR",1,12,13,3,10,"run059"
"11879","GGG","RRG",1,23,24,14,10,"run059"
"11880","GGG","RRR",0,3,3,0,3,"run059"
"11881","GGR","BBB",0,2,2,2,0,"run059"
"11882","GGR","BBR",0,2,2,0,2,"run059"
"11883","GGR","BGG",0,1,1,1,0,"run059"
"11884","GGR","BRR",1,0,1,0,1,"run059"
"11885","GGR","GRR",1,0,1,0,1,"run059"
"11886","GGR","RBB",0,2,2,1,1,"run059"
"11887","GRG","BBB",3,8,11,9,2,"run059"
"11888","GRG","BBR",0,1,1,1,0,"run059"
"11889","GRG","BGG",0,1,1,0,1,"run059"
"11890","GRG","BRB",0,3,3,0,3,"run059"
"11891","GRG","BRR",0,1,1,0,1,"run059"
"11892","GRG","GBG",0,1,1,0,1,"run059"
"11893","GRG","GGB",2,15,17,12,5,"run059"
"11894","GRG","GGG",3,12,15,15,0,"run059"
"11895","GRG","GGR",0,5,5,2,3,"run059"
"11896","GRG","GRR",0,1,1,0,1,"run059"
"11897","GRG","RBG",0,1,1,0,1,"run059"
"11898","GRG","RBR",0,1,1,0,1,"run059"
"11899","GRG","RGR",1,2,3,3,0,"run059"
"11900","GRG","RRG",2,4,6,2,4,"run059"
"11901","GRR","BBB",0,1,1,0,1,"run059"
"11902","GRR","BBR",0,1,1,1,0,"run059"
"11903","GRR","BGB",1,2,3,2,1,"run059"
"11904","GRR","BGG",0,2,2,0,2,"run059"
"11905","GRR","BRB",0,1,1,1,0,"run059"
"11906","GRR","BRR",0,2,2,0,2,"run059"
"11907","GRR","GGG",0,1,1,0,1,"run059"
"11908","GRR","GGR",0,1,1,1,0,"run059"
"11909","RBB","BBB",0,1,1,1,0,"run059"
"11910","RBB","BBR",0,1,1,1,0,"run059"
"11911","RBB","BRB",0,1,1,1,0,"run059"
"11912","RBB","GRR",0,1,1,0,1,"run059"
"11913","RBB","RGG",0,1,1,0,1,"run059"
"11914","RBG","BBB",2,8,10,2,8,"run059"
"11915","RBG","BBG",0,1,1,1,0,"run059"
"11916","RBG","BRR",0,1,1,0,1,"run059"
"11917","RBG","GBB",0,1,1,0,1,"run059"
"11918","RBG","GRR",0,3,3,2,1,"run059"
"11919","RBG","RBB",1,1,2,1,1,"run059"
"11920","RBG","RBR",0,1,1,1,0,"run059"
"11921","RBG","RGR",0,1,1,0,1,"run059"
"11922","RBR","BBB",0,13,13,12,1,"run059"
"11923","RBR","BBR",0,1,1,0,1,"run059"
"11924","RBR","BGB",2,4,6,0,6,"run059"
"11925","RBR","BGG",0,2,2,0,2,"run059"
"11926","RBR","BRB",1,0,1,1,0,"run059"
"11927","RBR","BRR",1,4,5,1,4,"run059"
"11928","RBR","GGB",0,12,12,7,5,"run059"
"11929","RBR","GRR",4,4,8,1,7,"run059"
"11930","RBR","RBB",0,3,3,0,3,"run059"
"11931","RBR","RGG",2,9,11,1,10,"run059"
"11932","RBR","RGR",1,0,1,1,0,"run059"
"11933","RBR","RRR",0,1,1,0,1,"run059"
"11934","RGG","BBB",0,8,8,6,2,"run059"
"11935","RGG","BBR",1,2,3,3,0,"run059"
"11936","RGG","BGB",0,1,1,1,0,"run059"
"11937","RGG","BRR",0,4,4,1,3,"run059"
"11938","RGG","GGG",0,1,1,0,1,"run059"
"11939","RGG","GGR",0,3,3,0,3,"run059"
"11940","RGG","GRR",0,8,8,3,5,"run059"
"11941","RGG","RBB",0,1,1,1,0,"run059"
"11942","RGR","BBB",2,5,7,0,7,"run059"
"11943","RGR","BBR",1,1,2,0,2,"run059"
"11944","RGR","BGB",2,5,7,2,5,"run059"
"11945","RGR","BGG",2,2,4,1,3,"run059"
"11946","RGR","BRR",1,5,6,6,0,"run059"
"11947","RGR","GGB",2,12,14,0,14,"run059"
"11948","RGR","GGG",0,2,2,2,0,"run059"
"11949","RGR","GGR",0,4,4,3,1,"run059"
"11950","RGR","RBB",0,4,4,1,3,"run059"
"11951","RGR","RGG",1,1,2,2,0,"run059"
"11952","RGR","RRG",0,3,3,2,1,"run059"
"11953","RRG","BBB",2,33,35,25,10,"run059"
"11954","RRG","BBR",0,5,5,3,2,"run059"
"11955","RRG","BGB",1,10,11,11,0,"run059"
"11956","RRG","BGG",0,2,2,0,2,"run059"
"11957","RRG","BRB",2,40,42,16,26,"run059"
"11958","RRG","BRR",1,16,17,12,5,"run059"
"11959","RRG","GGG",2,14,16,12,4,"run059"
"11960","RRG","GGR",0,5,5,2,3,"run059"
"11961","RRG","GRG",1,0,1,1,0,"run059"
"11962","RRG","GRR",3,8,11,6,5,"run059"
"11963","RRG","RBB",1,1,2,2,0,"run059"
"11964","RRG","RGG",0,1,1,0,1,"run059"
"11965","RRG","RGR",0,1,1,0,1,"run059"
"11966","RRR","BBR",1,0,1,0,1,"run059"
"11967","RRR","BGB",2,1,3,2,1,"run059"
"11968","RRR","BGG",1,0,1,1,0,"run059"
"11969","RRR","BRB",1,1,2,0,2,"run059"
"11970","RRR","BRR",1,1,2,1,1,"run059"
"11971","RRR","GGR",0,1,1,0,1,"run059"
"11972","RRR","GRR",0,3,3,1,2,"run059"
"11973","RRR","RBB",1,2,3,3,0,"run059"
"11974","RRR","RBR",0,2,2,0,2,"run059"
"11975","RRR","RGG",0,1,1,1,0,"run059"
"11976","RRR","RGR",1,2,3,1,2,"run059"
"11977","RRR","RRG",2,2,4,1,3,"run059"
"11978","BBB","BRB",0,1,1,0,1,"run060"
"11979","BBB","GGG",1,2,3,3,0,"run060"
"11980","BBB","GRR",0,2,2,1,1,"run060"
"11981","BBB","RBG",0,1,1,0,1,"run060"
"11982","BBB","RRG",1,3,4,1,3,"run060"
"11983","BBB","RRR",0,2,2,2,0,"run060"
"11984","BBG","BBB",1,4,5,1,4,"run060"
"11985","BBG","BGB",0,1,1,1,0,"run060"
"11986","BBG","BGG",0,1,1,1,0,"run060"
"11987","BBG","BRB",1,16,17,4,13,"run060"
"11988","BBG","GBB",0,1,1,0,1,"run060"
"11989","BBG","GBG",2,7,9,7,2,"run060"
"11990","BBG","GGB",2,25,27,27,0,"run060"
"11991","BBG","GGG",4,38,42,18,24,"run060"
"11992","BBG","GRG",1,9,10,8,2,"run060"
"11993","BBG","GRR",0,1,1,1,0,"run060"
"11994","BBG","RBB",0,1,1,1,0,"run060"
"11995","BBG","RBG",0,4,4,3,1,"run060"
"11996","BBG","RBR",0,1,1,1,0,"run060"
"11997","BBG","RGR",0,1,1,1,0,"run060"
"11998","BBG","RRG",1,2,3,0,3,"run060"
"11999","BBG","RRR",0,7,7,1,6,"run060"
"12000","BGB","BBB",0,2,2,2,0,"run060"
"12001","BGB","RRG",0,1,1,0,1,"run060"
"12002","BGG","BBB",0,3,3,1,2,"run060"
"12003","BGG","BBR",0,1,1,0,1,"run060"
"12004","BGG","GRG",0,1,1,0,1,"run060"
"12005","BGG","RBG",1,1,2,0,2,"run060"
"12006","BGG","RGG",0,3,3,2,1,"run060"
"12007","BGG","RGR",0,1,1,0,1,"run060"
"12008","BGG","RRR",1,1,2,1,1,"run060"
"12009","BRB","BBB",0,13,13,9,4,"run060"
"12010","BRB","BBR",0,1,1,1,0,"run060"
"12011","BRB","BRR",0,3,3,3,0,"run060"
"12012","BRB","GGG",0,1,1,0,1,"run060"
"12013","BRB","GGR",0,1,1,1,0,"run060"
"12014","BRB","RBB",0,1,1,1,0,"run060"
"12015","BRB","RBG",0,1,1,0,1,"run060"
"12016","BRB","RGR",0,1,1,0,1,"run060"
"12017","BRB","RRR",0,1,1,1,0,"run060"
"12018","BRR","BBB",0,11,11,4,7,"run060"
"12019","BRR","BGB",1,1,2,1,1,"run060"
"12020","BRR","BGG",0,1,1,0,1,"run060"
"12021","BRR","BRB",0,1,1,0,1,"run060"
"12022","BRR","RBB",0,2,2,0,2,"run060"
"12023","GBB","BBB",12,38,50,27,23,"run060"
"12024","GBB","BGG",0,1,1,0,1,"run060"
"12025","GBB","BRB",1,9,10,6,4,"run060"
"12026","GBB","BRR",1,3,4,4,0,"run060"
"12027","GBB","GBG",0,4,4,3,1,"run060"
"12028","GBB","GGB",0,21,21,20,1,"run060"
"12029","GBB","GGG",7,86,93,62,31,"run060"
"12030","GBB","GGR",1,3,4,4,0,"run060"
"12031","GBB","GRG",0,6,6,4,2,"run060"
"12032","GBB","GRR",0,1,1,0,1,"run060"
"12033","GBB","RBB",0,2,2,2,0,"run060"
"12034","GBB","RBG",3,9,12,1,11,"run060"
"12035","GBB","RBR",1,0,1,0,1,"run060"
"12036","GBB","RGG",1,0,1,1,0,"run060"
"12037","GBB","RGR",2,1,3,2,1,"run060"
"12038","GBB","RRG",0,2,2,0,2,"run060"
"12039","GBB","RRR",1,9,10,2,8,"run060"
"12040","GBG","BBB",0,5,5,3,2,"run060"
"12041","GBG","BBR",0,1,1,0,1,"run060"
"12042","GBG","BRB",1,4,5,5,0,"run060"
"12043","GBG","BRR",1,0,1,1,0,"run060"
"12044","GBG","GGB",0,4,4,0,4,"run060"
"12045","GBG","GGG",4,11,15,5,10,"run060"
"12046","GBG","RBB",1,0,1,1,0,"run060"
"12047","GBG","RBG",0,1,1,0,1,"run060"
"12048","GBG","RGG",0,1,1,1,0,"run060"
"12049","GBG","RGR",1,3,4,0,4,"run060"
"12050","GBG","RRG",1,3,4,2,2,"run060"
"12051","GGB","BBB",3,16,19,1,18,"run060"
"12052","GGB","BBR",1,4,5,5,0,"run060"
"12053","GGB","BGB",0,3,3,3,0,"run060"
"12054","GGB","BGG",0,4,4,1,3,"run060"
"12055","GGB","BRB",0,1,1,1,0,"run060"
"12056","GGB","BRR",1,15,16,9,7,"run060"
"12057","GGB","GBB",0,1,1,0,1,"run060"
"12058","GGB","GBG",1,0,1,0,1,"run060"
"12059","GGB","GGG",13,48,61,16,45,"run060"
"12060","GGB","GGR",0,7,7,0,7,"run060"
"12061","GGB","GRR",0,4,4,3,1,"run060"
"12062","GGB","RBB",0,5,5,4,1,"run060"
"12063","GGB","RBG",0,4,4,3,1,"run060"
"12064","GGB","RBR",0,5,5,1,4,"run060"
"12065","GGB","RGG",1,5,6,1,5,"run060"
"12066","GGB","RGR",0,2,2,1,1,"run060"
"12067","GGB","RRG",1,5,6,6,0,"run060"
"12068","GGB","RRR",1,5,6,0,6,"run060"
"12069","GGG","BBB",8,31,39,9,30,"run060"
"12070","GGG","BGB",0,2,2,0,2,"run060"
"12071","GGG","BGG",1,7,8,5,3,"run060"
"12072","GGG","BRB",1,3,4,1,3,"run060"
"12073","GGG","BRR",0,6,6,0,6,"run060"
"12074","GGG","GGB",5,1,6,6,0,"run060"
"12075","GGG","GGR",1,9,10,4,6,"run060"
"12076","GGG","GRR",0,2,2,1,1,"run060"
"12077","GGG","RBB",1,8,9,0,9,"run060"
"12078","GGG","RBG",0,6,6,1,5,"run060"
"12079","GGG","RBR",0,21,21,4,17,"run060"
"12080","GGG","RGG",0,3,3,0,3,"run060"
"12081","GGG","RGR",1,12,13,3,10,"run060"
"12082","GGG","RRG",1,23,24,9,15,"run060"
"12083","GGG","RRR",0,3,3,2,1,"run060"
"12084","GGR","BBB",0,2,2,1,1,"run060"
"12085","GGR","BBR",0,2,2,2,0,"run060"
"12086","GGR","BGG",0,1,1,0,1,"run060"
"12087","GGR","BRR",1,0,1,0,1,"run060"
"12088","GGR","GRR",1,0,1,1,0,"run060"
"12089","GGR","RBB",0,2,2,2,0,"run060"
"12090","GRG","BBB",3,8,11,2,9,"run060"
"12091","GRG","BBR",0,1,1,1,0,"run060"
"12092","GRG","BGG",0,1,1,1,0,"run060"
"12093","GRG","BRB",0,3,3,0,3,"run060"
"12094","GRG","BRR",0,1,1,1,0,"run060"
"12095","GRG","GBG",0,1,1,0,1,"run060"
"12096","GRG","GGB",2,15,17,10,7,"run060"
"12097","GRG","GGG",3,12,15,6,9,"run060"
"12098","GRG","GGR",0,5,5,1,4,"run060"
"12099","GRG","GRR",0,1,1,0,1,"run060"
"12100","GRG","RBG",0,1,1,0,1,"run060"
"12101","GRG","RBR",0,1,1,1,0,"run060"
"12102","GRG","RGR",1,2,3,0,3,"run060"
"12103","GRG","RRG",2,4,6,0,6,"run060"
"12104","GRR","BBB",0,1,1,1,0,"run060"
"12105","GRR","BBR",0,1,1,1,0,"run060"
"12106","GRR","BGB",1,2,3,1,2,"run060"
"12107","GRR","BGG",0,2,2,2,0,"run060"
"12108","GRR","BRB",0,1,1,1,0,"run060"
"12109","GRR","BRR",0,2,2,1,1,"run060"
"12110","GRR","GGG",0,1,1,1,0,"run060"
"12111","GRR","GGR",0,1,1,1,0,"run060"
"12112","RBB","BBB",0,1,1,0,1,"run060"
"12113","RBB","BBR",0,1,1,0,1,"run060"
"12114","RBB","BRB",0,1,1,1,0,"run060"
"12115","RBB","GRR",0,1,1,0,1,"run060"
"12116","RBB","RGG",0,1,1,0,1,"run060"
"12117","RBG","BBB",2,8,10,10,0,"run060"
"12118","RBG","BBG",0,1,1,1,0,"run060"
"12119","RBG","BRR",0,1,1,0,1,"run060"
"12120","RBG","GBB",0,1,1,1,0,"run060"
"12121","RBG","GRR",0,3,3,1,2,"run060"
"12122","RBG","RBB",1,1,2,2,0,"run060"
"12123","RBG","RBR",0,1,1,0,1,"run060"
"12124","RBG","RGR",0,1,1,1,0,"run060"
"12125","RBR","BBB",0,13,13,9,4,"run060"
"12126","RBR","BBR",0,1,1,0,1,"run060"
"12127","RBR","BGB",2,4,6,0,6,"run060"
"12128","RBR","BGG",0,2,2,2,0,"run060"
"12129","RBR","BRB",1,0,1,0,1,"run060"
"12130","RBR","BRR",1,4,5,2,3,"run060"
"12131","RBR","GGB",0,12,12,3,9,"run060"
"12132","RBR","GRR",4,4,8,2,6,"run060"
"12133","RBR","RBB",0,3,3,0,3,"run060"
"12134","RBR","RGG",2,9,11,10,1,"run060"
"12135","RBR","RGR",1,0,1,0,1,"run060"
"12136","RBR","RRR",0,1,1,0,1,"run060"
"12137","RGG","BBB",0,8,8,5,3,"run060"
"12138","RGG","BBR",1,2,3,0,3,"run060"
"12139","RGG","BGB",0,1,1,1,0,"run060"
"12140","RGG","BRR",0,4,4,2,2,"run060"
"12141","RGG","GGG",0,1,1,1,0,"run060"
"12142","RGG","GGR",0,3,3,0,3,"run060"
"12143","RGG","GRR",0,8,8,2,6,"run060"
"12144","RGG","RBB",0,1,1,1,0,"run060"
"12145","RGR","BBB",2,5,7,1,6,"run060"
"12146","RGR","BBR",1,1,2,2,0,"run060"
"12147","RGR","BGB",2,5,7,1,6,"run060"
"12148","RGR","BGG",2,2,4,3,1,"run060"
"12149","RGR","BRR",1,5,6,5,1,"run060"
"12150","RGR","GGB",2,12,14,12,2,"run060"
"12151","RGR","GGG",0,2,2,1,1,"run060"
"12152","RGR","GGR",0,4,4,1,3,"run060"
"12153","RGR","RBB",0,4,4,4,0,"run060"
"12154","RGR","RGG",1,1,2,1,1,"run060"
"12155","RGR","RRG",0,3,3,1,2,"run060"
"12156","RRG","BBB",2,33,35,1,34,"run060"
"12157","RRG","BBR",0,5,5,0,5,"run060"
"12158","RRG","BGB",1,10,11,8,3,"run060"
"12159","RRG","BGG",0,2,2,1,1,"run060"
"12160","RRG","BRB",2,40,42,37,5,"run060"
"12161","RRG","BRR",1,16,17,13,4,"run060"
"12162","RRG","GGG",2,14,16,2,14,"run060"
"12163","RRG","GGR",0,5,5,1,4,"run060"
"12164","RRG","GRG",1,0,1,1,0,"run060"
"12165","RRG","GRR",3,8,11,3,8,"run060"
"12166","RRG","RBB",1,1,2,1,1,"run060"
"12167","RRG","RGG",0,1,1,1,0,"run060"
"12168","RRG","RGR",0,1,1,0,1,"run060"
"12169","RRR","BBR",1,0,1,1,0,"run060"
"12170","RRR","BGB",2,1,3,1,2,"run060"
"12171","RRR","BGG",1,0,1,0,1,"run060"
"12172","RRR","BRB",1,1,2,2,0,"run060"
"12173","RRR","BRR",1,1,2,0,2,"run060"
"12174","RRR","GGR",0,1,1,0,1,"run060"
"12175","RRR","GRR",0,3,3,1,2,"run060"
"12176","RRR","RBB",1,2,3,1,2,"run060"
"12177","RRR","RBR",0,2,2,0,2,"run060"
"12178","RRR","RGG",0,1,1,1,0,"run060"
"12179","RRR","RGR",1,2,3,3,0,"run060"
"12180","RRR","RRG",2,2,4,3,1,"run060"
"12181","BBB","BRB",0,1,1,1,0,"run061"
"12182","BBB","GGG",1,2,3,2,1,"run061"
"12183","BBB","GRR",0,2,2,2,0,"run061"
"12184","BBB","RBG",0,1,1,1,0,"run061"
"12185","BBB","RRG",1,3,4,1,3,"run061"
"12186","BBB","RRR",0,2,2,0,2,"run061"
"12187","BBG","BBB",1,4,5,3,2,"run061"
"12188","BBG","BGB",0,1,1,1,0,"run061"
"12189","BBG","BGG",0,1,1,0,1,"run061"
"12190","BBG","BRB",1,16,17,0,17,"run061"
"12191","BBG","GBB",0,1,1,1,0,"run061"
"12192","BBG","GBG",2,7,9,8,1,"run061"
"12193","BBG","GGB",2,25,27,2,25,"run061"
"12194","BBG","GGG",4,38,42,15,27,"run061"
"12195","BBG","GRG",1,9,10,7,3,"run061"
"12196","BBG","GRR",0,1,1,0,1,"run061"
"12197","BBG","RBB",0,1,1,1,0,"run061"
"12198","BBG","RBG",0,4,4,3,1,"run061"
"12199","BBG","RBR",0,1,1,0,1,"run061"
"12200","BBG","RGR",0,1,1,0,1,"run061"
"12201","BBG","RRG",1,2,3,1,2,"run061"
"12202","BBG","RRR",0,7,7,7,0,"run061"
"12203","BGB","BBB",0,2,2,2,0,"run061"
"12204","BGB","RRG",0,1,1,1,0,"run061"
"12205","BGG","BBB",0,3,3,0,3,"run061"
"12206","BGG","BBR",0,1,1,1,0,"run061"
"12207","BGG","GRG",0,1,1,1,0,"run061"
"12208","BGG","RBG",1,1,2,0,2,"run061"
"12209","BGG","RGG",0,3,3,2,1,"run061"
"12210","BGG","RGR",0,1,1,0,1,"run061"
"12211","BGG","RRR",1,1,2,1,1,"run061"
"12212","BRB","BBB",0,13,13,7,6,"run061"
"12213","BRB","BBR",0,1,1,0,1,"run061"
"12214","BRB","BRR",0,3,3,2,1,"run061"
"12215","BRB","GGG",0,1,1,1,0,"run061"
"12216","BRB","GGR",0,1,1,1,0,"run061"
"12217","BRB","RBB",0,1,1,1,0,"run061"
"12218","BRB","RBG",0,1,1,0,1,"run061"
"12219","BRB","RGR",0,1,1,0,1,"run061"
"12220","BRB","RRR",0,1,1,0,1,"run061"
"12221","BRR","BBB",0,11,11,10,1,"run061"
"12222","BRR","BGB",1,1,2,2,0,"run061"
"12223","BRR","BGG",0,1,1,0,1,"run061"
"12224","BRR","BRB",0,1,1,1,0,"run061"
"12225","BRR","RBB",0,2,2,1,1,"run061"
"12226","GBB","BBB",12,38,50,10,40,"run061"
"12227","GBB","BGG",0,1,1,0,1,"run061"
"12228","GBB","BRB",1,9,10,8,2,"run061"
"12229","GBB","BRR",1,3,4,1,3,"run061"
"12230","GBB","GBG",0,4,4,1,3,"run061"
"12231","GBB","GGB",0,21,21,7,14,"run061"
"12232","GBB","GGG",7,86,93,65,28,"run061"
"12233","GBB","GGR",1,3,4,1,3,"run061"
"12234","GBB","GRG",0,6,6,1,5,"run061"
"12235","GBB","GRR",0,1,1,1,0,"run061"
"12236","GBB","RBB",0,2,2,2,0,"run061"
"12237","GBB","RBG",3,9,12,1,11,"run061"
"12238","GBB","RBR",1,0,1,0,1,"run061"
"12239","GBB","RGG",1,0,1,0,1,"run061"
"12240","GBB","RGR",2,1,3,1,2,"run061"
"12241","GBB","RRG",0,2,2,1,1,"run061"
"12242","GBB","RRR",1,9,10,0,10,"run061"
"12243","GBG","BBB",0,5,5,0,5,"run061"
"12244","GBG","BBR",0,1,1,0,1,"run061"
"12245","GBG","BRB",1,4,5,4,1,"run061"
"12246","GBG","BRR",1,0,1,1,0,"run061"
"12247","GBG","GGB",0,4,4,1,3,"run061"
"12248","GBG","GGG",4,11,15,10,5,"run061"
"12249","GBG","RBB",1,0,1,1,0,"run061"
"12250","GBG","RBG",0,1,1,1,0,"run061"
"12251","GBG","RGG",0,1,1,0,1,"run061"
"12252","GBG","RGR",1,3,4,0,4,"run061"
"12253","GBG","RRG",1,3,4,4,0,"run061"
"12254","GGB","BBB",3,16,19,2,17,"run061"
"12255","GGB","BBR",1,4,5,0,5,"run061"
"12256","GGB","BGB",0,3,3,1,2,"run061"
"12257","GGB","BGG",0,4,4,1,3,"run061"
"12258","GGB","BRB",0,1,1,1,0,"run061"
"12259","GGB","BRR",1,15,16,1,15,"run061"
"12260","GGB","GBB",0,1,1,0,1,"run061"
"12261","GGB","GBG",1,0,1,0,1,"run061"
"12262","GGB","GGG",13,48,61,14,47,"run061"
"12263","GGB","GGR",0,7,7,0,7,"run061"
"12264","GGB","GRR",0,4,4,1,3,"run061"
"12265","GGB","RBB",0,5,5,1,4,"run061"
"12266","GGB","RBG",0,4,4,4,0,"run061"
"12267","GGB","RBR",0,5,5,2,3,"run061"
"12268","GGB","RGG",1,5,6,2,4,"run061"
"12269","GGB","RGR",0,2,2,0,2,"run061"
"12270","GGB","RRG",1,5,6,5,1,"run061"
"12271","GGB","RRR",1,5,6,5,1,"run061"
"12272","GGG","BBB",8,31,39,19,20,"run061"
"12273","GGG","BGB",0,2,2,0,2,"run061"
"12274","GGG","BGG",1,7,8,3,5,"run061"
"12275","GGG","BRB",1,3,4,0,4,"run061"
"12276","GGG","BRR",0,6,6,3,3,"run061"
"12277","GGG","GGB",5,1,6,3,3,"run061"
"12278","GGG","GGR",1,9,10,3,7,"run061"
"12279","GGG","GRR",0,2,2,1,1,"run061"
"12280","GGG","RBB",1,8,9,6,3,"run061"
"12281","GGG","RBG",0,6,6,5,1,"run061"
"12282","GGG","RBR",0,21,21,15,6,"run061"
"12283","GGG","RGG",0,3,3,0,3,"run061"
"12284","GGG","RGR",1,12,13,13,0,"run061"
"12285","GGG","RRG",1,23,24,3,21,"run061"
"12286","GGG","RRR",0,3,3,3,0,"run061"
"12287","GGR","BBB",0,2,2,0,2,"run061"
"12288","GGR","BBR",0,2,2,2,0,"run061"
"12289","GGR","BGG",0,1,1,1,0,"run061"
"12290","GGR","BRR",1,0,1,0,1,"run061"
"12291","GGR","GRR",1,0,1,0,1,"run061"
"12292","GGR","RBB",0,2,2,2,0,"run061"
"12293","GRG","BBB",3,8,11,7,4,"run061"
"12294","GRG","BBR",0,1,1,1,0,"run061"
"12295","GRG","BGG",0,1,1,0,1,"run061"
"12296","GRG","BRB",0,3,3,0,3,"run061"
"12297","GRG","BRR",0,1,1,1,0,"run061"
"12298","GRG","GBG",0,1,1,1,0,"run061"
"12299","GRG","GGB",2,15,17,7,10,"run061"
"12300","GRG","GGG",3,12,15,1,14,"run061"
"12301","GRG","GGR",0,5,5,1,4,"run061"
"12302","GRG","GRR",0,1,1,0,1,"run061"
"12303","GRG","RBG",0,1,1,0,1,"run061"
"12304","GRG","RBR",0,1,1,1,0,"run061"
"12305","GRG","RGR",1,2,3,3,0,"run061"
"12306","GRG","RRG",2,4,6,5,1,"run061"
"12307","GRR","BBB",0,1,1,0,1,"run061"
"12308","GRR","BBR",0,1,1,0,1,"run061"
"12309","GRR","BGB",1,2,3,1,2,"run061"
"12310","GRR","BGG",0,2,2,1,1,"run061"
"12311","GRR","BRB",0,1,1,1,0,"run061"
"12312","GRR","BRR",0,2,2,2,0,"run061"
"12313","GRR","GGG",0,1,1,1,0,"run061"
"12314","GRR","GGR",0,1,1,0,1,"run061"
"12315","RBB","BBB",0,1,1,1,0,"run061"
"12316","RBB","BBR",0,1,1,0,1,"run061"
"12317","RBB","BRB",0,1,1,1,0,"run061"
"12318","RBB","GRR",0,1,1,0,1,"run061"
"12319","RBB","RGG",0,1,1,1,0,"run061"
"12320","RBG","BBB",2,8,10,3,7,"run061"
"12321","RBG","BBG",0,1,1,0,1,"run061"
"12322","RBG","BRR",0,1,1,0,1,"run061"
"12323","RBG","GBB",0,1,1,1,0,"run061"
"12324","RBG","GRR",0,3,3,0,3,"run061"
"12325","RBG","RBB",1,1,2,0,2,"run061"
"12326","RBG","RBR",0,1,1,0,1,"run061"
"12327","RBG","RGR",0,1,1,0,1,"run061"
"12328","RBR","BBB",0,13,13,5,8,"run061"
"12329","RBR","BBR",0,1,1,0,1,"run061"
"12330","RBR","BGB",2,4,6,1,5,"run061"
"12331","RBR","BGG",0,2,2,0,2,"run061"
"12332","RBR","BRB",1,0,1,0,1,"run061"
"12333","RBR","BRR",1,4,5,1,4,"run061"
"12334","RBR","GGB",0,12,12,12,0,"run061"
"12335","RBR","GRR",4,4,8,8,0,"run061"
"12336","RBR","RBB",0,3,3,2,1,"run061"
"12337","RBR","RGG",2,9,11,10,1,"run061"
"12338","RBR","RGR",1,0,1,1,0,"run061"
"12339","RBR","RRR",0,1,1,0,1,"run061"
"12340","RGG","BBB",0,8,8,3,5,"run061"
"12341","RGG","BBR",1,2,3,0,3,"run061"
"12342","RGG","BGB",0,1,1,0,1,"run061"
"12343","RGG","BRR",0,4,4,3,1,"run061"
"12344","RGG","GGG",0,1,1,0,1,"run061"
"12345","RGG","GGR",0,3,3,3,0,"run061"
"12346","RGG","GRR",0,8,8,8,0,"run061"
"12347","RGG","RBB",0,1,1,1,0,"run061"
"12348","RGR","BBB",2,5,7,6,1,"run061"
"12349","RGR","BBR",1,1,2,2,0,"run061"
"12350","RGR","BGB",2,5,7,4,3,"run061"
"12351","RGR","BGG",2,2,4,4,0,"run061"
"12352","RGR","BRR",1,5,6,6,0,"run061"
"12353","RGR","GGB",2,12,14,13,1,"run061"
"12354","RGR","GGG",0,2,2,0,2,"run061"
"12355","RGR","GGR",0,4,4,0,4,"run061"
"12356","RGR","RBB",0,4,4,1,3,"run061"
"12357","RGR","RGG",1,1,2,0,2,"run061"
"12358","RGR","RRG",0,3,3,1,2,"run061"
"12359","RRG","BBB",2,33,35,1,34,"run061"
"12360","RRG","BBR",0,5,5,3,2,"run061"
"12361","RRG","BGB",1,10,11,1,10,"run061"
"12362","RRG","BGG",0,2,2,0,2,"run061"
"12363","RRG","BRB",2,40,42,37,5,"run061"
"12364","RRG","BRR",1,16,17,10,7,"run061"
"12365","RRG","GGG",2,14,16,14,2,"run061"
"12366","RRG","GGR",0,5,5,3,2,"run061"
"12367","RRG","GRG",1,0,1,0,1,"run061"
"12368","RRG","GRR",3,8,11,3,8,"run061"
"12369","RRG","RBB",1,1,2,1,1,"run061"
"12370","RRG","RGG",0,1,1,0,1,"run061"
"12371","RRG","RGR",0,1,1,0,1,"run061"
"12372","RRR","BBR",1,0,1,1,0,"run061"
"12373","RRR","BGB",2,1,3,3,0,"run061"
"12374","RRR","BGG",1,0,1,1,0,"run061"
"12375","RRR","BRB",1,1,2,2,0,"run061"
"12376","RRR","BRR",1,1,2,1,1,"run061"
"12377","RRR","GGR",0,1,1,1,0,"run061"
"12378","RRR","GRR",0,3,3,2,1,"run061"
"12379","RRR","RBB",1,2,3,0,3,"run061"
"12380","RRR","RBR",0,2,2,0,2,"run061"
"12381","RRR","RGG",0,1,1,1,0,"run061"
"12382","RRR","RGR",1,2,3,2,1,"run061"
"12383","RRR","RRG",2,2,4,3,1,"run061"
"12384","BBB","BRB",0,1,1,1,0,"run062"
"12385","BBB","GGG",1,2,3,1,2,"run062"
"12386","BBB","GRR",0,2,2,2,0,"run062"
"12387","BBB","RBG",0,1,1,0,1,"run062"
"12388","BBB","RRG",1,3,4,4,0,"run062"
"12389","BBB","RRR",0,2,2,1,1,"run062"
"12390","BBG","BBB",1,4,5,4,1,"run062"
"12391","BBG","BGB",0,1,1,0,1,"run062"
"12392","BBG","BGG",0,1,1,0,1,"run062"
"12393","BBG","BRB",1,16,17,3,14,"run062"
"12394","BBG","GBB",0,1,1,0,1,"run062"
"12395","BBG","GBG",2,7,9,6,3,"run062"
"12396","BBG","GGB",2,25,27,12,15,"run062"
"12397","BBG","GGG",4,38,42,33,9,"run062"
"12398","BBG","GRG",1,9,10,6,4,"run062"
"12399","BBG","GRR",0,1,1,0,1,"run062"
"12400","BBG","RBB",0,1,1,0,1,"run062"
"12401","BBG","RBG",0,4,4,3,1,"run062"
"12402","BBG","RBR",0,1,1,1,0,"run062"
"12403","BBG","RGR",0,1,1,0,1,"run062"
"12404","BBG","RRG",1,2,3,1,2,"run062"
"12405","BBG","RRR",0,7,7,4,3,"run062"
"12406","BGB","BBB",0,2,2,1,1,"run062"
"12407","BGB","RRG",0,1,1,0,1,"run062"
"12408","BGG","BBB",0,3,3,2,1,"run062"
"12409","BGG","BBR",0,1,1,0,1,"run062"
"12410","BGG","GRG",0,1,1,0,1,"run062"
"12411","BGG","RBG",1,1,2,0,2,"run062"
"12412","BGG","RGG",0,3,3,1,2,"run062"
"12413","BGG","RGR",0,1,1,0,1,"run062"
"12414","BGG","RRR",1,1,2,0,2,"run062"
"12415","BRB","BBB",0,13,13,9,4,"run062"
"12416","BRB","BBR",0,1,1,1,0,"run062"
"12417","BRB","BRR",0,3,3,3,0,"run062"
"12418","BRB","GGG",0,1,1,0,1,"run062"
"12419","BRB","GGR",0,1,1,0,1,"run062"
"12420","BRB","RBB",0,1,1,0,1,"run062"
"12421","BRB","RBG",0,1,1,0,1,"run062"
"12422","BRB","RGR",0,1,1,1,0,"run062"
"12423","BRB","RRR",0,1,1,1,0,"run062"
"12424","BRR","BBB",0,11,11,3,8,"run062"
"12425","BRR","BGB",1,1,2,1,1,"run062"
"12426","BRR","BGG",0,1,1,0,1,"run062"
"12427","BRR","BRB",0,1,1,1,0,"run062"
"12428","BRR","RBB",0,2,2,1,1,"run062"
"12429","GBB","BBB",12,38,50,11,39,"run062"
"12430","GBB","BGG",0,1,1,1,0,"run062"
"12431","GBB","BRB",1,9,10,2,8,"run062"
"12432","GBB","BRR",1,3,4,4,0,"run062"
"12433","GBB","GBG",0,4,4,0,4,"run062"
"12434","GBB","GGB",0,21,21,1,20,"run062"
"12435","GBB","GGG",7,86,93,90,3,"run062"
"12436","GBB","GGR",1,3,4,0,4,"run062"
"12437","GBB","GRG",0,6,6,4,2,"run062"
"12438","GBB","GRR",0,1,1,1,0,"run062"
"12439","GBB","RBB",0,2,2,2,0,"run062"
"12440","GBB","RBG",3,9,12,2,10,"run062"
"12441","GBB","RBR",1,0,1,0,1,"run062"
"12442","GBB","RGG",1,0,1,1,0,"run062"
"12443","GBB","RGR",2,1,3,3,0,"run062"
"12444","GBB","RRG",0,2,2,1,1,"run062"
"12445","GBB","RRR",1,9,10,7,3,"run062"
"12446","GBG","BBB",0,5,5,3,2,"run062"
"12447","GBG","BBR",0,1,1,1,0,"run062"
"12448","GBG","BRB",1,4,5,1,4,"run062"
"12449","GBG","BRR",1,0,1,1,0,"run062"
"12450","GBG","GGB",0,4,4,2,2,"run062"
"12451","GBG","GGG",4,11,15,12,3,"run062"
"12452","GBG","RBB",1,0,1,1,0,"run062"
"12453","GBG","RBG",0,1,1,0,1,"run062"
"12454","GBG","RGG",0,1,1,0,1,"run062"
"12455","GBG","RGR",1,3,4,4,0,"run062"
"12456","GBG","RRG",1,3,4,1,3,"run062"
"12457","GGB","BBB",3,16,19,18,1,"run062"
"12458","GGB","BBR",1,4,5,2,3,"run062"
"12459","GGB","BGB",0,3,3,1,2,"run062"
"12460","GGB","BGG",0,4,4,0,4,"run062"
"12461","GGB","BRB",0,1,1,1,0,"run062"
"12462","GGB","BRR",1,15,16,13,3,"run062"
"12463","GGB","GBB",0,1,1,0,1,"run062"
"12464","GGB","GBG",1,0,1,1,0,"run062"
"12465","GGB","GGG",13,48,61,20,41,"run062"
"12466","GGB","GGR",0,7,7,7,0,"run062"
"12467","GGB","GRR",0,4,4,4,0,"run062"
"12468","GGB","RBB",0,5,5,4,1,"run062"
"12469","GGB","RBG",0,4,4,0,4,"run062"
"12470","GGB","RBR",0,5,5,4,1,"run062"
"12471","GGB","RGG",1,5,6,3,3,"run062"
"12472","GGB","RGR",0,2,2,0,2,"run062"
"12473","GGB","RRG",1,5,6,5,1,"run062"
"12474","GGB","RRR",1,5,6,2,4,"run062"
"12475","GGG","BBB",8,31,39,0,39,"run062"
"12476","GGG","BGB",0,2,2,2,0,"run062"
"12477","GGG","BGG",1,7,8,0,8,"run062"
"12478","GGG","BRB",1,3,4,2,2,"run062"
"12479","GGG","BRR",0,6,6,1,5,"run062"
"12480","GGG","GGB",5,1,6,0,6,"run062"
"12481","GGG","GGR",1,9,10,10,0,"run062"
"12482","GGG","GRR",0,2,2,0,2,"run062"
"12483","GGG","RBB",1,8,9,9,0,"run062"
"12484","GGG","RBG",0,6,6,3,3,"run062"
"12485","GGG","RBR",0,21,21,20,1,"run062"
"12486","GGG","RGG",0,3,3,2,1,"run062"
"12487","GGG","RGR",1,12,13,11,2,"run062"
"12488","GGG","RRG",1,23,24,5,19,"run062"
"12489","GGG","RRR",0,3,3,3,0,"run062"
"12490","GGR","BBB",0,2,2,2,0,"run062"
"12491","GGR","BBR",0,2,2,1,1,"run062"
"12492","GGR","BGG",0,1,1,0,1,"run062"
"12493","GGR","BRR",1,0,1,0,1,"run062"
"12494","GGR","GRR",1,0,1,0,1,"run062"
"12495","GGR","RBB",0,2,2,0,2,"run062"
"12496","GRG","BBB",3,8,11,10,1,"run062"
"12497","GRG","BBR",0,1,1,1,0,"run062"
"12498","GRG","BGG",0,1,1,1,0,"run062"
"12499","GRG","BRB",0,3,3,3,0,"run062"
"12500","GRG","BRR",0,1,1,0,1,"run062"
"12501","GRG","GBG",0,1,1,1,0,"run062"
"12502","GRG","GGB",2,15,17,11,6,"run062"
"12503","GRG","GGG",3,12,15,1,14,"run062"
"12504","GRG","GGR",0,5,5,2,3,"run062"
"12505","GRG","GRR",0,1,1,1,0,"run062"
"12506","GRG","RBG",0,1,1,0,1,"run062"
"12507","GRG","RBR",0,1,1,1,0,"run062"
"12508","GRG","RGR",1,2,3,0,3,"run062"
"12509","GRG","RRG",2,4,6,6,0,"run062"
"12510","GRR","BBB",0,1,1,0,1,"run062"
"12511","GRR","BBR",0,1,1,0,1,"run062"
"12512","GRR","BGB",1,2,3,3,0,"run062"
"12513","GRR","BGG",0,2,2,2,0,"run062"
"12514","GRR","BRB",0,1,1,0,1,"run062"
"12515","GRR","BRR",0,2,2,2,0,"run062"
"12516","GRR","GGG",0,1,1,1,0,"run062"
"12517","GRR","GGR",0,1,1,0,1,"run062"
"12518","RBB","BBB",0,1,1,1,0,"run062"
"12519","RBB","BBR",0,1,1,1,0,"run062"
"12520","RBB","BRB",0,1,1,0,1,"run062"
"12521","RBB","GRR",0,1,1,1,0,"run062"
"12522","RBB","RGG",0,1,1,0,1,"run062"
"12523","RBG","BBB",2,8,10,2,8,"run062"
"12524","RBG","BBG",0,1,1,0,1,"run062"
"12525","RBG","BRR",0,1,1,1,0,"run062"
"12526","RBG","GBB",0,1,1,1,0,"run062"
"12527","RBG","GRR",0,3,3,2,1,"run062"
"12528","RBG","RBB",1,1,2,1,1,"run062"
"12529","RBG","RBR",0,1,1,1,0,"run062"
"12530","RBG","RGR",0,1,1,0,1,"run062"
"12531","RBR","BBB",0,13,13,13,0,"run062"
"12532","RBR","BBR",0,1,1,1,0,"run062"
"12533","RBR","BGB",2,4,6,5,1,"run062"
"12534","RBR","BGG",0,2,2,2,0,"run062"
"12535","RBR","BRB",1,0,1,1,0,"run062"
"12536","RBR","BRR",1,4,5,1,4,"run062"
"12537","RBR","GGB",0,12,12,0,12,"run062"
"12538","RBR","GRR",4,4,8,3,5,"run062"
"12539","RBR","RBB",0,3,3,3,0,"run062"
"12540","RBR","RGG",2,9,11,6,5,"run062"
"12541","RBR","RGR",1,0,1,0,1,"run062"
"12542","RBR","RRR",0,1,1,0,1,"run062"
"12543","RGG","BBB",0,8,8,3,5,"run062"
"12544","RGG","BBR",1,2,3,0,3,"run062"
"12545","RGG","BGB",0,1,1,0,1,"run062"
"12546","RGG","BRR",0,4,4,2,2,"run062"
"12547","RGG","GGG",0,1,1,0,1,"run062"
"12548","RGG","GGR",0,3,3,3,0,"run062"
"12549","RGG","GRR",0,8,8,4,4,"run062"
"12550","RGG","RBB",0,1,1,1,0,"run062"
"12551","RGR","BBB",2,5,7,0,7,"run062"
"12552","RGR","BBR",1,1,2,0,2,"run062"
"12553","RGR","BGB",2,5,7,2,5,"run062"
"12554","RGR","BGG",2,2,4,4,0,"run062"
"12555","RGR","BRR",1,5,6,2,4,"run062"
"12556","RGR","GGB",2,12,14,7,7,"run062"
"12557","RGR","GGG",0,2,2,0,2,"run062"
"12558","RGR","GGR",0,4,4,0,4,"run062"
"12559","RGR","RBB",0,4,4,1,3,"run062"
"12560","RGR","RGG",1,1,2,0,2,"run062"
"12561","RGR","RRG",0,3,3,2,1,"run062"
"12562","RRG","BBB",2,33,35,19,16,"run062"
"12563","RRG","BBR",0,5,5,2,3,"run062"
"12564","RRG","BGB",1,10,11,1,10,"run062"
"12565","RRG","BGG",0,2,2,0,2,"run062"
"12566","RRG","BRB",2,40,42,37,5,"run062"
"12567","RRG","BRR",1,16,17,7,10,"run062"
"12568","RRG","GGG",2,14,16,15,1,"run062"
"12569","RRG","GGR",0,5,5,1,4,"run062"
"12570","RRG","GRG",1,0,1,0,1,"run062"
"12571","RRG","GRR",3,8,11,4,7,"run062"
"12572","RRG","RBB",1,1,2,2,0,"run062"
"12573","RRG","RGG",0,1,1,1,0,"run062"
"12574","RRG","RGR",0,1,1,0,1,"run062"
"12575","RRR","BBR",1,0,1,1,0,"run062"
"12576","RRR","BGB",2,1,3,0,3,"run062"
"12577","RRR","BGG",1,0,1,1,0,"run062"
"12578","RRR","BRB",1,1,2,1,1,"run062"
"12579","RRR","BRR",1,1,2,1,1,"run062"
"12580","RRR","GGR",0,1,1,0,1,"run062"
"12581","RRR","GRR",0,3,3,3,0,"run062"
"12582","RRR","RBB",1,2,3,3,0,"run062"
"12583","RRR","RBR",0,2,2,0,2,"run062"
"12584","RRR","RGG",0,1,1,0,1,"run062"
"12585","RRR","RGR",1,2,3,3,0,"run062"
"12586","RRR","RRG",2,2,4,3,1,"run062"
"12587","BBB","BRB",0,1,1,0,1,"run063"
"12588","BBB","GGG",1,2,3,1,2,"run063"
"12589","BBB","GRR",0,2,2,0,2,"run063"
"12590","BBB","RBG",0,1,1,0,1,"run063"
"12591","BBB","RRG",1,3,4,4,0,"run063"
"12592","BBB","RRR",0,2,2,0,2,"run063"
"12593","BBG","BBB",1,4,5,2,3,"run063"
"12594","BBG","BGB",0,1,1,0,1,"run063"
"12595","BBG","BGG",0,1,1,1,0,"run063"
"12596","BBG","BRB",1,16,17,1,16,"run063"
"12597","BBG","GBB",0,1,1,0,1,"run063"
"12598","BBG","GBG",2,7,9,1,8,"run063"
"12599","BBG","GGB",2,25,27,19,8,"run063"
"12600","BBG","GGG",4,38,42,33,9,"run063"
"12601","BBG","GRG",1,9,10,5,5,"run063"
"12602","BBG","GRR",0,1,1,0,1,"run063"
"12603","BBG","RBB",0,1,1,0,1,"run063"
"12604","BBG","RBG",0,4,4,4,0,"run063"
"12605","BBG","RBR",0,1,1,1,0,"run063"
"12606","BBG","RGR",0,1,1,0,1,"run063"
"12607","BBG","RRG",1,2,3,3,0,"run063"
"12608","BBG","RRR",0,7,7,3,4,"run063"
"12609","BGB","BBB",0,2,2,2,0,"run063"
"12610","BGB","RRG",0,1,1,1,0,"run063"
"12611","BGG","BBB",0,3,3,0,3,"run063"
"12612","BGG","BBR",0,1,1,1,0,"run063"
"12613","BGG","GRG",0,1,1,0,1,"run063"
"12614","BGG","RBG",1,1,2,2,0,"run063"
"12615","BGG","RGG",0,3,3,3,0,"run063"
"12616","BGG","RGR",0,1,1,1,0,"run063"
"12617","BGG","RRR",1,1,2,2,0,"run063"
"12618","BRB","BBB",0,13,13,13,0,"run063"
"12619","BRB","BBR",0,1,1,1,0,"run063"
"12620","BRB","BRR",0,3,3,2,1,"run063"
"12621","BRB","GGG",0,1,1,1,0,"run063"
"12622","BRB","GGR",0,1,1,0,1,"run063"
"12623","BRB","RBB",0,1,1,0,1,"run063"
"12624","BRB","RBG",0,1,1,1,0,"run063"
"12625","BRB","RGR",0,1,1,1,0,"run063"
"12626","BRB","RRR",0,1,1,0,1,"run063"
"12627","BRR","BBB",0,11,11,9,2,"run063"
"12628","BRR","BGB",1,1,2,0,2,"run063"
"12629","BRR","BGG",0,1,1,1,0,"run063"
"12630","BRR","BRB",0,1,1,0,1,"run063"
"12631","BRR","RBB",0,2,2,0,2,"run063"
"12632","GBB","BBB",12,38,50,21,29,"run063"
"12633","GBB","BGG",0,1,1,0,1,"run063"
"12634","GBB","BRB",1,9,10,3,7,"run063"
"12635","GBB","BRR",1,3,4,1,3,"run063"
"12636","GBB","GBG",0,4,4,4,0,"run063"
"12637","GBB","GGB",0,21,21,10,11,"run063"
"12638","GBB","GGG",7,86,93,28,65,"run063"
"12639","GBB","GGR",1,3,4,0,4,"run063"
"12640","GBB","GRG",0,6,6,5,1,"run063"
"12641","GBB","GRR",0,1,1,1,0,"run063"
"12642","GBB","RBB",0,2,2,0,2,"run063"
"12643","GBB","RBG",3,9,12,4,8,"run063"
"12644","GBB","RBR",1,0,1,1,0,"run063"
"12645","GBB","RGG",1,0,1,0,1,"run063"
"12646","GBB","RGR",2,1,3,2,1,"run063"
"12647","GBB","RRG",0,2,2,0,2,"run063"
"12648","GBB","RRR",1,9,10,10,0,"run063"
"12649","GBG","BBB",0,5,5,4,1,"run063"
"12650","GBG","BBR",0,1,1,0,1,"run063"
"12651","GBG","BRB",1,4,5,2,3,"run063"
"12652","GBG","BRR",1,0,1,0,1,"run063"
"12653","GBG","GGB",0,4,4,2,2,"run063"
"12654","GBG","GGG",4,11,15,13,2,"run063"
"12655","GBG","RBB",1,0,1,0,1,"run063"
"12656","GBG","RBG",0,1,1,0,1,"run063"
"12657","GBG","RGG",0,1,1,0,1,"run063"
"12658","GBG","RGR",1,3,4,0,4,"run063"
"12659","GBG","RRG",1,3,4,4,0,"run063"
"12660","GGB","BBB",3,16,19,12,7,"run063"
"12661","GGB","BBR",1,4,5,3,2,"run063"
"12662","GGB","BGB",0,3,3,1,2,"run063"
"12663","GGB","BGG",0,4,4,1,3,"run063"
"12664","GGB","BRB",0,1,1,1,0,"run063"
"12665","GGB","BRR",1,15,16,0,16,"run063"
"12666","GGB","GBB",0,1,1,1,0,"run063"
"12667","GGB","GBG",1,0,1,1,0,"run063"
"12668","GGB","GGG",13,48,61,3,58,"run063"
"12669","GGB","GGR",0,7,7,4,3,"run063"
"12670","GGB","GRR",0,4,4,2,2,"run063"
"12671","GGB","RBB",0,5,5,2,3,"run063"
"12672","GGB","RBG",0,4,4,2,2,"run063"
"12673","GGB","RBR",0,5,5,1,4,"run063"
"12674","GGB","RGG",1,5,6,0,6,"run063"
"12675","GGB","RGR",0,2,2,0,2,"run063"
"12676","GGB","RRG",1,5,6,1,5,"run063"
"12677","GGB","RRR",1,5,6,6,0,"run063"
"12678","GGG","BBB",8,31,39,22,17,"run063"
"12679","GGG","BGB",0,2,2,2,0,"run063"
"12680","GGG","BGG",1,7,8,0,8,"run063"
"12681","GGG","BRB",1,3,4,2,2,"run063"
"12682","GGG","BRR",0,6,6,4,2,"run063"
"12683","GGG","GGB",5,1,6,6,0,"run063"
"12684","GGG","GGR",1,9,10,5,5,"run063"
"12685","GGG","GRR",0,2,2,2,0,"run063"
"12686","GGG","RBB",1,8,9,8,1,"run063"
"12687","GGG","RBG",0,6,6,0,6,"run063"
"12688","GGG","RBR",0,21,21,20,1,"run063"
"12689","GGG","RGG",0,3,3,1,2,"run063"
"12690","GGG","RGR",1,12,13,3,10,"run063"
"12691","GGG","RRG",1,23,24,12,12,"run063"
"12692","GGG","RRR",0,3,3,2,1,"run063"
"12693","GGR","BBB",0,2,2,0,2,"run063"
"12694","GGR","BBR",0,2,2,1,1,"run063"
"12695","GGR","BGG",0,1,1,0,1,"run063"
"12696","GGR","BRR",1,0,1,1,0,"run063"
"12697","GGR","GRR",1,0,1,0,1,"run063"
"12698","GGR","RBB",0,2,2,0,2,"run063"
"12699","GRG","BBB",3,8,11,1,10,"run063"
"12700","GRG","BBR",0,1,1,1,0,"run063"
"12701","GRG","BGG",0,1,1,1,0,"run063"
"12702","GRG","BRB",0,3,3,2,1,"run063"
"12703","GRG","BRR",0,1,1,1,0,"run063"
"12704","GRG","GBG",0,1,1,0,1,"run063"
"12705","GRG","GGB",2,15,17,2,15,"run063"
"12706","GRG","GGG",3,12,15,11,4,"run063"
"12707","GRG","GGR",0,5,5,0,5,"run063"
"12708","GRG","GRR",0,1,1,0,1,"run063"
"12709","GRG","RBG",0,1,1,0,1,"run063"
"12710","GRG","RBR",0,1,1,0,1,"run063"
"12711","GRG","RGR",1,2,3,3,0,"run063"
"12712","GRG","RRG",2,4,6,6,0,"run063"
"12713","GRR","BBB",0,1,1,1,0,"run063"
"12714","GRR","BBR",0,1,1,0,1,"run063"
"12715","GRR","BGB",1,2,3,2,1,"run063"
"12716","GRR","BGG",0,2,2,2,0,"run063"
"12717","GRR","BRB",0,1,1,0,1,"run063"
"12718","GRR","BRR",0,2,2,0,2,"run063"
"12719","GRR","GGG",0,1,1,0,1,"run063"
"12720","GRR","GGR",0,1,1,1,0,"run063"
"12721","RBB","BBB",0,1,1,0,1,"run063"
"12722","RBB","BBR",0,1,1,1,0,"run063"
"12723","RBB","BRB",0,1,1,1,0,"run063"
"12724","RBB","GRR",0,1,1,1,0,"run063"
"12725","RBB","RGG",0,1,1,1,0,"run063"
"12726","RBG","BBB",2,8,10,10,0,"run063"
"12727","RBG","BBG",0,1,1,1,0,"run063"
"12728","RBG","BRR",0,1,1,0,1,"run063"
"12729","RBG","GBB",0,1,1,0,1,"run063"
"12730","RBG","GRR",0,3,3,0,3,"run063"
"12731","RBG","RBB",1,1,2,1,1,"run063"
"12732","RBG","RBR",0,1,1,1,0,"run063"
"12733","RBG","RGR",0,1,1,1,0,"run063"
"12734","RBR","BBB",0,13,13,4,9,"run063"
"12735","RBR","BBR",0,1,1,1,0,"run063"
"12736","RBR","BGB",2,4,6,2,4,"run063"
"12737","RBR","BGG",0,2,2,0,2,"run063"
"12738","RBR","BRB",1,0,1,1,0,"run063"
"12739","RBR","BRR",1,4,5,4,1,"run063"
"12740","RBR","GGB",0,12,12,8,4,"run063"
"12741","RBR","GRR",4,4,8,1,7,"run063"
"12742","RBR","RBB",0,3,3,1,2,"run063"
"12743","RBR","RGG",2,9,11,7,4,"run063"
"12744","RBR","RGR",1,0,1,1,0,"run063"
"12745","RBR","RRR",0,1,1,0,1,"run063"
"12746","RGG","BBB",0,8,8,5,3,"run063"
"12747","RGG","BBR",1,2,3,1,2,"run063"
"12748","RGG","BGB",0,1,1,1,0,"run063"
"12749","RGG","BRR",0,4,4,3,1,"run063"
"12750","RGG","GGG",0,1,1,1,0,"run063"
"12751","RGG","GGR",0,3,3,0,3,"run063"
"12752","RGG","GRR",0,8,8,2,6,"run063"
"12753","RGG","RBB",0,1,1,0,1,"run063"
"12754","RGR","BBB",2,5,7,3,4,"run063"
"12755","RGR","BBR",1,1,2,0,2,"run063"
"12756","RGR","BGB",2,5,7,3,4,"run063"
"12757","RGR","BGG",2,2,4,4,0,"run063"
"12758","RGR","BRR",1,5,6,2,4,"run063"
"12759","RGR","GGB",2,12,14,1,13,"run063"
"12760","RGR","GGG",0,2,2,2,0,"run063"
"12761","RGR","GGR",0,4,4,3,1,"run063"
"12762","RGR","RBB",0,4,4,2,2,"run063"
"12763","RGR","RGG",1,1,2,0,2,"run063"
"12764","RGR","RRG",0,3,3,0,3,"run063"
"12765","RRG","BBB",2,33,35,12,23,"run063"
"12766","RRG","BBR",0,5,5,2,3,"run063"
"12767","RRG","BGB",1,10,11,0,11,"run063"
"12768","RRG","BGG",0,2,2,1,1,"run063"
"12769","RRG","BRB",2,40,42,15,27,"run063"
"12770","RRG","BRR",1,16,17,13,4,"run063"
"12771","RRG","GGG",2,14,16,6,10,"run063"
"12772","RRG","GGR",0,5,5,3,2,"run063"
"12773","RRG","GRG",1,0,1,0,1,"run063"
"12774","RRG","GRR",3,8,11,11,0,"run063"
"12775","RRG","RBB",1,1,2,0,2,"run063"
"12776","RRG","RGG",0,1,1,1,0,"run063"
"12777","RRG","RGR",0,1,1,1,0,"run063"
"12778","RRR","BBR",1,0,1,0,1,"run063"
"12779","RRR","BGB",2,1,3,0,3,"run063"
"12780","RRR","BGG",1,0,1,0,1,"run063"
"12781","RRR","BRB",1,1,2,1,1,"run063"
"12782","RRR","BRR",1,1,2,1,1,"run063"
"12783","RRR","GGR",0,1,1,0,1,"run063"
"12784","RRR","GRR",0,3,3,0,3,"run063"
"12785","RRR","RBB",1,2,3,2,1,"run063"
"12786","RRR","RBR",0,2,2,0,2,"run063"
"12787","RRR","RGG",0,1,1,1,0,"run063"
"12788","RRR","RGR",1,2,3,2,1,"run063"
"12789","RRR","RRG",2,2,4,2,2,"run063"
"12790","BBB","BRB",0,1,1,1,0,"run064"
"12791","BBB","GGG",1,2,3,3,0,"run064"
"12792","BBB","GRR",0,2,2,2,0,"run064"
"12793","BBB","RBG",0,1,1,0,1,"run064"
"12794","BBB","RRG",1,3,4,0,4,"run064"
"12795","BBB","RRR",0,2,2,0,2,"run064"
"12796","BBG","BBB",1,4,5,5,0,"run064"
"12797","BBG","BGB",0,1,1,1,0,"run064"
"12798","BBG","BGG",0,1,1,0,1,"run064"
"12799","BBG","BRB",1,16,17,5,12,"run064"
"12800","BBG","GBB",0,1,1,0,1,"run064"
"12801","BBG","GBG",2,7,9,8,1,"run064"
"12802","BBG","GGB",2,25,27,7,20,"run064"
"12803","BBG","GGG",4,38,42,38,4,"run064"
"12804","BBG","GRG",1,9,10,7,3,"run064"
"12805","BBG","GRR",0,1,1,0,1,"run064"
"12806","BBG","RBB",0,1,1,0,1,"run064"
"12807","BBG","RBG",0,4,4,1,3,"run064"
"12808","BBG","RBR",0,1,1,0,1,"run064"
"12809","BBG","RGR",0,1,1,1,0,"run064"
"12810","BBG","RRG",1,2,3,1,2,"run064"
"12811","BBG","RRR",0,7,7,6,1,"run064"
"12812","BGB","BBB",0,2,2,0,2,"run064"
"12813","BGB","RRG",0,1,1,0,1,"run064"
"12814","BGG","BBB",0,3,3,1,2,"run064"
"12815","BGG","BBR",0,1,1,1,0,"run064"
"12816","BGG","GRG",0,1,1,1,0,"run064"
"12817","BGG","RBG",1,1,2,2,0,"run064"
"12818","BGG","RGG",0,3,3,3,0,"run064"
"12819","BGG","RGR",0,1,1,0,1,"run064"
"12820","BGG","RRR",1,1,2,2,0,"run064"
"12821","BRB","BBB",0,13,13,13,0,"run064"
"12822","BRB","BBR",0,1,1,1,0,"run064"
"12823","BRB","BRR",0,3,3,2,1,"run064"
"12824","BRB","GGG",0,1,1,0,1,"run064"
"12825","BRB","GGR",0,1,1,1,0,"run064"
"12826","BRB","RBB",0,1,1,0,1,"run064"
"12827","BRB","RBG",0,1,1,0,1,"run064"
"12828","BRB","RGR",0,1,1,1,0,"run064"
"12829","BRB","RRR",0,1,1,0,1,"run064"
"12830","BRR","BBB",0,11,11,1,10,"run064"
"12831","BRR","BGB",1,1,2,0,2,"run064"
"12832","BRR","BGG",0,1,1,0,1,"run064"
"12833","BRR","BRB",0,1,1,1,0,"run064"
"12834","BRR","RBB",0,2,2,1,1,"run064"
"12835","GBB","BBB",12,38,50,50,0,"run064"
"12836","GBB","BGG",0,1,1,0,1,"run064"
"12837","GBB","BRB",1,9,10,8,2,"run064"
"12838","GBB","BRR",1,3,4,2,2,"run064"
"12839","GBB","GBG",0,4,4,3,1,"run064"
"12840","GBB","GGB",0,21,21,10,11,"run064"
"12841","GBB","GGG",7,86,93,42,51,"run064"
"12842","GBB","GGR",1,3,4,0,4,"run064"
"12843","GBB","GRG",0,6,6,0,6,"run064"
"12844","GBB","GRR",0,1,1,1,0,"run064"
"12845","GBB","RBB",0,2,2,0,2,"run064"
"12846","GBB","RBG",3,9,12,12,0,"run064"
"12847","GBB","RBR",1,0,1,0,1,"run064"
"12848","GBB","RGG",1,0,1,1,0,"run064"
"12849","GBB","RGR",2,1,3,1,2,"run064"
"12850","GBB","RRG",0,2,2,2,0,"run064"
"12851","GBB","RRR",1,9,10,0,10,"run064"
"12852","GBG","BBB",0,5,5,0,5,"run064"
"12853","GBG","BBR",0,1,1,0,1,"run064"
"12854","GBG","BRB",1,4,5,5,0,"run064"
"12855","GBG","BRR",1,0,1,1,0,"run064"
"12856","GBG","GGB",0,4,4,4,0,"run064"
"12857","GBG","GGG",4,11,15,15,0,"run064"
"12858","GBG","RBB",1,0,1,0,1,"run064"
"12859","GBG","RBG",0,1,1,0,1,"run064"
"12860","GBG","RGG",0,1,1,0,1,"run064"
"12861","GBG","RGR",1,3,4,0,4,"run064"
"12862","GBG","RRG",1,3,4,1,3,"run064"
"12863","GGB","BBB",3,16,19,3,16,"run064"
"12864","GGB","BBR",1,4,5,2,3,"run064"
"12865","GGB","BGB",0,3,3,3,0,"run064"
"12866","GGB","BGG",0,4,4,0,4,"run064"
"12867","GGB","BRB",0,1,1,0,1,"run064"
"12868","GGB","BRR",1,15,16,10,6,"run064"
"12869","GGB","GBB",0,1,1,0,1,"run064"
"12870","GGB","GBG",1,0,1,1,0,"run064"
"12871","GGB","GGG",13,48,61,15,46,"run064"
"12872","GGB","GGR",0,7,7,6,1,"run064"
"12873","GGB","GRR",0,4,4,1,3,"run064"
"12874","GGB","RBB",0,5,5,5,0,"run064"
"12875","GGB","RBG",0,4,4,0,4,"run064"
"12876","GGB","RBR",0,5,5,0,5,"run064"
"12877","GGB","RGG",1,5,6,5,1,"run064"
"12878","GGB","RGR",0,2,2,2,0,"run064"
"12879","GGB","RRG",1,5,6,4,2,"run064"
"12880","GGB","RRR",1,5,6,1,5,"run064"
"12881","GGG","BBB",8,31,39,5,34,"run064"
"12882","GGG","BGB",0,2,2,0,2,"run064"
"12883","GGG","BGG",1,7,8,3,5,"run064"
"12884","GGG","BRB",1,3,4,2,2,"run064"
"12885","GGG","BRR",0,6,6,1,5,"run064"
"12886","GGG","GGB",5,1,6,6,0,"run064"
"12887","GGG","GGR",1,9,10,8,2,"run064"
"12888","GGG","GRR",0,2,2,1,1,"run064"
"12889","GGG","RBB",1,8,9,0,9,"run064"
"12890","GGG","RBG",0,6,6,0,6,"run064"
"12891","GGG","RBR",0,21,21,13,8,"run064"
"12892","GGG","RGG",0,3,3,0,3,"run064"
"12893","GGG","RGR",1,12,13,11,2,"run064"
"12894","GGG","RRG",1,23,24,16,8,"run064"
"12895","GGG","RRR",0,3,3,3,0,"run064"
"12896","GGR","BBB",0,2,2,1,1,"run064"
"12897","GGR","BBR",0,2,2,1,1,"run064"
"12898","GGR","BGG",0,1,1,0,1,"run064"
"12899","GGR","BRR",1,0,1,0,1,"run064"
"12900","GGR","GRR",1,0,1,0,1,"run064"
"12901","GGR","RBB",0,2,2,2,0,"run064"
"12902","GRG","BBB",3,8,11,5,6,"run064"
"12903","GRG","BBR",0,1,1,0,1,"run064"
"12904","GRG","BGG",0,1,1,0,1,"run064"
"12905","GRG","BRB",0,3,3,0,3,"run064"
"12906","GRG","BRR",0,1,1,1,0,"run064"
"12907","GRG","GBG",0,1,1,0,1,"run064"
"12908","GRG","GGB",2,15,17,3,14,"run064"
"12909","GRG","GGG",3,12,15,9,6,"run064"
"12910","GRG","GGR",0,5,5,5,0,"run064"
"12911","GRG","GRR",0,1,1,1,0,"run064"
"12912","GRG","RBG",0,1,1,0,1,"run064"
"12913","GRG","RBR",0,1,1,0,1,"run064"
"12914","GRG","RGR",1,2,3,3,0,"run064"
"12915","GRG","RRG",2,4,6,6,0,"run064"
"12916","GRR","BBB",0,1,1,0,1,"run064"
"12917","GRR","BBR",0,1,1,1,0,"run064"
"12918","GRR","BGB",1,2,3,2,1,"run064"
"12919","GRR","BGG",0,2,2,1,1,"run064"
"12920","GRR","BRB",0,1,1,1,0,"run064"
"12921","GRR","BRR",0,2,2,1,1,"run064"
"12922","GRR","GGG",0,1,1,0,1,"run064"
"12923","GRR","GGR",0,1,1,1,0,"run064"
"12924","RBB","BBB",0,1,1,0,1,"run064"
"12925","RBB","BBR",0,1,1,1,0,"run064"
"12926","RBB","BRB",0,1,1,1,0,"run064"
"12927","RBB","GRR",0,1,1,1,0,"run064"
"12928","RBB","RGG",0,1,1,0,1,"run064"
"12929","RBG","BBB",2,8,10,7,3,"run064"
"12930","RBG","BBG",0,1,1,0,1,"run064"
"12931","RBG","BRR",0,1,1,1,0,"run064"
"12932","RBG","GBB",0,1,1,1,0,"run064"
"12933","RBG","GRR",0,3,3,3,0,"run064"
"12934","RBG","RBB",1,1,2,2,0,"run064"
"12935","RBG","RBR",0,1,1,0,1,"run064"
"12936","RBG","RGR",0,1,1,1,0,"run064"
"12937","RBR","BBB",0,13,13,8,5,"run064"
"12938","RBR","BBR",0,1,1,1,0,"run064"
"12939","RBR","BGB",2,4,6,2,4,"run064"
"12940","RBR","BGG",0,2,2,2,0,"run064"
"12941","RBR","BRB",1,0,1,0,1,"run064"
"12942","RBR","BRR",1,4,5,0,5,"run064"
"12943","RBR","GGB",0,12,12,8,4,"run064"
"12944","RBR","GRR",4,4,8,1,7,"run064"
"12945","RBR","RBB",0,3,3,3,0,"run064"
"12946","RBR","RGG",2,9,11,2,9,"run064"
"12947","RBR","RGR",1,0,1,0,1,"run064"
"12948","RBR","RRR",0,1,1,0,1,"run064"
"12949","RGG","BBB",0,8,8,8,0,"run064"
"12950","RGG","BBR",1,2,3,2,1,"run064"
"12951","RGG","BGB",0,1,1,1,0,"run064"
"12952","RGG","BRR",0,4,4,2,2,"run064"
"12953","RGG","GGG",0,1,1,1,0,"run064"
"12954","RGG","GGR",0,3,3,2,1,"run064"
"12955","RGG","GRR",0,8,8,7,1,"run064"
"12956","RGG","RBB",0,1,1,1,0,"run064"
"12957","RGR","BBB",2,5,7,0,7,"run064"
"12958","RGR","BBR",1,1,2,1,1,"run064"
"12959","RGR","BGB",2,5,7,3,4,"run064"
"12960","RGR","BGG",2,2,4,3,1,"run064"
"12961","RGR","BRR",1,5,6,6,0,"run064"
"12962","RGR","GGB",2,12,14,2,12,"run064"
"12963","RGR","GGG",0,2,2,2,0,"run064"
"12964","RGR","GGR",0,4,4,2,2,"run064"
"12965","RGR","RBB",0,4,4,4,0,"run064"
"12966","RGR","RGG",1,1,2,0,2,"run064"
"12967","RGR","RRG",0,3,3,2,1,"run064"
"12968","RRG","BBB",2,33,35,27,8,"run064"
"12969","RRG","BBR",0,5,5,0,5,"run064"
"12970","RRG","BGB",1,10,11,3,8,"run064"
"12971","RRG","BGG",0,2,2,2,0,"run064"
"12972","RRG","BRB",2,40,42,0,42,"run064"
"12973","RRG","BRR",1,16,17,8,9,"run064"
"12974","RRG","GGG",2,14,16,7,9,"run064"
"12975","RRG","GGR",0,5,5,2,3,"run064"
"12976","RRG","GRG",1,0,1,0,1,"run064"
"12977","RRG","GRR",3,8,11,5,6,"run064"
"12978","RRG","RBB",1,1,2,1,1,"run064"
"12979","RRG","RGG",0,1,1,0,1,"run064"
"12980","RRG","RGR",0,1,1,1,0,"run064"
"12981","RRR","BBR",1,0,1,1,0,"run064"
"12982","RRR","BGB",2,1,3,0,3,"run064"
"12983","RRR","BGG",1,0,1,1,0,"run064"
"12984","RRR","BRB",1,1,2,0,2,"run064"
"12985","RRR","BRR",1,1,2,2,0,"run064"
"12986","RRR","GGR",0,1,1,1,0,"run064"
"12987","RRR","GRR",0,3,3,1,2,"run064"
"12988","RRR","RBB",1,2,3,3,0,"run064"
"12989","RRR","RBR",0,2,2,0,2,"run064"
"12990","RRR","RGG",0,1,1,1,0,"run064"
"12991","RRR","RGR",1,2,3,1,2,"run064"
"12992","RRR","RRG",2,2,4,1,3,"run064"
"12993","BBB","BRB",0,1,1,1,0,"run065"
"12994","BBB","GGG",1,2,3,2,1,"run065"
"12995","BBB","GRR",0,2,2,2,0,"run065"
"12996","BBB","RBG",0,1,1,1,0,"run065"
"12997","BBB","RRG",1,3,4,1,3,"run065"
"12998","BBB","RRR",0,2,2,1,1,"run065"
"12999","BBG","BBB",1,4,5,3,2,"run065"
"13000","BBG","BGB",0,1,1,0,1,"run065"
"13001","BBG","BGG",0,1,1,0,1,"run065"
"13002","BBG","BRB",1,16,17,16,1,"run065"
"13003","BBG","GBB",0,1,1,0,1,"run065"
"13004","BBG","GBG",2,7,9,7,2,"run065"
"13005","BBG","GGB",2,25,27,5,22,"run065"
"13006","BBG","GGG",4,38,42,5,37,"run065"
"13007","BBG","GRG",1,9,10,2,8,"run065"
"13008","BBG","GRR",0,1,1,1,0,"run065"
"13009","BBG","RBB",0,1,1,1,0,"run065"
"13010","BBG","RBG",0,4,4,0,4,"run065"
"13011","BBG","RBR",0,1,1,0,1,"run065"
"13012","BBG","RGR",0,1,1,1,0,"run065"
"13013","BBG","RRG",1,2,3,1,2,"run065"
"13014","BBG","RRR",0,7,7,4,3,"run065"
"13015","BGB","BBB",0,2,2,2,0,"run065"
"13016","BGB","RRG",0,1,1,1,0,"run065"
"13017","BGG","BBB",0,3,3,0,3,"run065"
"13018","BGG","BBR",0,1,1,1,0,"run065"
"13019","BGG","GRG",0,1,1,1,0,"run065"
"13020","BGG","RBG",1,1,2,1,1,"run065"
"13021","BGG","RGG",0,3,3,2,1,"run065"
"13022","BGG","RGR",0,1,1,0,1,"run065"
"13023","BGG","RRR",1,1,2,1,1,"run065"
"13024","BRB","BBB",0,13,13,2,11,"run065"
"13025","BRB","BBR",0,1,1,0,1,"run065"
"13026","BRB","BRR",0,3,3,2,1,"run065"
"13027","BRB","GGG",0,1,1,0,1,"run065"
"13028","BRB","GGR",0,1,1,1,0,"run065"
"13029","BRB","RBB",0,1,1,1,0,"run065"
"13030","BRB","RBG",0,1,1,0,1,"run065"
"13031","BRB","RGR",0,1,1,1,0,"run065"
"13032","BRB","RRR",0,1,1,1,0,"run065"
"13033","BRR","BBB",0,11,11,1,10,"run065"
"13034","BRR","BGB",1,1,2,1,1,"run065"
"13035","BRR","BGG",0,1,1,1,0,"run065"
"13036","BRR","BRB",0,1,1,1,0,"run065"
"13037","BRR","RBB",0,2,2,1,1,"run065"
"13038","GBB","BBB",12,38,50,21,29,"run065"
"13039","GBB","BGG",0,1,1,0,1,"run065"
"13040","GBB","BRB",1,9,10,1,9,"run065"
"13041","GBB","BRR",1,3,4,1,3,"run065"
"13042","GBB","GBG",0,4,4,1,3,"run065"
"13043","GBB","GGB",0,21,21,17,4,"run065"
"13044","GBB","GGG",7,86,93,12,81,"run065"
"13045","GBB","GGR",1,3,4,3,1,"run065"
"13046","GBB","GRG",0,6,6,6,0,"run065"
"13047","GBB","GRR",0,1,1,1,0,"run065"
"13048","GBB","RBB",0,2,2,1,1,"run065"
"13049","GBB","RBG",3,9,12,3,9,"run065"
"13050","GBB","RBR",1,0,1,0,1,"run065"
"13051","GBB","RGG",1,0,1,1,0,"run065"
"13052","GBB","RGR",2,1,3,1,2,"run065"
"13053","GBB","RRG",0,2,2,0,2,"run065"
"13054","GBB","RRR",1,9,10,4,6,"run065"
"13055","GBG","BBB",0,5,5,2,3,"run065"
"13056","GBG","BBR",0,1,1,1,0,"run065"
"13057","GBG","BRB",1,4,5,3,2,"run065"
"13058","GBG","BRR",1,0,1,0,1,"run065"
"13059","GBG","GGB",0,4,4,3,1,"run065"
"13060","GBG","GGG",4,11,15,13,2,"run065"
"13061","GBG","RBB",1,0,1,1,0,"run065"
"13062","GBG","RBG",0,1,1,1,0,"run065"
"13063","GBG","RGG",0,1,1,1,0,"run065"
"13064","GBG","RGR",1,3,4,3,1,"run065"
"13065","GBG","RRG",1,3,4,0,4,"run065"
"13066","GGB","BBB",3,16,19,12,7,"run065"
"13067","GGB","BBR",1,4,5,0,5,"run065"
"13068","GGB","BGB",0,3,3,0,3,"run065"
"13069","GGB","BGG",0,4,4,4,0,"run065"
"13070","GGB","BRB",0,1,1,1,0,"run065"
"13071","GGB","BRR",1,15,16,14,2,"run065"
"13072","GGB","GBB",0,1,1,1,0,"run065"
"13073","GGB","GBG",1,0,1,0,1,"run065"
"13074","GGB","GGG",13,48,61,45,16,"run065"
"13075","GGB","GGR",0,7,7,6,1,"run065"
"13076","GGB","GRR",0,4,4,0,4,"run065"
"13077","GGB","RBB",0,5,5,4,1,"run065"
"13078","GGB","RBG",0,4,4,3,1,"run065"
"13079","GGB","RBR",0,5,5,0,5,"run065"
"13080","GGB","RGG",1,5,6,3,3,"run065"
"13081","GGB","RGR",0,2,2,0,2,"run065"
"13082","GGB","RRG",1,5,6,1,5,"run065"
"13083","GGB","RRR",1,5,6,0,6,"run065"
"13084","GGG","BBB",8,31,39,31,8,"run065"
"13085","GGG","BGB",0,2,2,0,2,"run065"
"13086","GGG","BGG",1,7,8,6,2,"run065"
"13087","GGG","BRB",1,3,4,2,2,"run065"
"13088","GGG","BRR",0,6,6,3,3,"run065"
"13089","GGG","GGB",5,1,6,6,0,"run065"
"13090","GGG","GGR",1,9,10,6,4,"run065"
"13091","GGG","GRR",0,2,2,2,0,"run065"
"13092","GGG","RBB",1,8,9,4,5,"run065"
"13093","GGG","RBG",0,6,6,1,5,"run065"
"13094","GGG","RBR",0,21,21,9,12,"run065"
"13095","GGG","RGG",0,3,3,2,1,"run065"
"13096","GGG","RGR",1,12,13,4,9,"run065"
"13097","GGG","RRG",1,23,24,2,22,"run065"
"13098","GGG","RRR",0,3,3,1,2,"run065"
"13099","GGR","BBB",0,2,2,1,1,"run065"
"13100","GGR","BBR",0,2,2,0,2,"run065"
"13101","GGR","BGG",0,1,1,1,0,"run065"
"13102","GGR","BRR",1,0,1,0,1,"run065"
"13103","GGR","GRR",1,0,1,0,1,"run065"
"13104","GGR","RBB",0,2,2,1,1,"run065"
"13105","GRG","BBB",3,8,11,0,11,"run065"
"13106","GRG","BBR",0,1,1,0,1,"run065"
"13107","GRG","BGG",0,1,1,0,1,"run065"
"13108","GRG","BRB",0,3,3,0,3,"run065"
"13109","GRG","BRR",0,1,1,0,1,"run065"
"13110","GRG","GBG",0,1,1,1,0,"run065"
"13111","GRG","GGB",2,15,17,6,11,"run065"
"13112","GRG","GGG",3,12,15,5,10,"run065"
"13113","GRG","GGR",0,5,5,3,2,"run065"
"13114","GRG","GRR",0,1,1,1,0,"run065"
"13115","GRG","RBG",0,1,1,1,0,"run065"
"13116","GRG","RBR",0,1,1,0,1,"run065"
"13117","GRG","RGR",1,2,3,2,1,"run065"
"13118","GRG","RRG",2,4,6,6,0,"run065"
"13119","GRR","BBB",0,1,1,1,0,"run065"
"13120","GRR","BBR",0,1,1,1,0,"run065"
"13121","GRR","BGB",1,2,3,2,1,"run065"
"13122","GRR","BGG",0,2,2,1,1,"run065"
"13123","GRR","BRB",0,1,1,0,1,"run065"
"13124","GRR","BRR",0,2,2,2,0,"run065"
"13125","GRR","GGG",0,1,1,1,0,"run065"
"13126","GRR","GGR",0,1,1,1,0,"run065"
"13127","RBB","BBB",0,1,1,0,1,"run065"
"13128","RBB","BBR",0,1,1,1,0,"run065"
"13129","RBB","BRB",0,1,1,1,0,"run065"
"13130","RBB","GRR",0,1,1,0,1,"run065"
"13131","RBB","RGG",0,1,1,1,0,"run065"
"13132","RBG","BBB",2,8,10,7,3,"run065"
"13133","RBG","BBG",0,1,1,0,1,"run065"
"13134","RBG","BRR",0,1,1,0,1,"run065"
"13135","RBG","GBB",0,1,1,0,1,"run065"
"13136","RBG","GRR",0,3,3,2,1,"run065"
"13137","RBG","RBB",1,1,2,0,2,"run065"
"13138","RBG","RBR",0,1,1,1,0,"run065"
"13139","RBG","RGR",0,1,1,1,0,"run065"
"13140","RBR","BBB",0,13,13,2,11,"run065"
"13141","RBR","BBR",0,1,1,1,0,"run065"
"13142","RBR","BGB",2,4,6,3,3,"run065"
"13143","RBR","BGG",0,2,2,0,2,"run065"
"13144","RBR","BRB",1,0,1,0,1,"run065"
"13145","RBR","BRR",1,4,5,0,5,"run065"
"13146","RBR","GGB",0,12,12,1,11,"run065"
"13147","RBR","GRR",4,4,8,1,7,"run065"
"13148","RBR","RBB",0,3,3,0,3,"run065"
"13149","RBR","RGG",2,9,11,10,1,"run065"
"13150","RBR","RGR",1,0,1,0,1,"run065"
"13151","RBR","RRR",0,1,1,0,1,"run065"
"13152","RGG","BBB",0,8,8,2,6,"run065"
"13153","RGG","BBR",1,2,3,1,2,"run065"
"13154","RGG","BGB",0,1,1,1,0,"run065"
"13155","RGG","BRR",0,4,4,0,4,"run065"
"13156","RGG","GGG",0,1,1,0,1,"run065"
"13157","RGG","GGR",0,3,3,1,2,"run065"
"13158","RGG","GRR",0,8,8,4,4,"run065"
"13159","RGG","RBB",0,1,1,1,0,"run065"
"13160","RGR","BBB",2,5,7,4,3,"run065"
"13161","RGR","BBR",1,1,2,2,0,"run065"
"13162","RGR","BGB",2,5,7,2,5,"run065"
"13163","RGR","BGG",2,2,4,0,4,"run065"
"13164","RGR","BRR",1,5,6,2,4,"run065"
"13165","RGR","GGB",2,12,14,14,0,"run065"
"13166","RGR","GGG",0,2,2,1,1,"run065"
"13167","RGR","GGR",0,4,4,0,4,"run065"
"13168","RGR","RBB",0,4,4,0,4,"run065"
"13169","RGR","RGG",1,1,2,2,0,"run065"
"13170","RGR","RRG",0,3,3,0,3,"run065"
"13171","RRG","BBB",2,33,35,9,26,"run065"
"13172","RRG","BBR",0,5,5,1,4,"run065"
"13173","RRG","BGB",1,10,11,7,4,"run065"
"13174","RRG","BGG",0,2,2,0,2,"run065"
"13175","RRG","BRB",2,40,42,21,21,"run065"
"13176","RRG","BRR",1,16,17,1,16,"run065"
"13177","RRG","GGG",2,14,16,11,5,"run065"
"13178","RRG","GGR",0,5,5,0,5,"run065"
"13179","RRG","GRG",1,0,1,0,1,"run065"
"13180","RRG","GRR",3,8,11,10,1,"run065"
"13181","RRG","RBB",1,1,2,0,2,"run065"
"13182","RRG","RGG",0,1,1,0,1,"run065"
"13183","RRG","RGR",0,1,1,1,0,"run065"
"13184","RRR","BBR",1,0,1,0,1,"run065"
"13185","RRR","BGB",2,1,3,1,2,"run065"
"13186","RRR","BGG",1,0,1,1,0,"run065"
"13187","RRR","BRB",1,1,2,1,1,"run065"
"13188","RRR","BRR",1,1,2,2,0,"run065"
"13189","RRR","GGR",0,1,1,0,1,"run065"
"13190","RRR","GRR",0,3,3,2,1,"run065"
"13191","RRR","RBB",1,2,3,1,2,"run065"
"13192","RRR","RBR",0,2,2,2,0,"run065"
"13193","RRR","RGG",0,1,1,1,0,"run065"
"13194","RRR","RGR",1,2,3,0,3,"run065"
"13195","RRR","RRG",2,2,4,0,4,"run065"
"13196","BBB","BRB",0,1,1,0,1,"run066"
"13197","BBB","GGG",1,2,3,2,1,"run066"
"13198","BBB","GRR",0,2,2,0,2,"run066"
"13199","BBB","RBG",0,1,1,1,0,"run066"
"13200","BBB","RRG",1,3,4,1,3,"run066"
"13201","BBB","RRR",0,2,2,0,2,"run066"
"13202","BBG","BBB",1,4,5,2,3,"run066"
"13203","BBG","BGB",0,1,1,1,0,"run066"
"13204","BBG","BGG",0,1,1,1,0,"run066"
"13205","BBG","BRB",1,16,17,0,17,"run066"
"13206","BBG","GBB",0,1,1,1,0,"run066"
"13207","BBG","GBG",2,7,9,6,3,"run066"
"13208","BBG","GGB",2,25,27,15,12,"run066"
"13209","BBG","GGG",4,38,42,39,3,"run066"
"13210","BBG","GRG",1,9,10,1,9,"run066"
"13211","BBG","GRR",0,1,1,1,0,"run066"
"13212","BBG","RBB",0,1,1,0,1,"run066"
"13213","BBG","RBG",0,4,4,3,1,"run066"
"13214","BBG","RBR",0,1,1,1,0,"run066"
"13215","BBG","RGR",0,1,1,0,1,"run066"
"13216","BBG","RRG",1,2,3,1,2,"run066"
"13217","BBG","RRR",0,7,7,3,4,"run066"
"13218","BGB","BBB",0,2,2,2,0,"run066"
"13219","BGB","RRG",0,1,1,0,1,"run066"
"13220","BGG","BBB",0,3,3,2,1,"run066"
"13221","BGG","BBR",0,1,1,0,1,"run066"
"13222","BGG","GRG",0,1,1,1,0,"run066"
"13223","BGG","RBG",1,1,2,1,1,"run066"
"13224","BGG","RGG",0,3,3,3,0,"run066"
"13225","BGG","RGR",0,1,1,1,0,"run066"
"13226","BGG","RRR",1,1,2,1,1,"run066"
"13227","BRB","BBB",0,13,13,5,8,"run066"
"13228","BRB","BBR",0,1,1,0,1,"run066"
"13229","BRB","BRR",0,3,3,0,3,"run066"
"13230","BRB","GGG",0,1,1,1,0,"run066"
"13231","BRB","GGR",0,1,1,0,1,"run066"
"13232","BRB","RBB",0,1,1,1,0,"run066"
"13233","BRB","RBG",0,1,1,0,1,"run066"
"13234","BRB","RGR",0,1,1,0,1,"run066"
"13235","BRB","RRR",0,1,1,1,0,"run066"
"13236","BRR","BBB",0,11,11,9,2,"run066"
"13237","BRR","BGB",1,1,2,0,2,"run066"
"13238","BRR","BGG",0,1,1,1,0,"run066"
"13239","BRR","BRB",0,1,1,1,0,"run066"
"13240","BRR","RBB",0,2,2,0,2,"run066"
"13241","GBB","BBB",12,38,50,14,36,"run066"
"13242","GBB","BGG",0,1,1,1,0,"run066"
"13243","GBB","BRB",1,9,10,0,10,"run066"
"13244","GBB","BRR",1,3,4,0,4,"run066"
"13245","GBB","GBG",0,4,4,3,1,"run066"
"13246","GBB","GGB",0,21,21,20,1,"run066"
"13247","GBB","GGG",7,86,93,74,19,"run066"
"13248","GBB","GGR",1,3,4,4,0,"run066"
"13249","GBB","GRG",0,6,6,4,2,"run066"
"13250","GBB","GRR",0,1,1,0,1,"run066"
"13251","GBB","RBB",0,2,2,1,1,"run066"
"13252","GBB","RBG",3,9,12,4,8,"run066"
"13253","GBB","RBR",1,0,1,0,1,"run066"
"13254","GBB","RGG",1,0,1,0,1,"run066"
"13255","GBB","RGR",2,1,3,1,2,"run066"
"13256","GBB","RRG",0,2,2,2,0,"run066"
"13257","GBB","RRR",1,9,10,8,2,"run066"
"13258","GBG","BBB",0,5,5,4,1,"run066"
"13259","GBG","BBR",0,1,1,1,0,"run066"
"13260","GBG","BRB",1,4,5,2,3,"run066"
"13261","GBG","BRR",1,0,1,0,1,"run066"
"13262","GBG","GGB",0,4,4,3,1,"run066"
"13263","GBG","GGG",4,11,15,13,2,"run066"
"13264","GBG","RBB",1,0,1,0,1,"run066"
"13265","GBG","RBG",0,1,1,0,1,"run066"
"13266","GBG","RGG",0,1,1,0,1,"run066"
"13267","GBG","RGR",1,3,4,3,1,"run066"
"13268","GBG","RRG",1,3,4,1,3,"run066"
"13269","GGB","BBB",3,16,19,1,18,"run066"
"13270","GGB","BBR",1,4,5,0,5,"run066"
"13271","GGB","BGB",0,3,3,1,2,"run066"
"13272","GGB","BGG",0,4,4,1,3,"run066"
"13273","GGB","BRB",0,1,1,0,1,"run066"
"13274","GGB","BRR",1,15,16,15,1,"run066"
"13275","GGB","GBB",0,1,1,1,0,"run066"
"13276","GGB","GBG",1,0,1,0,1,"run066"
"13277","GGB","GGG",13,48,61,60,1,"run066"
"13278","GGB","GGR",0,7,7,3,4,"run066"
"13279","GGB","GRR",0,4,4,2,2,"run066"
"13280","GGB","RBB",0,5,5,2,3,"run066"
"13281","GGB","RBG",0,4,4,3,1,"run066"
"13282","GGB","RBR",0,5,5,2,3,"run066"
"13283","GGB","RGG",1,5,6,5,1,"run066"
"13284","GGB","RGR",0,2,2,0,2,"run066"
"13285","GGB","RRG",1,5,6,4,2,"run066"
"13286","GGB","RRR",1,5,6,2,4,"run066"
"13287","GGG","BBB",8,31,39,32,7,"run066"
"13288","GGG","BGB",0,2,2,2,0,"run066"
"13289","GGG","BGG",1,7,8,6,2,"run066"
"13290","GGG","BRB",1,3,4,4,0,"run066"
"13291","GGG","BRR",0,6,6,2,4,"run066"
"13292","GGG","GGB",5,1,6,5,1,"run066"
"13293","GGG","GGR",1,9,10,2,8,"run066"
"13294","GGG","GRR",0,2,2,1,1,"run066"
"13295","GGG","RBB",1,8,9,1,8,"run066"
"13296","GGG","RBG",0,6,6,2,4,"run066"
"13297","GGG","RBR",0,21,21,16,5,"run066"
"13298","GGG","RGG",0,3,3,3,0,"run066"
"13299","GGG","RGR",1,12,13,7,6,"run066"
"13300","GGG","RRG",1,23,24,6,18,"run066"
"13301","GGG","RRR",0,3,3,2,1,"run066"
"13302","GGR","BBB",0,2,2,0,2,"run066"
"13303","GGR","BBR",0,2,2,2,0,"run066"
"13304","GGR","BGG",0,1,1,0,1,"run066"
"13305","GGR","BRR",1,0,1,1,0,"run066"
"13306","GGR","GRR",1,0,1,1,0,"run066"
"13307","GGR","RBB",0,2,2,2,0,"run066"
"13308","GRG","BBB",3,8,11,6,5,"run066"
"13309","GRG","BBR",0,1,1,1,0,"run066"
"13310","GRG","BGG",0,1,1,0,1,"run066"
"13311","GRG","BRB",0,3,3,0,3,"run066"
"13312","GRG","BRR",0,1,1,0,1,"run066"
"13313","GRG","GBG",0,1,1,0,1,"run066"
"13314","GRG","GGB",2,15,17,11,6,"run066"
"13315","GRG","GGG",3,12,15,10,5,"run066"
"13316","GRG","GGR",0,5,5,2,3,"run066"
"13317","GRG","GRR",0,1,1,1,0,"run066"
"13318","GRG","RBG",0,1,1,1,0,"run066"
"13319","GRG","RBR",0,1,1,0,1,"run066"
"13320","GRG","RGR",1,2,3,2,1,"run066"
"13321","GRG","RRG",2,4,6,5,1,"run066"
"13322","GRR","BBB",0,1,1,1,0,"run066"
"13323","GRR","BBR",0,1,1,1,0,"run066"
"13324","GRR","BGB",1,2,3,2,1,"run066"
"13325","GRR","BGG",0,2,2,2,0,"run066"
"13326","GRR","BRB",0,1,1,1,0,"run066"
"13327","GRR","BRR",0,2,2,1,1,"run066"
"13328","GRR","GGG",0,1,1,0,1,"run066"
"13329","GRR","GGR",0,1,1,1,0,"run066"
"13330","RBB","BBB",0,1,1,1,0,"run066"
"13331","RBB","BBR",0,1,1,1,0,"run066"
"13332","RBB","BRB",0,1,1,0,1,"run066"
"13333","RBB","GRR",0,1,1,1,0,"run066"
"13334","RBB","RGG",0,1,1,1,0,"run066"
"13335","RBG","BBB",2,8,10,7,3,"run066"
"13336","RBG","BBG",0,1,1,0,1,"run066"
"13337","RBG","BRR",0,1,1,0,1,"run066"
"13338","RBG","GBB",0,1,1,1,0,"run066"
"13339","RBG","GRR",0,3,3,3,0,"run066"
"13340","RBG","RBB",1,1,2,1,1,"run066"
"13341","RBG","RBR",0,1,1,1,0,"run066"
"13342","RBG","RGR",0,1,1,0,1,"run066"
"13343","RBR","BBB",0,13,13,8,5,"run066"
"13344","RBR","BBR",0,1,1,1,0,"run066"
"13345","RBR","BGB",2,4,6,0,6,"run066"
"13346","RBR","BGG",0,2,2,2,0,"run066"
"13347","RBR","BRB",1,0,1,1,0,"run066"
"13348","RBR","BRR",1,4,5,3,2,"run066"
"13349","RBR","GGB",0,12,12,5,7,"run066"
"13350","RBR","GRR",4,4,8,0,8,"run066"
"13351","RBR","RBB",0,3,3,0,3,"run066"
"13352","RBR","RGG",2,9,11,5,6,"run066"
"13353","RBR","RGR",1,0,1,1,0,"run066"
"13354","RBR","RRR",0,1,1,0,1,"run066"
"13355","RGG","BBB",0,8,8,0,8,"run066"
"13356","RGG","BBR",1,2,3,1,2,"run066"
"13357","RGG","BGB",0,1,1,1,0,"run066"
"13358","RGG","BRR",0,4,4,1,3,"run066"
"13359","RGG","GGG",0,1,1,0,1,"run066"
"13360","RGG","GGR",0,3,3,1,2,"run066"
"13361","RGG","GRR",0,8,8,3,5,"run066"
"13362","RGG","RBB",0,1,1,1,0,"run066"
"13363","RGR","BBB",2,5,7,3,4,"run066"
"13364","RGR","BBR",1,1,2,0,2,"run066"
"13365","RGR","BGB",2,5,7,3,4,"run066"
"13366","RGR","BGG",2,2,4,3,1,"run066"
"13367","RGR","BRR",1,5,6,5,1,"run066"
"13368","RGR","GGB",2,12,14,5,9,"run066"
"13369","RGR","GGG",0,2,2,0,2,"run066"
"13370","RGR","GGR",0,4,4,1,3,"run066"
"13371","RGR","RBB",0,4,4,4,0,"run066"
"13372","RGR","RGG",1,1,2,0,2,"run066"
"13373","RGR","RRG",0,3,3,2,1,"run066"
"13374","RRG","BBB",2,33,35,30,5,"run066"
"13375","RRG","BBR",0,5,5,2,3,"run066"
"13376","RRG","BGB",1,10,11,0,11,"run066"
"13377","RRG","BGG",0,2,2,2,0,"run066"
"13378","RRG","BRB",2,40,42,12,30,"run066"
"13379","RRG","BRR",1,16,17,6,11,"run066"
"13380","RRG","GGG",2,14,16,8,8,"run066"
"13381","RRG","GGR",0,5,5,1,4,"run066"
"13382","RRG","GRG",1,0,1,0,1,"run066"
"13383","RRG","GRR",3,8,11,4,7,"run066"
"13384","RRG","RBB",1,1,2,2,0,"run066"
"13385","RRG","RGG",0,1,1,0,1,"run066"
"13386","RRG","RGR",0,1,1,0,1,"run066"
"13387","RRR","BBR",1,0,1,1,0,"run066"
"13388","RRR","BGB",2,1,3,2,1,"run066"
"13389","RRR","BGG",1,0,1,1,0,"run066"
"13390","RRR","BRB",1,1,2,0,2,"run066"
"13391","RRR","BRR",1,1,2,1,1,"run066"
"13392","RRR","GGR",0,1,1,1,0,"run066"
"13393","RRR","GRR",0,3,3,3,0,"run066"
"13394","RRR","RBB",1,2,3,3,0,"run066"
"13395","RRR","RBR",0,2,2,0,2,"run066"
"13396","RRR","RGG",0,1,1,0,1,"run066"
"13397","RRR","RGR",1,2,3,1,2,"run066"
"13398","RRR","RRG",2,2,4,3,1,"run066"
"13399","BBB","BRB",0,1,1,0,1,"run067"
"13400","BBB","GGG",1,2,3,2,1,"run067"
"13401","BBB","GRR",0,2,2,0,2,"run067"
"13402","BBB","RBG",0,1,1,1,0,"run067"
"13403","BBB","RRG",1,3,4,4,0,"run067"
"13404","BBB","RRR",0,2,2,0,2,"run067"
"13405","BBG","BBB",1,4,5,5,0,"run067"
"13406","BBG","BGB",0,1,1,0,1,"run067"
"13407","BBG","BGG",0,1,1,0,1,"run067"
"13408","BBG","BRB",1,16,17,12,5,"run067"
"13409","BBG","GBB",0,1,1,1,0,"run067"
"13410","BBG","GBG",2,7,9,0,9,"run067"
"13411","BBG","GGB",2,25,27,3,24,"run067"
"13412","BBG","GGG",4,38,42,41,1,"run067"
"13413","BBG","GRG",1,9,10,6,4,"run067"
"13414","BBG","GRR",0,1,1,1,0,"run067"
"13415","BBG","RBB",0,1,1,0,1,"run067"
"13416","BBG","RBG",0,4,4,2,2,"run067"
"13417","BBG","RBR",0,1,1,1,0,"run067"
"13418","BBG","RGR",0,1,1,1,0,"run067"
"13419","BBG","RRG",1,2,3,1,2,"run067"
"13420","BBG","RRR",0,7,7,2,5,"run067"
"13421","BGB","BBB",0,2,2,1,1,"run067"
"13422","BGB","RRG",0,1,1,1,0,"run067"
"13423","BGG","BBB",0,3,3,2,1,"run067"
"13424","BGG","BBR",0,1,1,1,0,"run067"
"13425","BGG","GRG",0,1,1,0,1,"run067"
"13426","BGG","RBG",1,1,2,0,2,"run067"
"13427","BGG","RGG",0,3,3,0,3,"run067"
"13428","BGG","RGR",0,1,1,0,1,"run067"
"13429","BGG","RRR",1,1,2,2,0,"run067"
"13430","BRB","BBB",0,13,13,3,10,"run067"
"13431","BRB","BBR",0,1,1,1,0,"run067"
"13432","BRB","BRR",0,3,3,0,3,"run067"
"13433","BRB","GGG",0,1,1,0,1,"run067"
"13434","BRB","GGR",0,1,1,0,1,"run067"
"13435","BRB","RBB",0,1,1,0,1,"run067"
"13436","BRB","RBG",0,1,1,0,1,"run067"
"13437","BRB","RGR",0,1,1,1,0,"run067"
"13438","BRB","RRR",0,1,1,1,0,"run067"
"13439","BRR","BBB",0,11,11,2,9,"run067"
"13440","BRR","BGB",1,1,2,0,2,"run067"
"13441","BRR","BGG",0,1,1,1,0,"run067"
"13442","BRR","BRB",0,1,1,0,1,"run067"
"13443","BRR","RBB",0,2,2,2,0,"run067"
"13444","GBB","BBB",12,38,50,15,35,"run067"
"13445","GBB","BGG",0,1,1,0,1,"run067"
"13446","GBB","BRB",1,9,10,3,7,"run067"
"13447","GBB","BRR",1,3,4,2,2,"run067"
"13448","GBB","GBG",0,4,4,3,1,"run067"
"13449","GBB","GGB",0,21,21,0,21,"run067"
"13450","GBB","GGG",7,86,93,21,72,"run067"
"13451","GBB","GGR",1,3,4,4,0,"run067"
"13452","GBB","GRG",0,6,6,6,0,"run067"
"13453","GBB","GRR",0,1,1,1,0,"run067"
"13454","GBB","RBB",0,2,2,2,0,"run067"
"13455","GBB","RBG",3,9,12,1,11,"run067"
"13456","GBB","RBR",1,0,1,0,1,"run067"
"13457","GBB","RGG",1,0,1,0,1,"run067"
"13458","GBB","RGR",2,1,3,3,0,"run067"
"13459","GBB","RRG",0,2,2,0,2,"run067"
"13460","GBB","RRR",1,9,10,7,3,"run067"
"13461","GBG","BBB",0,5,5,1,4,"run067"
"13462","GBG","BBR",0,1,1,0,1,"run067"
"13463","GBG","BRB",1,4,5,2,3,"run067"
"13464","GBG","BRR",1,0,1,1,0,"run067"
"13465","GBG","GGB",0,4,4,4,0,"run067"
"13466","GBG","GGG",4,11,15,10,5,"run067"
"13467","GBG","RBB",1,0,1,0,1,"run067"
"13468","GBG","RBG",0,1,1,1,0,"run067"
"13469","GBG","RGG",0,1,1,0,1,"run067"
"13470","GBG","RGR",1,3,4,2,2,"run067"
"13471","GBG","RRG",1,3,4,3,1,"run067"
"13472","GGB","BBB",3,16,19,4,15,"run067"
"13473","GGB","BBR",1,4,5,4,1,"run067"
"13474","GGB","BGB",0,3,3,3,0,"run067"
"13475","GGB","BGG",0,4,4,0,4,"run067"
"13476","GGB","BRB",0,1,1,1,0,"run067"
"13477","GGB","BRR",1,15,16,10,6,"run067"
"13478","GGB","GBB",0,1,1,0,1,"run067"
"13479","GGB","GBG",1,0,1,1,0,"run067"
"13480","GGB","GGG",13,48,61,61,0,"run067"
"13481","GGB","GGR",0,7,7,3,4,"run067"
"13482","GGB","GRR",0,4,4,1,3,"run067"
"13483","GGB","RBB",0,5,5,2,3,"run067"
"13484","GGB","RBG",0,4,4,2,2,"run067"
"13485","GGB","RBR",0,5,5,4,1,"run067"
"13486","GGB","RGG",1,5,6,1,5,"run067"
"13487","GGB","RGR",0,2,2,1,1,"run067"
"13488","GGB","RRG",1,5,6,6,0,"run067"
"13489","GGB","RRR",1,5,6,1,5,"run067"
"13490","GGG","BBB",8,31,39,3,36,"run067"
"13491","GGG","BGB",0,2,2,2,0,"run067"
"13492","GGG","BGG",1,7,8,2,6,"run067"
"13493","GGG","BRB",1,3,4,2,2,"run067"
"13494","GGG","BRR",0,6,6,2,4,"run067"
"13495","GGG","GGB",5,1,6,5,1,"run067"
"13496","GGG","GGR",1,9,10,6,4,"run067"
"13497","GGG","GRR",0,2,2,1,1,"run067"
"13498","GGG","RBB",1,8,9,6,3,"run067"
"13499","GGG","RBG",0,6,6,0,6,"run067"
"13500","GGG","RBR",0,21,21,9,12,"run067"
"13501","GGG","RGG",0,3,3,3,0,"run067"
"13502","GGG","RGR",1,12,13,7,6,"run067"
"13503","GGG","RRG",1,23,24,18,6,"run067"
"13504","GGG","RRR",0,3,3,2,1,"run067"
"13505","GGR","BBB",0,2,2,2,0,"run067"
"13506","GGR","BBR",0,2,2,2,0,"run067"
"13507","GGR","BGG",0,1,1,1,0,"run067"
"13508","GGR","BRR",1,0,1,1,0,"run067"
"13509","GGR","GRR",1,0,1,1,0,"run067"
"13510","GGR","RBB",0,2,2,1,1,"run067"
"13511","GRG","BBB",3,8,11,3,8,"run067"
"13512","GRG","BBR",0,1,1,0,1,"run067"
"13513","GRG","BGG",0,1,1,1,0,"run067"
"13514","GRG","BRB",0,3,3,2,1,"run067"
"13515","GRG","BRR",0,1,1,1,0,"run067"
"13516","GRG","GBG",0,1,1,0,1,"run067"
"13517","GRG","GGB",2,15,17,1,16,"run067"
"13518","GRG","GGG",3,12,15,12,3,"run067"
"13519","GRG","GGR",0,5,5,4,1,"run067"
"13520","GRG","GRR",0,1,1,1,0,"run067"
"13521","GRG","RBG",0,1,1,0,1,"run067"
"13522","GRG","RBR",0,1,1,1,0,"run067"
"13523","GRG","RGR",1,2,3,1,2,"run067"
"13524","GRG","RRG",2,4,6,5,1,"run067"
"13525","GRR","BBB",0,1,1,0,1,"run067"
"13526","GRR","BBR",0,1,1,1,0,"run067"
"13527","GRR","BGB",1,2,3,3,0,"run067"
"13528","GRR","BGG",0,2,2,0,2,"run067"
"13529","GRR","BRB",0,1,1,0,1,"run067"
"13530","GRR","BRR",0,2,2,1,1,"run067"
"13531","GRR","GGG",0,1,1,0,1,"run067"
"13532","GRR","GGR",0,1,1,0,1,"run067"
"13533","RBB","BBB",0,1,1,0,1,"run067"
"13534","RBB","BBR",0,1,1,1,0,"run067"
"13535","RBB","BRB",0,1,1,0,1,"run067"
"13536","RBB","GRR",0,1,1,0,1,"run067"
"13537","RBB","RGG",0,1,1,0,1,"run067"
"13538","RBG","BBB",2,8,10,4,6,"run067"
"13539","RBG","BBG",0,1,1,0,1,"run067"
"13540","RBG","BRR",0,1,1,0,1,"run067"
"13541","RBG","GBB",0,1,1,0,1,"run067"
"13542","RBG","GRR",0,3,3,2,1,"run067"
"13543","RBG","RBB",1,1,2,0,2,"run067"
"13544","RBG","RBR",0,1,1,0,1,"run067"
"13545","RBG","RGR",0,1,1,0,1,"run067"
"13546","RBR","BBB",0,13,13,8,5,"run067"
"13547","RBR","BBR",0,1,1,0,1,"run067"
"13548","RBR","BGB",2,4,6,6,0,"run067"
"13549","RBR","BGG",0,2,2,1,1,"run067"
"13550","RBR","BRB",1,0,1,1,0,"run067"
"13551","RBR","BRR",1,4,5,1,4,"run067"
"13552","RBR","GGB",0,12,12,6,6,"run067"
"13553","RBR","GRR",4,4,8,8,0,"run067"
"13554","RBR","RBB",0,3,3,1,2,"run067"
"13555","RBR","RGG",2,9,11,10,1,"run067"
"13556","RBR","RGR",1,0,1,1,0,"run067"
"13557","RBR","RRR",0,1,1,1,0,"run067"
"13558","RGG","BBB",0,8,8,7,1,"run067"
"13559","RGG","BBR",1,2,3,2,1,"run067"
"13560","RGG","BGB",0,1,1,0,1,"run067"
"13561","RGG","BRR",0,4,4,0,4,"run067"
"13562","RGG","GGG",0,1,1,1,0,"run067"
"13563","RGG","GGR",0,3,3,0,3,"run067"
"13564","RGG","GRR",0,8,8,8,0,"run067"
"13565","RGG","RBB",0,1,1,1,0,"run067"
"13566","RGR","BBB",2,5,7,3,4,"run067"
"13567","RGR","BBR",1,1,2,1,1,"run067"
"13568","RGR","BGB",2,5,7,4,3,"run067"
"13569","RGR","BGG",2,2,4,4,0,"run067"
"13570","RGR","BRR",1,5,6,5,1,"run067"
"13571","RGR","GGB",2,12,14,4,10,"run067"
"13572","RGR","GGG",0,2,2,0,2,"run067"
"13573","RGR","GGR",0,4,4,0,4,"run067"
"13574","RGR","RBB",0,4,4,0,4,"run067"
"13575","RGR","RGG",1,1,2,2,0,"run067"
"13576","RGR","RRG",0,3,3,1,2,"run067"
"13577","RRG","BBB",2,33,35,34,1,"run067"
"13578","RRG","BBR",0,5,5,3,2,"run067"
"13579","RRG","BGB",1,10,11,9,2,"run067"
"13580","RRG","BGG",0,2,2,0,2,"run067"
"13581","RRG","BRB",2,40,42,17,25,"run067"
"13582","RRG","BRR",1,16,17,5,12,"run067"
"13583","RRG","GGG",2,14,16,6,10,"run067"
"13584","RRG","GGR",0,5,5,0,5,"run067"
"13585","RRG","GRG",1,0,1,1,0,"run067"
"13586","RRG","GRR",3,8,11,6,5,"run067"
"13587","RRG","RBB",1,1,2,0,2,"run067"
"13588","RRG","RGG",0,1,1,1,0,"run067"
"13589","RRG","RGR",0,1,1,1,0,"run067"
"13590","RRR","BBR",1,0,1,0,1,"run067"
"13591","RRR","BGB",2,1,3,3,0,"run067"
"13592","RRR","BGG",1,0,1,1,0,"run067"
"13593","RRR","BRB",1,1,2,2,0,"run067"
"13594","RRR","BRR",1,1,2,1,1,"run067"
"13595","RRR","GGR",0,1,1,0,1,"run067"
"13596","RRR","GRR",0,3,3,2,1,"run067"
"13597","RRR","RBB",1,2,3,2,1,"run067"
"13598","RRR","RBR",0,2,2,2,0,"run067"
"13599","RRR","RGG",0,1,1,0,1,"run067"
"13600","RRR","RGR",1,2,3,3,0,"run067"
"13601","RRR","RRG",2,2,4,0,4,"run067"
"13602","BBB","BRB",0,1,1,1,0,"run068"
"13603","BBB","GGG",1,2,3,0,3,"run068"
"13604","BBB","GRR",0,2,2,0,2,"run068"
"13605","BBB","RBG",0,1,1,0,1,"run068"
"13606","BBB","RRG",1,3,4,1,3,"run068"
"13607","BBB","RRR",0,2,2,1,1,"run068"
"13608","BBG","BBB",1,4,5,0,5,"run068"
"13609","BBG","BGB",0,1,1,0,1,"run068"
"13610","BBG","BGG",0,1,1,1,0,"run068"
"13611","BBG","BRB",1,16,17,13,4,"run068"
"13612","BBG","GBB",0,1,1,0,1,"run068"
"13613","BBG","GBG",2,7,9,7,2,"run068"
"13614","BBG","GGB",2,25,27,7,20,"run068"
"13615","BBG","GGG",4,38,42,28,14,"run068"
"13616","BBG","GRG",1,9,10,9,1,"run068"
"13617","BBG","GRR",0,1,1,0,1,"run068"
"13618","BBG","RBB",0,1,1,0,1,"run068"
"13619","BBG","RBG",0,4,4,0,4,"run068"
"13620","BBG","RBR",0,1,1,1,0,"run068"
"13621","BBG","RGR",0,1,1,0,1,"run068"
"13622","BBG","RRG",1,2,3,1,2,"run068"
"13623","BBG","RRR",0,7,7,1,6,"run068"
"13624","BGB","BBB",0,2,2,1,1,"run068"
"13625","BGB","RRG",0,1,1,1,0,"run068"
"13626","BGG","BBB",0,3,3,1,2,"run068"
"13627","BGG","BBR",0,1,1,0,1,"run068"
"13628","BGG","GRG",0,1,1,1,0,"run068"
"13629","BGG","RBG",1,1,2,1,1,"run068"
"13630","BGG","RGG",0,3,3,3,0,"run068"
"13631","BGG","RGR",0,1,1,1,0,"run068"
"13632","BGG","RRR",1,1,2,2,0,"run068"
"13633","BRB","BBB",0,13,13,13,0,"run068"
"13634","BRB","BBR",0,1,1,0,1,"run068"
"13635","BRB","BRR",0,3,3,1,2,"run068"
"13636","BRB","GGG",0,1,1,1,0,"run068"
"13637","BRB","GGR",0,1,1,1,0,"run068"
"13638","BRB","RBB",0,1,1,0,1,"run068"
"13639","BRB","RBG",0,1,1,0,1,"run068"
"13640","BRB","RGR",0,1,1,0,1,"run068"
"13641","BRB","RRR",0,1,1,1,0,"run068"
"13642","BRR","BBB",0,11,11,3,8,"run068"
"13643","BRR","BGB",1,1,2,1,1,"run068"
"13644","BRR","BGG",0,1,1,0,1,"run068"
"13645","BRR","BRB",0,1,1,1,0,"run068"
"13646","BRR","RBB",0,2,2,0,2,"run068"
"13647","GBB","BBB",12,38,50,38,12,"run068"
"13648","GBB","BGG",0,1,1,1,0,"run068"
"13649","GBB","BRB",1,9,10,7,3,"run068"
"13650","GBB","BRR",1,3,4,4,0,"run068"
"13651","GBB","GBG",0,4,4,2,2,"run068"
"13652","GBB","GGB",0,21,21,2,19,"run068"
"13653","GBB","GGG",7,86,93,1,92,"run068"
"13654","GBB","GGR",1,3,4,2,2,"run068"
"13655","GBB","GRG",0,6,6,5,1,"run068"
"13656","GBB","GRR",0,1,1,0,1,"run068"
"13657","GBB","RBB",0,2,2,1,1,"run068"
"13658","GBB","RBG",3,9,12,1,11,"run068"
"13659","GBB","RBR",1,0,1,0,1,"run068"
"13660","GBB","RGG",1,0,1,0,1,"run068"
"13661","GBB","RGR",2,1,3,2,1,"run068"
"13662","GBB","RRG",0,2,2,2,0,"run068"
"13663","GBB","RRR",1,9,10,3,7,"run068"
"13664","GBG","BBB",0,5,5,1,4,"run068"
"13665","GBG","BBR",0,1,1,1,0,"run068"
"13666","GBG","BRB",1,4,5,1,4,"run068"
"13667","GBG","BRR",1,0,1,1,0,"run068"
"13668","GBG","GGB",0,4,4,1,3,"run068"
"13669","GBG","GGG",4,11,15,15,0,"run068"
"13670","GBG","RBB",1,0,1,1,0,"run068"
"13671","GBG","RBG",0,1,1,0,1,"run068"
"13672","GBG","RGG",0,1,1,0,1,"run068"
"13673","GBG","RGR",1,3,4,2,2,"run068"
"13674","GBG","RRG",1,3,4,3,1,"run068"
"13675","GGB","BBB",3,16,19,13,6,"run068"
"13676","GGB","BBR",1,4,5,4,1,"run068"
"13677","GGB","BGB",0,3,3,0,3,"run068"
"13678","GGB","BGG",0,4,4,1,3,"run068"
"13679","GGB","BRB",0,1,1,1,0,"run068"
"13680","GGB","BRR",1,15,16,13,3,"run068"
"13681","GGB","GBB",0,1,1,1,0,"run068"
"13682","GGB","GBG",1,0,1,1,0,"run068"
"13683","GGB","GGG",13,48,61,15,46,"run068"
"13684","GGB","GGR",0,7,7,0,7,"run068"
"13685","GGB","GRR",0,4,4,3,1,"run068"
"13686","GGB","RBB",0,5,5,4,1,"run068"
"13687","GGB","RBG",0,4,4,0,4,"run068"
"13688","GGB","RBR",0,5,5,2,3,"run068"
"13689","GGB","RGG",1,5,6,6,0,"run068"
"13690","GGB","RGR",0,2,2,0,2,"run068"
"13691","GGB","RRG",1,5,6,6,0,"run068"
"13692","GGB","RRR",1,5,6,0,6,"run068"
"13693","GGG","BBB",8,31,39,37,2,"run068"
"13694","GGG","BGB",0,2,2,2,0,"run068"
"13695","GGG","BGG",1,7,8,3,5,"run068"
"13696","GGG","BRB",1,3,4,0,4,"run068"
"13697","GGG","BRR",0,6,6,1,5,"run068"
"13698","GGG","GGB",5,1,6,6,0,"run068"
"13699","GGG","GGR",1,9,10,0,10,"run068"
"13700","GGG","GRR",0,2,2,1,1,"run068"
"13701","GGG","RBB",1,8,9,1,8,"run068"
"13702","GGG","RBG",0,6,6,1,5,"run068"
"13703","GGG","RBR",0,21,21,5,16,"run068"
"13704","GGG","RGG",0,3,3,0,3,"run068"
"13705","GGG","RGR",1,12,13,7,6,"run068"
"13706","GGG","RRG",1,23,24,16,8,"run068"
"13707","GGG","RRR",0,3,3,0,3,"run068"
"13708","GGR","BBB",0,2,2,2,0,"run068"
"13709","GGR","BBR",0,2,2,2,0,"run068"
"13710","GGR","BGG",0,1,1,1,0,"run068"
"13711","GGR","BRR",1,0,1,0,1,"run068"
"13712","GGR","GRR",1,0,1,1,0,"run068"
"13713","GGR","RBB",0,2,2,1,1,"run068"
"13714","GRG","BBB",3,8,11,0,11,"run068"
"13715","GRG","BBR",0,1,1,1,0,"run068"
"13716","GRG","BGG",0,1,1,1,0,"run068"
"13717","GRG","BRB",0,3,3,1,2,"run068"
"13718","GRG","BRR",0,1,1,0,1,"run068"
"13719","GRG","GBG",0,1,1,0,1,"run068"
"13720","GRG","GGB",2,15,17,8,9,"run068"
"13721","GRG","GGG",3,12,15,10,5,"run068"
"13722","GRG","GGR",0,5,5,1,4,"run068"
"13723","GRG","GRR",0,1,1,1,0,"run068"
"13724","GRG","RBG",0,1,1,0,1,"run068"
"13725","GRG","RBR",0,1,1,1,0,"run068"
"13726","GRG","RGR",1,2,3,3,0,"run068"
"13727","GRG","RRG",2,4,6,2,4,"run068"
"13728","GRR","BBB",0,1,1,0,1,"run068"
"13729","GRR","BBR",0,1,1,1,0,"run068"
"13730","GRR","BGB",1,2,3,2,1,"run068"
"13731","GRR","BGG",0,2,2,2,0,"run068"
"13732","GRR","BRB",0,1,1,1,0,"run068"
"13733","GRR","BRR",0,2,2,2,0,"run068"
"13734","GRR","GGG",0,1,1,1,0,"run068"
"13735","GRR","GGR",0,1,1,1,0,"run068"
"13736","RBB","BBB",0,1,1,1,0,"run068"
"13737","RBB","BBR",0,1,1,0,1,"run068"
"13738","RBB","BRB",0,1,1,1,0,"run068"
"13739","RBB","GRR",0,1,1,0,1,"run068"
"13740","RBB","RGG",0,1,1,0,1,"run068"
"13741","RBG","BBB",2,8,10,5,5,"run068"
"13742","RBG","BBG",0,1,1,0,1,"run068"
"13743","RBG","BRR",0,1,1,1,0,"run068"
"13744","RBG","GBB",0,1,1,1,0,"run068"
"13745","RBG","GRR",0,3,3,1,2,"run068"
"13746","RBG","RBB",1,1,2,2,0,"run068"
"13747","RBG","RBR",0,1,1,1,0,"run068"
"13748","RBG","RGR",0,1,1,1,0,"run068"
"13749","RBR","BBB",0,13,13,6,7,"run068"
"13750","RBR","BBR",0,1,1,0,1,"run068"
"13751","RBR","BGB",2,4,6,6,0,"run068"
"13752","RBR","BGG",0,2,2,2,0,"run068"
"13753","RBR","BRB",1,0,1,0,1,"run068"
"13754","RBR","BRR",1,4,5,2,3,"run068"
"13755","RBR","GGB",0,12,12,7,5,"run068"
"13756","RBR","GRR",4,4,8,2,6,"run068"
"13757","RBR","RBB",0,3,3,2,1,"run068"
"13758","RBR","RGG",2,9,11,11,0,"run068"
"13759","RBR","RGR",1,0,1,1,0,"run068"
"13760","RBR","RRR",0,1,1,0,1,"run068"
"13761","RGG","BBB",0,8,8,0,8,"run068"
"13762","RGG","BBR",1,2,3,2,1,"run068"
"13763","RGG","BGB",0,1,1,0,1,"run068"
"13764","RGG","BRR",0,4,4,1,3,"run068"
"13765","RGG","GGG",0,1,1,0,1,"run068"
"13766","RGG","GGR",0,3,3,0,3,"run068"
"13767","RGG","GRR",0,8,8,4,4,"run068"
"13768","RGG","RBB",0,1,1,1,0,"run068"
"13769","RGR","BBB",2,5,7,7,0,"run068"
"13770","RGR","BBR",1,1,2,0,2,"run068"
"13771","RGR","BGB",2,5,7,3,4,"run068"
"13772","RGR","BGG",2,2,4,1,3,"run068"
"13773","RGR","BRR",1,5,6,2,4,"run068"
"13774","RGR","GGB",2,12,14,7,7,"run068"
"13775","RGR","GGG",0,2,2,1,1,"run068"
"13776","RGR","GGR",0,4,4,1,3,"run068"
"13777","RGR","RBB",0,4,4,0,4,"run068"
"13778","RGR","RGG",1,1,2,0,2,"run068"
"13779","RGR","RRG",0,3,3,3,0,"run068"
"13780","RRG","BBB",2,33,35,7,28,"run068"
"13781","RRG","BBR",0,5,5,5,0,"run068"
"13782","RRG","BGB",1,10,11,0,11,"run068"
"13783","RRG","BGG",0,2,2,0,2,"run068"
"13784","RRG","BRB",2,40,42,31,11,"run068"
"13785","RRG","BRR",1,16,17,0,17,"run068"
"13786","RRG","GGG",2,14,16,3,13,"run068"
"13787","RRG","GGR",0,5,5,4,1,"run068"
"13788","RRG","GRG",1,0,1,1,0,"run068"
"13789","RRG","GRR",3,8,11,9,2,"run068"
"13790","RRG","RBB",1,1,2,1,1,"run068"
"13791","RRG","RGG",0,1,1,1,0,"run068"
"13792","RRG","RGR",0,1,1,1,0,"run068"
"13793","RRR","BBR",1,0,1,0,1,"run068"
"13794","RRR","BGB",2,1,3,3,0,"run068"
"13795","RRR","BGG",1,0,1,1,0,"run068"
"13796","RRR","BRB",1,1,2,2,0,"run068"
"13797","RRR","BRR",1,1,2,2,0,"run068"
"13798","RRR","GGR",0,1,1,0,1,"run068"
"13799","RRR","GRR",0,3,3,1,2,"run068"
"13800","RRR","RBB",1,2,3,1,2,"run068"
"13801","RRR","RBR",0,2,2,0,2,"run068"
"13802","RRR","RGG",0,1,1,0,1,"run068"
"13803","RRR","RGR",1,2,3,0,3,"run068"
"13804","RRR","RRG",2,2,4,4,0,"run068"
"13805","BBB","BRB",0,1,1,1,0,"run069"
"13806","BBB","GGG",1,2,3,0,3,"run069"
"13807","BBB","GRR",0,2,2,2,0,"run069"
"13808","BBB","RBG",0,1,1,1,0,"run069"
"13809","BBB","RRG",1,3,4,4,0,"run069"
"13810","BBB","RRR",0,2,2,2,0,"run069"
"13811","BBG","BBB",1,4,5,5,0,"run069"
"13812","BBG","BGB",0,1,1,0,1,"run069"
"13813","BBG","BGG",0,1,1,0,1,"run069"
"13814","BBG","BRB",1,16,17,1,16,"run069"
"13815","BBG","GBB",0,1,1,1,0,"run069"
"13816","BBG","GBG",2,7,9,3,6,"run069"
"13817","BBG","GGB",2,25,27,9,18,"run069"
"13818","BBG","GGG",4,38,42,30,12,"run069"
"13819","BBG","GRG",1,9,10,1,9,"run069"
"13820","BBG","GRR",0,1,1,1,0,"run069"
"13821","BBG","RBB",0,1,1,0,1,"run069"
"13822","BBG","RBG",0,4,4,2,2,"run069"
"13823","BBG","RBR",0,1,1,1,0,"run069"
"13824","BBG","RGR",0,1,1,0,1,"run069"
"13825","BBG","RRG",1,2,3,2,1,"run069"
"13826","BBG","RRR",0,7,7,2,5,"run069"
"13827","BGB","BBB",0,2,2,0,2,"run069"
"13828","BGB","RRG",0,1,1,1,0,"run069"
"13829","BGG","BBB",0,3,3,1,2,"run069"
"13830","BGG","BBR",0,1,1,1,0,"run069"
"13831","BGG","GRG",0,1,1,1,0,"run069"
"13832","BGG","RBG",1,1,2,2,0,"run069"
"13833","BGG","RGG",0,3,3,3,0,"run069"
"13834","BGG","RGR",0,1,1,0,1,"run069"
"13835","BGG","RRR",1,1,2,2,0,"run069"
"13836","BRB","BBB",0,13,13,7,6,"run069"
"13837","BRB","BBR",0,1,1,0,1,"run069"
"13838","BRB","BRR",0,3,3,2,1,"run069"
"13839","BRB","GGG",0,1,1,0,1,"run069"
"13840","BRB","GGR",0,1,1,1,0,"run069"
"13841","BRB","RBB",0,1,1,1,0,"run069"
"13842","BRB","RBG",0,1,1,1,0,"run069"
"13843","BRB","RGR",0,1,1,1,0,"run069"
"13844","BRB","RRR",0,1,1,1,0,"run069"
"13845","BRR","BBB",0,11,11,4,7,"run069"
"13846","BRR","BGB",1,1,2,0,2,"run069"
"13847","BRR","BGG",0,1,1,1,0,"run069"
"13848","BRR","BRB",0,1,1,0,1,"run069"
"13849","BRR","RBB",0,2,2,2,0,"run069"
"13850","GBB","BBB",12,38,50,29,21,"run069"
"13851","GBB","BGG",0,1,1,0,1,"run069"
"13852","GBB","BRB",1,9,10,9,1,"run069"
"13853","GBB","BRR",1,3,4,0,4,"run069"
"13854","GBB","GBG",0,4,4,4,0,"run069"
"13855","GBB","GGB",0,21,21,2,19,"run069"
"13856","GBB","GGG",7,86,93,82,11,"run069"
"13857","GBB","GGR",1,3,4,2,2,"run069"
"13858","GBB","GRG",0,6,6,0,6,"run069"
"13859","GBB","GRR",0,1,1,1,0,"run069"
"13860","GBB","RBB",0,2,2,0,2,"run069"
"13861","GBB","RBG",3,9,12,2,10,"run069"
"13862","GBB","RBR",1,0,1,0,1,"run069"
"13863","GBB","RGG",1,0,1,0,1,"run069"
"13864","GBB","RGR",2,1,3,0,3,"run069"
"13865","GBB","RRG",0,2,2,1,1,"run069"
"13866","GBB","RRR",1,9,10,3,7,"run069"
"13867","GBG","BBB",0,5,5,0,5,"run069"
"13868","GBG","BBR",0,1,1,0,1,"run069"
"13869","GBG","BRB",1,4,5,3,2,"run069"
"13870","GBG","BRR",1,0,1,0,1,"run069"
"13871","GBG","GGB",0,4,4,0,4,"run069"
"13872","GBG","GGG",4,11,15,5,10,"run069"
"13873","GBG","RBB",1,0,1,0,1,"run069"
"13874","GBG","RBG",0,1,1,0,1,"run069"
"13875","GBG","RGG",0,1,1,0,1,"run069"
"13876","GBG","RGR",1,3,4,2,2,"run069"
"13877","GBG","RRG",1,3,4,1,3,"run069"
"13878","GGB","BBB",3,16,19,1,18,"run069"
"13879","GGB","BBR",1,4,5,0,5,"run069"
"13880","GGB","BGB",0,3,3,2,1,"run069"
"13881","GGB","BGG",0,4,4,1,3,"run069"
"13882","GGB","BRB",0,1,1,0,1,"run069"
"13883","GGB","BRR",1,15,16,0,16,"run069"
"13884","GGB","GBB",0,1,1,0,1,"run069"
"13885","GGB","GBG",1,0,1,0,1,"run069"
"13886","GGB","GGG",13,48,61,7,54,"run069"
"13887","GGB","GGR",0,7,7,4,3,"run069"
"13888","GGB","GRR",0,4,4,3,1,"run069"
"13889","GGB","RBB",0,5,5,0,5,"run069"
"13890","GGB","RBG",0,4,4,4,0,"run069"
"13891","GGB","RBR",0,5,5,2,3,"run069"
"13892","GGB","RGG",1,5,6,3,3,"run069"
"13893","GGB","RGR",0,2,2,1,1,"run069"
"13894","GGB","RRG",1,5,6,1,5,"run069"
"13895","GGB","RRR",1,5,6,2,4,"run069"
"13896","GGG","BBB",8,31,39,37,2,"run069"
"13897","GGG","BGB",0,2,2,1,1,"run069"
"13898","GGG","BGG",1,7,8,5,3,"run069"
"13899","GGG","BRB",1,3,4,1,3,"run069"
"13900","GGG","BRR",0,6,6,5,1,"run069"
"13901","GGG","GGB",5,1,6,6,0,"run069"
"13902","GGG","GGR",1,9,10,2,8,"run069"
"13903","GGG","GRR",0,2,2,1,1,"run069"
"13904","GGG","RBB",1,8,9,4,5,"run069"
"13905","GGG","RBG",0,6,6,0,6,"run069"
"13906","GGG","RBR",0,21,21,13,8,"run069"
"13907","GGG","RGG",0,3,3,0,3,"run069"
"13908","GGG","RGR",1,12,13,13,0,"run069"
"13909","GGG","RRG",1,23,24,7,17,"run069"
"13910","GGG","RRR",0,3,3,0,3,"run069"
"13911","GGR","BBB",0,2,2,2,0,"run069"
"13912","GGR","BBR",0,2,2,2,0,"run069"
"13913","GGR","BGG",0,1,1,0,1,"run069"
"13914","GGR","BRR",1,0,1,1,0,"run069"
"13915","GGR","GRR",1,0,1,1,0,"run069"
"13916","GGR","RBB",0,2,2,1,1,"run069"
"13917","GRG","BBB",3,8,11,0,11,"run069"
"13918","GRG","BBR",0,1,1,0,1,"run069"
"13919","GRG","BGG",0,1,1,0,1,"run069"
"13920","GRG","BRB",0,3,3,1,2,"run069"
"13921","GRG","BRR",0,1,1,1,0,"run069"
"13922","GRG","GBG",0,1,1,0,1,"run069"
"13923","GRG","GGB",2,15,17,6,11,"run069"
"13924","GRG","GGG",3,12,15,7,8,"run069"
"13925","GRG","GGR",0,5,5,3,2,"run069"
"13926","GRG","GRR",0,1,1,1,0,"run069"
"13927","GRG","RBG",0,1,1,1,0,"run069"
"13928","GRG","RBR",0,1,1,1,0,"run069"
"13929","GRG","RGR",1,2,3,0,3,"run069"
"13930","GRG","RRG",2,4,6,5,1,"run069"
"13931","GRR","BBB",0,1,1,1,0,"run069"
"13932","GRR","BBR",0,1,1,1,0,"run069"
"13933","GRR","BGB",1,2,3,2,1,"run069"
"13934","GRR","BGG",0,2,2,1,1,"run069"
"13935","GRR","BRB",0,1,1,0,1,"run069"
"13936","GRR","BRR",0,2,2,1,1,"run069"
"13937","GRR","GGG",0,1,1,0,1,"run069"
"13938","GRR","GGR",0,1,1,0,1,"run069"
"13939","RBB","BBB",0,1,1,1,0,"run069"
"13940","RBB","BBR",0,1,1,0,1,"run069"
"13941","RBB","BRB",0,1,1,1,0,"run069"
"13942","RBB","GRR",0,1,1,1,0,"run069"
"13943","RBB","RGG",0,1,1,0,1,"run069"
"13944","RBG","BBB",2,8,10,7,3,"run069"
"13945","RBG","BBG",0,1,1,1,0,"run069"
"13946","RBG","BRR",0,1,1,1,0,"run069"
"13947","RBG","GBB",0,1,1,1,0,"run069"
"13948","RBG","GRR",0,3,3,1,2,"run069"
"13949","RBG","RBB",1,1,2,2,0,"run069"
"13950","RBG","RBR",0,1,1,0,1,"run069"
"13951","RBG","RGR",0,1,1,0,1,"run069"
"13952","RBR","BBB",0,13,13,5,8,"run069"
"13953","RBR","BBR",0,1,1,0,1,"run069"
"13954","RBR","BGB",2,4,6,5,1,"run069"
"13955","RBR","BGG",0,2,2,1,1,"run069"
"13956","RBR","BRB",1,0,1,0,1,"run069"
"13957","RBR","BRR",1,4,5,4,1,"run069"
"13958","RBR","GGB",0,12,12,10,2,"run069"
"13959","RBR","GRR",4,4,8,0,8,"run069"
"13960","RBR","RBB",0,3,3,2,1,"run069"
"13961","RBR","RGG",2,9,11,11,0,"run069"
"13962","RBR","RGR",1,0,1,0,1,"run069"
"13963","RBR","RRR",0,1,1,0,1,"run069"
"13964","RGG","BBB",0,8,8,7,1,"run069"
"13965","RGG","BBR",1,2,3,2,1,"run069"
"13966","RGG","BGB",0,1,1,1,0,"run069"
"13967","RGG","BRR",0,4,4,1,3,"run069"
"13968","RGG","GGG",0,1,1,1,0,"run069"
"13969","RGG","GGR",0,3,3,3,0,"run069"
"13970","RGG","GRR",0,8,8,6,2,"run069"
"13971","RGG","RBB",0,1,1,0,1,"run069"
"13972","RGR","BBB",2,5,7,7,0,"run069"
"13973","RGR","BBR",1,1,2,1,1,"run069"
"13974","RGR","BGB",2,5,7,2,5,"run069"
"13975","RGR","BGG",2,2,4,3,1,"run069"
"13976","RGR","BRR",1,5,6,3,3,"run069"
"13977","RGR","GGB",2,12,14,10,4,"run069"
"13978","RGR","GGG",0,2,2,2,0,"run069"
"13979","RGR","GGR",0,4,4,0,4,"run069"
"13980","RGR","RBB",0,4,4,1,3,"run069"
"13981","RGR","RGG",1,1,2,1,1,"run069"
"13982","RGR","RRG",0,3,3,0,3,"run069"
"13983","RRG","BBB",2,33,35,28,7,"run069"
"13984","RRG","BBR",0,5,5,5,0,"run069"
"13985","RRG","BGB",1,10,11,1,10,"run069"
"13986","RRG","BGG",0,2,2,0,2,"run069"
"13987","RRG","BRB",2,40,42,8,34,"run069"
"13988","RRG","BRR",1,16,17,0,17,"run069"
"13989","RRG","GGG",2,14,16,10,6,"run069"
"13990","RRG","GGR",0,5,5,1,4,"run069"
"13991","RRG","GRG",1,0,1,0,1,"run069"
"13992","RRG","GRR",3,8,11,0,11,"run069"
"13993","RRG","RBB",1,1,2,0,2,"run069"
"13994","RRG","RGG",0,1,1,0,1,"run069"
"13995","RRG","RGR",0,1,1,0,1,"run069"
"13996","RRR","BBR",1,0,1,1,0,"run069"
"13997","RRR","BGB",2,1,3,0,3,"run069"
"13998","RRR","BGG",1,0,1,0,1,"run069"
"13999","RRR","BRB",1,1,2,0,2,"run069"
"14000","RRR","BRR",1,1,2,0,2,"run069"
"14001","RRR","GGR",0,1,1,1,0,"run069"
"14002","RRR","GRR",0,3,3,1,2,"run069"
"14003","RRR","RBB",1,2,3,3,0,"run069"
"14004","RRR","RBR",0,2,2,0,2,"run069"
"14005","RRR","RGG",0,1,1,0,1,"run069"
"14006","RRR","RGR",1,2,3,1,2,"run069"
"14007","RRR","RRG",2,2,4,2,2,"run069"
"14008","BBB","BRB",0,1,1,0,1,"run070"
"14009","BBB","GGG",1,2,3,1,2,"run070"
"14010","BBB","GRR",0,2,2,0,2,"run070"
"14011","BBB","RBG",0,1,1,1,0,"run070"
"14012","BBB","RRG",1,3,4,4,0,"run070"
"14013","BBB","RRR",0,2,2,2,0,"run070"
"14014","BBG","BBB",1,4,5,5,0,"run070"
"14015","BBG","BGB",0,1,1,0,1,"run070"
"14016","BBG","BGG",0,1,1,1,0,"run070"
"14017","BBG","BRB",1,16,17,14,3,"run070"
"14018","BBG","GBB",0,1,1,0,1,"run070"
"14019","BBG","GBG",2,7,9,3,6,"run070"
"14020","BBG","GGB",2,25,27,16,11,"run070"
"14021","BBG","GGG",4,38,42,39,3,"run070"
"14022","BBG","GRG",1,9,10,4,6,"run070"
"14023","BBG","GRR",0,1,1,0,1,"run070"
"14024","BBG","RBB",0,1,1,0,1,"run070"
"14025","BBG","RBG",0,4,4,3,1,"run070"
"14026","BBG","RBR",0,1,1,1,0,"run070"
"14027","BBG","RGR",0,1,1,1,0,"run070"
"14028","BBG","RRG",1,2,3,0,3,"run070"
"14029","BBG","RRR",0,7,7,7,0,"run070"
"14030","BGB","BBB",0,2,2,2,0,"run070"
"14031","BGB","RRG",0,1,1,1,0,"run070"
"14032","BGG","BBB",0,3,3,0,3,"run070"
"14033","BGG","BBR",0,1,1,1,0,"run070"
"14034","BGG","GRG",0,1,1,1,0,"run070"
"14035","BGG","RBG",1,1,2,2,0,"run070"
"14036","BGG","RGG",0,3,3,0,3,"run070"
"14037","BGG","RGR",0,1,1,0,1,"run070"
"14038","BGG","RRR",1,1,2,2,0,"run070"
"14039","BRB","BBB",0,13,13,2,11,"run070"
"14040","BRB","BBR",0,1,1,1,0,"run070"
"14041","BRB","BRR",0,3,3,2,1,"run070"
"14042","BRB","GGG",0,1,1,1,0,"run070"
"14043","BRB","GGR",0,1,1,0,1,"run070"
"14044","BRB","RBB",0,1,1,0,1,"run070"
"14045","BRB","RBG",0,1,1,1,0,"run070"
"14046","BRB","RGR",0,1,1,1,0,"run070"
"14047","BRB","RRR",0,1,1,0,1,"run070"
"14048","BRR","BBB",0,11,11,7,4,"run070"
"14049","BRR","BGB",1,1,2,0,2,"run070"
"14050","BRR","BGG",0,1,1,0,1,"run070"
"14051","BRR","BRB",0,1,1,1,0,"run070"
"14052","BRR","RBB",0,2,2,1,1,"run070"
"14053","GBB","BBB",12,38,50,44,6,"run070"
"14054","GBB","BGG",0,1,1,1,0,"run070"
"14055","GBB","BRB",1,9,10,0,10,"run070"
"14056","GBB","BRR",1,3,4,1,3,"run070"
"14057","GBB","GBG",0,4,4,1,3,"run070"
"14058","GBB","GGB",0,21,21,14,7,"run070"
"14059","GBB","GGG",7,86,93,37,56,"run070"
"14060","GBB","GGR",1,3,4,2,2,"run070"
"14061","GBB","GRG",0,6,6,3,3,"run070"
"14062","GBB","GRR",0,1,1,0,1,"run070"
"14063","GBB","RBB",0,2,2,0,2,"run070"
"14064","GBB","RBG",3,9,12,12,0,"run070"
"14065","GBB","RBR",1,0,1,0,1,"run070"
"14066","GBB","RGG",1,0,1,0,1,"run070"
"14067","GBB","RGR",2,1,3,2,1,"run070"
"14068","GBB","RRG",0,2,2,1,1,"run070"
"14069","GBB","RRR",1,9,10,4,6,"run070"
"14070","GBG","BBB",0,5,5,4,1,"run070"
"14071","GBG","BBR",0,1,1,0,1,"run070"
"14072","GBG","BRB",1,4,5,0,5,"run070"
"14073","GBG","BRR",1,0,1,1,0,"run070"
"14074","GBG","GGB",0,4,4,0,4,"run070"
"14075","GBG","GGG",4,11,15,5,10,"run070"
"14076","GBG","RBB",1,0,1,1,0,"run070"
"14077","GBG","RBG",0,1,1,0,1,"run070"
"14078","GBG","RGG",0,1,1,1,0,"run070"
"14079","GBG","RGR",1,3,4,2,2,"run070"
"14080","GBG","RRG",1,3,4,1,3,"run070"
"14081","GGB","BBB",3,16,19,0,19,"run070"
"14082","GGB","BBR",1,4,5,0,5,"run070"
"14083","GGB","BGB",0,3,3,2,1,"run070"
"14084","GGB","BGG",0,4,4,0,4,"run070"
"14085","GGB","BRB",0,1,1,1,0,"run070"
"14086","GGB","BRR",1,15,16,1,15,"run070"
"14087","GGB","GBB",0,1,1,1,0,"run070"
"14088","GGB","GBG",1,0,1,1,0,"run070"
"14089","GGB","GGG",13,48,61,58,3,"run070"
"14090","GGB","GGR",0,7,7,4,3,"run070"
"14091","GGB","GRR",0,4,4,0,4,"run070"
"14092","GGB","RBB",0,5,5,4,1,"run070"
"14093","GGB","RBG",0,4,4,2,2,"run070"
"14094","GGB","RBR",0,5,5,2,3,"run070"
"14095","GGB","RGG",1,5,6,2,4,"run070"
"14096","GGB","RGR",0,2,2,0,2,"run070"
"14097","GGB","RRG",1,5,6,2,4,"run070"
"14098","GGB","RRR",1,5,6,0,6,"run070"
"14099","GGG","BBB",8,31,39,17,22,"run070"
"14100","GGG","BGB",0,2,2,1,1,"run070"
"14101","GGG","BGG",1,7,8,7,1,"run070"
"14102","GGG","BRB",1,3,4,0,4,"run070"
"14103","GGG","BRR",0,6,6,1,5,"run070"
"14104","GGG","GGB",5,1,6,1,5,"run070"
"14105","GGG","GGR",1,9,10,9,1,"run070"
"14106","GGG","GRR",0,2,2,2,0,"run070"
"14107","GGG","RBB",1,8,9,5,4,"run070"
"14108","GGG","RBG",0,6,6,1,5,"run070"
"14109","GGG","RBR",0,21,21,18,3,"run070"
"14110","GGG","RGG",0,3,3,3,0,"run070"
"14111","GGG","RGR",1,12,13,8,5,"run070"
"14112","GGG","RRG",1,23,24,24,0,"run070"
"14113","GGG","RRR",0,3,3,0,3,"run070"
"14114","GGR","BBB",0,2,2,2,0,"run070"
"14115","GGR","BBR",0,2,2,1,1,"run070"
"14116","GGR","BGG",0,1,1,1,0,"run070"
"14117","GGR","BRR",1,0,1,1,0,"run070"
"14118","GGR","GRR",1,0,1,0,1,"run070"
"14119","GGR","RBB",0,2,2,0,2,"run070"
"14120","GRG","BBB",3,8,11,8,3,"run070"
"14121","GRG","BBR",0,1,1,0,1,"run070"
"14122","GRG","BGG",0,1,1,1,0,"run070"
"14123","GRG","BRB",0,3,3,3,0,"run070"
"14124","GRG","BRR",0,1,1,1,0,"run070"
"14125","GRG","GBG",0,1,1,0,1,"run070"
"14126","GRG","GGB",2,15,17,10,7,"run070"
"14127","GRG","GGG",3,12,15,7,8,"run070"
"14128","GRG","GGR",0,5,5,2,3,"run070"
"14129","GRG","GRR",0,1,1,1,0,"run070"
"14130","GRG","RBG",0,1,1,1,0,"run070"
"14131","GRG","RBR",0,1,1,0,1,"run070"
"14132","GRG","RGR",1,2,3,3,0,"run070"
"14133","GRG","RRG",2,4,6,1,5,"run070"
"14134","GRR","BBB",0,1,1,1,0,"run070"
"14135","GRR","BBR",0,1,1,1,0,"run070"
"14136","GRR","BGB",1,2,3,2,1,"run070"
"14137","GRR","BGG",0,2,2,2,0,"run070"
"14138","GRR","BRB",0,1,1,0,1,"run070"
"14139","GRR","BRR",0,2,2,1,1,"run070"
"14140","GRR","GGG",0,1,1,0,1,"run070"
"14141","GRR","GGR",0,1,1,0,1,"run070"
"14142","RBB","BBB",0,1,1,1,0,"run070"
"14143","RBB","BBR",0,1,1,0,1,"run070"
"14144","RBB","BRB",0,1,1,0,1,"run070"
"14145","RBB","GRR",0,1,1,1,0,"run070"
"14146","RBB","RGG",0,1,1,1,0,"run070"
"14147","RBG","BBB",2,8,10,9,1,"run070"
"14148","RBG","BBG",0,1,1,1,0,"run070"
"14149","RBG","BRR",0,1,1,1,0,"run070"
"14150","RBG","GBB",0,1,1,0,1,"run070"
"14151","RBG","GRR",0,3,3,2,1,"run070"
"14152","RBG","RBB",1,1,2,2,0,"run070"
"14153","RBG","RBR",0,1,1,1,0,"run070"
"14154","RBG","RGR",0,1,1,1,0,"run070"
"14155","RBR","BBB",0,13,13,0,13,"run070"
"14156","RBR","BBR",0,1,1,0,1,"run070"
"14157","RBR","BGB",2,4,6,4,2,"run070"
"14158","RBR","BGG",0,2,2,0,2,"run070"
"14159","RBR","BRB",1,0,1,0,1,"run070"
"14160","RBR","BRR",1,4,5,4,1,"run070"
"14161","RBR","GGB",0,12,12,5,7,"run070"
"14162","RBR","GRR",4,4,8,6,2,"run070"
"14163","RBR","RBB",0,3,3,2,1,"run070"
"14164","RBR","RGG",2,9,11,4,7,"run070"
"14165","RBR","RGR",1,0,1,0,1,"run070"
"14166","RBR","RRR",0,1,1,0,1,"run070"
"14167","RGG","BBB",0,8,8,3,5,"run070"
"14168","RGG","BBR",1,2,3,3,0,"run070"
"14169","RGG","BGB",0,1,1,0,1,"run070"
"14170","RGG","BRR",0,4,4,1,3,"run070"
"14171","RGG","GGG",0,1,1,0,1,"run070"
"14172","RGG","GGR",0,3,3,1,2,"run070"
"14173","RGG","GRR",0,8,8,7,1,"run070"
"14174","RGG","RBB",0,1,1,0,1,"run070"
"14175","RGR","BBB",2,5,7,3,4,"run070"
"14176","RGR","BBR",1,1,2,1,1,"run070"
"14177","RGR","BGB",2,5,7,2,5,"run070"
"14178","RGR","BGG",2,2,4,1,3,"run070"
"14179","RGR","BRR",1,5,6,3,3,"run070"
"14180","RGR","GGB",2,12,14,6,8,"run070"
"14181","RGR","GGG",0,2,2,1,1,"run070"
"14182","RGR","GGR",0,4,4,3,1,"run070"
"14183","RGR","RBB",0,4,4,3,1,"run070"
"14184","RGR","RGG",1,1,2,0,2,"run070"
"14185","RGR","RRG",0,3,3,1,2,"run070"
"14186","RRG","BBB",2,33,35,12,23,"run070"
"14187","RRG","BBR",0,5,5,0,5,"run070"
"14188","RRG","BGB",1,10,11,9,2,"run070"
"14189","RRG","BGG",0,2,2,0,2,"run070"
"14190","RRG","BRB",2,40,42,42,0,"run070"
"14191","RRG","BRR",1,16,17,16,1,"run070"
"14192","RRG","GGG",2,14,16,9,7,"run070"
"14193","RRG","GGR",0,5,5,5,0,"run070"
"14194","RRG","GRG",1,0,1,0,1,"run070"
"14195","RRG","GRR",3,8,11,7,4,"run070"
"14196","RRG","RBB",1,1,2,1,1,"run070"
"14197","RRG","RGG",0,1,1,0,1,"run070"
"14198","RRG","RGR",0,1,1,0,1,"run070"
"14199","RRR","BBR",1,0,1,1,0,"run070"
"14200","RRR","BGB",2,1,3,2,1,"run070"
"14201","RRR","BGG",1,0,1,1,0,"run070"
"14202","RRR","BRB",1,1,2,2,0,"run070"
"14203","RRR","BRR",1,1,2,2,0,"run070"
"14204","RRR","GGR",0,1,1,1,0,"run070"
"14205","RRR","GRR",0,3,3,1,2,"run070"
"14206","RRR","RBB",1,2,3,0,3,"run070"
"14207","RRR","RBR",0,2,2,2,0,"run070"
"14208","RRR","RGG",0,1,1,1,0,"run070"
"14209","RRR","RGR",1,2,3,2,1,"run070"
"14210","RRR","RRG",2,2,4,0,4,"run070"
"14211","BBB","BRB",0,1,1,0,1,"run071"
"14212","BBB","GGG",1,2,3,3,0,"run071"
"14213","BBB","GRR",0,2,2,2,0,"run071"
"14214","BBB","RBG",0,1,1,1,0,"run071"
"14215","BBB","RRG",1,3,4,0,4,"run071"
"14216","BBB","RRR",0,2,2,2,0,"run071"
"14217","BBG","BBB",1,4,5,1,4,"run071"
"14218","BBG","BGB",0,1,1,1,0,"run071"
"14219","BBG","BGG",0,1,1,1,0,"run071"
"14220","BBG","BRB",1,16,17,12,5,"run071"
"14221","BBG","GBB",0,1,1,0,1,"run071"
"14222","BBG","GBG",2,7,9,6,3,"run071"
"14223","BBG","GGB",2,25,27,25,2,"run071"
"14224","BBG","GGG",4,38,42,2,40,"run071"
"14225","BBG","GRG",1,9,10,1,9,"run071"
"14226","BBG","GRR",0,1,1,1,0,"run071"
"14227","BBG","RBB",0,1,1,0,1,"run071"
"14228","BBG","RBG",0,4,4,0,4,"run071"
"14229","BBG","RBR",0,1,1,1,0,"run071"
"14230","BBG","RGR",0,1,1,1,0,"run071"
"14231","BBG","RRG",1,2,3,0,3,"run071"
"14232","BBG","RRR",0,7,7,4,3,"run071"
"14233","BGB","BBB",0,2,2,2,0,"run071"
"14234","BGB","RRG",0,1,1,0,1,"run071"
"14235","BGG","BBB",0,3,3,1,2,"run071"
"14236","BGG","BBR",0,1,1,1,0,"run071"
"14237","BGG","GRG",0,1,1,0,1,"run071"
"14238","BGG","RBG",1,1,2,0,2,"run071"
"14239","BGG","RGG",0,3,3,2,1,"run071"
"14240","BGG","RGR",0,1,1,1,0,"run071"
"14241","BGG","RRR",1,1,2,2,0,"run071"
"14242","BRB","BBB",0,13,13,6,7,"run071"
"14243","BRB","BBR",0,1,1,1,0,"run071"
"14244","BRB","BRR",0,3,3,3,0,"run071"
"14245","BRB","GGG",0,1,1,1,0,"run071"
"14246","BRB","GGR",0,1,1,0,1,"run071"
"14247","BRB","RBB",0,1,1,0,1,"run071"
"14248","BRB","RBG",0,1,1,1,0,"run071"
"14249","BRB","RGR",0,1,1,0,1,"run071"
"14250","BRB","RRR",0,1,1,0,1,"run071"
"14251","BRR","BBB",0,11,11,9,2,"run071"
"14252","BRR","BGB",1,1,2,2,0,"run071"
"14253","BRR","BGG",0,1,1,0,1,"run071"
"14254","BRR","BRB",0,1,1,1,0,"run071"
"14255","BRR","RBB",0,2,2,1,1,"run071"
"14256","GBB","BBB",12,38,50,8,42,"run071"
"14257","GBB","BGG",0,1,1,0,1,"run071"
"14258","GBB","BRB",1,9,10,4,6,"run071"
"14259","GBB","BRR",1,3,4,4,0,"run071"
"14260","GBB","GBG",0,4,4,0,4,"run071"
"14261","GBB","GGB",0,21,21,1,20,"run071"
"14262","GBB","GGG",7,86,93,37,56,"run071"
"14263","GBB","GGR",1,3,4,3,1,"run071"
"14264","GBB","GRG",0,6,6,0,6,"run071"
"14265","GBB","GRR",0,1,1,1,0,"run071"
"14266","GBB","RBB",0,2,2,2,0,"run071"
"14267","GBB","RBG",3,9,12,5,7,"run071"
"14268","GBB","RBR",1,0,1,1,0,"run071"
"14269","GBB","RGG",1,0,1,1,0,"run071"
"14270","GBB","RGR",2,1,3,3,0,"run071"
"14271","GBB","RRG",0,2,2,0,2,"run071"
"14272","GBB","RRR",1,9,10,0,10,"run071"
"14273","GBG","BBB",0,5,5,3,2,"run071"
"14274","GBG","BBR",0,1,1,0,1,"run071"
"14275","GBG","BRB",1,4,5,5,0,"run071"
"14276","GBG","BRR",1,0,1,1,0,"run071"
"14277","GBG","GGB",0,4,4,3,1,"run071"
"14278","GBG","GGG",4,11,15,1,14,"run071"
"14279","GBG","RBB",1,0,1,1,0,"run071"
"14280","GBG","RBG",0,1,1,1,0,"run071"
"14281","GBG","RGG",0,1,1,1,0,"run071"
"14282","GBG","RGR",1,3,4,1,3,"run071"
"14283","GBG","RRG",1,3,4,2,2,"run071"
"14284","GGB","BBB",3,16,19,6,13,"run071"
"14285","GGB","BBR",1,4,5,1,4,"run071"
"14286","GGB","BGB",0,3,3,2,1,"run071"
"14287","GGB","BGG",0,4,4,4,0,"run071"
"14288","GGB","BRB",0,1,1,1,0,"run071"
"14289","GGB","BRR",1,15,16,1,15,"run071"
"14290","GGB","GBB",0,1,1,1,0,"run071"
"14291","GGB","GBG",1,0,1,0,1,"run071"
"14292","GGB","GGG",13,48,61,17,44,"run071"
"14293","GGB","GGR",0,7,7,6,1,"run071"
"14294","GGB","GRR",0,4,4,2,2,"run071"
"14295","GGB","RBB",0,5,5,3,2,"run071"
"14296","GGB","RBG",0,4,4,3,1,"run071"
"14297","GGB","RBR",0,5,5,0,5,"run071"
"14298","GGB","RGG",1,5,6,5,1,"run071"
"14299","GGB","RGR",0,2,2,0,2,"run071"
"14300","GGB","RRG",1,5,6,0,6,"run071"
"14301","GGB","RRR",1,5,6,2,4,"run071"
"14302","GGG","BBB",8,31,39,38,1,"run071"
"14303","GGG","BGB",0,2,2,1,1,"run071"
"14304","GGG","BGG",1,7,8,0,8,"run071"
"14305","GGG","BRB",1,3,4,3,1,"run071"
"14306","GGG","BRR",0,6,6,5,1,"run071"
"14307","GGG","GGB",5,1,6,1,5,"run071"
"14308","GGG","GGR",1,9,10,4,6,"run071"
"14309","GGG","GRR",0,2,2,0,2,"run071"
"14310","GGG","RBB",1,8,9,5,4,"run071"
"14311","GGG","RBG",0,6,6,6,0,"run071"
"14312","GGG","RBR",0,21,21,6,15,"run071"
"14313","GGG","RGG",0,3,3,1,2,"run071"
"14314","GGG","RGR",1,12,13,2,11,"run071"
"14315","GGG","RRG",1,23,24,24,0,"run071"
"14316","GGG","RRR",0,3,3,0,3,"run071"
"14317","GGR","BBB",0,2,2,2,0,"run071"
"14318","GGR","BBR",0,2,2,0,2,"run071"
"14319","GGR","BGG",0,1,1,0,1,"run071"
"14320","GGR","BRR",1,0,1,1,0,"run071"
"14321","GGR","GRR",1,0,1,1,0,"run071"
"14322","GGR","RBB",0,2,2,2,0,"run071"
"14323","GRG","BBB",3,8,11,9,2,"run071"
"14324","GRG","BBR",0,1,1,1,0,"run071"
"14325","GRG","BGG",0,1,1,0,1,"run071"
"14326","GRG","BRB",0,3,3,0,3,"run071"
"14327","GRG","BRR",0,1,1,1,0,"run071"
"14328","GRG","GBG",0,1,1,1,0,"run071"
"14329","GRG","GGB",2,15,17,9,8,"run071"
"14330","GRG","GGG",3,12,15,1,14,"run071"
"14331","GRG","GGR",0,5,5,5,0,"run071"
"14332","GRG","GRR",0,1,1,1,0,"run071"
"14333","GRG","RBG",0,1,1,0,1,"run071"
"14334","GRG","RBR",0,1,1,0,1,"run071"
"14335","GRG","RGR",1,2,3,3,0,"run071"
"14336","GRG","RRG",2,4,6,3,3,"run071"
"14337","GRR","BBB",0,1,1,0,1,"run071"
"14338","GRR","BBR",0,1,1,1,0,"run071"
"14339","GRR","BGB",1,2,3,3,0,"run071"
"14340","GRR","BGG",0,2,2,2,0,"run071"
"14341","GRR","BRB",0,1,1,0,1,"run071"
"14342","GRR","BRR",0,2,2,2,0,"run071"
"14343","GRR","GGG",0,1,1,1,0,"run071"
"14344","GRR","GGR",0,1,1,1,0,"run071"
"14345","RBB","BBB",0,1,1,1,0,"run071"
"14346","RBB","BBR",0,1,1,0,1,"run071"
"14347","RBB","BRB",0,1,1,1,0,"run071"
"14348","RBB","GRR",0,1,1,0,1,"run071"
"14349","RBB","RGG",0,1,1,0,1,"run071"
"14350","RBG","BBB",2,8,10,8,2,"run071"
"14351","RBG","BBG",0,1,1,0,1,"run071"
"14352","RBG","BRR",0,1,1,0,1,"run071"
"14353","RBG","GBB",0,1,1,0,1,"run071"
"14354","RBG","GRR",0,3,3,3,0,"run071"
"14355","RBG","RBB",1,1,2,1,1,"run071"
"14356","RBG","RBR",0,1,1,1,0,"run071"
"14357","RBG","RGR",0,1,1,0,1,"run071"
"14358","RBR","BBB",0,13,13,11,2,"run071"
"14359","RBR","BBR",0,1,1,1,0,"run071"
"14360","RBR","BGB",2,4,6,1,5,"run071"
"14361","RBR","BGG",0,2,2,1,1,"run071"
"14362","RBR","BRB",1,0,1,1,0,"run071"
"14363","RBR","BRR",1,4,5,0,5,"run071"
"14364","RBR","GGB",0,12,12,8,4,"run071"
"14365","RBR","GRR",4,4,8,1,7,"run071"
"14366","RBR","RBB",0,3,3,2,1,"run071"
"14367","RBR","RGG",2,9,11,5,6,"run071"
"14368","RBR","RGR",1,0,1,0,1,"run071"
"14369","RBR","RRR",0,1,1,1,0,"run071"
"14370","RGG","BBB",0,8,8,3,5,"run071"
"14371","RGG","BBR",1,2,3,1,2,"run071"
"14372","RGG","BGB",0,1,1,1,0,"run071"
"14373","RGG","BRR",0,4,4,3,1,"run071"
"14374","RGG","GGG",0,1,1,0,1,"run071"
"14375","RGG","GGR",0,3,3,0,3,"run071"
"14376","RGG","GRR",0,8,8,5,3,"run071"
"14377","RGG","RBB",0,1,1,1,0,"run071"
"14378","RGR","BBB",2,5,7,2,5,"run071"
"14379","RGR","BBR",1,1,2,1,1,"run071"
"14380","RGR","BGB",2,5,7,3,4,"run071"
"14381","RGR","BGG",2,2,4,0,4,"run071"
"14382","RGR","BRR",1,5,6,4,2,"run071"
"14383","RGR","GGB",2,12,14,9,5,"run071"
"14384","RGR","GGG",0,2,2,2,0,"run071"
"14385","RGR","GGR",0,4,4,1,3,"run071"
"14386","RGR","RBB",0,4,4,2,2,"run071"
"14387","RGR","RGG",1,1,2,2,0,"run071"
"14388","RGR","RRG",0,3,3,1,2,"run071"
"14389","RRG","BBB",2,33,35,7,28,"run071"
"14390","RRG","BBR",0,5,5,3,2,"run071"
"14391","RRG","BGB",1,10,11,4,7,"run071"
"14392","RRG","BGG",0,2,2,1,1,"run071"
"14393","RRG","BRB",2,40,42,21,21,"run071"
"14394","RRG","BRR",1,16,17,12,5,"run071"
"14395","RRG","GGG",2,14,16,11,5,"run071"
"14396","RRG","GGR",0,5,5,2,3,"run071"
"14397","RRG","GRG",1,0,1,0,1,"run071"
"14398","RRG","GRR",3,8,11,8,3,"run071"
"14399","RRG","RBB",1,1,2,1,1,"run071"
"14400","RRG","RGG",0,1,1,1,0,"run071"
"14401","RRG","RGR",0,1,1,0,1,"run071"
"14402","RRR","BBR",1,0,1,1,0,"run071"
"14403","RRR","BGB",2,1,3,3,0,"run071"
"14404","RRR","BGG",1,0,1,0,1,"run071"
"14405","RRR","BRB",1,1,2,2,0,"run071"
"14406","RRR","BRR",1,1,2,0,2,"run071"
"14407","RRR","GGR",0,1,1,0,1,"run071"
"14408","RRR","GRR",0,3,3,1,2,"run071"
"14409","RRR","RBB",1,2,3,1,2,"run071"
"14410","RRR","RBR",0,2,2,2,0,"run071"
"14411","RRR","RGG",0,1,1,0,1,"run071"
"14412","RRR","RGR",1,2,3,0,3,"run071"
"14413","RRR","RRG",2,2,4,0,4,"run071"
"14414","BBB","BRB",0,1,1,0,1,"run072"
"14415","BBB","GGG",1,2,3,0,3,"run072"
"14416","BBB","GRR",0,2,2,2,0,"run072"
"14417","BBB","RBG",0,1,1,0,1,"run072"
"14418","BBB","RRG",1,3,4,4,0,"run072"
"14419","BBB","RRR",0,2,2,1,1,"run072"
"14420","BBG","BBB",1,4,5,3,2,"run072"
"14421","BBG","BGB",0,1,1,0,1,"run072"
"14422","BBG","BGG",0,1,1,1,0,"run072"
"14423","BBG","BRB",1,16,17,11,6,"run072"
"14424","BBG","GBB",0,1,1,0,1,"run072"
"14425","BBG","GBG",2,7,9,4,5,"run072"
"14426","BBG","GGB",2,25,27,8,19,"run072"
"14427","BBG","GGG",4,38,42,5,37,"run072"
"14428","BBG","GRG",1,9,10,3,7,"run072"
"14429","BBG","GRR",0,1,1,0,1,"run072"
"14430","BBG","RBB",0,1,1,0,1,"run072"
"14431","BBG","RBG",0,4,4,2,2,"run072"
"14432","BBG","RBR",0,1,1,1,0,"run072"
"14433","BBG","RGR",0,1,1,0,1,"run072"
"14434","BBG","RRG",1,2,3,1,2,"run072"
"14435","BBG","RRR",0,7,7,3,4,"run072"
"14436","BGB","BBB",0,2,2,1,1,"run072"
"14437","BGB","RRG",0,1,1,0,1,"run072"
"14438","BGG","BBB",0,3,3,1,2,"run072"
"14439","BGG","BBR",0,1,1,1,0,"run072"
"14440","BGG","GRG",0,1,1,0,1,"run072"
"14441","BGG","RBG",1,1,2,2,0,"run072"
"14442","BGG","RGG",0,3,3,1,2,"run072"
"14443","BGG","RGR",0,1,1,1,0,"run072"
"14444","BGG","RRR",1,1,2,0,2,"run072"
"14445","BRB","BBB",0,13,13,8,5,"run072"
"14446","BRB","BBR",0,1,1,0,1,"run072"
"14447","BRB","BRR",0,3,3,3,0,"run072"
"14448","BRB","GGG",0,1,1,0,1,"run072"
"14449","BRB","GGR",0,1,1,1,0,"run072"
"14450","BRB","RBB",0,1,1,1,0,"run072"
"14451","BRB","RBG",0,1,1,1,0,"run072"
"14452","BRB","RGR",0,1,1,1,0,"run072"
"14453","BRB","RRR",0,1,1,0,1,"run072"
"14454","BRR","BBB",0,11,11,8,3,"run072"
"14455","BRR","BGB",1,1,2,1,1,"run072"
"14456","BRR","BGG",0,1,1,1,0,"run072"
"14457","BRR","BRB",0,1,1,1,0,"run072"
"14458","BRR","RBB",0,2,2,1,1,"run072"
"14459","GBB","BBB",12,38,50,26,24,"run072"
"14460","GBB","BGG",0,1,1,1,0,"run072"
"14461","GBB","BRB",1,9,10,9,1,"run072"
"14462","GBB","BRR",1,3,4,2,2,"run072"
"14463","GBB","GBG",0,4,4,2,2,"run072"
"14464","GBB","GGB",0,21,21,20,1,"run072"
"14465","GBB","GGG",7,86,93,69,24,"run072"
"14466","GBB","GGR",1,3,4,1,3,"run072"
"14467","GBB","GRG",0,6,6,3,3,"run072"
"14468","GBB","GRR",0,1,1,1,0,"run072"
"14469","GBB","RBB",0,2,2,0,2,"run072"
"14470","GBB","RBG",3,9,12,5,7,"run072"
"14471","GBB","RBR",1,0,1,1,0,"run072"
"14472","GBB","RGG",1,0,1,0,1,"run072"
"14473","GBB","RGR",2,1,3,3,0,"run072"
"14474","GBB","RRG",0,2,2,1,1,"run072"
"14475","GBB","RRR",1,9,10,8,2,"run072"
"14476","GBG","BBB",0,5,5,5,0,"run072"
"14477","GBG","BBR",0,1,1,0,1,"run072"
"14478","GBG","BRB",1,4,5,0,5,"run072"
"14479","GBG","BRR",1,0,1,0,1,"run072"
"14480","GBG","GGB",0,4,4,4,0,"run072"
"14481","GBG","GGG",4,11,15,1,14,"run072"
"14482","GBG","RBB",1,0,1,1,0,"run072"
"14483","GBG","RBG",0,1,1,1,0,"run072"
"14484","GBG","RGG",0,1,1,1,0,"run072"
"14485","GBG","RGR",1,3,4,2,2,"run072"
"14486","GBG","RRG",1,3,4,3,1,"run072"
"14487","GGB","BBB",3,16,19,8,11,"run072"
"14488","GGB","BBR",1,4,5,1,4,"run072"
"14489","GGB","BGB",0,3,3,3,0,"run072"
"14490","GGB","BGG",0,4,4,0,4,"run072"
"14491","GGB","BRB",0,1,1,1,0,"run072"
"14492","GGB","BRR",1,15,16,2,14,"run072"
"14493","GGB","GBB",0,1,1,1,0,"run072"
"14494","GGB","GBG",1,0,1,0,1,"run072"
"14495","GGB","GGG",13,48,61,57,4,"run072"
"14496","GGB","GGR",0,7,7,0,7,"run072"
"14497","GGB","GRR",0,4,4,2,2,"run072"
"14498","GGB","RBB",0,5,5,3,2,"run072"
"14499","GGB","RBG",0,4,4,3,1,"run072"
"14500","GGB","RBR",0,5,5,2,3,"run072"
"14501","GGB","RGG",1,5,6,3,3,"run072"
"14502","GGB","RGR",0,2,2,0,2,"run072"
"14503","GGB","RRG",1,5,6,0,6,"run072"
"14504","GGB","RRR",1,5,6,6,0,"run072"
"14505","GGG","BBB",8,31,39,15,24,"run072"
"14506","GGG","BGB",0,2,2,2,0,"run072"
"14507","GGG","BGG",1,7,8,6,2,"run072"
"14508","GGG","BRB",1,3,4,2,2,"run072"
"14509","GGG","BRR",0,6,6,4,2,"run072"
"14510","GGG","GGB",5,1,6,1,5,"run072"
"14511","GGG","GGR",1,9,10,2,8,"run072"
"14512","GGG","GRR",0,2,2,1,1,"run072"
"14513","GGG","RBB",1,8,9,4,5,"run072"
"14514","GGG","RBG",0,6,6,2,4,"run072"
"14515","GGG","RBR",0,21,21,21,0,"run072"
"14516","GGG","RGG",0,3,3,0,3,"run072"
"14517","GGG","RGR",1,12,13,8,5,"run072"
"14518","GGG","RRG",1,23,24,8,16,"run072"
"14519","GGG","RRR",0,3,3,0,3,"run072"
"14520","GGR","BBB",0,2,2,0,2,"run072"
"14521","GGR","BBR",0,2,2,2,0,"run072"
"14522","GGR","BGG",0,1,1,1,0,"run072"
"14523","GGR","BRR",1,0,1,1,0,"run072"
"14524","GGR","GRR",1,0,1,1,0,"run072"
"14525","GGR","RBB",0,2,2,2,0,"run072"
"14526","GRG","BBB",3,8,11,4,7,"run072"
"14527","GRG","BBR",0,1,1,0,1,"run072"
"14528","GRG","BGG",0,1,1,0,1,"run072"
"14529","GRG","BRB",0,3,3,1,2,"run072"
"14530","GRG","BRR",0,1,1,1,0,"run072"
"14531","GRG","GBG",0,1,1,1,0,"run072"
"14532","GRG","GGB",2,15,17,8,9,"run072"
"14533","GRG","GGG",3,12,15,14,1,"run072"
"14534","GRG","GGR",0,5,5,0,5,"run072"
"14535","GRG","GRR",0,1,1,0,1,"run072"
"14536","GRG","RBG",0,1,1,1,0,"run072"
"14537","GRG","RBR",0,1,1,1,0,"run072"
"14538","GRG","RGR",1,2,3,2,1,"run072"
"14539","GRG","RRG",2,4,6,3,3,"run072"
"14540","GRR","BBB",0,1,1,0,1,"run072"
"14541","GRR","BBR",0,1,1,0,1,"run072"
"14542","GRR","BGB",1,2,3,3,0,"run072"
"14543","GRR","BGG",0,2,2,0,2,"run072"
"14544","GRR","BRB",0,1,1,1,0,"run072"
"14545","GRR","BRR",0,2,2,1,1,"run072"
"14546","GRR","GGG",0,1,1,0,1,"run072"
"14547","GRR","GGR",0,1,1,1,0,"run072"
"14548","RBB","BBB",0,1,1,0,1,"run072"
"14549","RBB","BBR",0,1,1,0,1,"run072"
"14550","RBB","BRB",0,1,1,1,0,"run072"
"14551","RBB","GRR",0,1,1,1,0,"run072"
"14552","RBB","RGG",0,1,1,1,0,"run072"
"14553","RBG","BBB",2,8,10,6,4,"run072"
"14554","RBG","BBG",0,1,1,1,0,"run072"
"14555","RBG","BRR",0,1,1,1,0,"run072"
"14556","RBG","GBB",0,1,1,1,0,"run072"
"14557","RBG","GRR",0,3,3,0,3,"run072"
"14558","RBG","RBB",1,1,2,0,2,"run072"
"14559","RBG","RBR",0,1,1,1,0,"run072"
"14560","RBG","RGR",0,1,1,1,0,"run072"
"14561","RBR","BBB",0,13,13,2,11,"run072"
"14562","RBR","BBR",0,1,1,0,1,"run072"
"14563","RBR","BGB",2,4,6,2,4,"run072"
"14564","RBR","BGG",0,2,2,0,2,"run072"
"14565","RBR","BRB",1,0,1,1,0,"run072"
"14566","RBR","BRR",1,4,5,2,3,"run072"
"14567","RBR","GGB",0,12,12,7,5,"run072"
"14568","RBR","GRR",4,4,8,1,7,"run072"
"14569","RBR","RBB",0,3,3,3,0,"run072"
"14570","RBR","RGG",2,9,11,4,7,"run072"
"14571","RBR","RGR",1,0,1,1,0,"run072"
"14572","RBR","RRR",0,1,1,1,0,"run072"
"14573","RGG","BBB",0,8,8,8,0,"run072"
"14574","RGG","BBR",1,2,3,2,1,"run072"
"14575","RGG","BGB",0,1,1,1,0,"run072"
"14576","RGG","BRR",0,4,4,2,2,"run072"
"14577","RGG","GGG",0,1,1,1,0,"run072"
"14578","RGG","GGR",0,3,3,0,3,"run072"
"14579","RGG","GRR",0,8,8,3,5,"run072"
"14580","RGG","RBB",0,1,1,0,1,"run072"
"14581","RGR","BBB",2,5,7,6,1,"run072"
"14582","RGR","BBR",1,1,2,2,0,"run072"
"14583","RGR","BGB",2,5,7,2,5,"run072"
"14584","RGR","BGG",2,2,4,2,2,"run072"
"14585","RGR","BRR",1,5,6,0,6,"run072"
"14586","RGR","GGB",2,12,14,4,10,"run072"
"14587","RGR","GGG",0,2,2,2,0,"run072"
"14588","RGR","GGR",0,4,4,0,4,"run072"
"14589","RGR","RBB",0,4,4,1,3,"run072"
"14590","RGR","RGG",1,1,2,2,0,"run072"
"14591","RGR","RRG",0,3,3,0,3,"run072"
"14592","RRG","BBB",2,33,35,7,28,"run072"
"14593","RRG","BBR",0,5,5,2,3,"run072"
"14594","RRG","BGB",1,10,11,1,10,"run072"
"14595","RRG","BGG",0,2,2,2,0,"run072"
"14596","RRG","BRB",2,40,42,37,5,"run072"
"14597","RRG","BRR",1,16,17,2,15,"run072"
"14598","RRG","GGG",2,14,16,2,14,"run072"
"14599","RRG","GGR",0,5,5,2,3,"run072"
"14600","RRG","GRG",1,0,1,1,0,"run072"
"14601","RRG","GRR",3,8,11,2,9,"run072"
"14602","RRG","RBB",1,1,2,1,1,"run072"
"14603","RRG","RGG",0,1,1,0,1,"run072"
"14604","RRG","RGR",0,1,1,1,0,"run072"
"14605","RRR","BBR",1,0,1,1,0,"run072"
"14606","RRR","BGB",2,1,3,3,0,"run072"
"14607","RRR","BGG",1,0,1,1,0,"run072"
"14608","RRR","BRB",1,1,2,2,0,"run072"
"14609","RRR","BRR",1,1,2,2,0,"run072"
"14610","RRR","GGR",0,1,1,0,1,"run072"
"14611","RRR","GRR",0,3,3,3,0,"run072"
"14612","RRR","RBB",1,2,3,3,0,"run072"
"14613","RRR","RBR",0,2,2,0,2,"run072"
"14614","RRR","RGG",0,1,1,0,1,"run072"
"14615","RRR","RGR",1,2,3,1,2,"run072"
"14616","RRR","RRG",2,2,4,1,3,"run072"
"14617","BBB","BRB",0,1,1,0,1,"run073"
"14618","BBB","GGG",1,2,3,2,1,"run073"
"14619","BBB","GRR",0,2,2,0,2,"run073"
"14620","BBB","RBG",0,1,1,0,1,"run073"
"14621","BBB","RRG",1,3,4,2,2,"run073"
"14622","BBB","RRR",0,2,2,2,0,"run073"
"14623","BBG","BBB",1,4,5,2,3,"run073"
"14624","BBG","BGB",0,1,1,0,1,"run073"
"14625","BBG","BGG",0,1,1,1,0,"run073"
"14626","BBG","BRB",1,16,17,3,14,"run073"
"14627","BBG","GBB",0,1,1,1,0,"run073"
"14628","BBG","GBG",2,7,9,2,7,"run073"
"14629","BBG","GGB",2,25,27,4,23,"run073"
"14630","BBG","GGG",4,38,42,39,3,"run073"
"14631","BBG","GRG",1,9,10,0,10,"run073"
"14632","BBG","GRR",0,1,1,0,1,"run073"
"14633","BBG","RBB",0,1,1,0,1,"run073"
"14634","BBG","RBG",0,4,4,2,2,"run073"
"14635","BBG","RBR",0,1,1,0,1,"run073"
"14636","BBG","RGR",0,1,1,1,0,"run073"
"14637","BBG","RRG",1,2,3,0,3,"run073"
"14638","BBG","RRR",0,7,7,4,3,"run073"
"14639","BGB","BBB",0,2,2,1,1,"run073"
"14640","BGB","RRG",0,1,1,0,1,"run073"
"14641","BGG","BBB",0,3,3,3,0,"run073"
"14642","BGG","BBR",0,1,1,1,0,"run073"
"14643","BGG","GRG",0,1,1,0,1,"run073"
"14644","BGG","RBG",1,1,2,2,0,"run073"
"14645","BGG","RGG",0,3,3,2,1,"run073"
"14646","BGG","RGR",0,1,1,0,1,"run073"
"14647","BGG","RRR",1,1,2,1,1,"run073"
"14648","BRB","BBB",0,13,13,8,5,"run073"
"14649","BRB","BBR",0,1,1,0,1,"run073"
"14650","BRB","BRR",0,3,3,0,3,"run073"
"14651","BRB","GGG",0,1,1,0,1,"run073"
"14652","BRB","GGR",0,1,1,1,0,"run073"
"14653","BRB","RBB",0,1,1,0,1,"run073"
"14654","BRB","RBG",0,1,1,0,1,"run073"
"14655","BRB","RGR",0,1,1,0,1,"run073"
"14656","BRB","RRR",0,1,1,0,1,"run073"
"14657","BRR","BBB",0,11,11,4,7,"run073"
"14658","BRR","BGB",1,1,2,2,0,"run073"
"14659","BRR","BGG",0,1,1,0,1,"run073"
"14660","BRR","BRB",0,1,1,1,0,"run073"
"14661","BRR","RBB",0,2,2,1,1,"run073"
"14662","GBB","BBB",12,38,50,47,3,"run073"
"14663","GBB","BGG",0,1,1,0,1,"run073"
"14664","GBB","BRB",1,9,10,9,1,"run073"
"14665","GBB","BRR",1,3,4,3,1,"run073"
"14666","GBB","GBG",0,4,4,0,4,"run073"
"14667","GBB","GGB",0,21,21,8,13,"run073"
"14668","GBB","GGG",7,86,93,83,10,"run073"
"14669","GBB","GGR",1,3,4,0,4,"run073"
"14670","GBB","GRG",0,6,6,1,5,"run073"
"14671","GBB","GRR",0,1,1,0,1,"run073"
"14672","GBB","RBB",0,2,2,1,1,"run073"
"14673","GBB","RBG",3,9,12,6,6,"run073"
"14674","GBB","RBR",1,0,1,0,1,"run073"
"14675","GBB","RGG",1,0,1,1,0,"run073"
"14676","GBB","RGR",2,1,3,3,0,"run073"
"14677","GBB","RRG",0,2,2,2,0,"run073"
"14678","GBB","RRR",1,9,10,1,9,"run073"
"14679","GBG","BBB",0,5,5,5,0,"run073"
"14680","GBG","BBR",0,1,1,1,0,"run073"
"14681","GBG","BRB",1,4,5,5,0,"run073"
"14682","GBG","BRR",1,0,1,0,1,"run073"
"14683","GBG","GGB",0,4,4,2,2,"run073"
"14684","GBG","GGG",4,11,15,7,8,"run073"
"14685","GBG","RBB",1,0,1,0,1,"run073"
"14686","GBG","RBG",0,1,1,1,0,"run073"
"14687","GBG","RGG",0,1,1,1,0,"run073"
"14688","GBG","RGR",1,3,4,0,4,"run073"
"14689","GBG","RRG",1,3,4,3,1,"run073"
"14690","GGB","BBB",3,16,19,3,16,"run073"
"14691","GGB","BBR",1,4,5,0,5,"run073"
"14692","GGB","BGB",0,3,3,1,2,"run073"
"14693","GGB","BGG",0,4,4,0,4,"run073"
"14694","GGB","BRB",0,1,1,1,0,"run073"
"14695","GGB","BRR",1,15,16,13,3,"run073"
"14696","GGB","GBB",0,1,1,1,0,"run073"
"14697","GGB","GBG",1,0,1,0,1,"run073"
"14698","GGB","GGG",13,48,61,8,53,"run073"
"14699","GGB","GGR",0,7,7,2,5,"run073"
"14700","GGB","GRR",0,4,4,2,2,"run073"
"14701","GGB","RBB",0,5,5,3,2,"run073"
"14702","GGB","RBG",0,4,4,0,4,"run073"
"14703","GGB","RBR",0,5,5,2,3,"run073"
"14704","GGB","RGG",1,5,6,1,5,"run073"
"14705","GGB","RGR",0,2,2,0,2,"run073"
"14706","GGB","RRG",1,5,6,3,3,"run073"
"14707","GGB","RRR",1,5,6,0,6,"run073"
"14708","GGG","BBB",8,31,39,35,4,"run073"
"14709","GGG","BGB",0,2,2,2,0,"run073"
"14710","GGG","BGG",1,7,8,7,1,"run073"
"14711","GGG","BRB",1,3,4,2,2,"run073"
"14712","GGG","BRR",0,6,6,5,1,"run073"
"14713","GGG","GGB",5,1,6,0,6,"run073"
"14714","GGG","GGR",1,9,10,2,8,"run073"
"14715","GGG","GRR",0,2,2,1,1,"run073"
"14716","GGG","RBB",1,8,9,2,7,"run073"
"14717","GGG","RBG",0,6,6,6,0,"run073"
"14718","GGG","RBR",0,21,21,18,3,"run073"
"14719","GGG","RGG",0,3,3,0,3,"run073"
"14720","GGG","RGR",1,12,13,8,5,"run073"
"14721","GGG","RRG",1,23,24,10,14,"run073"
"14722","GGG","RRR",0,3,3,0,3,"run073"
"14723","GGR","BBB",0,2,2,0,2,"run073"
"14724","GGR","BBR",0,2,2,2,0,"run073"
"14725","GGR","BGG",0,1,1,1,0,"run073"
"14726","GGR","BRR",1,0,1,1,0,"run073"
"14727","GGR","GRR",1,0,1,1,0,"run073"
"14728","GGR","RBB",0,2,2,1,1,"run073"
"14729","GRG","BBB",3,8,11,11,0,"run073"
"14730","GRG","BBR",0,1,1,0,1,"run073"
"14731","GRG","BGG",0,1,1,0,1,"run073"
"14732","GRG","BRB",0,3,3,2,1,"run073"
"14733","GRG","BRR",0,1,1,0,1,"run073"
"14734","GRG","GBG",0,1,1,1,0,"run073"
"14735","GRG","GGB",2,15,17,4,13,"run073"
"14736","GRG","GGG",3,12,15,0,15,"run073"
"14737","GRG","GGR",0,5,5,0,5,"run073"
"14738","GRG","GRR",0,1,1,1,0,"run073"
"14739","GRG","RBG",0,1,1,1,0,"run073"
"14740","GRG","RBR",0,1,1,0,1,"run073"
"14741","GRG","RGR",1,2,3,3,0,"run073"
"14742","GRG","RRG",2,4,6,6,0,"run073"
"14743","GRR","BBB",0,1,1,0,1,"run073"
"14744","GRR","BBR",0,1,1,1,0,"run073"
"14745","GRR","BGB",1,2,3,1,2,"run073"
"14746","GRR","BGG",0,2,2,0,2,"run073"
"14747","GRR","BRB",0,1,1,0,1,"run073"
"14748","GRR","BRR",0,2,2,0,2,"run073"
"14749","GRR","GGG",0,1,1,0,1,"run073"
"14750","GRR","GGR",0,1,1,0,1,"run073"
"14751","RBB","BBB",0,1,1,0,1,"run073"
"14752","RBB","BBR",0,1,1,1,0,"run073"
"14753","RBB","BRB",0,1,1,1,0,"run073"
"14754","RBB","GRR",0,1,1,0,1,"run073"
"14755","RBB","RGG",0,1,1,0,1,"run073"
"14756","RBG","BBB",2,8,10,6,4,"run073"
"14757","RBG","BBG",0,1,1,1,0,"run073"
"14758","RBG","BRR",0,1,1,1,0,"run073"
"14759","RBG","GBB",0,1,1,1,0,"run073"
"14760","RBG","GRR",0,3,3,2,1,"run073"
"14761","RBG","RBB",1,1,2,2,0,"run073"
"14762","RBG","RBR",0,1,1,1,0,"run073"
"14763","RBG","RGR",0,1,1,0,1,"run073"
"14764","RBR","BBB",0,13,13,9,4,"run073"
"14765","RBR","BBR",0,1,1,0,1,"run073"
"14766","RBR","BGB",2,4,6,6,0,"run073"
"14767","RBR","BGG",0,2,2,0,2,"run073"
"14768","RBR","BRB",1,0,1,0,1,"run073"
"14769","RBR","BRR",1,4,5,3,2,"run073"
"14770","RBR","GGB",0,12,12,11,1,"run073"
"14771","RBR","GRR",4,4,8,8,0,"run073"
"14772","RBR","RBB",0,3,3,2,1,"run073"
"14773","RBR","RGG",2,9,11,9,2,"run073"
"14774","RBR","RGR",1,0,1,0,1,"run073"
"14775","RBR","RRR",0,1,1,0,1,"run073"
"14776","RGG","BBB",0,8,8,3,5,"run073"
"14777","RGG","BBR",1,2,3,2,1,"run073"
"14778","RGG","BGB",0,1,1,1,0,"run073"
"14779","RGG","BRR",0,4,4,1,3,"run073"
"14780","RGG","GGG",0,1,1,1,0,"run073"
"14781","RGG","GGR",0,3,3,2,1,"run073"
"14782","RGG","GRR",0,8,8,3,5,"run073"
"14783","RGG","RBB",0,1,1,1,0,"run073"
"14784","RGR","BBB",2,5,7,2,5,"run073"
"14785","RGR","BBR",1,1,2,1,1,"run073"
"14786","RGR","BGB",2,5,7,0,7,"run073"
"14787","RGR","BGG",2,2,4,4,0,"run073"
"14788","RGR","BRR",1,5,6,2,4,"run073"
"14789","RGR","GGB",2,12,14,12,2,"run073"
"14790","RGR","GGG",0,2,2,1,1,"run073"
"14791","RGR","GGR",0,4,4,4,0,"run073"
"14792","RGR","RBB",0,4,4,0,4,"run073"
"14793","RGR","RGG",1,1,2,1,1,"run073"
"14794","RGR","RRG",0,3,3,0,3,"run073"
"14795","RRG","BBB",2,33,35,26,9,"run073"
"14796","RRG","BBR",0,5,5,0,5,"run073"
"14797","RRG","BGB",1,10,11,4,7,"run073"
"14798","RRG","BGG",0,2,2,1,1,"run073"
"14799","RRG","BRB",2,40,42,3,39,"run073"
"14800","RRG","BRR",1,16,17,3,14,"run073"
"14801","RRG","GGG",2,14,16,15,1,"run073"
"14802","RRG","GGR",0,5,5,0,5,"run073"
"14803","RRG","GRG",1,0,1,0,1,"run073"
"14804","RRG","GRR",3,8,11,7,4,"run073"
"14805","RRG","RBB",1,1,2,0,2,"run073"
"14806","RRG","RGG",0,1,1,1,0,"run073"
"14807","RRG","RGR",0,1,1,1,0,"run073"
"14808","RRR","BBR",1,0,1,0,1,"run073"
"14809","RRR","BGB",2,1,3,2,1,"run073"
"14810","RRR","BGG",1,0,1,0,1,"run073"
"14811","RRR","BRB",1,1,2,1,1,"run073"
"14812","RRR","BRR",1,1,2,2,0,"run073"
"14813","RRR","GGR",0,1,1,0,1,"run073"
"14814","RRR","GRR",0,3,3,2,1,"run073"
"14815","RRR","RBB",1,2,3,0,3,"run073"
"14816","RRR","RBR",0,2,2,2,0,"run073"
"14817","RRR","RGG",0,1,1,1,0,"run073"
"14818","RRR","RGR",1,2,3,3,0,"run073"
"14819","RRR","RRG",2,2,4,4,0,"run073"
"14820","BBB","BRB",0,1,1,1,0,"run074"
"14821","BBB","GGG",1,2,3,1,2,"run074"
"14822","BBB","GRR",0,2,2,2,0,"run074"
"14823","BBB","RBG",0,1,1,1,0,"run074"
"14824","BBB","RRG",1,3,4,2,2,"run074"
"14825","BBB","RRR",0,2,2,2,0,"run074"
"14826","BBG","BBB",1,4,5,3,2,"run074"
"14827","BBG","BGB",0,1,1,1,0,"run074"
"14828","BBG","BGG",0,1,1,0,1,"run074"
"14829","BBG","BRB",1,16,17,13,4,"run074"
"14830","BBG","GBB",0,1,1,0,1,"run074"
"14831","BBG","GBG",2,7,9,6,3,"run074"
"14832","BBG","GGB",2,25,27,7,20,"run074"
"14833","BBG","GGG",4,38,42,14,28,"run074"
"14834","BBG","GRG",1,9,10,7,3,"run074"
"14835","BBG","GRR",0,1,1,1,0,"run074"
"14836","BBG","RBB",0,1,1,1,0,"run074"
"14837","BBG","RBG",0,4,4,4,0,"run074"
"14838","BBG","RBR",0,1,1,1,0,"run074"
"14839","BBG","RGR",0,1,1,0,1,"run074"
"14840","BBG","RRG",1,2,3,1,2,"run074"
"14841","BBG","RRR",0,7,7,4,3,"run074"
"14842","BGB","BBB",0,2,2,1,1,"run074"
"14843","BGB","RRG",0,1,1,0,1,"run074"
"14844","BGG","BBB",0,3,3,0,3,"run074"
"14845","BGG","BBR",0,1,1,1,0,"run074"
"14846","BGG","GRG",0,1,1,1,0,"run074"
"14847","BGG","RBG",1,1,2,1,1,"run074"
"14848","BGG","RGG",0,3,3,3,0,"run074"
"14849","BGG","RGR",0,1,1,1,0,"run074"
"14850","BGG","RRR",1,1,2,1,1,"run074"
"14851","BRB","BBB",0,13,13,10,3,"run074"
"14852","BRB","BBR",0,1,1,0,1,"run074"
"14853","BRB","BRR",0,3,3,1,2,"run074"
"14854","BRB","GGG",0,1,1,0,1,"run074"
"14855","BRB","GGR",0,1,1,0,1,"run074"
"14856","BRB","RBB",0,1,1,0,1,"run074"
"14857","BRB","RBG",0,1,1,1,0,"run074"
"14858","BRB","RGR",0,1,1,1,0,"run074"
"14859","BRB","RRR",0,1,1,0,1,"run074"
"14860","BRR","BBB",0,11,11,10,1,"run074"
"14861","BRR","BGB",1,1,2,2,0,"run074"
"14862","BRR","BGG",0,1,1,1,0,"run074"
"14863","BRR","BRB",0,1,1,0,1,"run074"
"14864","BRR","RBB",0,2,2,0,2,"run074"
"14865","GBB","BBB",12,38,50,12,38,"run074"
"14866","GBB","BGG",0,1,1,0,1,"run074"
"14867","GBB","BRB",1,9,10,0,10,"run074"
"14868","GBB","BRR",1,3,4,3,1,"run074"
"14869","GBB","GBG",0,4,4,2,2,"run074"
"14870","GBB","GGB",0,21,21,14,7,"run074"
"14871","GBB","GGG",7,86,93,40,53,"run074"
"14872","GBB","GGR",1,3,4,0,4,"run074"
"14873","GBB","GRG",0,6,6,2,4,"run074"
"14874","GBB","GRR",0,1,1,0,1,"run074"
"14875","GBB","RBB",0,2,2,1,1,"run074"
"14876","GBB","RBG",3,9,12,9,3,"run074"
"14877","GBB","RBR",1,0,1,1,0,"run074"
"14878","GBB","RGG",1,0,1,1,0,"run074"
"14879","GBB","RGR",2,1,3,2,1,"run074"
"14880","GBB","RRG",0,2,2,1,1,"run074"
"14881","GBB","RRR",1,9,10,1,9,"run074"
"14882","GBG","BBB",0,5,5,3,2,"run074"
"14883","GBG","BBR",0,1,1,0,1,"run074"
"14884","GBG","BRB",1,4,5,1,4,"run074"
"14885","GBG","BRR",1,0,1,1,0,"run074"
"14886","GBG","GGB",0,4,4,3,1,"run074"
"14887","GBG","GGG",4,11,15,14,1,"run074"
"14888","GBG","RBB",1,0,1,0,1,"run074"
"14889","GBG","RBG",0,1,1,1,0,"run074"
"14890","GBG","RGG",0,1,1,1,0,"run074"
"14891","GBG","RGR",1,3,4,0,4,"run074"
"14892","GBG","RRG",1,3,4,0,4,"run074"
"14893","GGB","BBB",3,16,19,13,6,"run074"
"14894","GGB","BBR",1,4,5,4,1,"run074"
"14895","GGB","BGB",0,3,3,2,1,"run074"
"14896","GGB","BGG",0,4,4,2,2,"run074"
"14897","GGB","BRB",0,1,1,0,1,"run074"
"14898","GGB","BRR",1,15,16,15,1,"run074"
"14899","GGB","GBB",0,1,1,1,0,"run074"
"14900","GGB","GBG",1,0,1,0,1,"run074"
"14901","GGB","GGG",13,48,61,44,17,"run074"
"14902","GGB","GGR",0,7,7,7,0,"run074"
"14903","GGB","GRR",0,4,4,0,4,"run074"
"14904","GGB","RBB",0,5,5,0,5,"run074"
"14905","GGB","RBG",0,4,4,2,2,"run074"
"14906","GGB","RBR",0,5,5,4,1,"run074"
"14907","GGB","RGG",1,5,6,5,1,"run074"
"14908","GGB","RGR",0,2,2,1,1,"run074"
"14909","GGB","RRG",1,5,6,3,3,"run074"
"14910","GGB","RRR",1,5,6,1,5,"run074"
"14911","GGG","BBB",8,31,39,20,19,"run074"
"14912","GGG","BGB",0,2,2,0,2,"run074"
"14913","GGG","BGG",1,7,8,8,0,"run074"
"14914","GGG","BRB",1,3,4,1,3,"run074"
"14915","GGG","BRR",0,6,6,2,4,"run074"
"14916","GGG","GGB",5,1,6,6,0,"run074"
"14917","GGG","GGR",1,9,10,1,9,"run074"
"14918","GGG","GRR",0,2,2,0,2,"run074"
"14919","GGG","RBB",1,8,9,3,6,"run074"
"14920","GGG","RBG",0,6,6,4,2,"run074"
"14921","GGG","RBR",0,21,21,2,19,"run074"
"14922","GGG","RGG",0,3,3,2,1,"run074"
"14923","GGG","RGR",1,12,13,8,5,"run074"
"14924","GGG","RRG",1,23,24,22,2,"run074"
"14925","GGG","RRR",0,3,3,3,0,"run074"
"14926","GGR","BBB",0,2,2,2,0,"run074"
"14927","GGR","BBR",0,2,2,2,0,"run074"
"14928","GGR","BGG",0,1,1,0,1,"run074"
"14929","GGR","BRR",1,0,1,0,1,"run074"
"14930","GGR","GRR",1,0,1,0,1,"run074"
"14931","GGR","RBB",0,2,2,2,0,"run074"
"14932","GRG","BBB",3,8,11,6,5,"run074"
"14933","GRG","BBR",0,1,1,0,1,"run074"
"14934","GRG","BGG",0,1,1,0,1,"run074"
"14935","GRG","BRB",0,3,3,1,2,"run074"
"14936","GRG","BRR",0,1,1,1,0,"run074"
"14937","GRG","GBG",0,1,1,1,0,"run074"
"14938","GRG","GGB",2,15,17,4,13,"run074"
"14939","GRG","GGG",3,12,15,3,12,"run074"
"14940","GRG","GGR",0,5,5,4,1,"run074"
"14941","GRG","GRR",0,1,1,1,0,"run074"
"14942","GRG","RBG",0,1,1,1,0,"run074"
"14943","GRG","RBR",0,1,1,1,0,"run074"
"14944","GRG","RGR",1,2,3,2,1,"run074"
"14945","GRG","RRG",2,4,6,2,4,"run074"
"14946","GRR","BBB",0,1,1,0,1,"run074"
"14947","GRR","BBR",0,1,1,0,1,"run074"
"14948","GRR","BGB",1,2,3,3,0,"run074"
"14949","GRR","BGG",0,2,2,0,2,"run074"
"14950","GRR","BRB",0,1,1,1,0,"run074"
"14951","GRR","BRR",0,2,2,0,2,"run074"
"14952","GRR","GGG",0,1,1,1,0,"run074"
"14953","GRR","GGR",0,1,1,0,1,"run074"
"14954","RBB","BBB",0,1,1,1,0,"run074"
"14955","RBB","BBR",0,1,1,0,1,"run074"
"14956","RBB","BRB",0,1,1,0,1,"run074"
"14957","RBB","GRR",0,1,1,1,0,"run074"
"14958","RBB","RGG",0,1,1,0,1,"run074"
"14959","RBG","BBB",2,8,10,8,2,"run074"
"14960","RBG","BBG",0,1,1,0,1,"run074"
"14961","RBG","BRR",0,1,1,0,1,"run074"
"14962","RBG","GBB",0,1,1,0,1,"run074"
"14963","RBG","GRR",0,3,3,2,1,"run074"
"14964","RBG","RBB",1,1,2,2,0,"run074"
"14965","RBG","RBR",0,1,1,0,1,"run074"
"14966","RBG","RGR",0,1,1,0,1,"run074"
"14967","RBR","BBB",0,13,13,1,12,"run074"
"14968","RBR","BBR",0,1,1,1,0,"run074"
"14969","RBR","BGB",2,4,6,1,5,"run074"
"14970","RBR","BGG",0,2,2,0,2,"run074"
"14971","RBR","BRB",1,0,1,1,0,"run074"
"14972","RBR","BRR",1,4,5,2,3,"run074"
"14973","RBR","GGB",0,12,12,2,10,"run074"
"14974","RBR","GRR",4,4,8,5,3,"run074"
"14975","RBR","RBB",0,3,3,3,0,"run074"
"14976","RBR","RGG",2,9,11,11,0,"run074"
"14977","RBR","RGR",1,0,1,1,0,"run074"
"14978","RBR","RRR",0,1,1,0,1,"run074"
"14979","RGG","BBB",0,8,8,5,3,"run074"
"14980","RGG","BBR",1,2,3,2,1,"run074"
"14981","RGG","BGB",0,1,1,1,0,"run074"
"14982","RGG","BRR",0,4,4,4,0,"run074"
"14983","RGG","GGG",0,1,1,1,0,"run074"
"14984","RGG","GGR",0,3,3,1,2,"run074"
"14985","RGG","GRR",0,8,8,4,4,"run074"
"14986","RGG","RBB",0,1,1,0,1,"run074"
"14987","RGR","BBB",2,5,7,1,6,"run074"
"14988","RGR","BBR",1,1,2,0,2,"run074"
"14989","RGR","BGB",2,5,7,7,0,"run074"
"14990","RGR","BGG",2,2,4,4,0,"run074"
"14991","RGR","BRR",1,5,6,3,3,"run074"
"14992","RGR","GGB",2,12,14,2,12,"run074"
"14993","RGR","GGG",0,2,2,1,1,"run074"
"14994","RGR","GGR",0,4,4,4,0,"run074"
"14995","RGR","RBB",0,4,4,0,4,"run074"
"14996","RGR","RGG",1,1,2,2,0,"run074"
"14997","RGR","RRG",0,3,3,0,3,"run074"
"14998","RRG","BBB",2,33,35,26,9,"run074"
"14999","RRG","BBR",0,5,5,5,0,"run074"
"15000","RRG","BGB",1,10,11,2,9,"run074"
"15001","RRG","BGG",0,2,2,2,0,"run074"
"15002","RRG","BRB",2,40,42,40,2,"run074"
"15003","RRG","BRR",1,16,17,0,17,"run074"
"15004","RRG","GGG",2,14,16,12,4,"run074"
"15005","RRG","GGR",0,5,5,3,2,"run074"
"15006","RRG","GRG",1,0,1,0,1,"run074"
"15007","RRG","GRR",3,8,11,5,6,"run074"
"15008","RRG","RBB",1,1,2,1,1,"run074"
"15009","RRG","RGG",0,1,1,1,0,"run074"
"15010","RRG","RGR",0,1,1,0,1,"run074"
"15011","RRR","BBR",1,0,1,0,1,"run074"
"15012","RRR","BGB",2,1,3,0,3,"run074"
"15013","RRR","BGG",1,0,1,1,0,"run074"
"15014","RRR","BRB",1,1,2,0,2,"run074"
"15015","RRR","BRR",1,1,2,0,2,"run074"
"15016","RRR","GGR",0,1,1,0,1,"run074"
"15017","RRR","GRR",0,3,3,1,2,"run074"
"15018","RRR","RBB",1,2,3,3,0,"run074"
"15019","RRR","RBR",0,2,2,0,2,"run074"
"15020","RRR","RGG",0,1,1,0,1,"run074"
"15021","RRR","RGR",1,2,3,1,2,"run074"
"15022","RRR","RRG",2,2,4,4,0,"run074"
"15023","BBB","BRB",0,1,1,1,0,"run075"
"15024","BBB","GGG",1,2,3,3,0,"run075"
"15025","BBB","GRR",0,2,2,0,2,"run075"
"15026","BBB","RBG",0,1,1,0,1,"run075"
"15027","BBB","RRG",1,3,4,0,4,"run075"
"15028","BBB","RRR",0,2,2,2,0,"run075"
"15029","BBG","BBB",1,4,5,2,3,"run075"
"15030","BBG","BGB",0,1,1,1,0,"run075"
"15031","BBG","BGG",0,1,1,0,1,"run075"
"15032","BBG","BRB",1,16,17,15,2,"run075"
"15033","BBG","GBB",0,1,1,1,0,"run075"
"15034","BBG","GBG",2,7,9,4,5,"run075"
"15035","BBG","GGB",2,25,27,0,27,"run075"
"15036","BBG","GGG",4,38,42,34,8,"run075"
"15037","BBG","GRG",1,9,10,2,8,"run075"
"15038","BBG","GRR",0,1,1,0,1,"run075"
"15039","BBG","RBB",0,1,1,0,1,"run075"
"15040","BBG","RBG",0,4,4,1,3,"run075"
"15041","BBG","RBR",0,1,1,1,0,"run075"
"15042","BBG","RGR",0,1,1,1,0,"run075"
"15043","BBG","RRG",1,2,3,3,0,"run075"
"15044","BBG","RRR",0,7,7,3,4,"run075"
"15045","BGB","BBB",0,2,2,0,2,"run075"
"15046","BGB","RRG",0,1,1,0,1,"run075"
"15047","BGG","BBB",0,3,3,2,1,"run075"
"15048","BGG","BBR",0,1,1,1,0,"run075"
"15049","BGG","GRG",0,1,1,0,1,"run075"
"15050","BGG","RBG",1,1,2,2,0,"run075"
"15051","BGG","RGG",0,3,3,3,0,"run075"
"15052","BGG","RGR",0,1,1,0,1,"run075"
"15053","BGG","RRR",1,1,2,2,0,"run075"
"15054","BRB","BBB",0,13,13,5,8,"run075"
"15055","BRB","BBR",0,1,1,1,0,"run075"
"15056","BRB","BRR",0,3,3,0,3,"run075"
"15057","BRB","GGG",0,1,1,0,1,"run075"
"15058","BRB","GGR",0,1,1,1,0,"run075"
"15059","BRB","RBB",0,1,1,1,0,"run075"
"15060","BRB","RBG",0,1,1,0,1,"run075"
"15061","BRB","RGR",0,1,1,1,0,"run075"
"15062","BRB","RRR",0,1,1,0,1,"run075"
"15063","BRR","BBB",0,11,11,4,7,"run075"
"15064","BRR","BGB",1,1,2,1,1,"run075"
"15065","BRR","BGG",0,1,1,0,1,"run075"
"15066","BRR","BRB",0,1,1,1,0,"run075"
"15067","BRR","RBB",0,2,2,0,2,"run075"
"15068","GBB","BBB",12,38,50,11,39,"run075"
"15069","GBB","BGG",0,1,1,0,1,"run075"
"15070","GBB","BRB",1,9,10,0,10,"run075"
"15071","GBB","BRR",1,3,4,1,3,"run075"
"15072","GBB","GBG",0,4,4,3,1,"run075"
"15073","GBB","GGB",0,21,21,19,2,"run075"
"15074","GBB","GGG",7,86,93,1,92,"run075"
"15075","GBB","GGR",1,3,4,1,3,"run075"
"15076","GBB","GRG",0,6,6,5,1,"run075"
"15077","GBB","GRR",0,1,1,0,1,"run075"
"15078","GBB","RBB",0,2,2,2,0,"run075"
"15079","GBB","RBG",3,9,12,7,5,"run075"
"15080","GBB","RBR",1,0,1,1,0,"run075"
"15081","GBB","RGG",1,0,1,1,0,"run075"
"15082","GBB","RGR",2,1,3,0,3,"run075"
"15083","GBB","RRG",0,2,2,2,0,"run075"
"15084","GBB","RRR",1,9,10,1,9,"run075"
"15085","GBG","BBB",0,5,5,5,0,"run075"
"15086","GBG","BBR",0,1,1,0,1,"run075"
"15087","GBG","BRB",1,4,5,5,0,"run075"
"15088","GBG","BRR",1,0,1,1,0,"run075"
"15089","GBG","GGB",0,4,4,3,1,"run075"
"15090","GBG","GGG",4,11,15,15,0,"run075"
"15091","GBG","RBB",1,0,1,0,1,"run075"
"15092","GBG","RBG",0,1,1,0,1,"run075"
"15093","GBG","RGG",0,1,1,1,0,"run075"
"15094","GBG","RGR",1,3,4,0,4,"run075"
"15095","GBG","RRG",1,3,4,4,0,"run075"
"15096","GGB","BBB",3,16,19,9,10,"run075"
"15097","GGB","BBR",1,4,5,5,0,"run075"
"15098","GGB","BGB",0,3,3,0,3,"run075"
"15099","GGB","BGG",0,4,4,1,3,"run075"
"15100","GGB","BRB",0,1,1,1,0,"run075"
"15101","GGB","BRR",1,15,16,0,16,"run075"
"15102","GGB","GBB",0,1,1,1,0,"run075"
"15103","GGB","GBG",1,0,1,1,0,"run075"
"15104","GGB","GGG",13,48,61,34,27,"run075"
"15105","GGB","GGR",0,7,7,0,7,"run075"
"15106","GGB","GRR",0,4,4,0,4,"run075"
"15107","GGB","RBB",0,5,5,1,4,"run075"
"15108","GGB","RBG",0,4,4,4,0,"run075"
"15109","GGB","RBR",0,5,5,4,1,"run075"
"15110","GGB","RGG",1,5,6,0,6,"run075"
"15111","GGB","RGR",0,2,2,0,2,"run075"
"15112","GGB","RRG",1,5,6,0,6,"run075"
"15113","GGB","RRR",1,5,6,2,4,"run075"
"15114","GGG","BBB",8,31,39,23,16,"run075"
"15115","GGG","BGB",0,2,2,0,2,"run075"
"15116","GGG","BGG",1,7,8,4,4,"run075"
"15117","GGG","BRB",1,3,4,4,0,"run075"
"15118","GGG","BRR",0,6,6,0,6,"run075"
"15119","GGG","GGB",5,1,6,3,3,"run075"
"15120","GGG","GGR",1,9,10,5,5,"run075"
"15121","GGG","GRR",0,2,2,0,2,"run075"
"15122","GGG","RBB",1,8,9,6,3,"run075"
"15123","GGG","RBG",0,6,6,2,4,"run075"
"15124","GGG","RBR",0,21,21,13,8,"run075"
"15125","GGG","RGG",0,3,3,0,3,"run075"
"15126","GGG","RGR",1,12,13,11,2,"run075"
"15127","GGG","RRG",1,23,24,15,9,"run075"
"15128","GGG","RRR",0,3,3,2,1,"run075"
"15129","GGR","BBB",0,2,2,2,0,"run075"
"15130","GGR","BBR",0,2,2,1,1,"run075"
"15131","GGR","BGG",0,1,1,1,0,"run075"
"15132","GGR","BRR",1,0,1,1,0,"run075"
"15133","GGR","GRR",1,0,1,0,1,"run075"
"15134","GGR","RBB",0,2,2,0,2,"run075"
"15135","GRG","BBB",3,8,11,11,0,"run075"
"15136","GRG","BBR",0,1,1,0,1,"run075"
"15137","GRG","BGG",0,1,1,0,1,"run075"
"15138","GRG","BRB",0,3,3,0,3,"run075"
"15139","GRG","BRR",0,1,1,0,1,"run075"
"15140","GRG","GBG",0,1,1,1,0,"run075"
"15141","GRG","GGB",2,15,17,5,12,"run075"
"15142","GRG","GGG",3,12,15,7,8,"run075"
"15143","GRG","GGR",0,5,5,5,0,"run075"
"15144","GRG","GRR",0,1,1,0,1,"run075"
"15145","GRG","RBG",0,1,1,1,0,"run075"
"15146","GRG","RBR",0,1,1,1,0,"run075"
"15147","GRG","RGR",1,2,3,3,0,"run075"
"15148","GRG","RRG",2,4,6,2,4,"run075"
"15149","GRR","BBB",0,1,1,0,1,"run075"
"15150","GRR","BBR",0,1,1,1,0,"run075"
"15151","GRR","BGB",1,2,3,3,0,"run075"
"15152","GRR","BGG",0,2,2,0,2,"run075"
"15153","GRR","BRB",0,1,1,1,0,"run075"
"15154","GRR","BRR",0,2,2,0,2,"run075"
"15155","GRR","GGG",0,1,1,0,1,"run075"
"15156","GRR","GGR",0,1,1,0,1,"run075"
"15157","RBB","BBB",0,1,1,0,1,"run075"
"15158","RBB","BBR",0,1,1,0,1,"run075"
"15159","RBB","BRB",0,1,1,1,0,"run075"
"15160","RBB","GRR",0,1,1,0,1,"run075"
"15161","RBB","RGG",0,1,1,1,0,"run075"
"15162","RBG","BBB",2,8,10,0,10,"run075"
"15163","RBG","BBG",0,1,1,0,1,"run075"
"15164","RBG","BRR",0,1,1,0,1,"run075"
"15165","RBG","GBB",0,1,1,1,0,"run075"
"15166","RBG","GRR",0,3,3,0,3,"run075"
"15167","RBG","RBB",1,1,2,2,0,"run075"
"15168","RBG","RBR",0,1,1,1,0,"run075"
"15169","RBG","RGR",0,1,1,0,1,"run075"
"15170","RBR","BBB",0,13,13,0,13,"run075"
"15171","RBR","BBR",0,1,1,0,1,"run075"
"15172","RBR","BGB",2,4,6,2,4,"run075"
"15173","RBR","BGG",0,2,2,1,1,"run075"
"15174","RBR","BRB",1,0,1,1,0,"run075"
"15175","RBR","BRR",1,4,5,2,3,"run075"
"15176","RBR","GGB",0,12,12,9,3,"run075"
"15177","RBR","GRR",4,4,8,6,2,"run075"
"15178","RBR","RBB",0,3,3,3,0,"run075"
"15179","RBR","RGG",2,9,11,7,4,"run075"
"15180","RBR","RGR",1,0,1,1,0,"run075"
"15181","RBR","RRR",0,1,1,1,0,"run075"
"15182","RGG","BBB",0,8,8,5,3,"run075"
"15183","RGG","BBR",1,2,3,0,3,"run075"
"15184","RGG","BGB",0,1,1,1,0,"run075"
"15185","RGG","BRR",0,4,4,4,0,"run075"
"15186","RGG","GGG",0,1,1,1,0,"run075"
"15187","RGG","GGR",0,3,3,2,1,"run075"
"15188","RGG","GRR",0,8,8,7,1,"run075"
"15189","RGG","RBB",0,1,1,0,1,"run075"
"15190","RGR","BBB",2,5,7,4,3,"run075"
"15191","RGR","BBR",1,1,2,2,0,"run075"
"15192","RGR","BGB",2,5,7,6,1,"run075"
"15193","RGR","BGG",2,2,4,3,1,"run075"
"15194","RGR","BRR",1,5,6,4,2,"run075"
"15195","RGR","GGB",2,12,14,5,9,"run075"
"15196","RGR","GGG",0,2,2,1,1,"run075"
"15197","RGR","GGR",0,4,4,0,4,"run075"
"15198","RGR","RBB",0,4,4,3,1,"run075"
"15199","RGR","RGG",1,1,2,0,2,"run075"
"15200","RGR","RRG",0,3,3,3,0,"run075"
"15201","RRG","BBB",2,33,35,14,21,"run075"
"15202","RRG","BBR",0,5,5,2,3,"run075"
"15203","RRG","BGB",1,10,11,7,4,"run075"
"15204","RRG","BGG",0,2,2,0,2,"run075"
"15205","RRG","BRB",2,40,42,42,0,"run075"
"15206","RRG","BRR",1,16,17,6,11,"run075"
"15207","RRG","GGG",2,14,16,3,13,"run075"
"15208","RRG","GGR",0,5,5,0,5,"run075"
"15209","RRG","GRG",1,0,1,1,0,"run075"
"15210","RRG","GRR",3,8,11,5,6,"run075"
"15211","RRG","RBB",1,1,2,1,1,"run075"
"15212","RRG","RGG",0,1,1,1,0,"run075"
"15213","RRG","RGR",0,1,1,0,1,"run075"
"15214","RRR","BBR",1,0,1,0,1,"run075"
"15215","RRR","BGB",2,1,3,0,3,"run075"
"15216","RRR","BGG",1,0,1,1,0,"run075"
"15217","RRR","BRB",1,1,2,1,1,"run075"
"15218","RRR","BRR",1,1,2,1,1,"run075"
"15219","RRR","GGR",0,1,1,0,1,"run075"
"15220","RRR","GRR",0,3,3,1,2,"run075"
"15221","RRR","RBB",1,2,3,1,2,"run075"
"15222","RRR","RBR",0,2,2,0,2,"run075"
"15223","RRR","RGG",0,1,1,1,0,"run075"
"15224","RRR","RGR",1,2,3,1,2,"run075"
"15225","RRR","RRG",2,2,4,2,2,"run075"
"15226","BBB","BRB",0,1,1,0,1,"run076"
"15227","BBB","GGG",1,2,3,0,3,"run076"
"15228","BBB","GRR",0,2,2,0,2,"run076"
"15229","BBB","RBG",0,1,1,1,0,"run076"
"15230","BBB","RRG",1,3,4,1,3,"run076"
"15231","BBB","RRR",0,2,2,1,1,"run076"
"15232","BBG","BBB",1,4,5,3,2,"run076"
"15233","BBG","BGB",0,1,1,0,1,"run076"
"15234","BBG","BGG",0,1,1,1,0,"run076"
"15235","BBG","BRB",1,16,17,5,12,"run076"
"15236","BBG","GBB",0,1,1,1,0,"run076"
"15237","BBG","GBG",2,7,9,9,0,"run076"
"15238","BBG","GGB",2,25,27,23,4,"run076"
"15239","BBG","GGG",4,38,42,13,29,"run076"
"15240","BBG","GRG",1,9,10,5,5,"run076"
"15241","BBG","GRR",0,1,1,1,0,"run076"
"15242","BBG","RBB",0,1,1,1,0,"run076"
"15243","BBG","RBG",0,4,4,2,2,"run076"
"15244","BBG","RBR",0,1,1,0,1,"run076"
"15245","BBG","RGR",0,1,1,1,0,"run076"
"15246","BBG","RRG",1,2,3,0,3,"run076"
"15247","BBG","RRR",0,7,7,4,3,"run076"
"15248","BGB","BBB",0,2,2,0,2,"run076"
"15249","BGB","RRG",0,1,1,0,1,"run076"
"15250","BGG","BBB",0,3,3,1,2,"run076"
"15251","BGG","BBR",0,1,1,1,0,"run076"
"15252","BGG","GRG",0,1,1,1,0,"run076"
"15253","BGG","RBG",1,1,2,0,2,"run076"
"15254","BGG","RGG",0,3,3,0,3,"run076"
"15255","BGG","RGR",0,1,1,0,1,"run076"
"15256","BGG","RRR",1,1,2,1,1,"run076"
"15257","BRB","BBB",0,13,13,6,7,"run076"
"15258","BRB","BBR",0,1,1,1,0,"run076"
"15259","BRB","BRR",0,3,3,2,1,"run076"
"15260","BRB","GGG",0,1,1,1,0,"run076"
"15261","BRB","GGR",0,1,1,0,1,"run076"
"15262","BRB","RBB",0,1,1,0,1,"run076"
"15263","BRB","RBG",0,1,1,1,0,"run076"
"15264","BRB","RGR",0,1,1,1,0,"run076"
"15265","BRB","RRR",0,1,1,1,0,"run076"
"15266","BRR","BBB",0,11,11,0,11,"run076"
"15267","BRR","BGB",1,1,2,0,2,"run076"
"15268","BRR","BGG",0,1,1,1,0,"run076"
"15269","BRR","BRB",0,1,1,0,1,"run076"
"15270","BRR","RBB",0,2,2,2,0,"run076"
"15271","GBB","BBB",12,38,50,47,3,"run076"
"15272","GBB","BGG",0,1,1,1,0,"run076"
"15273","GBB","BRB",1,9,10,5,5,"run076"
"15274","GBB","BRR",1,3,4,4,0,"run076"
"15275","GBB","GBG",0,4,4,1,3,"run076"
"15276","GBB","GGB",0,21,21,3,18,"run076"
"15277","GBB","GGG",7,86,93,10,83,"run076"
"15278","GBB","GGR",1,3,4,1,3,"run076"
"15279","GBB","GRG",0,6,6,1,5,"run076"
"15280","GBB","GRR",0,1,1,1,0,"run076"
"15281","GBB","RBB",0,2,2,2,0,"run076"
"15282","GBB","RBG",3,9,12,4,8,"run076"
"15283","GBB","RBR",1,0,1,0,1,"run076"
"15284","GBB","RGG",1,0,1,1,0,"run076"
"15285","GBB","RGR",2,1,3,3,0,"run076"
"15286","GBB","RRG",0,2,2,1,1,"run076"
"15287","GBB","RRR",1,9,10,10,0,"run076"
"15288","GBG","BBB",0,5,5,2,3,"run076"
"15289","GBG","BBR",0,1,1,0,1,"run076"
"15290","GBG","BRB",1,4,5,4,1,"run076"
"15291","GBG","BRR",1,0,1,1,0,"run076"
"15292","GBG","GGB",0,4,4,4,0,"run076"
"15293","GBG","GGG",4,11,15,15,0,"run076"
"15294","GBG","RBB",1,0,1,0,1,"run076"
"15295","GBG","RBG",0,1,1,0,1,"run076"
"15296","GBG","RGG",0,1,1,0,1,"run076"
"15297","GBG","RGR",1,3,4,4,0,"run076"
"15298","GBG","RRG",1,3,4,4,0,"run076"
"15299","GGB","BBB",3,16,19,10,9,"run076"
"15300","GGB","BBR",1,4,5,2,3,"run076"
"15301","GGB","BGB",0,3,3,0,3,"run076"
"15302","GGB","BGG",0,4,4,3,1,"run076"
"15303","GGB","BRB",0,1,1,0,1,"run076"
"15304","GGB","BRR",1,15,16,2,14,"run076"
"15305","GGB","GBB",0,1,1,1,0,"run076"
"15306","GGB","GBG",1,0,1,1,0,"run076"
"15307","GGB","GGG",13,48,61,10,51,"run076"
"15308","GGB","GGR",0,7,7,6,1,"run076"
"15309","GGB","GRR",0,4,4,2,2,"run076"
"15310","GGB","RBB",0,5,5,0,5,"run076"
"15311","GGB","RBG",0,4,4,4,0,"run076"
"15312","GGB","RBR",0,5,5,1,4,"run076"
"15313","GGB","RGG",1,5,6,1,5,"run076"
"15314","GGB","RGR",0,2,2,0,2,"run076"
"15315","GGB","RRG",1,5,6,4,2,"run076"
"15316","GGB","RRR",1,5,6,5,1,"run076"
"15317","GGG","BBB",8,31,39,7,32,"run076"
"15318","GGG","BGB",0,2,2,2,0,"run076"
"15319","GGG","BGG",1,7,8,3,5,"run076"
"15320","GGG","BRB",1,3,4,2,2,"run076"
"15321","GGG","BRR",0,6,6,4,2,"run076"
"15322","GGG","GGB",5,1,6,0,6,"run076"
"15323","GGG","GGR",1,9,10,9,1,"run076"
"15324","GGG","GRR",0,2,2,2,0,"run076"
"15325","GGG","RBB",1,8,9,8,1,"run076"
"15326","GGG","RBG",0,6,6,1,5,"run076"
"15327","GGG","RBR",0,21,21,2,19,"run076"
"15328","GGG","RGG",0,3,3,3,0,"run076"
"15329","GGG","RGR",1,12,13,5,8,"run076"
"15330","GGG","RRG",1,23,24,6,18,"run076"
"15331","GGG","RRR",0,3,3,1,2,"run076"
"15332","GGR","BBB",0,2,2,2,0,"run076"
"15333","GGR","BBR",0,2,2,2,0,"run076"
"15334","GGR","BGG",0,1,1,1,0,"run076"
"15335","GGR","BRR",1,0,1,0,1,"run076"
"15336","GGR","GRR",1,0,1,1,0,"run076"
"15337","GGR","RBB",0,2,2,2,0,"run076"
"15338","GRG","BBB",3,8,11,7,4,"run076"
"15339","GRG","BBR",0,1,1,0,1,"run076"
"15340","GRG","BGG",0,1,1,1,0,"run076"
"15341","GRG","BRB",0,3,3,2,1,"run076"
"15342","GRG","BRR",0,1,1,1,0,"run076"
"15343","GRG","GBG",0,1,1,0,1,"run076"
"15344","GRG","GGB",2,15,17,6,11,"run076"
"15345","GRG","GGG",3,12,15,15,0,"run076"
"15346","GRG","GGR",0,5,5,0,5,"run076"
"15347","GRG","GRR",0,1,1,1,0,"run076"
"15348","GRG","RBG",0,1,1,1,0,"run076"
"15349","GRG","RBR",0,1,1,0,1,"run076"
"15350","GRG","RGR",1,2,3,3,0,"run076"
"15351","GRG","RRG",2,4,6,4,2,"run076"
"15352","GRR","BBB",0,1,1,1,0,"run076"
"15353","GRR","BBR",0,1,1,0,1,"run076"
"15354","GRR","BGB",1,2,3,0,3,"run076"
"15355","GRR","BGG",0,2,2,0,2,"run076"
"15356","GRR","BRB",0,1,1,0,1,"run076"
"15357","GRR","BRR",0,2,2,0,2,"run076"
"15358","GRR","GGG",0,1,1,0,1,"run076"
"15359","GRR","GGR",0,1,1,0,1,"run076"
"15360","RBB","BBB",0,1,1,0,1,"run076"
"15361","RBB","BBR",0,1,1,1,0,"run076"
"15362","RBB","BRB",0,1,1,1,0,"run076"
"15363","RBB","GRR",0,1,1,0,1,"run076"
"15364","RBB","RGG",0,1,1,0,1,"run076"
"15365","RBG","BBB",2,8,10,4,6,"run076"
"15366","RBG","BBG",0,1,1,1,0,"run076"
"15367","RBG","BRR",0,1,1,0,1,"run076"
"15368","RBG","GBB",0,1,1,1,0,"run076"
"15369","RBG","GRR",0,3,3,0,3,"run076"
"15370","RBG","RBB",1,1,2,2,0,"run076"
"15371","RBG","RBR",0,1,1,1,0,"run076"
"15372","RBG","RGR",0,1,1,1,0,"run076"
"15373","RBR","BBB",0,13,13,3,10,"run076"
"15374","RBR","BBR",0,1,1,1,0,"run076"
"15375","RBR","BGB",2,4,6,0,6,"run076"
"15376","RBR","BGG",0,2,2,1,1,"run076"
"15377","RBR","BRB",1,0,1,1,0,"run076"
"15378","RBR","BRR",1,4,5,5,0,"run076"
"15379","RBR","GGB",0,12,12,8,4,"run076"
"15380","RBR","GRR",4,4,8,5,3,"run076"
"15381","RBR","RBB",0,3,3,1,2,"run076"
"15382","RBR","RGG",2,9,11,8,3,"run076"
"15383","RBR","RGR",1,0,1,1,0,"run076"
"15384","RBR","RRR",0,1,1,0,1,"run076"
"15385","RGG","BBB",0,8,8,7,1,"run076"
"15386","RGG","BBR",1,2,3,0,3,"run076"
"15387","RGG","BGB",0,1,1,0,1,"run076"
"15388","RGG","BRR",0,4,4,4,0,"run076"
"15389","RGG","GGG",0,1,1,1,0,"run076"
"15390","RGG","GGR",0,3,3,3,0,"run076"
"15391","RGG","GRR",0,8,8,2,6,"run076"
"15392","RGG","RBB",0,1,1,1,0,"run076"
"15393","RGR","BBB",2,5,7,2,5,"run076"
"15394","RGR","BBR",1,1,2,2,0,"run076"
"15395","RGR","BGB",2,5,7,1,6,"run076"
"15396","RGR","BGG",2,2,4,0,4,"run076"
"15397","RGR","BRR",1,5,6,3,3,"run076"
"15398","RGR","GGB",2,12,14,10,4,"run076"
"15399","RGR","GGG",0,2,2,1,1,"run076"
"15400","RGR","GGR",0,4,4,2,2,"run076"
"15401","RGR","RBB",0,4,4,1,3,"run076"
"15402","RGR","RGG",1,1,2,0,2,"run076"
"15403","RGR","RRG",0,3,3,2,1,"run076"
"15404","RRG","BBB",2,33,35,4,31,"run076"
"15405","RRG","BBR",0,5,5,1,4,"run076"
"15406","RRG","BGB",1,10,11,1,10,"run076"
"15407","RRG","BGG",0,2,2,0,2,"run076"
"15408","RRG","BRB",2,40,42,7,35,"run076"
"15409","RRG","BRR",1,16,17,4,13,"run076"
"15410","RRG","GGG",2,14,16,2,14,"run076"
"15411","RRG","GGR",0,5,5,3,2,"run076"
"15412","RRG","GRG",1,0,1,1,0,"run076"
"15413","RRG","GRR",3,8,11,2,9,"run076"
"15414","RRG","RBB",1,1,2,1,1,"run076"
"15415","RRG","RGG",0,1,1,1,0,"run076"
"15416","RRG","RGR",0,1,1,0,1,"run076"
"15417","RRR","BBR",1,0,1,1,0,"run076"
"15418","RRR","BGB",2,1,3,2,1,"run076"
"15419","RRR","BGG",1,0,1,1,0,"run076"
"15420","RRR","BRB",1,1,2,0,2,"run076"
"15421","RRR","BRR",1,1,2,1,1,"run076"
"15422","RRR","GGR",0,1,1,1,0,"run076"
"15423","RRR","GRR",0,3,3,2,1,"run076"
"15424","RRR","RBB",1,2,3,3,0,"run076"
"15425","RRR","RBR",0,2,2,0,2,"run076"
"15426","RRR","RGG",0,1,1,0,1,"run076"
"15427","RRR","RGR",1,2,3,2,1,"run076"
"15428","RRR","RRG",2,2,4,4,0,"run076"
"15429","BBB","BRB",0,1,1,1,0,"run077"
"15430","BBB","GGG",1,2,3,0,3,"run077"
"15431","BBB","GRR",0,2,2,0,2,"run077"
"15432","BBB","RBG",0,1,1,0,1,"run077"
"15433","BBB","RRG",1,3,4,4,0,"run077"
"15434","BBB","RRR",0,2,2,0,2,"run077"
"15435","BBG","BBB",1,4,5,5,0,"run077"
"15436","BBG","BGB",0,1,1,1,0,"run077"
"15437","BBG","BGG",0,1,1,1,0,"run077"
"15438","BBG","BRB",1,16,17,1,16,"run077"
"15439","BBG","GBB",0,1,1,1,0,"run077"
"15440","BBG","GBG",2,7,9,8,1,"run077"
"15441","BBG","GGB",2,25,27,11,16,"run077"
"15442","BBG","GGG",4,38,42,24,18,"run077"
"15443","BBG","GRG",1,9,10,0,10,"run077"
"15444","BBG","GRR",0,1,1,0,1,"run077"
"15445","BBG","RBB",0,1,1,0,1,"run077"
"15446","BBG","RBG",0,4,4,2,2,"run077"
"15447","BBG","RBR",0,1,1,0,1,"run077"
"15448","BBG","RGR",0,1,1,0,1,"run077"
"15449","BBG","RRG",1,2,3,1,2,"run077"
"15450","BBG","RRR",0,7,7,7,0,"run077"
"15451","BGB","BBB",0,2,2,2,0,"run077"
"15452","BGB","RRG",0,1,1,0,1,"run077"
"15453","BGG","BBB",0,3,3,2,1,"run077"
"15454","BGG","BBR",0,1,1,1,0,"run077"
"15455","BGG","GRG",0,1,1,0,1,"run077"
"15456","BGG","RBG",1,1,2,1,1,"run077"
"15457","BGG","RGG",0,3,3,2,1,"run077"
"15458","BGG","RGR",0,1,1,0,1,"run077"
"15459","BGG","RRR",1,1,2,0,2,"run077"
"15460","BRB","BBB",0,13,13,3,10,"run077"
"15461","BRB","BBR",0,1,1,0,1,"run077"
"15462","BRB","BRR",0,3,3,0,3,"run077"
"15463","BRB","GGG",0,1,1,0,1,"run077"
"15464","BRB","GGR",0,1,1,1,0,"run077"
"15465","BRB","RBB",0,1,1,0,1,"run077"
"15466","BRB","RBG",0,1,1,1,0,"run077"
"15467","BRB","RGR",0,1,1,0,1,"run077"
"15468","BRB","RRR",0,1,1,1,0,"run077"
"15469","BRR","BBB",0,11,11,7,4,"run077"
"15470","BRR","BGB",1,1,2,1,1,"run077"
"15471","BRR","BGG",0,1,1,0,1,"run077"
"15472","BRR","BRB",0,1,1,0,1,"run077"
"15473","BRR","RBB",0,2,2,2,0,"run077"
"15474","GBB","BBB",12,38,50,15,35,"run077"
"15475","GBB","BGG",0,1,1,0,1,"run077"
"15476","GBB","BRB",1,9,10,8,2,"run077"
"15477","GBB","BRR",1,3,4,1,3,"run077"
"15478","GBB","GBG",0,4,4,2,2,"run077"
"15479","GBB","GGB",0,21,21,21,0,"run077"
"15480","GBB","GGG",7,86,93,25,68,"run077"
"15481","GBB","GGR",1,3,4,4,0,"run077"
"15482","GBB","GRG",0,6,6,2,4,"run077"
"15483","GBB","GRR",0,1,1,1,0,"run077"
"15484","GBB","RBB",0,2,2,0,2,"run077"
"15485","GBB","RBG",3,9,12,0,12,"run077"
"15486","GBB","RBR",1,0,1,1,0,"run077"
"15487","GBB","RGG",1,0,1,0,1,"run077"
"15488","GBB","RGR",2,1,3,1,2,"run077"
"15489","GBB","RRG",0,2,2,2,0,"run077"
"15490","GBB","RRR",1,9,10,6,4,"run077"
"15491","GBG","BBB",0,5,5,5,0,"run077"
"15492","GBG","BBR",0,1,1,0,1,"run077"
"15493","GBG","BRB",1,4,5,1,4,"run077"
"15494","GBG","BRR",1,0,1,0,1,"run077"
"15495","GBG","GGB",0,4,4,1,3,"run077"
"15496","GBG","GGG",4,11,15,2,13,"run077"
"15497","GBG","RBB",1,0,1,0,1,"run077"
"15498","GBG","RBG",0,1,1,0,1,"run077"
"15499","GBG","RGG",0,1,1,1,0,"run077"
"15500","GBG","RGR",1,3,4,4,0,"run077"
"15501","GBG","RRG",1,3,4,4,0,"run077"
"15502","GGB","BBB",3,16,19,19,0,"run077"
"15503","GGB","BBR",1,4,5,2,3,"run077"
"15504","GGB","BGB",0,3,3,1,2,"run077"
"15505","GGB","BGG",0,4,4,0,4,"run077"
"15506","GGB","BRB",0,1,1,1,0,"run077"
"15507","GGB","BRR",1,15,16,3,13,"run077"
"15508","GGB","GBB",0,1,1,1,0,"run077"
"15509","GGB","GBG",1,0,1,0,1,"run077"
"15510","GGB","GGG",13,48,61,54,7,"run077"
"15511","GGB","GGR",0,7,7,4,3,"run077"
"15512","GGB","GRR",0,4,4,2,2,"run077"
"15513","GGB","RBB",0,5,5,1,4,"run077"
"15514","GGB","RBG",0,4,4,0,4,"run077"
"15515","GGB","RBR",0,5,5,4,1,"run077"
"15516","GGB","RGG",1,5,6,1,5,"run077"
"15517","GGB","RGR",0,2,2,0,2,"run077"
"15518","GGB","RRG",1,5,6,6,0,"run077"
"15519","GGB","RRR",1,5,6,6,0,"run077"
"15520","GGG","BBB",8,31,39,25,14,"run077"
"15521","GGG","BGB",0,2,2,1,1,"run077"
"15522","GGG","BGG",1,7,8,8,0,"run077"
"15523","GGG","BRB",1,3,4,0,4,"run077"
"15524","GGG","BRR",0,6,6,2,4,"run077"
"15525","GGG","GGB",5,1,6,3,3,"run077"
"15526","GGG","GGR",1,9,10,3,7,"run077"
"15527","GGG","GRR",0,2,2,1,1,"run077"
"15528","GGG","RBB",1,8,9,4,5,"run077"
"15529","GGG","RBG",0,6,6,1,5,"run077"
"15530","GGG","RBR",0,21,21,10,11,"run077"
"15531","GGG","RGG",0,3,3,1,2,"run077"
"15532","GGG","RGR",1,12,13,10,3,"run077"
"15533","GGG","RRG",1,23,24,6,18,"run077"
"15534","GGG","RRR",0,3,3,3,0,"run077"
"15535","GGR","BBB",0,2,2,0,2,"run077"
"15536","GGR","BBR",0,2,2,2,0,"run077"
"15537","GGR","BGG",0,1,1,1,0,"run077"
"15538","GGR","BRR",1,0,1,0,1,"run077"
"15539","GGR","GRR",1,0,1,0,1,"run077"
"15540","GGR","RBB",0,2,2,0,2,"run077"
"15541","GRG","BBB",3,8,11,0,11,"run077"
"15542","GRG","BBR",0,1,1,1,0,"run077"
"15543","GRG","BGG",0,1,1,0,1,"run077"
"15544","GRG","BRB",0,3,3,1,2,"run077"
"15545","GRG","BRR",0,1,1,0,1,"run077"
"15546","GRG","GBG",0,1,1,1,0,"run077"
"15547","GRG","GGB",2,15,17,9,8,"run077"
"15548","GRG","GGG",3,12,15,14,1,"run077"
"15549","GRG","GGR",0,5,5,3,2,"run077"
"15550","GRG","GRR",0,1,1,0,1,"run077"
"15551","GRG","RBG",0,1,1,1,0,"run077"
"15552","GRG","RBR",0,1,1,1,0,"run077"
"15553","GRG","RGR",1,2,3,0,3,"run077"
"15554","GRG","RRG",2,4,6,5,1,"run077"
"15555","GRR","BBB",0,1,1,0,1,"run077"
"15556","GRR","BBR",0,1,1,0,1,"run077"
"15557","GRR","BGB",1,2,3,0,3,"run077"
"15558","GRR","BGG",0,2,2,2,0,"run077"
"15559","GRR","BRB",0,1,1,1,0,"run077"
"15560","GRR","BRR",0,2,2,0,2,"run077"
"15561","GRR","GGG",0,1,1,1,0,"run077"
"15562","GRR","GGR",0,1,1,1,0,"run077"
"15563","RBB","BBB",0,1,1,1,0,"run077"
"15564","RBB","BBR",0,1,1,0,1,"run077"
"15565","RBB","BRB",0,1,1,1,0,"run077"
"15566","RBB","GRR",0,1,1,0,1,"run077"
"15567","RBB","RGG",0,1,1,0,1,"run077"
"15568","RBG","BBB",2,8,10,8,2,"run077"
"15569","RBG","BBG",0,1,1,1,0,"run077"
"15570","RBG","BRR",0,1,1,0,1,"run077"
"15571","RBG","GBB",0,1,1,0,1,"run077"
"15572","RBG","GRR",0,3,3,0,3,"run077"
"15573","RBG","RBB",1,1,2,2,0,"run077"
"15574","RBG","RBR",0,1,1,0,1,"run077"
"15575","RBG","RGR",0,1,1,0,1,"run077"
"15576","RBR","BBB",0,13,13,13,0,"run077"
"15577","RBR","BBR",0,1,1,0,1,"run077"
"15578","RBR","BGB",2,4,6,1,5,"run077"
"15579","RBR","BGG",0,2,2,1,1,"run077"
"15580","RBR","BRB",1,0,1,1,0,"run077"
"15581","RBR","BRR",1,4,5,0,5,"run077"
"15582","RBR","GGB",0,12,12,3,9,"run077"
"15583","RBR","GRR",4,4,8,7,1,"run077"
"15584","RBR","RBB",0,3,3,3,0,"run077"
"15585","RBR","RGG",2,9,11,5,6,"run077"
"15586","RBR","RGR",1,0,1,0,1,"run077"
"15587","RBR","RRR",0,1,1,0,1,"run077"
"15588","RGG","BBB",0,8,8,5,3,"run077"
"15589","RGG","BBR",1,2,3,0,3,"run077"
"15590","RGG","BGB",0,1,1,0,1,"run077"
"15591","RGG","BRR",0,4,4,4,0,"run077"
"15592","RGG","GGG",0,1,1,1,0,"run077"
"15593","RGG","GGR",0,3,3,0,3,"run077"
"15594","RGG","GRR",0,8,8,7,1,"run077"
"15595","RGG","RBB",0,1,1,0,1,"run077"
"15596","RGR","BBB",2,5,7,3,4,"run077"
"15597","RGR","BBR",1,1,2,0,2,"run077"
"15598","RGR","BGB",2,5,7,7,0,"run077"
"15599","RGR","BGG",2,2,4,0,4,"run077"
"15600","RGR","BRR",1,5,6,4,2,"run077"
"15601","RGR","GGB",2,12,14,14,0,"run077"
"15602","RGR","GGG",0,2,2,2,0,"run077"
"15603","RGR","GGR",0,4,4,1,3,"run077"
"15604","RGR","RBB",0,4,4,2,2,"run077"
"15605","RGR","RGG",1,1,2,2,0,"run077"
"15606","RGR","RRG",0,3,3,0,3,"run077"
"15607","RRG","BBB",2,33,35,10,25,"run077"
"15608","RRG","BBR",0,5,5,4,1,"run077"
"15609","RRG","BGB",1,10,11,2,9,"run077"
"15610","RRG","BGG",0,2,2,0,2,"run077"
"15611","RRG","BRB",2,40,42,27,15,"run077"
"15612","RRG","BRR",1,16,17,1,16,"run077"
"15613","RRG","GGG",2,14,16,16,0,"run077"
"15614","RRG","GGR",0,5,5,4,1,"run077"
"15615","RRG","GRG",1,0,1,0,1,"run077"
"15616","RRG","GRR",3,8,11,6,5,"run077"
"15617","RRG","RBB",1,1,2,0,2,"run077"
"15618","RRG","RGG",0,1,1,0,1,"run077"
"15619","RRG","RGR",0,1,1,0,1,"run077"
"15620","RRR","BBR",1,0,1,1,0,"run077"
"15621","RRR","BGB",2,1,3,1,2,"run077"
"15622","RRR","BGG",1,0,1,0,1,"run077"
"15623","RRR","BRB",1,1,2,2,0,"run077"
"15624","RRR","BRR",1,1,2,1,1,"run077"
"15625","RRR","GGR",0,1,1,0,1,"run077"
"15626","RRR","GRR",0,3,3,3,0,"run077"
"15627","RRR","RBB",1,2,3,3,0,"run077"
"15628","RRR","RBR",0,2,2,0,2,"run077"
"15629","RRR","RGG",0,1,1,0,1,"run077"
"15630","RRR","RGR",1,2,3,2,1,"run077"
"15631","RRR","RRG",2,2,4,3,1,"run077"
"15632","BBB","BRB",0,1,1,0,1,"run078"
"15633","BBB","GGG",1,2,3,1,2,"run078"
"15634","BBB","GRR",0,2,2,2,0,"run078"
"15635","BBB","RBG",0,1,1,1,0,"run078"
"15636","BBB","RRG",1,3,4,1,3,"run078"
"15637","BBB","RRR",0,2,2,1,1,"run078"
"15638","BBG","BBB",1,4,5,4,1,"run078"
"15639","BBG","BGB",0,1,1,0,1,"run078"
"15640","BBG","BGG",0,1,1,1,0,"run078"
"15641","BBG","BRB",1,16,17,2,15,"run078"
"15642","BBG","GBB",0,1,1,0,1,"run078"
"15643","BBG","GBG",2,7,9,7,2,"run078"
"15644","BBG","GGB",2,25,27,5,22,"run078"
"15645","BBG","GGG",4,38,42,9,33,"run078"
"15646","BBG","GRG",1,9,10,4,6,"run078"
"15647","BBG","GRR",0,1,1,1,0,"run078"
"15648","BBG","RBB",0,1,1,0,1,"run078"
"15649","BBG","RBG",0,4,4,4,0,"run078"
"15650","BBG","RBR",0,1,1,0,1,"run078"
"15651","BBG","RGR",0,1,1,0,1,"run078"
"15652","BBG","RRG",1,2,3,3,0,"run078"
"15653","BBG","RRR",0,7,7,1,6,"run078"
"15654","BGB","BBB",0,2,2,2,0,"run078"
"15655","BGB","RRG",0,1,1,1,0,"run078"
"15656","BGG","BBB",0,3,3,3,0,"run078"
"15657","BGG","BBR",0,1,1,1,0,"run078"
"15658","BGG","GRG",0,1,1,1,0,"run078"
"15659","BGG","RBG",1,1,2,1,1,"run078"
"15660","BGG","RGG",0,3,3,3,0,"run078"
"15661","BGG","RGR",0,1,1,0,1,"run078"
"15662","BGG","RRR",1,1,2,2,0,"run078"
"15663","BRB","BBB",0,13,13,5,8,"run078"
"15664","BRB","BBR",0,1,1,0,1,"run078"
"15665","BRB","BRR",0,3,3,2,1,"run078"
"15666","BRB","GGG",0,1,1,1,0,"run078"
"15667","BRB","GGR",0,1,1,1,0,"run078"
"15668","BRB","RBB",0,1,1,0,1,"run078"
"15669","BRB","RBG",0,1,1,0,1,"run078"
"15670","BRB","RGR",0,1,1,0,1,"run078"
"15671","BRB","RRR",0,1,1,0,1,"run078"
"15672","BRR","BBB",0,11,11,0,11,"run078"
"15673","BRR","BGB",1,1,2,1,1,"run078"
"15674","BRR","BGG",0,1,1,1,0,"run078"
"15675","BRR","BRB",0,1,1,0,1,"run078"
"15676","BRR","RBB",0,2,2,0,2,"run078"
"15677","GBB","BBB",12,38,50,49,1,"run078"
"15678","GBB","BGG",0,1,1,1,0,"run078"
"15679","GBB","BRB",1,9,10,1,9,"run078"
"15680","GBB","BRR",1,3,4,2,2,"run078"
"15681","GBB","GBG",0,4,4,2,2,"run078"
"15682","GBB","GGB",0,21,21,21,0,"run078"
"15683","GBB","GGG",7,86,93,18,75,"run078"
"15684","GBB","GGR",1,3,4,3,1,"run078"
"15685","GBB","GRG",0,6,6,3,3,"run078"
"15686","GBB","GRR",0,1,1,0,1,"run078"
"15687","GBB","RBB",0,2,2,2,0,"run078"
"15688","GBB","RBG",3,9,12,12,0,"run078"
"15689","GBB","RBR",1,0,1,0,1,"run078"
"15690","GBB","RGG",1,0,1,0,1,"run078"
"15691","GBB","RGR",2,1,3,3,0,"run078"
"15692","GBB","RRG",0,2,2,0,2,"run078"
"15693","GBB","RRR",1,9,10,0,10,"run078"
"15694","GBG","BBB",0,5,5,5,0,"run078"
"15695","GBG","BBR",0,1,1,1,0,"run078"
"15696","GBG","BRB",1,4,5,0,5,"run078"
"15697","GBG","BRR",1,0,1,1,0,"run078"
"15698","GBG","GGB",0,4,4,0,4,"run078"
"15699","GBG","GGG",4,11,15,15,0,"run078"
"15700","GBG","RBB",1,0,1,0,1,"run078"
"15701","GBG","RBG",0,1,1,1,0,"run078"
"15702","GBG","RGG",0,1,1,1,0,"run078"
"15703","GBG","RGR",1,3,4,4,0,"run078"
"15704","GBG","RRG",1,3,4,3,1,"run078"
"15705","GGB","BBB",3,16,19,6,13,"run078"
"15706","GGB","BBR",1,4,5,4,1,"run078"
"15707","GGB","BGB",0,3,3,0,3,"run078"
"15708","GGB","BGG",0,4,4,4,0,"run078"
"15709","GGB","BRB",0,1,1,1,0,"run078"
"15710","GGB","BRR",1,15,16,13,3,"run078"
"15711","GGB","GBB",0,1,1,0,1,"run078"
"15712","GGB","GBG",1,0,1,0,1,"run078"
"15713","GGB","GGG",13,48,61,32,29,"run078"
"15714","GGB","GGR",0,7,7,4,3,"run078"
"15715","GGB","GRR",0,4,4,0,4,"run078"
"15716","GGB","RBB",0,5,5,5,0,"run078"
"15717","GGB","RBG",0,4,4,1,3,"run078"
"15718","GGB","RBR",0,5,5,1,4,"run078"
"15719","GGB","RGG",1,5,6,0,6,"run078"
"15720","GGB","RGR",0,2,2,1,1,"run078"
"15721","GGB","RRG",1,5,6,3,3,"run078"
"15722","GGB","RRR",1,5,6,1,5,"run078"
"15723","GGG","BBB",8,31,39,33,6,"run078"
"15724","GGG","BGB",0,2,2,1,1,"run078"
"15725","GGG","BGG",1,7,8,8,0,"run078"
"15726","GGG","BRB",1,3,4,4,0,"run078"
"15727","GGG","BRR",0,6,6,3,3,"run078"
"15728","GGG","GGB",5,1,6,5,1,"run078"
"15729","GGG","GGR",1,9,10,6,4,"run078"
"15730","GGG","GRR",0,2,2,0,2,"run078"
"15731","GGG","RBB",1,8,9,8,1,"run078"
"15732","GGG","RBG",0,6,6,2,4,"run078"
"15733","GGG","RBR",0,21,21,0,21,"run078"
"15734","GGG","RGG",0,3,3,2,1,"run078"
"15735","GGG","RGR",1,12,13,4,9,"run078"
"15736","GGG","RRG",1,23,24,15,9,"run078"
"15737","GGG","RRR",0,3,3,3,0,"run078"
"15738","GGR","BBB",0,2,2,2,0,"run078"
"15739","GGR","BBR",0,2,2,0,2,"run078"
"15740","GGR","BGG",0,1,1,1,0,"run078"
"15741","GGR","BRR",1,0,1,1,0,"run078"
"15742","GGR","GRR",1,0,1,0,1,"run078"
"15743","GGR","RBB",0,2,2,0,2,"run078"
"15744","GRG","BBB",3,8,11,4,7,"run078"
"15745","GRG","BBR",0,1,1,1,0,"run078"
"15746","GRG","BGG",0,1,1,0,1,"run078"
"15747","GRG","BRB",0,3,3,1,2,"run078"
"15748","GRG","BRR",0,1,1,0,1,"run078"
"15749","GRG","GBG",0,1,1,1,0,"run078"
"15750","GRG","GGB",2,15,17,4,13,"run078"
"15751","GRG","GGG",3,12,15,12,3,"run078"
"15752","GRG","GGR",0,5,5,5,0,"run078"
"15753","GRG","GRR",0,1,1,0,1,"run078"
"15754","GRG","RBG",0,1,1,1,0,"run078"
"15755","GRG","RBR",0,1,1,0,1,"run078"
"15756","GRG","RGR",1,2,3,1,2,"run078"
"15757","GRG","RRG",2,4,6,2,4,"run078"
"15758","GRR","BBB",0,1,1,0,1,"run078"
"15759","GRR","BBR",0,1,1,1,0,"run078"
"15760","GRR","BGB",1,2,3,1,2,"run078"
"15761","GRR","BGG",0,2,2,0,2,"run078"
"15762","GRR","BRB",0,1,1,1,0,"run078"
"15763","GRR","BRR",0,2,2,0,2,"run078"
"15764","GRR","GGG",0,1,1,0,1,"run078"
"15765","GRR","GGR",0,1,1,1,0,"run078"
"15766","RBB","BBB",0,1,1,0,1,"run078"
"15767","RBB","BBR",0,1,1,1,0,"run078"
"15768","RBB","BRB",0,1,1,1,0,"run078"
"15769","RBB","GRR",0,1,1,0,1,"run078"
"15770","RBB","RGG",0,1,1,0,1,"run078"
"15771","RBG","BBB",2,8,10,4,6,"run078"
"15772","RBG","BBG",0,1,1,0,1,"run078"
"15773","RBG","BRR",0,1,1,1,0,"run078"
"15774","RBG","GBB",0,1,1,1,0,"run078"
"15775","RBG","GRR",0,3,3,3,0,"run078"
"15776","RBG","RBB",1,1,2,1,1,"run078"
"15777","RBG","RBR",0,1,1,1,0,"run078"
"15778","RBG","RGR",0,1,1,1,0,"run078"
"15779","RBR","BBB",0,13,13,2,11,"run078"
"15780","RBR","BBR",0,1,1,1,0,"run078"
"15781","RBR","BGB",2,4,6,3,3,"run078"
"15782","RBR","BGG",0,2,2,1,1,"run078"
"15783","RBR","BRB",1,0,1,1,0,"run078"
"15784","RBR","BRR",1,4,5,0,5,"run078"
"15785","RBR","GGB",0,12,12,8,4,"run078"
"15786","RBR","GRR",4,4,8,7,1,"run078"
"15787","RBR","RBB",0,3,3,3,0,"run078"
"15788","RBR","RGG",2,9,11,4,7,"run078"
"15789","RBR","RGR",1,0,1,0,1,"run078"
"15790","RBR","RRR",0,1,1,1,0,"run078"
"15791","RGG","BBB",0,8,8,6,2,"run078"
"15792","RGG","BBR",1,2,3,1,2,"run078"
"15793","RGG","BGB",0,1,1,0,1,"run078"
"15794","RGG","BRR",0,4,4,4,0,"run078"
"15795","RGG","GGG",0,1,1,0,1,"run078"
"15796","RGG","GGR",0,3,3,1,2,"run078"
"15797","RGG","GRR",0,8,8,3,5,"run078"
"15798","RGG","RBB",0,1,1,1,0,"run078"
"15799","RGR","BBB",2,5,7,3,4,"run078"
"15800","RGR","BBR",1,1,2,1,1,"run078"
"15801","RGR","BGB",2,5,7,2,5,"run078"
"15802","RGR","BGG",2,2,4,4,0,"run078"
"15803","RGR","BRR",1,5,6,0,6,"run078"
"15804","RGR","GGB",2,12,14,7,7,"run078"
"15805","RGR","GGG",0,2,2,2,0,"run078"
"15806","RGR","GGR",0,4,4,0,4,"run078"
"15807","RGR","RBB",0,4,4,3,1,"run078"
"15808","RGR","RGG",1,1,2,2,0,"run078"
"15809","RGR","RRG",0,3,3,2,1,"run078"
"15810","RRG","BBB",2,33,35,4,31,"run078"
"15811","RRG","BBR",0,5,5,1,4,"run078"
"15812","RRG","BGB",1,10,11,8,3,"run078"
"15813","RRG","BGG",0,2,2,2,0,"run078"
"15814","RRG","BRB",2,40,42,42,0,"run078"
"15815","RRG","BRR",1,16,17,4,13,"run078"
"15816","RRG","GGG",2,14,16,11,5,"run078"
"15817","RRG","GGR",0,5,5,2,3,"run078"
"15818","RRG","GRG",1,0,1,0,1,"run078"
"15819","RRG","GRR",3,8,11,9,2,"run078"
"15820","RRG","RBB",1,1,2,2,0,"run078"
"15821","RRG","RGG",0,1,1,0,1,"run078"
"15822","RRG","RGR",0,1,1,1,0,"run078"
"15823","RRR","BBR",1,0,1,0,1,"run078"
"15824","RRR","BGB",2,1,3,0,3,"run078"
"15825","RRR","BGG",1,0,1,0,1,"run078"
"15826","RRR","BRB",1,1,2,1,1,"run078"
"15827","RRR","BRR",1,1,2,2,0,"run078"
"15828","RRR","GGR",0,1,1,1,0,"run078"
"15829","RRR","GRR",0,3,3,3,0,"run078"
"15830","RRR","RBB",1,2,3,2,1,"run078"
"15831","RRR","RBR",0,2,2,2,0,"run078"
"15832","RRR","RGG",0,1,1,1,0,"run078"
"15833","RRR","RGR",1,2,3,2,1,"run078"
"15834","RRR","RRG",2,2,4,2,2,"run078"
"15835","BBB","BRB",0,1,1,1,0,"run079"
"15836","BBB","GGG",1,2,3,2,1,"run079"
"15837","BBB","GRR",0,2,2,2,0,"run079"
"15838","BBB","RBG",0,1,1,1,0,"run079"
"15839","BBB","RRG",1,3,4,1,3,"run079"
"15840","BBB","RRR",0,2,2,1,1,"run079"
"15841","BBG","BBB",1,4,5,2,3,"run079"
"15842","BBG","BGB",0,1,1,0,1,"run079"
"15843","BBG","BGG",0,1,1,1,0,"run079"
"15844","BBG","BRB",1,16,17,13,4,"run079"
"15845","BBG","GBB",0,1,1,1,0,"run079"
"15846","BBG","GBG",2,7,9,8,1,"run079"
"15847","BBG","GGB",2,25,27,5,22,"run079"
"15848","BBG","GGG",4,38,42,36,6,"run079"
"15849","BBG","GRG",1,9,10,0,10,"run079"
"15850","BBG","GRR",0,1,1,0,1,"run079"
"15851","BBG","RBB",0,1,1,1,0,"run079"
"15852","BBG","RBG",0,4,4,4,0,"run079"
"15853","BBG","RBR",0,1,1,0,1,"run079"
"15854","BBG","RGR",0,1,1,0,1,"run079"
"15855","BBG","RRG",1,2,3,2,1,"run079"
"15856","BBG","RRR",0,7,7,1,6,"run079"
"15857","BGB","BBB",0,2,2,0,2,"run079"
"15858","BGB","RRG",0,1,1,0,1,"run079"
"15859","BGG","BBB",0,3,3,1,2,"run079"
"15860","BGG","BBR",0,1,1,0,1,"run079"
"15861","BGG","GRG",0,1,1,1,0,"run079"
"15862","BGG","RBG",1,1,2,0,2,"run079"
"15863","BGG","RGG",0,3,3,0,3,"run079"
"15864","BGG","RGR",0,1,1,1,0,"run079"
"15865","BGG","RRR",1,1,2,0,2,"run079"
"15866","BRB","BBB",0,13,13,3,10,"run079"
"15867","BRB","BBR",0,1,1,0,1,"run079"
"15868","BRB","BRR",0,3,3,0,3,"run079"
"15869","BRB","GGG",0,1,1,1,0,"run079"
"15870","BRB","GGR",0,1,1,1,0,"run079"
"15871","BRB","RBB",0,1,1,1,0,"run079"
"15872","BRB","RBG",0,1,1,0,1,"run079"
"15873","BRB","RGR",0,1,1,0,1,"run079"
"15874","BRB","RRR",0,1,1,0,1,"run079"
"15875","BRR","BBB",0,11,11,0,11,"run079"
"15876","BRR","BGB",1,1,2,1,1,"run079"
"15877","BRR","BGG",0,1,1,1,0,"run079"
"15878","BRR","BRB",0,1,1,1,0,"run079"
"15879","BRR","RBB",0,2,2,1,1,"run079"
"15880","GBB","BBB",12,38,50,1,49,"run079"
"15881","GBB","BGG",0,1,1,0,1,"run079"
"15882","GBB","BRB",1,9,10,0,10,"run079"
"15883","GBB","BRR",1,3,4,1,3,"run079"
"15884","GBB","GBG",0,4,4,4,0,"run079"
"15885","GBB","GGB",0,21,21,3,18,"run079"
"15886","GBB","GGG",7,86,93,68,25,"run079"
"15887","GBB","GGR",1,3,4,2,2,"run079"
"15888","GBB","GRG",0,6,6,5,1,"run079"
"15889","GBB","GRR",0,1,1,1,0,"run079"
"15890","GBB","RBB",0,2,2,0,2,"run079"
"15891","GBB","RBG",3,9,12,7,5,"run079"
"15892","GBB","RBR",1,0,1,0,1,"run079"
"15893","GBB","RGG",1,0,1,0,1,"run079"
"15894","GBB","RGR",2,1,3,1,2,"run079"
"15895","GBB","RRG",0,2,2,1,1,"run079"
"15896","GBB","RRR",1,9,10,8,2,"run079"
"15897","GBG","BBB",0,5,5,2,3,"run079"
"15898","GBG","BBR",0,1,1,0,1,"run079"
"15899","GBG","BRB",1,4,5,0,5,"run079"
"15900","GBG","BRR",1,0,1,1,0,"run079"
"15901","GBG","GGB",0,4,4,0,4,"run079"
"15902","GBG","GGG",4,11,15,14,1,"run079"
"15903","GBG","RBB",1,0,1,0,1,"run079"
"15904","GBG","RBG",0,1,1,0,1,"run079"
"15905","GBG","RGG",0,1,1,0,1,"run079"
"15906","GBG","RGR",1,3,4,3,1,"run079"
"15907","GBG","RRG",1,3,4,1,3,"run079"
"15908","GGB","BBB",3,16,19,19,0,"run079"
"15909","GGB","BBR",1,4,5,4,1,"run079"
"15910","GGB","BGB",0,3,3,3,0,"run079"
"15911","GGB","BGG",0,4,4,2,2,"run079"
"15912","GGB","BRB",0,1,1,0,1,"run079"
"15913","GGB","BRR",1,15,16,8,8,"run079"
"15914","GGB","GBB",0,1,1,1,0,"run079"
"15915","GGB","GBG",1,0,1,1,0,"run079"
"15916","GGB","GGG",13,48,61,54,7,"run079"
"15917","GGB","GGR",0,7,7,7,0,"run079"
"15918","GGB","GRR",0,4,4,4,0,"run079"
"15919","GGB","RBB",0,5,5,3,2,"run079"
"15920","GGB","RBG",0,4,4,0,4,"run079"
"15921","GGB","RBR",0,5,5,3,2,"run079"
"15922","GGB","RGG",1,5,6,4,2,"run079"
"15923","GGB","RGR",0,2,2,0,2,"run079"
"15924","GGB","RRG",1,5,6,0,6,"run079"
"15925","GGB","RRR",1,5,6,4,2,"run079"
"15926","GGG","BBB",8,31,39,35,4,"run079"
"15927","GGG","BGB",0,2,2,0,2,"run079"
"15928","GGG","BGG",1,7,8,1,7,"run079"
"15929","GGG","BRB",1,3,4,1,3,"run079"
"15930","GGG","BRR",0,6,6,0,6,"run079"
"15931","GGG","GGB",5,1,6,0,6,"run079"
"15932","GGG","GGR",1,9,10,6,4,"run079"
"15933","GGG","GRR",0,2,2,1,1,"run079"
"15934","GGG","RBB",1,8,9,9,0,"run079"
"15935","GGG","RBG",0,6,6,0,6,"run079"
"15936","GGG","RBR",0,21,21,15,6,"run079"
"15937","GGG","RGG",0,3,3,0,3,"run079"
"15938","GGG","RGR",1,12,13,1,12,"run079"
"15939","GGG","RRG",1,23,24,19,5,"run079"
"15940","GGG","RRR",0,3,3,3,0,"run079"
"15941","GGR","BBB",0,2,2,2,0,"run079"
"15942","GGR","BBR",0,2,2,1,1,"run079"
"15943","GGR","BGG",0,1,1,0,1,"run079"
"15944","GGR","BRR",1,0,1,1,0,"run079"
"15945","GGR","GRR",1,0,1,1,0,"run079"
"15946","GGR","RBB",0,2,2,0,2,"run079"
"15947","GRG","BBB",3,8,11,5,6,"run079"
"15948","GRG","BBR",0,1,1,1,0,"run079"
"15949","GRG","BGG",0,1,1,0,1,"run079"
"15950","GRG","BRB",0,3,3,3,0,"run079"
"15951","GRG","BRR",0,1,1,1,0,"run079"
"15952","GRG","GBG",0,1,1,0,1,"run079"
"15953","GRG","GGB",2,15,17,5,12,"run079"
"15954","GRG","GGG",3,12,15,8,7,"run079"
"15955","GRG","GGR",0,5,5,3,2,"run079"
"15956","GRG","GRR",0,1,1,0,1,"run079"
"15957","GRG","RBG",0,1,1,1,0,"run079"
"15958","GRG","RBR",0,1,1,1,0,"run079"
"15959","GRG","RGR",1,2,3,1,2,"run079"
"15960","GRG","RRG",2,4,6,2,4,"run079"
"15961","GRR","BBB",0,1,1,1,0,"run079"
"15962","GRR","BBR",0,1,1,0,1,"run079"
"15963","GRR","BGB",1,2,3,2,1,"run079"
"15964","GRR","BGG",0,2,2,2,0,"run079"
"15965","GRR","BRB",0,1,1,0,1,"run079"
"15966","GRR","BRR",0,2,2,1,1,"run079"
"15967","GRR","GGG",0,1,1,1,0,"run079"
"15968","GRR","GGR",0,1,1,0,1,"run079"
"15969","RBB","BBB",0,1,1,1,0,"run079"
"15970","RBB","BBR",0,1,1,0,1,"run079"
"15971","RBB","BRB",0,1,1,1,0,"run079"
"15972","RBB","GRR",0,1,1,0,1,"run079"
"15973","RBB","RGG",0,1,1,0,1,"run079"
"15974","RBG","BBB",2,8,10,2,8,"run079"
"15975","RBG","BBG",0,1,1,1,0,"run079"
"15976","RBG","BRR",0,1,1,1,0,"run079"
"15977","RBG","GBB",0,1,1,1,0,"run079"
"15978","RBG","GRR",0,3,3,0,3,"run079"
"15979","RBG","RBB",1,1,2,0,2,"run079"
"15980","RBG","RBR",0,1,1,0,1,"run079"
"15981","RBG","RGR",0,1,1,0,1,"run079"
"15982","RBR","BBB",0,13,13,1,12,"run079"
"15983","RBR","BBR",0,1,1,1,0,"run079"
"15984","RBR","BGB",2,4,6,6,0,"run079"
"15985","RBR","BGG",0,2,2,2,0,"run079"
"15986","RBR","BRB",1,0,1,0,1,"run079"
"15987","RBR","BRR",1,4,5,3,2,"run079"
"15988","RBR","GGB",0,12,12,5,7,"run079"
"15989","RBR","GRR",4,4,8,7,1,"run079"
"15990","RBR","RBB",0,3,3,3,0,"run079"
"15991","RBR","RGG",2,9,11,4,7,"run079"
"15992","RBR","RGR",1,0,1,1,0,"run079"
"15993","RBR","RRR",0,1,1,1,0,"run079"
"15994","RGG","BBB",0,8,8,2,6,"run079"
"15995","RGG","BBR",1,2,3,3,0,"run079"
"15996","RGG","BGB",0,1,1,1,0,"run079"
"15997","RGG","BRR",0,4,4,1,3,"run079"
"15998","RGG","GGG",0,1,1,0,1,"run079"
"15999","RGG","GGR",0,3,3,1,2,"run079"
"16000","RGG","GRR",0,8,8,3,5,"run079"
"16001","RGG","RBB",0,1,1,1,0,"run079"
"16002","RGR","BBB",2,5,7,0,7,"run079"
"16003","RGR","BBR",1,1,2,0,2,"run079"
"16004","RGR","BGB",2,5,7,1,6,"run079"
"16005","RGR","BGG",2,2,4,0,4,"run079"
"16006","RGR","BRR",1,5,6,2,4,"run079"
"16007","RGR","GGB",2,12,14,13,1,"run079"
"16008","RGR","GGG",0,2,2,1,1,"run079"
"16009","RGR","GGR",0,4,4,3,1,"run079"
"16010","RGR","RBB",0,4,4,1,3,"run079"
"16011","RGR","RGG",1,1,2,0,2,"run079"
"16012","RGR","RRG",0,3,3,3,0,"run079"
"16013","RRG","BBB",2,33,35,0,35,"run079"
"16014","RRG","BBR",0,5,5,3,2,"run079"
"16015","RRG","BGB",1,10,11,11,0,"run079"
"16016","RRG","BGG",0,2,2,2,0,"run079"
"16017","RRG","BRB",2,40,42,7,35,"run079"
"16018","RRG","BRR",1,16,17,14,3,"run079"
"16019","RRG","GGG",2,14,16,13,3,"run079"
"16020","RRG","GGR",0,5,5,5,0,"run079"
"16021","RRG","GRG",1,0,1,0,1,"run079"
"16022","RRG","GRR",3,8,11,0,11,"run079"
"16023","RRG","RBB",1,1,2,0,2,"run079"
"16024","RRG","RGG",0,1,1,0,1,"run079"
"16025","RRG","RGR",0,1,1,1,0,"run079"
"16026","RRR","BBR",1,0,1,0,1,"run079"
"16027","RRR","BGB",2,1,3,1,2,"run079"
"16028","RRR","BGG",1,0,1,1,0,"run079"
"16029","RRR","BRB",1,1,2,1,1,"run079"
"16030","RRR","BRR",1,1,2,1,1,"run079"
"16031","RRR","GGR",0,1,1,1,0,"run079"
"16032","RRR","GRR",0,3,3,0,3,"run079"
"16033","RRR","RBB",1,2,3,0,3,"run079"
"16034","RRR","RBR",0,2,2,2,0,"run079"
"16035","RRR","RGG",0,1,1,0,1,"run079"
"16036","RRR","RGR",1,2,3,2,1,"run079"
"16037","RRR","RRG",2,2,4,1,3,"run079"
"16038","BBB","BRB",0,1,1,0,1,"run080"
"16039","BBB","GGG",1,2,3,2,1,"run080"
"16040","BBB","GRR",0,2,2,2,0,"run080"
"16041","BBB","RBG",0,1,1,0,1,"run080"
"16042","BBB","RRG",1,3,4,0,4,"run080"
"16043","BBB","RRR",0,2,2,1,1,"run080"
"16044","BBG","BBB",1,4,5,3,2,"run080"
"16045","BBG","BGB",0,1,1,1,0,"run080"
"16046","BBG","BGG",0,1,1,1,0,"run080"
"16047","BBG","BRB",1,16,17,2,15,"run080"
"16048","BBG","GBB",0,1,1,0,1,"run080"
"16049","BBG","GBG",2,7,9,7,2,"run080"
"16050","BBG","GGB",2,25,27,3,24,"run080"
"16051","BBG","GGG",4,38,42,26,16,"run080"
"16052","BBG","GRG",1,9,10,2,8,"run080"
"16053","BBG","GRR",0,1,1,0,1,"run080"
"16054","BBG","RBB",0,1,1,1,0,"run080"
"16055","BBG","RBG",0,4,4,2,2,"run080"
"16056","BBG","RBR",0,1,1,0,1,"run080"
"16057","BBG","RGR",0,1,1,0,1,"run080"
"16058","BBG","RRG",1,2,3,0,3,"run080"
"16059","BBG","RRR",0,7,7,7,0,"run080"
"16060","BGB","BBB",0,2,2,1,1,"run080"
"16061","BGB","RRG",0,1,1,0,1,"run080"
"16062","BGG","BBB",0,3,3,1,2,"run080"
"16063","BGG","BBR",0,1,1,0,1,"run080"
"16064","BGG","GRG",0,1,1,0,1,"run080"
"16065","BGG","RBG",1,1,2,0,2,"run080"
"16066","BGG","RGG",0,3,3,3,0,"run080"
"16067","BGG","RGR",0,1,1,0,1,"run080"
"16068","BGG","RRR",1,1,2,1,1,"run080"
"16069","BRB","BBB",0,13,13,11,2,"run080"
"16070","BRB","BBR",0,1,1,1,0,"run080"
"16071","BRB","BRR",0,3,3,3,0,"run080"
"16072","BRB","GGG",0,1,1,1,0,"run080"
"16073","BRB","GGR",0,1,1,1,0,"run080"
"16074","BRB","RBB",0,1,1,1,0,"run080"
"16075","BRB","RBG",0,1,1,0,1,"run080"
"16076","BRB","RGR",0,1,1,1,0,"run080"
"16077","BRB","RRR",0,1,1,1,0,"run080"
"16078","BRR","BBB",0,11,11,0,11,"run080"
"16079","BRR","BGB",1,1,2,0,2,"run080"
"16080","BRR","BGG",0,1,1,0,1,"run080"
"16081","BRR","BRB",0,1,1,0,1,"run080"
"16082","BRR","RBB",0,2,2,2,0,"run080"
"16083","GBB","BBB",12,38,50,26,24,"run080"
"16084","GBB","BGG",0,1,1,0,1,"run080"
"16085","GBB","BRB",1,9,10,3,7,"run080"
"16086","GBB","BRR",1,3,4,0,4,"run080"
"16087","GBB","GBG",0,4,4,4,0,"run080"
"16088","GBB","GGB",0,21,21,18,3,"run080"
"16089","GBB","GGG",7,86,93,28,65,"run080"
"16090","GBB","GGR",1,3,4,4,0,"run080"
"16091","GBB","GRG",0,6,6,5,1,"run080"
"16092","GBB","GRR",0,1,1,0,1,"run080"
"16093","GBB","RBB",0,2,2,1,1,"run080"
"16094","GBB","RBG",3,9,12,2,10,"run080"
"16095","GBB","RBR",1,0,1,0,1,"run080"
"16096","GBB","RGG",1,0,1,0,1,"run080"
"16097","GBB","RGR",2,1,3,1,2,"run080"
"16098","GBB","RRG",0,2,2,0,2,"run080"
"16099","GBB","RRR",1,9,10,8,2,"run080"
"16100","GBG","BBB",0,5,5,1,4,"run080"
"16101","GBG","BBR",0,1,1,1,0,"run080"
"16102","GBG","BRB",1,4,5,0,5,"run080"
"16103","GBG","BRR",1,0,1,0,1,"run080"
"16104","GBG","GGB",0,4,4,0,4,"run080"
"16105","GBG","GGG",4,11,15,5,10,"run080"
"16106","GBG","RBB",1,0,1,0,1,"run080"
"16107","GBG","RBG",0,1,1,0,1,"run080"
"16108","GBG","RGG",0,1,1,1,0,"run080"
"16109","GBG","RGR",1,3,4,1,3,"run080"
"16110","GBG","RRG",1,3,4,2,2,"run080"
"16111","GGB","BBB",3,16,19,5,14,"run080"
"16112","GGB","BBR",1,4,5,0,5,"run080"
"16113","GGB","BGB",0,3,3,2,1,"run080"
"16114","GGB","BGG",0,4,4,4,0,"run080"
"16115","GGB","BRB",0,1,1,1,0,"run080"
"16116","GGB","BRR",1,15,16,8,8,"run080"
"16117","GGB","GBB",0,1,1,1,0,"run080"
"16118","GGB","GBG",1,0,1,0,1,"run080"
"16119","GGB","GGG",13,48,61,18,43,"run080"
"16120","GGB","GGR",0,7,7,1,6,"run080"
"16121","GGB","GRR",0,4,4,4,0,"run080"
"16122","GGB","RBB",0,5,5,4,1,"run080"
"16123","GGB","RBG",0,4,4,0,4,"run080"
"16124","GGB","RBR",0,5,5,3,2,"run080"
"16125","GGB","RGG",1,5,6,4,2,"run080"
"16126","GGB","RGR",0,2,2,0,2,"run080"
"16127","GGB","RRG",1,5,6,2,4,"run080"
"16128","GGB","RRR",1,5,6,2,4,"run080"
"16129","GGG","BBB",8,31,39,18,21,"run080"
"16130","GGG","BGB",0,2,2,0,2,"run080"
"16131","GGG","BGG",1,7,8,5,3,"run080"
"16132","GGG","BRB",1,3,4,3,1,"run080"
"16133","GGG","BRR",0,6,6,4,2,"run080"
"16134","GGG","GGB",5,1,6,4,2,"run080"
"16135","GGG","GGR",1,9,10,0,10,"run080"
"16136","GGG","GRR",0,2,2,0,2,"run080"
"16137","GGG","RBB",1,8,9,6,3,"run080"
"16138","GGG","RBG",0,6,6,5,1,"run080"
"16139","GGG","RBR",0,21,21,9,12,"run080"
"16140","GGG","RGG",0,3,3,2,1,"run080"
"16141","GGG","RGR",1,12,13,0,13,"run080"
"16142","GGG","RRG",1,23,24,16,8,"run080"
"16143","GGG","RRR",0,3,3,0,3,"run080"
"16144","GGR","BBB",0,2,2,0,2,"run080"
"16145","GGR","BBR",0,2,2,2,0,"run080"
"16146","GGR","BGG",0,1,1,1,0,"run080"
"16147","GGR","BRR",1,0,1,1,0,"run080"
"16148","GGR","GRR",1,0,1,1,0,"run080"
"16149","GGR","RBB",0,2,2,0,2,"run080"
"16150","GRG","BBB",3,8,11,4,7,"run080"
"16151","GRG","BBR",0,1,1,1,0,"run080"
"16152","GRG","BGG",0,1,1,0,1,"run080"
"16153","GRG","BRB",0,3,3,0,3,"run080"
"16154","GRG","BRR",0,1,1,1,0,"run080"
"16155","GRG","GBG",0,1,1,1,0,"run080"
"16156","GRG","GGB",2,15,17,16,1,"run080"
"16157","GRG","GGG",3,12,15,15,0,"run080"
"16158","GRG","GGR",0,5,5,2,3,"run080"
"16159","GRG","GRR",0,1,1,1,0,"run080"
"16160","GRG","RBG",0,1,1,1,0,"run080"
"16161","GRG","RBR",0,1,1,1,0,"run080"
"16162","GRG","RGR",1,2,3,1,2,"run080"
"16163","GRG","RRG",2,4,6,0,6,"run080"
"16164","GRR","BBB",0,1,1,0,1,"run080"
"16165","GRR","BBR",0,1,1,1,0,"run080"
"16166","GRR","BGB",1,2,3,1,2,"run080"
"16167","GRR","BGG",0,2,2,0,2,"run080"
"16168","GRR","BRB",0,1,1,1,0,"run080"
"16169","GRR","BRR",0,2,2,2,0,"run080"
"16170","GRR","GGG",0,1,1,0,1,"run080"
"16171","GRR","GGR",0,1,1,1,0,"run080"
"16172","RBB","BBB",0,1,1,0,1,"run080"
"16173","RBB","BBR",0,1,1,1,0,"run080"
"16174","RBB","BRB",0,1,1,1,0,"run080"
"16175","RBB","GRR",0,1,1,1,0,"run080"
"16176","RBB","RGG",0,1,1,1,0,"run080"
"16177","RBG","BBB",2,8,10,5,5,"run080"
"16178","RBG","BBG",0,1,1,1,0,"run080"
"16179","RBG","BRR",0,1,1,1,0,"run080"
"16180","RBG","GBB",0,1,1,0,1,"run080"
"16181","RBG","GRR",0,3,3,2,1,"run080"
"16182","RBG","RBB",1,1,2,2,0,"run080"
"16183","RBG","RBR",0,1,1,0,1,"run080"
"16184","RBG","RGR",0,1,1,0,1,"run080"
"16185","RBR","BBB",0,13,13,3,10,"run080"
"16186","RBR","BBR",0,1,1,0,1,"run080"
"16187","RBR","BGB",2,4,6,6,0,"run080"
"16188","RBR","BGG",0,2,2,1,1,"run080"
"16189","RBR","BRB",1,0,1,0,1,"run080"
"16190","RBR","BRR",1,4,5,1,4,"run080"
"16191","RBR","GGB",0,12,12,5,7,"run080"
"16192","RBR","GRR",4,4,8,6,2,"run080"
"16193","RBR","RBB",0,3,3,2,1,"run080"
"16194","RBR","RGG",2,9,11,1,10,"run080"
"16195","RBR","RGR",1,0,1,0,1,"run080"
"16196","RBR","RRR",0,1,1,0,1,"run080"
"16197","RGG","BBB",0,8,8,5,3,"run080"
"16198","RGG","BBR",1,2,3,3,0,"run080"
"16199","RGG","BGB",0,1,1,0,1,"run080"
"16200","RGG","BRR",0,4,4,3,1,"run080"
"16201","RGG","GGG",0,1,1,0,1,"run080"
"16202","RGG","GGR",0,3,3,1,2,"run080"
"16203","RGG","GRR",0,8,8,7,1,"run080"
"16204","RGG","RBB",0,1,1,0,1,"run080"
"16205","RGR","BBB",2,5,7,3,4,"run080"
"16206","RGR","BBR",1,1,2,0,2,"run080"
"16207","RGR","BGB",2,5,7,5,2,"run080"
"16208","RGR","BGG",2,2,4,2,2,"run080"
"16209","RGR","BRR",1,5,6,4,2,"run080"
"16210","RGR","GGB",2,12,14,4,10,"run080"
"16211","RGR","GGG",0,2,2,0,2,"run080"
"16212","RGR","GGR",0,4,4,3,1,"run080"
"16213","RGR","RBB",0,4,4,3,1,"run080"
"16214","RGR","RGG",1,1,2,1,1,"run080"
"16215","RGR","RRG",0,3,3,3,0,"run080"
"16216","RRG","BBB",2,33,35,27,8,"run080"
"16217","RRG","BBR",0,5,5,4,1,"run080"
"16218","RRG","BGB",1,10,11,4,7,"run080"
"16219","RRG","BGG",0,2,2,1,1,"run080"
"16220","RRG","BRB",2,40,42,29,13,"run080"
"16221","RRG","BRR",1,16,17,0,17,"run080"
"16222","RRG","GGG",2,14,16,9,7,"run080"
"16223","RRG","GGR",0,5,5,1,4,"run080"
"16224","RRG","GRG",1,0,1,1,0,"run080"
"16225","RRG","GRR",3,8,11,4,7,"run080"
"16226","RRG","RBB",1,1,2,0,2,"run080"
"16227","RRG","RGG",0,1,1,0,1,"run080"
"16228","RRG","RGR",0,1,1,1,0,"run080"
"16229","RRR","BBR",1,0,1,1,0,"run080"
"16230","RRR","BGB",2,1,3,1,2,"run080"
"16231","RRR","BGG",1,0,1,0,1,"run080"
"16232","RRR","BRB",1,1,2,2,0,"run080"
"16233","RRR","BRR",1,1,2,1,1,"run080"
"16234","RRR","GGR",0,1,1,0,1,"run080"
"16235","RRR","GRR",0,3,3,3,0,"run080"
"16236","RRR","RBB",1,2,3,0,3,"run080"
"16237","RRR","RBR",0,2,2,1,1,"run080"
"16238","RRR","RGG",0,1,1,0,1,"run080"
"16239","RRR","RGR",1,2,3,0,3,"run080"
"16240","RRR","RRG",2,2,4,0,4,"run080"
"16241","BBB","BRB",0,1,1,1,0,"run081"
"16242","BBB","GGG",1,2,3,2,1,"run081"
"16243","BBB","GRR",0,2,2,0,2,"run081"
"16244","BBB","RBG",0,1,1,0,1,"run081"
"16245","BBB","RRG",1,3,4,4,0,"run081"
"16246","BBB","RRR",0,2,2,0,2,"run081"
"16247","BBG","BBB",1,4,5,1,4,"run081"
"16248","BBG","BGB",0,1,1,0,1,"run081"
"16249","BBG","BGG",0,1,1,1,0,"run081"
"16250","BBG","BRB",1,16,17,4,13,"run081"
"16251","BBG","GBB",0,1,1,0,1,"run081"
"16252","BBG","GBG",2,7,9,5,4,"run081"
"16253","BBG","GGB",2,25,27,14,13,"run081"
"16254","BBG","GGG",4,38,42,25,17,"run081"
"16255","BBG","GRG",1,9,10,10,0,"run081"
"16256","BBG","GRR",0,1,1,0,1,"run081"
"16257","BBG","RBB",0,1,1,0,1,"run081"
"16258","BBG","RBG",0,4,4,4,0,"run081"
"16259","BBG","RBR",0,1,1,1,0,"run081"
"16260","BBG","RGR",0,1,1,1,0,"run081"
"16261","BBG","RRG",1,2,3,0,3,"run081"
"16262","BBG","RRR",0,7,7,0,7,"run081"
"16263","BGB","BBB",0,2,2,2,0,"run081"
"16264","BGB","RRG",0,1,1,1,0,"run081"
"16265","BGG","BBB",0,3,3,3,0,"run081"
"16266","BGG","BBR",0,1,1,0,1,"run081"
"16267","BGG","GRG",0,1,1,0,1,"run081"
"16268","BGG","RBG",1,1,2,1,1,"run081"
"16269","BGG","RGG",0,3,3,1,2,"run081"
"16270","BGG","RGR",0,1,1,1,0,"run081"
"16271","BGG","RRR",1,1,2,1,1,"run081"
"16272","BRB","BBB",0,13,13,6,7,"run081"
"16273","BRB","BBR",0,1,1,1,0,"run081"
"16274","BRB","BRR",0,3,3,1,2,"run081"
"16275","BRB","GGG",0,1,1,1,0,"run081"
"16276","BRB","GGR",0,1,1,1,0,"run081"
"16277","BRB","RBB",0,1,1,1,0,"run081"
"16278","BRB","RBG",0,1,1,0,1,"run081"
"16279","BRB","RGR",0,1,1,0,1,"run081"
"16280","BRB","RRR",0,1,1,1,0,"run081"
"16281","BRR","BBB",0,11,11,8,3,"run081"
"16282","BRR","BGB",1,1,2,2,0,"run081"
"16283","BRR","BGG",0,1,1,0,1,"run081"
"16284","BRR","BRB",0,1,1,1,0,"run081"
"16285","BRR","RBB",0,2,2,0,2,"run081"
"16286","GBB","BBB",12,38,50,46,4,"run081"
"16287","GBB","BGG",0,1,1,1,0,"run081"
"16288","GBB","BRB",1,9,10,7,3,"run081"
"16289","GBB","BRR",1,3,4,4,0,"run081"
"16290","GBB","GBG",0,4,4,3,1,"run081"
"16291","GBB","GGB",0,21,21,1,20,"run081"
"16292","GBB","GGG",7,86,93,10,83,"run081"
"16293","GBB","GGR",1,3,4,1,3,"run081"
"16294","GBB","GRG",0,6,6,1,5,"run081"
"16295","GBB","GRR",0,1,1,1,0,"run081"
"16296","GBB","RBB",0,2,2,1,1,"run081"
"16297","GBB","RBG",3,9,12,11,1,"run081"
"16298","GBB","RBR",1,0,1,0,1,"run081"
"16299","GBB","RGG",1,0,1,1,0,"run081"
"16300","GBB","RGR",2,1,3,2,1,"run081"
"16301","GBB","RRG",0,2,2,1,1,"run081"
"16302","GBB","RRR",1,9,10,8,2,"run081"
"16303","GBG","BBB",0,5,5,2,3,"run081"
"16304","GBG","BBR",0,1,1,1,0,"run081"
"16305","GBG","BRB",1,4,5,4,1,"run081"
"16306","GBG","BRR",1,0,1,0,1,"run081"
"16307","GBG","GGB",0,4,4,1,3,"run081"
"16308","GBG","GGG",4,11,15,0,15,"run081"
"16309","GBG","RBB",1,0,1,1,0,"run081"
"16310","GBG","RBG",0,1,1,1,0,"run081"
"16311","GBG","RGG",0,1,1,1,0,"run081"
"16312","GBG","RGR",1,3,4,4,0,"run081"
"16313","GBG","RRG",1,3,4,0,4,"run081"
"16314","GGB","BBB",3,16,19,14,5,"run081"
"16315","GGB","BBR",1,4,5,4,1,"run081"
"16316","GGB","BGB",0,3,3,2,1,"run081"
"16317","GGB","BGG",0,4,4,0,4,"run081"
"16318","GGB","BRB",0,1,1,0,1,"run081"
"16319","GGB","BRR",1,15,16,1,15,"run081"
"16320","GGB","GBB",0,1,1,0,1,"run081"
"16321","GGB","GBG",1,0,1,0,1,"run081"
"16322","GGB","GGG",13,48,61,30,31,"run081"
"16323","GGB","GGR",0,7,7,6,1,"run081"
"16324","GGB","GRR",0,4,4,1,3,"run081"
"16325","GGB","RBB",0,5,5,2,3,"run081"
"16326","GGB","RBG",0,4,4,1,3,"run081"
"16327","GGB","RBR",0,5,5,3,2,"run081"
"16328","GGB","RGG",1,5,6,3,3,"run081"
"16329","GGB","RGR",0,2,2,2,0,"run081"
"16330","GGB","RRG",1,5,6,2,4,"run081"
"16331","GGB","RRR",1,5,6,0,6,"run081"
"16332","GGG","BBB",8,31,39,1,38,"run081"
"16333","GGG","BGB",0,2,2,0,2,"run081"
"16334","GGG","BGG",1,7,8,1,7,"run081"
"16335","GGG","BRB",1,3,4,0,4,"run081"
"16336","GGG","BRR",0,6,6,4,2,"run081"
"16337","GGG","GGB",5,1,6,6,0,"run081"
"16338","GGG","GGR",1,9,10,8,2,"run081"
"16339","GGG","GRR",0,2,2,0,2,"run081"
"16340","GGG","RBB",1,8,9,3,6,"run081"
"16341","GGG","RBG",0,6,6,0,6,"run081"
"16342","GGG","RBR",0,21,21,15,6,"run081"
"16343","GGG","RGG",0,3,3,0,3,"run081"
"16344","GGG","RGR",1,12,13,5,8,"run081"
"16345","GGG","RRG",1,23,24,4,20,"run081"
"16346","GGG","RRR",0,3,3,3,0,"run081"
"16347","GGR","BBB",0,2,2,2,0,"run081"
"16348","GGR","BBR",0,2,2,1,1,"run081"
"16349","GGR","BGG",0,1,1,1,0,"run081"
"16350","GGR","BRR",1,0,1,0,1,"run081"
"16351","GGR","GRR",1,0,1,1,0,"run081"
"16352","GGR","RBB",0,2,2,0,2,"run081"
"16353","GRG","BBB",3,8,11,8,3,"run081"
"16354","GRG","BBR",0,1,1,1,0,"run081"
"16355","GRG","BGG",0,1,1,1,0,"run081"
"16356","GRG","BRB",0,3,3,1,2,"run081"
"16357","GRG","BRR",0,1,1,1,0,"run081"
"16358","GRG","GBG",0,1,1,1,0,"run081"
"16359","GRG","GGB",2,15,17,6,11,"run081"
"16360","GRG","GGG",3,12,15,13,2,"run081"
"16361","GRG","GGR",0,5,5,1,4,"run081"
"16362","GRG","GRR",0,1,1,1,0,"run081"
"16363","GRG","RBG",0,1,1,0,1,"run081"
"16364","GRG","RBR",0,1,1,1,0,"run081"
"16365","GRG","RGR",1,2,3,1,2,"run081"
"16366","GRG","RRG",2,4,6,2,4,"run081"
"16367","GRR","BBB",0,1,1,0,1,"run081"
"16368","GRR","BBR",0,1,1,1,0,"run081"
"16369","GRR","BGB",1,2,3,1,2,"run081"
"16370","GRR","BGG",0,2,2,0,2,"run081"
"16371","GRR","BRB",0,1,1,0,1,"run081"
"16372","GRR","BRR",0,2,2,2,0,"run081"
"16373","GRR","GGG",0,1,1,1,0,"run081"
"16374","GRR","GGR",0,1,1,1,0,"run081"
"16375","RBB","BBB",0,1,1,1,0,"run081"
"16376","RBB","BBR",0,1,1,0,1,"run081"
"16377","RBB","BRB",0,1,1,0,1,"run081"
"16378","RBB","GRR",0,1,1,1,0,"run081"
"16379","RBB","RGG",0,1,1,1,0,"run081"
"16380","RBG","BBB",2,8,10,8,2,"run081"
"16381","RBG","BBG",0,1,1,1,0,"run081"
"16382","RBG","BRR",0,1,1,1,0,"run081"
"16383","RBG","GBB",0,1,1,0,1,"run081"
"16384","RBG","GRR",0,3,3,3,0,"run081"
"16385","RBG","RBB",1,1,2,1,1,"run081"
"16386","RBG","RBR",0,1,1,1,0,"run081"
"16387","RBG","RGR",0,1,1,0,1,"run081"
"16388","RBR","BBB",0,13,13,11,2,"run081"
"16389","RBR","BBR",0,1,1,0,1,"run081"
"16390","RBR","BGB",2,4,6,2,4,"run081"
"16391","RBR","BGG",0,2,2,1,1,"run081"
"16392","RBR","BRB",1,0,1,0,1,"run081"
"16393","RBR","BRR",1,4,5,3,2,"run081"
"16394","RBR","GGB",0,12,12,2,10,"run081"
"16395","RBR","GRR",4,4,8,0,8,"run081"
"16396","RBR","RBB",0,3,3,2,1,"run081"
"16397","RBR","RGG",2,9,11,9,2,"run081"
"16398","RBR","RGR",1,0,1,0,1,"run081"
"16399","RBR","RRR",0,1,1,0,1,"run081"
"16400","RGG","BBB",0,8,8,2,6,"run081"
"16401","RGG","BBR",1,2,3,0,3,"run081"
"16402","RGG","BGB",0,1,1,0,1,"run081"
"16403","RGG","BRR",0,4,4,3,1,"run081"
"16404","RGG","GGG",0,1,1,0,1,"run081"
"16405","RGG","GGR",0,3,3,3,0,"run081"
"16406","RGG","GRR",0,8,8,7,1,"run081"
"16407","RGG","RBB",0,1,1,1,0,"run081"
"16408","RGR","BBB",2,5,7,0,7,"run081"
"16409","RGR","BBR",1,1,2,1,1,"run081"
"16410","RGR","BGB",2,5,7,6,1,"run081"
"16411","RGR","BGG",2,2,4,4,0,"run081"
"16412","RGR","BRR",1,5,6,1,5,"run081"
"16413","RGR","GGB",2,12,14,14,0,"run081"
"16414","RGR","GGG",0,2,2,1,1,"run081"
"16415","RGR","GGR",0,4,4,2,2,"run081"
"16416","RGR","RBB",0,4,4,2,2,"run081"
"16417","RGR","RGG",1,1,2,2,0,"run081"
"16418","RGR","RRG",0,3,3,0,3,"run081"
"16419","RRG","BBB",2,33,35,25,10,"run081"
"16420","RRG","BBR",0,5,5,2,3,"run081"
"16421","RRG","BGB",1,10,11,3,8,"run081"
"16422","RRG","BGG",0,2,2,1,1,"run081"
"16423","RRG","BRB",2,40,42,37,5,"run081"
"16424","RRG","BRR",1,16,17,2,15,"run081"
"16425","RRG","GGG",2,14,16,6,10,"run081"
"16426","RRG","GGR",0,5,5,0,5,"run081"
"16427","RRG","GRG",1,0,1,1,0,"run081"
"16428","RRG","GRR",3,8,11,11,0,"run081"
"16429","RRG","RBB",1,1,2,1,1,"run081"
"16430","RRG","RGG",0,1,1,0,1,"run081"
"16431","RRG","RGR",0,1,1,0,1,"run081"
"16432","RRR","BBR",1,0,1,1,0,"run081"
"16433","RRR","BGB",2,1,3,1,2,"run081"
"16434","RRR","BGG",1,0,1,0,1,"run081"
"16435","RRR","BRB",1,1,2,1,1,"run081"
"16436","RRR","BRR",1,1,2,0,2,"run081"
"16437","RRR","GGR",0,1,1,1,0,"run081"
"16438","RRR","GRR",0,3,3,1,2,"run081"
"16439","RRR","RBB",1,2,3,2,1,"run081"
"16440","RRR","RBR",0,2,2,0,2,"run081"
"16441","RRR","RGG",0,1,1,0,1,"run081"
"16442","RRR","RGR",1,2,3,0,3,"run081"
"16443","RRR","RRG",2,2,4,4,0,"run081"
"16444","BBB","BRB",0,1,1,1,0,"run082"
"16445","BBB","GGG",1,2,3,0,3,"run082"
"16446","BBB","GRR",0,2,2,2,0,"run082"
"16447","BBB","RBG",0,1,1,0,1,"run082"
"16448","BBB","RRG",1,3,4,2,2,"run082"
"16449","BBB","RRR",0,2,2,1,1,"run082"
"16450","BBG","BBB",1,4,5,5,0,"run082"
"16451","BBG","BGB",0,1,1,0,1,"run082"
"16452","BBG","BGG",0,1,1,0,1,"run082"
"16453","BBG","BRB",1,16,17,10,7,"run082"
"16454","BBG","GBB",0,1,1,0,1,"run082"
"16455","BBG","GBG",2,7,9,3,6,"run082"
"16456","BBG","GGB",2,25,27,7,20,"run082"
"16457","BBG","GGG",4,38,42,5,37,"run082"
"16458","BBG","GRG",1,9,10,10,0,"run082"
"16459","BBG","GRR",0,1,1,0,1,"run082"
"16460","BBG","RBB",0,1,1,0,1,"run082"
"16461","BBG","RBG",0,4,4,0,4,"run082"
"16462","BBG","RBR",0,1,1,1,0,"run082"
"16463","BBG","RGR",0,1,1,1,0,"run082"
"16464","BBG","RRG",1,2,3,3,0,"run082"
"16465","BBG","RRR",0,7,7,4,3,"run082"
"16466","BGB","BBB",0,2,2,1,1,"run082"
"16467","BGB","RRG",0,1,1,1,0,"run082"
"16468","BGG","BBB",0,3,3,3,0,"run082"
"16469","BGG","BBR",0,1,1,0,1,"run082"
"16470","BGG","GRG",0,1,1,0,1,"run082"
"16471","BGG","RBG",1,1,2,0,2,"run082"
"16472","BGG","RGG",0,3,3,2,1,"run082"
"16473","BGG","RGR",0,1,1,1,0,"run082"
"16474","BGG","RRR",1,1,2,1,1,"run082"
"16475","BRB","BBB",0,13,13,3,10,"run082"
"16476","BRB","BBR",0,1,1,1,0,"run082"
"16477","BRB","BRR",0,3,3,2,1,"run082"
"16478","BRB","GGG",0,1,1,0,1,"run082"
"16479","BRB","GGR",0,1,1,1,0,"run082"
"16480","BRB","RBB",0,1,1,0,1,"run082"
"16481","BRB","RBG",0,1,1,0,1,"run082"
"16482","BRB","RGR",0,1,1,1,0,"run082"
"16483","BRB","RRR",0,1,1,1,0,"run082"
"16484","BRR","BBB",0,11,11,6,5,"run082"
"16485","BRR","BGB",1,1,2,1,1,"run082"
"16486","BRR","BGG",0,1,1,0,1,"run082"
"16487","BRR","BRB",0,1,1,0,1,"run082"
"16488","BRR","RBB",0,2,2,1,1,"run082"
"16489","GBB","BBB",12,38,50,5,45,"run082"
"16490","GBB","BGG",0,1,1,1,0,"run082"
"16491","GBB","BRB",1,9,10,6,4,"run082"
"16492","GBB","BRR",1,3,4,2,2,"run082"
"16493","GBB","GBG",0,4,4,4,0,"run082"
"16494","GBB","GGB",0,21,21,15,6,"run082"
"16495","GBB","GGG",7,86,93,32,61,"run082"
"16496","GBB","GGR",1,3,4,1,3,"run082"
"16497","GBB","GRG",0,6,6,1,5,"run082"
"16498","GBB","GRR",0,1,1,0,1,"run082"
"16499","GBB","RBB",0,2,2,1,1,"run082"
"16500","GBB","RBG",3,9,12,12,0,"run082"
"16501","GBB","RBR",1,0,1,1,0,"run082"
"16502","GBB","RGG",1,0,1,1,0,"run082"
"16503","GBB","RGR",2,1,3,3,0,"run082"
"16504","GBB","RRG",0,2,2,2,0,"run082"
"16505","GBB","RRR",1,9,10,5,5,"run082"
"16506","GBG","BBB",0,5,5,2,3,"run082"
"16507","GBG","BBR",0,1,1,0,1,"run082"
"16508","GBG","BRB",1,4,5,3,2,"run082"
"16509","GBG","BRR",1,0,1,1,0,"run082"
"16510","GBG","GGB",0,4,4,0,4,"run082"
"16511","GBG","GGG",4,11,15,0,15,"run082"
"16512","GBG","RBB",1,0,1,1,0,"run082"
"16513","GBG","RBG",0,1,1,1,0,"run082"
"16514","GBG","RGG",0,1,1,1,0,"run082"
"16515","GBG","RGR",1,3,4,2,2,"run082"
"16516","GBG","RRG",1,3,4,4,0,"run082"
"16517","GGB","BBB",3,16,19,9,10,"run082"
"16518","GGB","BBR",1,4,5,0,5,"run082"
"16519","GGB","BGB",0,3,3,2,1,"run082"
"16520","GGB","BGG",0,4,4,0,4,"run082"
"16521","GGB","BRB",0,1,1,1,0,"run082"
"16522","GGB","BRR",1,15,16,0,16,"run082"
"16523","GGB","GBB",0,1,1,1,0,"run082"
"16524","GGB","GBG",1,0,1,0,1,"run082"
"16525","GGB","GGG",13,48,61,17,44,"run082"
"16526","GGB","GGR",0,7,7,1,6,"run082"
"16527","GGB","GRR",0,4,4,3,1,"run082"
"16528","GGB","RBB",0,5,5,4,1,"run082"
"16529","GGB","RBG",0,4,4,4,0,"run082"
"16530","GGB","RBR",0,5,5,5,0,"run082"
"16531","GGB","RGG",1,5,6,5,1,"run082"
"16532","GGB","RGR",0,2,2,2,0,"run082"
"16533","GGB","RRG",1,5,6,1,5,"run082"
"16534","GGB","RRR",1,5,6,5,1,"run082"
"16535","GGG","BBB",8,31,39,15,24,"run082"
"16536","GGG","BGB",0,2,2,0,2,"run082"
"16537","GGG","BGG",1,7,8,4,4,"run082"
"16538","GGG","BRB",1,3,4,1,3,"run082"
"16539","GGG","BRR",0,6,6,3,3,"run082"
"16540","GGG","GGB",5,1,6,5,1,"run082"
"16541","GGG","GGR",1,9,10,8,2,"run082"
"16542","GGG","GRR",0,2,2,1,1,"run082"
"16543","GGG","RBB",1,8,9,2,7,"run082"
"16544","GGG","RBG",0,6,6,6,0,"run082"
"16545","GGG","RBR",0,21,21,4,17,"run082"
"16546","GGG","RGG",0,3,3,2,1,"run082"
"16547","GGG","RGR",1,12,13,2,11,"run082"
"16548","GGG","RRG",1,23,24,14,10,"run082"
"16549","GGG","RRR",0,3,3,2,1,"run082"
"16550","GGR","BBB",0,2,2,2,0,"run082"
"16551","GGR","BBR",0,2,2,1,1,"run082"
"16552","GGR","BGG",0,1,1,0,1,"run082"
"16553","GGR","BRR",1,0,1,0,1,"run082"
"16554","GGR","GRR",1,0,1,0,1,"run082"
"16555","GGR","RBB",0,2,2,2,0,"run082"
"16556","GRG","BBB",3,8,11,2,9,"run082"
"16557","GRG","BBR",0,1,1,1,0,"run082"
"16558","GRG","BGG",0,1,1,0,1,"run082"
"16559","GRG","BRB",0,3,3,2,1,"run082"
"16560","GRG","BRR",0,1,1,1,0,"run082"
"16561","GRG","GBG",0,1,1,1,0,"run082"
"16562","GRG","GGB",2,15,17,1,16,"run082"
"16563","GRG","GGG",3,12,15,0,15,"run082"
"16564","GRG","GGR",0,5,5,3,2,"run082"
"16565","GRG","GRR",0,1,1,1,0,"run082"
"16566","GRG","RBG",0,1,1,1,0,"run082"
"16567","GRG","RBR",0,1,1,0,1,"run082"
"16568","GRG","RGR",1,2,3,2,1,"run082"
"16569","GRG","RRG",2,4,6,0,6,"run082"
"16570","GRR","BBB",0,1,1,1,0,"run082"
"16571","GRR","BBR",0,1,1,1,0,"run082"
"16572","GRR","BGB",1,2,3,3,0,"run082"
"16573","GRR","BGG",0,2,2,0,2,"run082"
"16574","GRR","BRB",0,1,1,1,0,"run082"
"16575","GRR","BRR",0,2,2,0,2,"run082"
"16576","GRR","GGG",0,1,1,0,1,"run082"
"16577","GRR","GGR",0,1,1,0,1,"run082"
"16578","RBB","BBB",0,1,1,1,0,"run082"
"16579","RBB","BBR",0,1,1,0,1,"run082"
"16580","RBB","BRB",0,1,1,1,0,"run082"
"16581","RBB","GRR",0,1,1,0,1,"run082"
"16582","RBB","RGG",0,1,1,1,0,"run082"
"16583","RBG","BBB",2,8,10,8,2,"run082"
"16584","RBG","BBG",0,1,1,1,0,"run082"
"16585","RBG","BRR",0,1,1,1,0,"run082"
"16586","RBG","GBB",0,1,1,1,0,"run082"
"16587","RBG","GRR",0,3,3,1,2,"run082"
"16588","RBG","RBB",1,1,2,0,2,"run082"
"16589","RBG","RBR",0,1,1,1,0,"run082"
"16590","RBG","RGR",0,1,1,1,0,"run082"
"16591","RBR","BBB",0,13,13,4,9,"run082"
"16592","RBR","BBR",0,1,1,0,1,"run082"
"16593","RBR","BGB",2,4,6,3,3,"run082"
"16594","RBR","BGG",0,2,2,1,1,"run082"
"16595","RBR","BRB",1,0,1,0,1,"run082"
"16596","RBR","BRR",1,4,5,0,5,"run082"
"16597","RBR","GGB",0,12,12,11,1,"run082"
"16598","RBR","GRR",4,4,8,1,7,"run082"
"16599","RBR","RBB",0,3,3,0,3,"run082"
"16600","RBR","RGG",2,9,11,0,11,"run082"
"16601","RBR","RGR",1,0,1,1,0,"run082"
"16602","RBR","RRR",0,1,1,0,1,"run082"
"16603","RGG","BBB",0,8,8,7,1,"run082"
"16604","RGG","BBR",1,2,3,1,2,"run082"
"16605","RGG","BGB",0,1,1,1,0,"run082"
"16606","RGG","BRR",0,4,4,1,3,"run082"
"16607","RGG","GGG",0,1,1,0,1,"run082"
"16608","RGG","GGR",0,3,3,2,1,"run082"
"16609","RGG","GRR",0,8,8,2,6,"run082"
"16610","RGG","RBB",0,1,1,0,1,"run082"
"16611","RGR","BBB",2,5,7,4,3,"run082"
"16612","RGR","BBR",1,1,2,2,0,"run082"
"16613","RGR","BGB",2,5,7,7,0,"run082"
"16614","RGR","BGG",2,2,4,2,2,"run082"
"16615","RGR","BRR",1,5,6,3,3,"run082"
"16616","RGR","GGB",2,12,14,11,3,"run082"
"16617","RGR","GGG",0,2,2,0,2,"run082"
"16618","RGR","GGR",0,4,4,4,0,"run082"
"16619","RGR","RBB",0,4,4,1,3,"run082"
"16620","RGR","RGG",1,1,2,1,1,"run082"
"16621","RGR","RRG",0,3,3,3,0,"run082"
"16622","RRG","BBB",2,33,35,12,23,"run082"
"16623","RRG","BBR",0,5,5,1,4,"run082"
"16624","RRG","BGB",1,10,11,1,10,"run082"
"16625","RRG","BGG",0,2,2,2,0,"run082"
"16626","RRG","BRB",2,40,42,29,13,"run082"
"16627","RRG","BRR",1,16,17,1,16,"run082"
"16628","RRG","GGG",2,14,16,11,5,"run082"
"16629","RRG","GGR",0,5,5,0,5,"run082"
"16630","RRG","GRG",1,0,1,1,0,"run082"
"16631","RRG","GRR",3,8,11,10,1,"run082"
"16632","RRG","RBB",1,1,2,0,2,"run082"
"16633","RRG","RGG",0,1,1,1,0,"run082"
"16634","RRG","RGR",0,1,1,1,0,"run082"
"16635","RRR","BBR",1,0,1,1,0,"run082"
"16636","RRR","BGB",2,1,3,1,2,"run082"
"16637","RRR","BGG",1,0,1,0,1,"run082"
"16638","RRR","BRB",1,1,2,1,1,"run082"
"16639","RRR","BRR",1,1,2,2,0,"run082"
"16640","RRR","GGR",0,1,1,0,1,"run082"
"16641","RRR","GRR",0,3,3,0,3,"run082"
"16642","RRR","RBB",1,2,3,2,1,"run082"
"16643","RRR","RBR",0,2,2,1,1,"run082"
"16644","RRR","RGG",0,1,1,1,0,"run082"
"16645","RRR","RGR",1,2,3,3,0,"run082"
"16646","RRR","RRG",2,2,4,2,2,"run082"
"16647","BBB","BRB",0,1,1,0,1,"run083"
"16648","BBB","GGG",1,2,3,1,2,"run083"
"16649","BBB","GRR",0,2,2,1,1,"run083"
"16650","BBB","RBG",0,1,1,0,1,"run083"
"16651","BBB","RRG",1,3,4,0,4,"run083"
"16652","BBB","RRR",0,2,2,2,0,"run083"
"16653","BBG","BBB",1,4,5,5,0,"run083"
"16654","BBG","BGB",0,1,1,1,0,"run083"
"16655","BBG","BGG",0,1,1,1,0,"run083"
"16656","BBG","BRB",1,16,17,16,1,"run083"
"16657","BBG","GBB",0,1,1,0,1,"run083"
"16658","BBG","GBG",2,7,9,5,4,"run083"
"16659","BBG","GGB",2,25,27,27,0,"run083"
"16660","BBG","GGG",4,38,42,17,25,"run083"
"16661","BBG","GRG",1,9,10,9,1,"run083"
"16662","BBG","GRR",0,1,1,1,0,"run083"
"16663","BBG","RBB",0,1,1,0,1,"run083"
"16664","BBG","RBG",0,4,4,1,3,"run083"
"16665","BBG","RBR",0,1,1,0,1,"run083"
"16666","BBG","RGR",0,1,1,0,1,"run083"
"16667","BBG","RRG",1,2,3,3,0,"run083"
"16668","BBG","RRR",0,7,7,6,1,"run083"
"16669","BGB","BBB",0,2,2,1,1,"run083"
"16670","BGB","RRG",0,1,1,0,1,"run083"
"16671","BGG","BBB",0,3,3,2,1,"run083"
"16672","BGG","BBR",0,1,1,0,1,"run083"
"16673","BGG","GRG",0,1,1,1,0,"run083"
"16674","BGG","RBG",1,1,2,2,0,"run083"
"16675","BGG","RGG",0,3,3,1,2,"run083"
"16676","BGG","RGR",0,1,1,1,0,"run083"
"16677","BGG","RRR",1,1,2,1,1,"run083"
"16678","BRB","BBB",0,13,13,3,10,"run083"
"16679","BRB","BBR",0,1,1,1,0,"run083"
"16680","BRB","BRR",0,3,3,3,0,"run083"
"16681","BRB","GGG",0,1,1,1,0,"run083"
"16682","BRB","GGR",0,1,1,0,1,"run083"
"16683","BRB","RBB",0,1,1,0,1,"run083"
"16684","BRB","RBG",0,1,1,1,0,"run083"
"16685","BRB","RGR",0,1,1,1,0,"run083"
"16686","BRB","RRR",0,1,1,1,0,"run083"
"16687","BRR","BBB",0,11,11,5,6,"run083"
"16688","BRR","BGB",1,1,2,2,0,"run083"
"16689","BRR","BGG",0,1,1,0,1,"run083"
"16690","BRR","BRB",0,1,1,0,1,"run083"
"16691","BRR","RBB",0,2,2,2,0,"run083"
"16692","GBB","BBB",12,38,50,4,46,"run083"
"16693","GBB","BGG",0,1,1,0,1,"run083"
"16694","GBB","BRB",1,9,10,7,3,"run083"
"16695","GBB","BRR",1,3,4,0,4,"run083"
"16696","GBB","GBG",0,4,4,4,0,"run083"
"16697","GBB","GGB",0,21,21,7,14,"run083"
"16698","GBB","GGG",7,86,93,69,24,"run083"
"16699","GBB","GGR",1,3,4,0,4,"run083"
"16700","GBB","GRG",0,6,6,5,1,"run083"
"16701","GBB","GRR",0,1,1,0,1,"run083"
"16702","GBB","RBB",0,2,2,0,2,"run083"
"16703","GBB","RBG",3,9,12,10,2,"run083"
"16704","GBB","RBR",1,0,1,0,1,"run083"
"16705","GBB","RGG",1,0,1,0,1,"run083"
"16706","GBB","RGR",2,1,3,2,1,"run083"
"16707","GBB","RRG",0,2,2,1,1,"run083"
"16708","GBB","RRR",1,9,10,5,5,"run083"
"16709","GBG","BBB",0,5,5,3,2,"run083"
"16710","GBG","BBR",0,1,1,1,0,"run083"
"16711","GBG","BRB",1,4,5,5,0,"run083"
"16712","GBG","BRR",1,0,1,1,0,"run083"
"16713","GBG","GGB",0,4,4,2,2,"run083"
"16714","GBG","GGG",4,11,15,13,2,"run083"
"16715","GBG","RBB",1,0,1,1,0,"run083"
"16716","GBG","RBG",0,1,1,0,1,"run083"
"16717","GBG","RGG",0,1,1,0,1,"run083"
"16718","GBG","RGR",1,3,4,1,3,"run083"
"16719","GBG","RRG",1,3,4,1,3,"run083"
"16720","GGB","BBB",3,16,19,15,4,"run083"
"16721","GGB","BBR",1,4,5,0,5,"run083"
"16722","GGB","BGB",0,3,3,1,2,"run083"
"16723","GGB","BGG",0,4,4,2,2,"run083"
"16724","GGB","BRB",0,1,1,0,1,"run083"
"16725","GGB","BRR",1,15,16,0,16,"run083"
"16726","GGB","GBB",0,1,1,0,1,"run083"
"16727","GGB","GBG",1,0,1,0,1,"run083"
"16728","GGB","GGG",13,48,61,25,36,"run083"
"16729","GGB","GGR",0,7,7,4,3,"run083"
"16730","GGB","GRR",0,4,4,0,4,"run083"
"16731","GGB","RBB",0,5,5,2,3,"run083"
"16732","GGB","RBG",0,4,4,2,2,"run083"
"16733","GGB","RBR",0,5,5,2,3,"run083"
"16734","GGB","RGG",1,5,6,3,3,"run083"
"16735","GGB","RGR",0,2,2,2,0,"run083"
"16736","GGB","RRG",1,5,6,0,6,"run083"
"16737","GGB","RRR",1,5,6,0,6,"run083"
"16738","GGG","BBB",8,31,39,28,11,"run083"
"16739","GGG","BGB",0,2,2,0,2,"run083"
"16740","GGG","BGG",1,7,8,0,8,"run083"
"16741","GGG","BRB",1,3,4,3,1,"run083"
"16742","GGG","BRR",0,6,6,3,3,"run083"
"16743","GGG","GGB",5,1,6,6,0,"run083"
"16744","GGG","GGR",1,9,10,7,3,"run083"
"16745","GGG","GRR",0,2,2,1,1,"run083"
"16746","GGG","RBB",1,8,9,9,0,"run083"
"16747","GGG","RBG",0,6,6,5,1,"run083"
"16748","GGG","RBR",0,21,21,8,13,"run083"
"16749","GGG","RGG",0,3,3,0,3,"run083"
"16750","GGG","RGR",1,12,13,10,3,"run083"
"16751","GGG","RRG",1,23,24,19,5,"run083"
"16752","GGG","RRR",0,3,3,1,2,"run083"
"16753","GGR","BBB",0,2,2,2,0,"run083"
"16754","GGR","BBR",0,2,2,2,0,"run083"
"16755","GGR","BGG",0,1,1,1,0,"run083"
"16756","GGR","BRR",1,0,1,0,1,"run083"
"16757","GGR","GRR",1,0,1,0,1,"run083"
"16758","GGR","RBB",0,2,2,1,1,"run083"
"16759","GRG","BBB",3,8,11,10,1,"run083"
"16760","GRG","BBR",0,1,1,0,1,"run083"
"16761","GRG","BGG",0,1,1,1,0,"run083"
"16762","GRG","BRB",0,3,3,1,2,"run083"
"16763","GRG","BRR",0,1,1,1,0,"run083"
"16764","GRG","GBG",0,1,1,0,1,"run083"
"16765","GRG","GGB",2,15,17,3,14,"run083"
"16766","GRG","GGG",3,12,15,5,10,"run083"
"16767","GRG","GGR",0,5,5,0,5,"run083"
"16768","GRG","GRR",0,1,1,1,0,"run083"
"16769","GRG","RBG",0,1,1,0,1,"run083"
"16770","GRG","RBR",0,1,1,1,0,"run083"
"16771","GRG","RGR",1,2,3,3,0,"run083"
"16772","GRG","RRG",2,4,6,1,5,"run083"
"16773","GRR","BBB",0,1,1,0,1,"run083"
"16774","GRR","BBR",0,1,1,1,0,"run083"
"16775","GRR","BGB",1,2,3,0,3,"run083"
"16776","GRR","BGG",0,2,2,1,1,"run083"
"16777","GRR","BRB",0,1,1,0,1,"run083"
"16778","GRR","BRR",0,2,2,2,0,"run083"
"16779","GRR","GGG",0,1,1,0,1,"run083"
"16780","GRR","GGR",0,1,1,0,1,"run083"
"16781","RBB","BBB",0,1,1,1,0,"run083"
"16782","RBB","BBR",0,1,1,1,0,"run083"
"16783","RBB","BRB",0,1,1,0,1,"run083"
"16784","RBB","GRR",0,1,1,1,0,"run083"
"16785","RBB","RGG",0,1,1,0,1,"run083"
"16786","RBG","BBB",2,8,10,1,9,"run083"
"16787","RBG","BBG",0,1,1,0,1,"run083"
"16788","RBG","BRR",0,1,1,0,1,"run083"
"16789","RBG","GBB",0,1,1,1,0,"run083"
"16790","RBG","GRR",0,3,3,1,2,"run083"
"16791","RBG","RBB",1,1,2,2,0,"run083"
"16792","RBG","RBR",0,1,1,0,1,"run083"
"16793","RBG","RGR",0,1,1,1,0,"run083"
"16794","RBR","BBB",0,13,13,7,6,"run083"
"16795","RBR","BBR",0,1,1,1,0,"run083"
"16796","RBR","BGB",2,4,6,6,0,"run083"
"16797","RBR","BGG",0,2,2,2,0,"run083"
"16798","RBR","BRB",1,0,1,0,1,"run083"
"16799","RBR","BRR",1,4,5,1,4,"run083"
"16800","RBR","GGB",0,12,12,10,2,"run083"
"16801","RBR","GRR",4,4,8,2,6,"run083"
"16802","RBR","RBB",0,3,3,1,2,"run083"
"16803","RBR","RGG",2,9,11,6,5,"run083"
"16804","RBR","RGR",1,0,1,0,1,"run083"
"16805","RBR","RRR",0,1,1,0,1,"run083"
"16806","RGG","BBB",0,8,8,6,2,"run083"
"16807","RGG","BBR",1,2,3,2,1,"run083"
"16808","RGG","BGB",0,1,1,1,0,"run083"
"16809","RGG","BRR",0,4,4,3,1,"run083"
"16810","RGG","GGG",0,1,1,1,0,"run083"
"16811","RGG","GGR",0,3,3,3,0,"run083"
"16812","RGG","GRR",0,8,8,2,6,"run083"
"16813","RGG","RBB",0,1,1,1,0,"run083"
"16814","RGR","BBB",2,5,7,5,2,"run083"
"16815","RGR","BBR",1,1,2,1,1,"run083"
"16816","RGR","BGB",2,5,7,6,1,"run083"
"16817","RGR","BGG",2,2,4,1,3,"run083"
"16818","RGR","BRR",1,5,6,1,5,"run083"
"16819","RGR","GGB",2,12,14,6,8,"run083"
"16820","RGR","GGG",0,2,2,0,2,"run083"
"16821","RGR","GGR",0,4,4,1,3,"run083"
"16822","RGR","RBB",0,4,4,1,3,"run083"
"16823","RGR","RGG",1,1,2,2,0,"run083"
"16824","RGR","RRG",0,3,3,3,0,"run083"
"16825","RRG","BBB",2,33,35,8,27,"run083"
"16826","RRG","BBR",0,5,5,3,2,"run083"
"16827","RRG","BGB",1,10,11,8,3,"run083"
"16828","RRG","BGG",0,2,2,0,2,"run083"
"16829","RRG","BRB",2,40,42,27,15,"run083"
"16830","RRG","BRR",1,16,17,7,10,"run083"
"16831","RRG","GGG",2,14,16,14,2,"run083"
"16832","RRG","GGR",0,5,5,4,1,"run083"
"16833","RRG","GRG",1,0,1,1,0,"run083"
"16834","RRG","GRR",3,8,11,10,1,"run083"
"16835","RRG","RBB",1,1,2,1,1,"run083"
"16836","RRG","RGG",0,1,1,1,0,"run083"
"16837","RRG","RGR",0,1,1,1,0,"run083"
"16838","RRR","BBR",1,0,1,1,0,"run083"
"16839","RRR","BGB",2,1,3,2,1,"run083"
"16840","RRR","BGG",1,0,1,1,0,"run083"
"16841","RRR","BRB",1,1,2,1,1,"run083"
"16842","RRR","BRR",1,1,2,0,2,"run083"
"16843","RRR","GGR",0,1,1,0,1,"run083"
"16844","RRR","GRR",0,3,3,1,2,"run083"
"16845","RRR","RBB",1,2,3,1,2,"run083"
"16846","RRR","RBR",0,2,2,2,0,"run083"
"16847","RRR","RGG",0,1,1,0,1,"run083"
"16848","RRR","RGR",1,2,3,3,0,"run083"
"16849","RRR","RRG",2,2,4,2,2,"run083"
"16850","BBB","BRB",0,1,1,1,0,"run084"
"16851","BBB","GGG",1,2,3,2,1,"run084"
"16852","BBB","GRR",0,2,2,1,1,"run084"
"16853","BBB","RBG",0,1,1,0,1,"run084"
"16854","BBB","RRG",1,3,4,3,1,"run084"
"16855","BBB","RRR",0,2,2,0,2,"run084"
"16856","BBG","BBB",1,4,5,4,1,"run084"
"16857","BBG","BGB",0,1,1,0,1,"run084"
"16858","BBG","BGG",0,1,1,1,0,"run084"
"16859","BBG","BRB",1,16,17,14,3,"run084"
"16860","BBG","GBB",0,1,1,0,1,"run084"
"16861","BBG","GBG",2,7,9,4,5,"run084"
"16862","BBG","GGB",2,25,27,16,11,"run084"
"16863","BBG","GGG",4,38,42,23,19,"run084"
"16864","BBG","GRG",1,9,10,4,6,"run084"
"16865","BBG","GRR",0,1,1,0,1,"run084"
"16866","BBG","RBB",0,1,1,0,1,"run084"
"16867","BBG","RBG",0,4,4,4,0,"run084"
"16868","BBG","RBR",0,1,1,1,0,"run084"
"16869","BBG","RGR",0,1,1,0,1,"run084"
"16870","BBG","RRG",1,2,3,2,1,"run084"
"16871","BBG","RRR",0,7,7,1,6,"run084"
"16872","BGB","BBB",0,2,2,2,0,"run084"
"16873","BGB","RRG",0,1,1,1,0,"run084"
"16874","BGG","BBB",0,3,3,0,3,"run084"
"16875","BGG","BBR",0,1,1,1,0,"run084"
"16876","BGG","GRG",0,1,1,0,1,"run084"
"16877","BGG","RBG",1,1,2,2,0,"run084"
"16878","BGG","RGG",0,3,3,3,0,"run084"
"16879","BGG","RGR",0,1,1,0,1,"run084"
"16880","BGG","RRR",1,1,2,0,2,"run084"
"16881","BRB","BBB",0,13,13,3,10,"run084"
"16882","BRB","BBR",0,1,1,1,0,"run084"
"16883","BRB","BRR",0,3,3,2,1,"run084"
"16884","BRB","GGG",0,1,1,0,1,"run084"
"16885","BRB","GGR",0,1,1,0,1,"run084"
"16886","BRB","RBB",0,1,1,0,1,"run084"
"16887","BRB","RBG",0,1,1,0,1,"run084"
"16888","BRB","RGR",0,1,1,0,1,"run084"
"16889","BRB","RRR",0,1,1,0,1,"run084"
"16890","BRR","BBB",0,11,11,1,10,"run084"
"16891","BRR","BGB",1,1,2,1,1,"run084"
"16892","BRR","BGG",0,1,1,0,1,"run084"
"16893","BRR","BRB",0,1,1,1,0,"run084"
"16894","BRR","RBB",0,2,2,0,2,"run084"
"16895","GBB","BBB",12,38,50,24,26,"run084"
"16896","GBB","BGG",0,1,1,1,0,"run084"
"16897","GBB","BRB",1,9,10,6,4,"run084"
"16898","GBB","BRR",1,3,4,4,0,"run084"
"16899","GBB","GBG",0,4,4,3,1,"run084"
"16900","GBB","GGB",0,21,21,14,7,"run084"
"16901","GBB","GGG",7,86,93,68,25,"run084"
"16902","GBB","GGR",1,3,4,3,1,"run084"
"16903","GBB","GRG",0,6,6,1,5,"run084"
"16904","GBB","GRR",0,1,1,0,1,"run084"
"16905","GBB","RBB",0,2,2,2,0,"run084"
"16906","GBB","RBG",3,9,12,7,5,"run084"
"16907","GBB","RBR",1,0,1,0,1,"run084"
"16908","GBB","RGG",1,0,1,1,0,"run084"
"16909","GBB","RGR",2,1,3,3,0,"run084"
"16910","GBB","RRG",0,2,2,1,1,"run084"
"16911","GBB","RRR",1,9,10,3,7,"run084"
"16912","GBG","BBB",0,5,5,4,1,"run084"
"16913","GBG","BBR",0,1,1,1,0,"run084"
"16914","GBG","BRB",1,4,5,2,3,"run084"
"16915","GBG","BRR",1,0,1,1,0,"run084"
"16916","GBG","GGB",0,4,4,4,0,"run084"
"16917","GBG","GGG",4,11,15,7,8,"run084"
"16918","GBG","RBB",1,0,1,1,0,"run084"
"16919","GBG","RBG",0,1,1,1,0,"run084"
"16920","GBG","RGG",0,1,1,1,0,"run084"
"16921","GBG","RGR",1,3,4,2,2,"run084"
"16922","GBG","RRG",1,3,4,1,3,"run084"
"16923","GGB","BBB",3,16,19,4,15,"run084"
"16924","GGB","BBR",1,4,5,5,0,"run084"
"16925","GGB","BGB",0,3,3,3,0,"run084"
"16926","GGB","BGG",0,4,4,3,1,"run084"
"16927","GGB","BRB",0,1,1,0,1,"run084"
"16928","GGB","BRR",1,15,16,10,6,"run084"
"16929","GGB","GBB",0,1,1,1,0,"run084"
"16930","GGB","GBG",1,0,1,0,1,"run084"
"16931","GGB","GGG",13,48,61,27,34,"run084"
"16932","GGB","GGR",0,7,7,1,6,"run084"
"16933","GGB","GRR",0,4,4,0,4,"run084"
"16934","GGB","RBB",0,5,5,2,3,"run084"
"16935","GGB","RBG",0,4,4,2,2,"run084"
"16936","GGB","RBR",0,5,5,4,1,"run084"
"16937","GGB","RGG",1,5,6,2,4,"run084"
"16938","GGB","RGR",0,2,2,2,0,"run084"
"16939","GGB","RRG",1,5,6,6,0,"run084"
"16940","GGB","RRR",1,5,6,0,6,"run084"
"16941","GGG","BBB",8,31,39,39,0,"run084"
"16942","GGG","BGB",0,2,2,2,0,"run084"
"16943","GGG","BGG",1,7,8,6,2,"run084"
"16944","GGG","BRB",1,3,4,0,4,"run084"
"16945","GGG","BRR",0,6,6,0,6,"run084"
"16946","GGG","GGB",5,1,6,3,3,"run084"
"16947","GGG","GGR",1,9,10,9,1,"run084"
"16948","GGG","GRR",0,2,2,2,0,"run084"
"16949","GGG","RBB",1,8,9,9,0,"run084"
"16950","GGG","RBG",0,6,6,1,5,"run084"
"16951","GGG","RBR",0,21,21,4,17,"run084"
"16952","GGG","RGG",0,3,3,0,3,"run084"
"16953","GGG","RGR",1,12,13,12,1,"run084"
"16954","GGG","RRG",1,23,24,24,0,"run084"
"16955","GGG","RRR",0,3,3,1,2,"run084"
"16956","GGR","BBB",0,2,2,2,0,"run084"
"16957","GGR","BBR",0,2,2,1,1,"run084"
"16958","GGR","BGG",0,1,1,0,1,"run084"
"16959","GGR","BRR",1,0,1,1,0,"run084"
"16960","GGR","GRR",1,0,1,1,0,"run084"
"16961","GGR","RBB",0,2,2,2,0,"run084"
"16962","GRG","BBB",3,8,11,11,0,"run084"
"16963","GRG","BBR",0,1,1,1,0,"run084"
"16964","GRG","BGG",0,1,1,1,0,"run084"
"16965","GRG","BRB",0,3,3,3,0,"run084"
"16966","GRG","BRR",0,1,1,0,1,"run084"
"16967","GRG","GBG",0,1,1,0,1,"run084"
"16968","GRG","GGB",2,15,17,14,3,"run084"
"16969","GRG","GGG",3,12,15,12,3,"run084"
"16970","GRG","GGR",0,5,5,4,1,"run084"
"16971","GRG","GRR",0,1,1,1,0,"run084"
"16972","GRG","RBG",0,1,1,1,0,"run084"
"16973","GRG","RBR",0,1,1,0,1,"run084"
"16974","GRG","RGR",1,2,3,1,2,"run084"
"16975","GRG","RRG",2,4,6,4,2,"run084"
"16976","GRR","BBB",0,1,1,1,0,"run084"
"16977","GRR","BBR",0,1,1,0,1,"run084"
"16978","GRR","BGB",1,2,3,2,1,"run084"
"16979","GRR","BGG",0,2,2,1,1,"run084"
"16980","GRR","BRB",0,1,1,0,1,"run084"
"16981","GRR","BRR",0,2,2,1,1,"run084"
"16982","GRR","GGG",0,1,1,1,0,"run084"
"16983","GRR","GGR",0,1,1,0,1,"run084"
"16984","RBB","BBB",0,1,1,1,0,"run084"
"16985","RBB","BBR",0,1,1,0,1,"run084"
"16986","RBB","BRB",0,1,1,1,0,"run084"
"16987","RBB","GRR",0,1,1,0,1,"run084"
"16988","RBB","RGG",0,1,1,0,1,"run084"
"16989","RBG","BBB",2,8,10,7,3,"run084"
"16990","RBG","BBG",0,1,1,1,0,"run084"
"16991","RBG","BRR",0,1,1,0,1,"run084"
"16992","RBG","GBB",0,1,1,0,1,"run084"
"16993","RBG","GRR",0,3,3,3,0,"run084"
"16994","RBG","RBB",1,1,2,0,2,"run084"
"16995","RBG","RBR",0,1,1,0,1,"run084"
"16996","RBG","RGR",0,1,1,1,0,"run084"
"16997","RBR","BBB",0,13,13,0,13,"run084"
"16998","RBR","BBR",0,1,1,1,0,"run084"
"16999","RBR","BGB",2,4,6,4,2,"run084"
"17000","RBR","BGG",0,2,2,2,0,"run084"
"17001","RBR","BRB",1,0,1,1,0,"run084"
"17002","RBR","BRR",1,4,5,1,4,"run084"
"17003","RBR","GGB",0,12,12,6,6,"run084"
"17004","RBR","GRR",4,4,8,6,2,"run084"
"17005","RBR","RBB",0,3,3,1,2,"run084"
"17006","RBR","RGG",2,9,11,0,11,"run084"
"17007","RBR","RGR",1,0,1,0,1,"run084"
"17008","RBR","RRR",0,1,1,0,1,"run084"
"17009","RGG","BBB",0,8,8,2,6,"run084"
"17010","RGG","BBR",1,2,3,0,3,"run084"
"17011","RGG","BGB",0,1,1,0,1,"run084"
"17012","RGG","BRR",0,4,4,4,0,"run084"
"17013","RGG","GGG",0,1,1,1,0,"run084"
"17014","RGG","GGR",0,3,3,2,1,"run084"
"17015","RGG","GRR",0,8,8,8,0,"run084"
"17016","RGG","RBB",0,1,1,1,0,"run084"
"17017","RGR","BBB",2,5,7,4,3,"run084"
"17018","RGR","BBR",1,1,2,2,0,"run084"
"17019","RGR","BGB",2,5,7,5,2,"run084"
"17020","RGR","BGG",2,2,4,2,2,"run084"
"17021","RGR","BRR",1,5,6,3,3,"run084"
"17022","RGR","GGB",2,12,14,13,1,"run084"
"17023","RGR","GGG",0,2,2,1,1,"run084"
"17024","RGR","GGR",0,4,4,0,4,"run084"
"17025","RGR","RBB",0,4,4,0,4,"run084"
"17026","RGR","RGG",1,1,2,0,2,"run084"
"17027","RGR","RRG",0,3,3,1,2,"run084"
"17028","RRG","BBB",2,33,35,11,24,"run084"
"17029","RRG","BBR",0,5,5,5,0,"run084"
"17030","RRG","BGB",1,10,11,8,3,"run084"
"17031","RRG","BGG",0,2,2,2,0,"run084"
"17032","RRG","BRB",2,40,42,41,1,"run084"
"17033","RRG","BRR",1,16,17,14,3,"run084"
"17034","RRG","GGG",2,14,16,2,14,"run084"
"17035","RRG","GGR",0,5,5,4,1,"run084"
"17036","RRG","GRG",1,0,1,0,1,"run084"
"17037","RRG","GRR",3,8,11,3,8,"run084"
"17038","RRG","RBB",1,1,2,2,0,"run084"
"17039","RRG","RGG",0,1,1,0,1,"run084"
"17040","RRG","RGR",0,1,1,0,1,"run084"
"17041","RRR","BBR",1,0,1,0,1,"run084"
"17042","RRR","BGB",2,1,3,0,3,"run084"
"17043","RRR","BGG",1,0,1,0,1,"run084"
"17044","RRR","BRB",1,1,2,0,2,"run084"
"17045","RRR","BRR",1,1,2,1,1,"run084"
"17046","RRR","GGR",0,1,1,0,1,"run084"
"17047","RRR","GRR",0,3,3,2,1,"run084"
"17048","RRR","RBB",1,2,3,1,2,"run084"
"17049","RRR","RBR",0,2,2,0,2,"run084"
"17050","RRR","RGG",0,1,1,1,0,"run084"
"17051","RRR","RGR",1,2,3,1,2,"run084"
"17052","RRR","RRG",2,2,4,4,0,"run084"
"17053","BBB","BRB",0,1,1,0,1,"run085"
"17054","BBB","GGG",1,2,3,2,1,"run085"
"17055","BBB","GRR",0,2,2,2,0,"run085"
"17056","BBB","RBG",0,1,1,1,0,"run085"
"17057","BBB","RRG",1,3,4,1,3,"run085"
"17058","BBB","RRR",0,2,2,2,0,"run085"
"17059","BBG","BBB",1,4,5,4,1,"run085"
"17060","BBG","BGB",0,1,1,0,1,"run085"
"17061","BBG","BGG",0,1,1,0,1,"run085"
"17062","BBG","BRB",1,16,17,4,13,"run085"
"17063","BBG","GBB",0,1,1,0,1,"run085"
"17064","BBG","GBG",2,7,9,7,2,"run085"
"17065","BBG","GGB",2,25,27,17,10,"run085"
"17066","BBG","GGG",4,38,42,31,11,"run085"
"17067","BBG","GRG",1,9,10,3,7,"run085"
"17068","BBG","GRR",0,1,1,1,0,"run085"
"17069","BBG","RBB",0,1,1,1,0,"run085"
"17070","BBG","RBG",0,4,4,0,4,"run085"
"17071","BBG","RBR",0,1,1,1,0,"run085"
"17072","BBG","RGR",0,1,1,1,0,"run085"
"17073","BBG","RRG",1,2,3,2,1,"run085"
"17074","BBG","RRR",0,7,7,3,4,"run085"
"17075","BGB","BBB",0,2,2,0,2,"run085"
"17076","BGB","RRG",0,1,1,0,1,"run085"
"17077","BGG","BBB",0,3,3,1,2,"run085"
"17078","BGG","BBR",0,1,1,0,1,"run085"
"17079","BGG","GRG",0,1,1,1,0,"run085"
"17080","BGG","RBG",1,1,2,2,0,"run085"
"17081","BGG","RGG",0,3,3,1,2,"run085"
"17082","BGG","RGR",0,1,1,0,1,"run085"
"17083","BGG","RRR",1,1,2,2,0,"run085"
"17084","BRB","BBB",0,13,13,4,9,"run085"
"17085","BRB","BBR",0,1,1,0,1,"run085"
"17086","BRB","BRR",0,3,3,1,2,"run085"
"17087","BRB","GGG",0,1,1,1,0,"run085"
"17088","BRB","GGR",0,1,1,1,0,"run085"
"17089","BRB","RBB",0,1,1,0,1,"run085"
"17090","BRB","RBG",0,1,1,0,1,"run085"
"17091","BRB","RGR",0,1,1,1,0,"run085"
"17092","BRB","RRR",0,1,1,0,1,"run085"
"17093","BRR","BBB",0,11,11,3,8,"run085"
"17094","BRR","BGB",1,1,2,0,2,"run085"
"17095","BRR","BGG",0,1,1,0,1,"run085"
"17096","BRR","BRB",0,1,1,0,1,"run085"
"17097","BRR","RBB",0,2,2,2,0,"run085"
"17098","GBB","BBB",12,38,50,24,26,"run085"
"17099","GBB","BGG",0,1,1,1,0,"run085"
"17100","GBB","BRB",1,9,10,2,8,"run085"
"17101","GBB","BRR",1,3,4,4,0,"run085"
"17102","GBB","GBG",0,4,4,2,2,"run085"
"17103","GBB","GGB",0,21,21,1,20,"run085"
"17104","GBB","GGG",7,86,93,15,78,"run085"
"17105","GBB","GGR",1,3,4,0,4,"run085"
"17106","GBB","GRG",0,6,6,5,1,"run085"
"17107","GBB","GRR",0,1,1,1,0,"run085"
"17108","GBB","RBB",0,2,2,1,1,"run085"
"17109","GBB","RBG",3,9,12,12,0,"run085"
"17110","GBB","RBR",1,0,1,1,0,"run085"
"17111","GBB","RGG",1,0,1,1,0,"run085"
"17112","GBB","RGR",2,1,3,1,2,"run085"
"17113","GBB","RRG",0,2,2,1,1,"run085"
"17114","GBB","RRR",1,9,10,7,3,"run085"
"17115","GBG","BBB",0,5,5,0,5,"run085"
"17116","GBG","BBR",0,1,1,1,0,"run085"
"17117","GBG","BRB",1,4,5,0,5,"run085"
"17118","GBG","BRR",1,0,1,1,0,"run085"
"17119","GBG","GGB",0,4,4,0,4,"run085"
"17120","GBG","GGG",4,11,15,7,8,"run085"
"17121","GBG","RBB",1,0,1,0,1,"run085"
"17122","GBG","RBG",0,1,1,0,1,"run085"
"17123","GBG","RGG",0,1,1,0,1,"run085"
"17124","GBG","RGR",1,3,4,2,2,"run085"
"17125","GBG","RRG",1,3,4,1,3,"run085"
"17126","GGB","BBB",3,16,19,16,3,"run085"
"17127","GGB","BBR",1,4,5,5,0,"run085"
"17128","GGB","BGB",0,3,3,3,0,"run085"
"17129","GGB","BGG",0,4,4,2,2,"run085"
"17130","GGB","BRB",0,1,1,1,0,"run085"
"17131","GGB","BRR",1,15,16,8,8,"run085"
"17132","GGB","GBB",0,1,1,1,0,"run085"
"17133","GGB","GBG",1,0,1,1,0,"run085"
"17134","GGB","GGG",13,48,61,38,23,"run085"
"17135","GGB","GGR",0,7,7,5,2,"run085"
"17136","GGB","GRR",0,4,4,4,0,"run085"
"17137","GGB","RBB",0,5,5,3,2,"run085"
"17138","GGB","RBG",0,4,4,3,1,"run085"
"17139","GGB","RBR",0,5,5,4,1,"run085"
"17140","GGB","RGG",1,5,6,4,2,"run085"
"17141","GGB","RGR",0,2,2,0,2,"run085"
"17142","GGB","RRG",1,5,6,6,0,"run085"
"17143","GGB","RRR",1,5,6,1,5,"run085"
"17144","GGG","BBB",8,31,39,0,39,"run085"
"17145","GGG","BGB",0,2,2,0,2,"run085"
"17146","GGG","BGG",1,7,8,5,3,"run085"
"17147","GGG","BRB",1,3,4,4,0,"run085"
"17148","GGG","BRR",0,6,6,1,5,"run085"
"17149","GGG","GGB",5,1,6,3,3,"run085"
"17150","GGG","GGR",1,9,10,5,5,"run085"
"17151","GGG","GRR",0,2,2,2,0,"run085"
"17152","GGG","RBB",1,8,9,6,3,"run085"
"17153","GGG","RBG",0,6,6,1,5,"run085"
"17154","GGG","RBR",0,21,21,16,5,"run085"
"17155","GGG","RGG",0,3,3,1,2,"run085"
"17156","GGG","RGR",1,12,13,9,4,"run085"
"17157","GGG","RRG",1,23,24,24,0,"run085"
"17158","GGG","RRR",0,3,3,3,0,"run085"
"17159","GGR","BBB",0,2,2,2,0,"run085"
"17160","GGR","BBR",0,2,2,0,2,"run085"
"17161","GGR","BGG",0,1,1,0,1,"run085"
"17162","GGR","BRR",1,0,1,1,0,"run085"
"17163","GGR","GRR",1,0,1,1,0,"run085"
"17164","GGR","RBB",0,2,2,2,0,"run085"
"17165","GRG","BBB",3,8,11,7,4,"run085"
"17166","GRG","BBR",0,1,1,1,0,"run085"
"17167","GRG","BGG",0,1,1,1,0,"run085"
"17168","GRG","BRB",0,3,3,3,0,"run085"
"17169","GRG","BRR",0,1,1,1,0,"run085"
"17170","GRG","GBG",0,1,1,0,1,"run085"
"17171","GRG","GGB",2,15,17,8,9,"run085"
"17172","GRG","GGG",3,12,15,0,15,"run085"
"17173","GRG","GGR",0,5,5,2,3,"run085"
"17174","GRG","GRR",0,1,1,1,0,"run085"
"17175","GRG","RBG",0,1,1,1,0,"run085"
"17176","GRG","RBR",0,1,1,1,0,"run085"
"17177","GRG","RGR",1,2,3,0,3,"run085"
"17178","GRG","RRG",2,4,6,2,4,"run085"
"17179","GRR","BBB",0,1,1,1,0,"run085"
"17180","GRR","BBR",0,1,1,0,1,"run085"
"17181","GRR","BGB",1,2,3,1,2,"run085"
"17182","GRR","BGG",0,2,2,0,2,"run085"
"17183","GRR","BRB",0,1,1,1,0,"run085"
"17184","GRR","BRR",0,2,2,0,2,"run085"
"17185","GRR","GGG",0,1,1,1,0,"run085"
"17186","GRR","GGR",0,1,1,1,0,"run085"
"17187","RBB","BBB",0,1,1,0,1,"run085"
"17188","RBB","BBR",0,1,1,1,0,"run085"
"17189","RBB","BRB",0,1,1,1,0,"run085"
"17190","RBB","GRR",0,1,1,0,1,"run085"
"17191","RBB","RGG",0,1,1,0,1,"run085"
"17192","RBG","BBB",2,8,10,4,6,"run085"
"17193","RBG","BBG",0,1,1,1,0,"run085"
"17194","RBG","BRR",0,1,1,0,1,"run085"
"17195","RBG","GBB",0,1,1,0,1,"run085"
"17196","RBG","GRR",0,3,3,3,0,"run085"
"17197","RBG","RBB",1,1,2,0,2,"run085"
"17198","RBG","RBR",0,1,1,0,1,"run085"
"17199","RBG","RGR",0,1,1,1,0,"run085"
"17200","RBR","BBB",0,13,13,5,8,"run085"
"17201","RBR","BBR",0,1,1,0,1,"run085"
"17202","RBR","BGB",2,4,6,2,4,"run085"
"17203","RBR","BGG",0,2,2,1,1,"run085"
"17204","RBR","BRB",1,0,1,0,1,"run085"
"17205","RBR","BRR",1,4,5,1,4,"run085"
"17206","RBR","GGB",0,12,12,9,3,"run085"
"17207","RBR","GRR",4,4,8,4,4,"run085"
"17208","RBR","RBB",0,3,3,2,1,"run085"
"17209","RBR","RGG",2,9,11,2,9,"run085"
"17210","RBR","RGR",1,0,1,0,1,"run085"
"17211","RBR","RRR",0,1,1,1,0,"run085"
"17212","RGG","BBB",0,8,8,7,1,"run085"
"17213","RGG","BBR",1,2,3,2,1,"run085"
"17214","RGG","BGB",0,1,1,0,1,"run085"
"17215","RGG","BRR",0,4,4,2,2,"run085"
"17216","RGG","GGG",0,1,1,1,0,"run085"
"17217","RGG","GGR",0,3,3,0,3,"run085"
"17218","RGG","GRR",0,8,8,3,5,"run085"
"17219","RGG","RBB",0,1,1,1,0,"run085"
"17220","RGR","BBB",2,5,7,2,5,"run085"
"17221","RGR","BBR",1,1,2,0,2,"run085"
"17222","RGR","BGB",2,5,7,3,4,"run085"
"17223","RGR","BGG",2,2,4,2,2,"run085"
"17224","RGR","BRR",1,5,6,5,1,"run085"
"17225","RGR","GGB",2,12,14,3,11,"run085"
"17226","RGR","GGG",0,2,2,0,2,"run085"
"17227","RGR","GGR",0,4,4,1,3,"run085"
"17228","RGR","RBB",0,4,4,1,3,"run085"
"17229","RGR","RGG",1,1,2,1,1,"run085"
"17230","RGR","RRG",0,3,3,2,1,"run085"
"17231","RRG","BBB",2,33,35,27,8,"run085"
"17232","RRG","BBR",0,5,5,3,2,"run085"
"17233","RRG","BGB",1,10,11,0,11,"run085"
"17234","RRG","BGG",0,2,2,0,2,"run085"
"17235","RRG","BRB",2,40,42,22,20,"run085"
"17236","RRG","BRR",1,16,17,12,5,"run085"
"17237","RRG","GGG",2,14,16,4,12,"run085"
"17238","RRG","GGR",0,5,5,5,0,"run085"
"17239","RRG","GRG",1,0,1,1,0,"run085"
"17240","RRG","GRR",3,8,11,8,3,"run085"
"17241","RRG","RBB",1,1,2,2,0,"run085"
"17242","RRG","RGG",0,1,1,1,0,"run085"
"17243","RRG","RGR",0,1,1,0,1,"run085"
"17244","RRR","BBR",1,0,1,1,0,"run085"
"17245","RRR","BGB",2,1,3,3,0,"run085"
"17246","RRR","BGG",1,0,1,1,0,"run085"
"17247","RRR","BRB",1,1,2,2,0,"run085"
"17248","RRR","BRR",1,1,2,0,2,"run085"
"17249","RRR","GGR",0,1,1,0,1,"run085"
"17250","RRR","GRR",0,3,3,0,3,"run085"
"17251","RRR","RBB",1,2,3,1,2,"run085"
"17252","RRR","RBR",0,2,2,0,2,"run085"
"17253","RRR","RGG",0,1,1,1,0,"run085"
"17254","RRR","RGR",1,2,3,0,3,"run085"
"17255","RRR","RRG",2,2,4,1,3,"run085"
"17256","BBB","BRB",0,1,1,0,1,"run086"
"17257","BBB","GGG",1,2,3,0,3,"run086"
"17258","BBB","GRR",0,2,2,0,2,"run086"
"17259","BBB","RBG",0,1,1,0,1,"run086"
"17260","BBB","RRG",1,3,4,3,1,"run086"
"17261","BBB","RRR",0,2,2,2,0,"run086"
"17262","BBG","BBB",1,4,5,1,4,"run086"
"17263","BBG","BGB",0,1,1,0,1,"run086"
"17264","BBG","BGG",0,1,1,0,1,"run086"
"17265","BBG","BRB",1,16,17,4,13,"run086"
"17266","BBG","GBB",0,1,1,1,0,"run086"
"17267","BBG","GBG",2,7,9,5,4,"run086"
"17268","BBG","GGB",2,25,27,25,2,"run086"
"17269","BBG","GGG",4,38,42,28,14,"run086"
"17270","BBG","GRG",1,9,10,5,5,"run086"
"17271","BBG","GRR",0,1,1,0,1,"run086"
"17272","BBG","RBB",0,1,1,0,1,"run086"
"17273","BBG","RBG",0,4,4,4,0,"run086"
"17274","BBG","RBR",0,1,1,1,0,"run086"
"17275","BBG","RGR",0,1,1,0,1,"run086"
"17276","BBG","RRG",1,2,3,2,1,"run086"
"17277","BBG","RRR",0,7,7,1,6,"run086"
"17278","BGB","BBB",0,2,2,0,2,"run086"
"17279","BGB","RRG",0,1,1,0,1,"run086"
"17280","BGG","BBB",0,3,3,0,3,"run086"
"17281","BGG","BBR",0,1,1,0,1,"run086"
"17282","BGG","GRG",0,1,1,0,1,"run086"
"17283","BGG","RBG",1,1,2,0,2,"run086"
"17284","BGG","RGG",0,3,3,2,1,"run086"
"17285","BGG","RGR",0,1,1,1,0,"run086"
"17286","BGG","RRR",1,1,2,1,1,"run086"
"17287","BRB","BBB",0,13,13,13,0,"run086"
"17288","BRB","BBR",0,1,1,1,0,"run086"
"17289","BRB","BRR",0,3,3,3,0,"run086"
"17290","BRB","GGG",0,1,1,0,1,"run086"
"17291","BRB","GGR",0,1,1,1,0,"run086"
"17292","BRB","RBB",0,1,1,0,1,"run086"
"17293","BRB","RBG",0,1,1,1,0,"run086"
"17294","BRB","RGR",0,1,1,1,0,"run086"
"17295","BRB","RRR",0,1,1,0,1,"run086"
"17296","BRR","BBB",0,11,11,9,2,"run086"
"17297","BRR","BGB",1,1,2,1,1,"run086"
"17298","BRR","BGG",0,1,1,1,0,"run086"
"17299","BRR","BRB",0,1,1,1,0,"run086"
"17300","BRR","RBB",0,2,2,0,2,"run086"
"17301","GBB","BBB",12,38,50,17,33,"run086"
"17302","GBB","BGG",0,1,1,1,0,"run086"
"17303","GBB","BRB",1,9,10,7,3,"run086"
"17304","GBB","BRR",1,3,4,3,1,"run086"
"17305","GBB","GBG",0,4,4,2,2,"run086"
"17306","GBB","GGB",0,21,21,15,6,"run086"
"17307","GBB","GGG",7,86,93,47,46,"run086"
"17308","GBB","GGR",1,3,4,1,3,"run086"
"17309","GBB","GRG",0,6,6,3,3,"run086"
"17310","GBB","GRR",0,1,1,0,1,"run086"
"17311","GBB","RBB",0,2,2,1,1,"run086"
"17312","GBB","RBG",3,9,12,1,11,"run086"
"17313","GBB","RBR",1,0,1,1,0,"run086"
"17314","GBB","RGG",1,0,1,0,1,"run086"
"17315","GBB","RGR",2,1,3,0,3,"run086"
"17316","GBB","RRG",0,2,2,1,1,"run086"
"17317","GBB","RRR",1,9,10,6,4,"run086"
"17318","GBG","BBB",0,5,5,2,3,"run086"
"17319","GBG","BBR",0,1,1,0,1,"run086"
"17320","GBG","BRB",1,4,5,0,5,"run086"
"17321","GBG","BRR",1,0,1,0,1,"run086"
"17322","GBG","GGB",0,4,4,2,2,"run086"
"17323","GBG","GGG",4,11,15,5,10,"run086"
"17324","GBG","RBB",1,0,1,0,1,"run086"
"17325","GBG","RBG",0,1,1,1,0,"run086"
"17326","GBG","RGG",0,1,1,0,1,"run086"
"17327","GBG","RGR",1,3,4,0,4,"run086"
"17328","GBG","RRG",1,3,4,1,3,"run086"
"17329","GGB","BBB",3,16,19,3,16,"run086"
"17330","GGB","BBR",1,4,5,5,0,"run086"
"17331","GGB","BGB",0,3,3,3,0,"run086"
"17332","GGB","BGG",0,4,4,0,4,"run086"
"17333","GGB","BRB",0,1,1,1,0,"run086"
"17334","GGB","BRR",1,15,16,7,9,"run086"
"17335","GGB","GBB",0,1,1,0,1,"run086"
"17336","GGB","GBG",1,0,1,1,0,"run086"
"17337","GGB","GGG",13,48,61,11,50,"run086"
"17338","GGB","GGR",0,7,7,2,5,"run086"
"17339","GGB","GRR",0,4,4,0,4,"run086"
"17340","GGB","RBB",0,5,5,0,5,"run086"
"17341","GGB","RBG",0,4,4,0,4,"run086"
"17342","GGB","RBR",0,5,5,0,5,"run086"
"17343","GGB","RGG",1,5,6,0,6,"run086"
"17344","GGB","RGR",0,2,2,1,1,"run086"
"17345","GGB","RRG",1,5,6,5,1,"run086"
"17346","GGB","RRR",1,5,6,4,2,"run086"
"17347","GGG","BBB",8,31,39,1,38,"run086"
"17348","GGG","BGB",0,2,2,1,1,"run086"
"17349","GGG","BGG",1,7,8,2,6,"run086"
"17350","GGG","BRB",1,3,4,0,4,"run086"
"17351","GGG","BRR",0,6,6,5,1,"run086"
"17352","GGG","GGB",5,1,6,2,4,"run086"
"17353","GGG","GGR",1,9,10,0,10,"run086"
"17354","GGG","GRR",0,2,2,2,0,"run086"
"17355","GGG","RBB",1,8,9,4,5,"run086"
"17356","GGG","RBG",0,6,6,3,3,"run086"
"17357","GGG","RBR",0,21,21,5,16,"run086"
"17358","GGG","RGG",0,3,3,3,0,"run086"
"17359","GGG","RGR",1,12,13,1,12,"run086"
"17360","GGG","RRG",1,23,24,13,11,"run086"
"17361","GGG","RRR",0,3,3,1,2,"run086"
"17362","GGR","BBB",0,2,2,2,0,"run086"
"17363","GGR","BBR",0,2,2,2,0,"run086"
"17364","GGR","BGG",0,1,1,1,0,"run086"
"17365","GGR","BRR",1,0,1,1,0,"run086"
"17366","GGR","GRR",1,0,1,1,0,"run086"
"17367","GGR","RBB",0,2,2,2,0,"run086"
"17368","GRG","BBB",3,8,11,2,9,"run086"
"17369","GRG","BBR",0,1,1,1,0,"run086"
"17370","GRG","BGG",0,1,1,1,0,"run086"
"17371","GRG","BRB",0,3,3,2,1,"run086"
"17372","GRG","BRR",0,1,1,0,1,"run086"
"17373","GRG","GBG",0,1,1,1,0,"run086"
"17374","GRG","GGB",2,15,17,6,11,"run086"
"17375","GRG","GGG",3,12,15,6,9,"run086"
"17376","GRG","GGR",0,5,5,2,3,"run086"
"17377","GRG","GRR",0,1,1,1,0,"run086"
"17378","GRG","RBG",0,1,1,1,0,"run086"
"17379","GRG","RBR",0,1,1,0,1,"run086"
"17380","GRG","RGR",1,2,3,3,0,"run086"
"17381","GRG","RRG",2,4,6,2,4,"run086"
"17382","GRR","BBB",0,1,1,1,0,"run086"
"17383","GRR","BBR",0,1,1,0,1,"run086"
"17384","GRR","BGB",1,2,3,3,0,"run086"
"17385","GRR","BGG",0,2,2,2,0,"run086"
"17386","GRR","BRB",0,1,1,1,0,"run086"
"17387","GRR","BRR",0,2,2,1,1,"run086"
"17388","GRR","GGG",0,1,1,0,1,"run086"
"17389","GRR","GGR",0,1,1,0,1,"run086"
"17390","RBB","BBB",0,1,1,0,1,"run086"
"17391","RBB","BBR",0,1,1,0,1,"run086"
"17392","RBB","BRB",0,1,1,0,1,"run086"
"17393","RBB","GRR",0,1,1,0,1,"run086"
"17394","RBB","RGG",0,1,1,1,0,"run086"
"17395","RBG","BBB",2,8,10,0,10,"run086"
"17396","RBG","BBG",0,1,1,1,0,"run086"
"17397","RBG","BRR",0,1,1,0,1,"run086"
"17398","RBG","GBB",0,1,1,0,1,"run086"
"17399","RBG","GRR",0,3,3,3,0,"run086"
"17400","RBG","RBB",1,1,2,0,2,"run086"
"17401","RBG","RBR",0,1,1,0,1,"run086"
"17402","RBG","RGR",0,1,1,1,0,"run086"
"17403","RBR","BBB",0,13,13,2,11,"run086"
"17404","RBR","BBR",0,1,1,1,0,"run086"
"17405","RBR","BGB",2,4,6,2,4,"run086"
"17406","RBR","BGG",0,2,2,1,1,"run086"
"17407","RBR","BRB",1,0,1,0,1,"run086"
"17408","RBR","BRR",1,4,5,5,0,"run086"
"17409","RBR","GGB",0,12,12,7,5,"run086"
"17410","RBR","GRR",4,4,8,1,7,"run086"
"17411","RBR","RBB",0,3,3,0,3,"run086"
"17412","RBR","RGG",2,9,11,0,11,"run086"
"17413","RBR","RGR",1,0,1,0,1,"run086"
"17414","RBR","RRR",0,1,1,1,0,"run086"
"17415","RGG","BBB",0,8,8,5,3,"run086"
"17416","RGG","BBR",1,2,3,1,2,"run086"
"17417","RGG","BGB",0,1,1,1,0,"run086"
"17418","RGG","BRR",0,4,4,3,1,"run086"
"17419","RGG","GGG",0,1,1,0,1,"run086"
"17420","RGG","GGR",0,3,3,3,0,"run086"
"17421","RGG","GRR",0,8,8,5,3,"run086"
"17422","RGG","RBB",0,1,1,1,0,"run086"
"17423","RGR","BBB",2,5,7,5,2,"run086"
"17424","RGR","BBR",1,1,2,0,2,"run086"
"17425","RGR","BGB",2,5,7,7,0,"run086"
"17426","RGR","BGG",2,2,4,2,2,"run086"
"17427","RGR","BRR",1,5,6,4,2,"run086"
"17428","RGR","GGB",2,12,14,14,0,"run086"
"17429","RGR","GGG",0,2,2,2,0,"run086"
"17430","RGR","GGR",0,4,4,4,0,"run086"
"17431","RGR","RBB",0,4,4,1,3,"run086"
"17432","RGR","RGG",1,1,2,2,0,"run086"
"17433","RGR","RRG",0,3,3,3,0,"run086"
"17434","RRG","BBB",2,33,35,25,10,"run086"
"17435","RRG","BBR",0,5,5,5,0,"run086"
"17436","RRG","BGB",1,10,11,6,5,"run086"
"17437","RRG","BGG",0,2,2,1,1,"run086"
"17438","RRG","BRB",2,40,42,14,28,"run086"
"17439","RRG","BRR",1,16,17,17,0,"run086"
"17440","RRG","GGG",2,14,16,14,2,"run086"
"17441","RRG","GGR",0,5,5,3,2,"run086"
"17442","RRG","GRG",1,0,1,0,1,"run086"
"17443","RRG","GRR",3,8,11,7,4,"run086"
"17444","RRG","RBB",1,1,2,0,2,"run086"
"17445","RRG","RGG",0,1,1,0,1,"run086"
"17446","RRG","RGR",0,1,1,1,0,"run086"
"17447","RRR","BBR",1,0,1,0,1,"run086"
"17448","RRR","BGB",2,1,3,1,2,"run086"
"17449","RRR","BGG",1,0,1,0,1,"run086"
"17450","RRR","BRB",1,1,2,2,0,"run086"
"17451","RRR","BRR",1,1,2,0,2,"run086"
"17452","RRR","GGR",0,1,1,1,0,"run086"
"17453","RRR","GRR",0,3,3,2,1,"run086"
"17454","RRR","RBB",1,2,3,0,3,"run086"
"17455","RRR","RBR",0,2,2,2,0,"run086"
"17456","RRR","RGG",0,1,1,1,0,"run086"
"17457","RRR","RGR",1,2,3,2,1,"run086"
"17458","RRR","RRG",2,2,4,3,1,"run086"
"17459","BBB","BRB",0,1,1,1,0,"run087"
"17460","BBB","GGG",1,2,3,1,2,"run087"
"17461","BBB","GRR",0,2,2,2,0,"run087"
"17462","BBB","RBG",0,1,1,1,0,"run087"
"17463","BBB","RRG",1,3,4,2,2,"run087"
"17464","BBB","RRR",0,2,2,2,0,"run087"
"17465","BBG","BBB",1,4,5,5,0,"run087"
"17466","BBG","BGB",0,1,1,1,0,"run087"
"17467","BBG","BGG",0,1,1,1,0,"run087"
"17468","BBG","BRB",1,16,17,14,3,"run087"
"17469","BBG","GBB",0,1,1,0,1,"run087"
"17470","BBG","GBG",2,7,9,1,8,"run087"
"17471","BBG","GGB",2,25,27,18,9,"run087"
"17472","BBG","GGG",4,38,42,14,28,"run087"
"17473","BBG","GRG",1,9,10,2,8,"run087"
"17474","BBG","GRR",0,1,1,0,1,"run087"
"17475","BBG","RBB",0,1,1,1,0,"run087"
"17476","BBG","RBG",0,4,4,4,0,"run087"
"17477","BBG","RBR",0,1,1,1,0,"run087"
"17478","BBG","RGR",0,1,1,0,1,"run087"
"17479","BBG","RRG",1,2,3,3,0,"run087"
"17480","BBG","RRR",0,7,7,1,6,"run087"
"17481","BGB","BBB",0,2,2,1,1,"run087"
"17482","BGB","RRG",0,1,1,1,0,"run087"
"17483","BGG","BBB",0,3,3,2,1,"run087"
"17484","BGG","BBR",0,1,1,1,0,"run087"
"17485","BGG","GRG",0,1,1,0,1,"run087"
"17486","BGG","RBG",1,1,2,1,1,"run087"
"17487","BGG","RGG",0,3,3,1,2,"run087"
"17488","BGG","RGR",0,1,1,1,0,"run087"
"17489","BGG","RRR",1,1,2,2,0,"run087"
"17490","BRB","BBB",0,13,13,11,2,"run087"
"17491","BRB","BBR",0,1,1,1,0,"run087"
"17492","BRB","BRR",0,3,3,0,3,"run087"
"17493","BRB","GGG",0,1,1,0,1,"run087"
"17494","BRB","GGR",0,1,1,0,1,"run087"
"17495","BRB","RBB",0,1,1,1,0,"run087"
"17496","BRB","RBG",0,1,1,1,0,"run087"
"17497","BRB","RGR",0,1,1,1,0,"run087"
"17498","BRB","RRR",0,1,1,0,1,"run087"
"17499","BRR","BBB",0,11,11,1,10,"run087"
"17500","BRR","BGB",1,1,2,2,0,"run087"
"17501","BRR","BGG",0,1,1,1,0,"run087"
"17502","BRR","BRB",0,1,1,0,1,"run087"
"17503","BRR","RBB",0,2,2,1,1,"run087"
"17504","GBB","BBB",12,38,50,36,14,"run087"
"17505","GBB","BGG",0,1,1,1,0,"run087"
"17506","GBB","BRB",1,9,10,2,8,"run087"
"17507","GBB","BRR",1,3,4,2,2,"run087"
"17508","GBB","GBG",0,4,4,0,4,"run087"
"17509","GBB","GGB",0,21,21,0,21,"run087"
"17510","GBB","GGG",7,86,93,35,58,"run087"
"17511","GBB","GGR",1,3,4,4,0,"run087"
"17512","GBB","GRG",0,6,6,5,1,"run087"
"17513","GBB","GRR",0,1,1,1,0,"run087"
"17514","GBB","RBB",0,2,2,1,1,"run087"
"17515","GBB","RBG",3,9,12,0,12,"run087"
"17516","GBB","RBR",1,0,1,0,1,"run087"
"17517","GBB","RGG",1,0,1,1,0,"run087"
"17518","GBB","RGR",2,1,3,1,2,"run087"
"17519","GBB","RRG",0,2,2,1,1,"run087"
"17520","GBB","RRR",1,9,10,8,2,"run087"
"17521","GBG","BBB",0,5,5,5,0,"run087"
"17522","GBG","BBR",0,1,1,1,0,"run087"
"17523","GBG","BRB",1,4,5,4,1,"run087"
"17524","GBG","BRR",1,0,1,0,1,"run087"
"17525","GBG","GGB",0,4,4,3,1,"run087"
"17526","GBG","GGG",4,11,15,9,6,"run087"
"17527","GBG","RBB",1,0,1,1,0,"run087"
"17528","GBG","RBG",0,1,1,0,1,"run087"
"17529","GBG","RGG",0,1,1,1,0,"run087"
"17530","GBG","RGR",1,3,4,0,4,"run087"
"17531","GBG","RRG",1,3,4,0,4,"run087"
"17532","GGB","BBB",3,16,19,4,15,"run087"
"17533","GGB","BBR",1,4,5,1,4,"run087"
"17534","GGB","BGB",0,3,3,2,1,"run087"
"17535","GGB","BGG",0,4,4,4,0,"run087"
"17536","GGB","BRB",0,1,1,1,0,"run087"
"17537","GGB","BRR",1,15,16,0,16,"run087"
"17538","GGB","GBB",0,1,1,0,1,"run087"
"17539","GGB","GBG",1,0,1,1,0,"run087"
"17540","GGB","GGG",13,48,61,50,11,"run087"
"17541","GGB","GGR",0,7,7,5,2,"run087"
"17542","GGB","GRR",0,4,4,0,4,"run087"
"17543","GGB","RBB",0,5,5,5,0,"run087"
"17544","GGB","RBG",0,4,4,2,2,"run087"
"17545","GGB","RBR",0,5,5,1,4,"run087"
"17546","GGB","RGG",1,5,6,3,3,"run087"
"17547","GGB","RGR",0,2,2,1,1,"run087"
"17548","GGB","RRG",1,5,6,5,1,"run087"
"17549","GGB","RRR",1,5,6,2,4,"run087"
"17550","GGG","BBB",8,31,39,9,30,"run087"
"17551","GGG","BGB",0,2,2,2,0,"run087"
"17552","GGG","BGG",1,7,8,8,0,"run087"
"17553","GGG","BRB",1,3,4,1,3,"run087"
"17554","GGG","BRR",0,6,6,3,3,"run087"
"17555","GGG","GGB",5,1,6,0,6,"run087"
"17556","GGG","GGR",1,9,10,6,4,"run087"
"17557","GGG","GRR",0,2,2,2,0,"run087"
"17558","GGG","RBB",1,8,9,6,3,"run087"
"17559","GGG","RBG",0,6,6,3,3,"run087"
"17560","GGG","RBR",0,21,21,15,6,"run087"
"17561","GGG","RGG",0,3,3,3,0,"run087"
"17562","GGG","RGR",1,12,13,13,0,"run087"
"17563","GGG","RRG",1,23,24,21,3,"run087"
"17564","GGG","RRR",0,3,3,1,2,"run087"
"17565","GGR","BBB",0,2,2,2,0,"run087"
"17566","GGR","BBR",0,2,2,2,0,"run087"
"17567","GGR","BGG",0,1,1,1,0,"run087"
"17568","GGR","BRR",1,0,1,0,1,"run087"
"17569","GGR","GRR",1,0,1,0,1,"run087"
"17570","GGR","RBB",0,2,2,1,1,"run087"
"17571","GRG","BBB",3,8,11,1,10,"run087"
"17572","GRG","BBR",0,1,1,0,1,"run087"
"17573","GRG","BGG",0,1,1,1,0,"run087"
"17574","GRG","BRB",0,3,3,2,1,"run087"
"17575","GRG","BRR",0,1,1,1,0,"run087"
"17576","GRG","GBG",0,1,1,0,1,"run087"
"17577","GRG","GGB",2,15,17,1,16,"run087"
"17578","GRG","GGG",3,12,15,2,13,"run087"
"17579","GRG","GGR",0,5,5,0,5,"run087"
"17580","GRG","GRR",0,1,1,1,0,"run087"
"17581","GRG","RBG",0,1,1,0,1,"run087"
"17582","GRG","RBR",0,1,1,1,0,"run087"
"17583","GRG","RGR",1,2,3,2,1,"run087"
"17584","GRG","RRG",2,4,6,0,6,"run087"
"17585","GRR","BBB",0,1,1,0,1,"run087"
"17586","GRR","BBR",0,1,1,0,1,"run087"
"17587","GRR","BGB",1,2,3,1,2,"run087"
"17588","GRR","BGG",0,2,2,1,1,"run087"
"17589","GRR","BRB",0,1,1,0,1,"run087"
"17590","GRR","BRR",0,2,2,0,2,"run087"
"17591","GRR","GGG",0,1,1,1,0,"run087"
"17592","GRR","GGR",0,1,1,0,1,"run087"
"17593","RBB","BBB",0,1,1,1,0,"run087"
"17594","RBB","BBR",0,1,1,0,1,"run087"
"17595","RBB","BRB",0,1,1,0,1,"run087"
"17596","RBB","GRR",0,1,1,1,0,"run087"
"17597","RBB","RGG",0,1,1,1,0,"run087"
"17598","RBG","BBB",2,8,10,1,9,"run087"
"17599","RBG","BBG",0,1,1,0,1,"run087"
"17600","RBG","BRR",0,1,1,0,1,"run087"
"17601","RBG","GBB",0,1,1,0,1,"run087"
"17602","RBG","GRR",0,3,3,3,0,"run087"
"17603","RBG","RBB",1,1,2,2,0,"run087"
"17604","RBG","RBR",0,1,1,0,1,"run087"
"17605","RBG","RGR",0,1,1,1,0,"run087"
"17606","RBR","BBB",0,13,13,7,6,"run087"
"17607","RBR","BBR",0,1,1,0,1,"run087"
"17608","RBR","BGB",2,4,6,4,2,"run087"
"17609","RBR","BGG",0,2,2,2,0,"run087"
"17610","RBR","BRB",1,0,1,0,1,"run087"
"17611","RBR","BRR",1,4,5,5,0,"run087"
"17612","RBR","GGB",0,12,12,12,0,"run087"
"17613","RBR","GRR",4,4,8,2,6,"run087"
"17614","RBR","RBB",0,3,3,2,1,"run087"
"17615","RBR","RGG",2,9,11,11,0,"run087"
"17616","RBR","RGR",1,0,1,1,0,"run087"
"17617","RBR","RRR",0,1,1,1,0,"run087"
"17618","RGG","BBB",0,8,8,4,4,"run087"
"17619","RGG","BBR",1,2,3,3,0,"run087"
"17620","RGG","BGB",0,1,1,1,0,"run087"
"17621","RGG","BRR",0,4,4,0,4,"run087"
"17622","RGG","GGG",0,1,1,1,0,"run087"
"17623","RGG","GGR",0,3,3,3,0,"run087"
"17624","RGG","GRR",0,8,8,0,8,"run087"
"17625","RGG","RBB",0,1,1,0,1,"run087"
"17626","RGR","BBB",2,5,7,0,7,"run087"
"17627","RGR","BBR",1,1,2,2,0,"run087"
"17628","RGR","BGB",2,5,7,6,1,"run087"
"17629","RGR","BGG",2,2,4,4,0,"run087"
"17630","RGR","BRR",1,5,6,0,6,"run087"
"17631","RGR","GGB",2,12,14,1,13,"run087"
"17632","RGR","GGG",0,2,2,2,0,"run087"
"17633","RGR","GGR",0,4,4,2,2,"run087"
"17634","RGR","RBB",0,4,4,4,0,"run087"
"17635","RGR","RGG",1,1,2,2,0,"run087"
"17636","RGR","RRG",0,3,3,3,0,"run087"
"17637","RRG","BBB",2,33,35,13,22,"run087"
"17638","RRG","BBR",0,5,5,2,3,"run087"
"17639","RRG","BGB",1,10,11,7,4,"run087"
"17640","RRG","BGG",0,2,2,1,1,"run087"
"17641","RRG","BRB",2,40,42,26,16,"run087"
"17642","RRG","BRR",1,16,17,14,3,"run087"
"17643","RRG","GGG",2,14,16,8,8,"run087"
"17644","RRG","GGR",0,5,5,4,1,"run087"
"17645","RRG","GRG",1,0,1,1,0,"run087"
"17646","RRG","GRR",3,8,11,7,4,"run087"
"17647","RRG","RBB",1,1,2,1,1,"run087"
"17648","RRG","RGG",0,1,1,0,1,"run087"
"17649","RRG","RGR",0,1,1,0,1,"run087"
"17650","RRR","BBR",1,0,1,1,0,"run087"
"17651","RRR","BGB",2,1,3,2,1,"run087"
"17652","RRR","BGG",1,0,1,1,0,"run087"
"17653","RRR","BRB",1,1,2,1,1,"run087"
"17654","RRR","BRR",1,1,2,1,1,"run087"
"17655","RRR","GGR",0,1,1,1,0,"run087"
"17656","RRR","GRR",0,3,3,3,0,"run087"
"17657","RRR","RBB",1,2,3,1,2,"run087"
"17658","RRR","RBR",0,2,2,1,1,"run087"
"17659","RRR","RGG",0,1,1,1,0,"run087"
"17660","RRR","RGR",1,2,3,3,0,"run087"
"17661","RRR","RRG",2,2,4,0,4,"run087"
"17662","BBB","BRB",0,1,1,0,1,"run088"
"17663","BBB","GGG",1,2,3,0,3,"run088"
"17664","BBB","GRR",0,2,2,1,1,"run088"
"17665","BBB","RBG",0,1,1,0,1,"run088"
"17666","BBB","RRG",1,3,4,2,2,"run088"
"17667","BBB","RRR",0,2,2,1,1,"run088"
"17668","BBG","BBB",1,4,5,0,5,"run088"
"17669","BBG","BGB",0,1,1,0,1,"run088"
"17670","BBG","BGG",0,1,1,0,1,"run088"
"17671","BBG","BRB",1,16,17,15,2,"run088"
"17672","BBG","GBB",0,1,1,0,1,"run088"
"17673","BBG","GBG",2,7,9,1,8,"run088"
"17674","BBG","GGB",2,25,27,14,13,"run088"
"17675","BBG","GGG",4,38,42,20,22,"run088"
"17676","BBG","GRG",1,9,10,8,2,"run088"
"17677","BBG","GRR",0,1,1,1,0,"run088"
"17678","BBG","RBB",0,1,1,1,0,"run088"
"17679","BBG","RBG",0,4,4,1,3,"run088"
"17680","BBG","RBR",0,1,1,1,0,"run088"
"17681","BBG","RGR",0,1,1,0,1,"run088"
"17682","BBG","RRG",1,2,3,0,3,"run088"
"17683","BBG","RRR",0,7,7,2,5,"run088"
"17684","BGB","BBB",0,2,2,2,0,"run088"
"17685","BGB","RRG",0,1,1,0,1,"run088"
"17686","BGG","BBB",0,3,3,2,1,"run088"
"17687","BGG","BBR",0,1,1,0,1,"run088"
"17688","BGG","GRG",0,1,1,1,0,"run088"
"17689","BGG","RBG",1,1,2,1,1,"run088"
"17690","BGG","RGG",0,3,3,3,0,"run088"
"17691","BGG","RGR",0,1,1,1,0,"run088"
"17692","BGG","RRR",1,1,2,1,1,"run088"
"17693","BRB","BBB",0,13,13,7,6,"run088"
"17694","BRB","BBR",0,1,1,0,1,"run088"
"17695","BRB","BRR",0,3,3,1,2,"run088"
"17696","BRB","GGG",0,1,1,1,0,"run088"
"17697","BRB","GGR",0,1,1,1,0,"run088"
"17698","BRB","RBB",0,1,1,1,0,"run088"
"17699","BRB","RBG",0,1,1,0,1,"run088"
"17700","BRB","RGR",0,1,1,1,0,"run088"
"17701","BRB","RRR",0,1,1,0,1,"run088"
"17702","BRR","BBB",0,11,11,6,5,"run088"
"17703","BRR","BGB",1,1,2,2,0,"run088"
"17704","BRR","BGG",0,1,1,0,1,"run088"
"17705","BRR","BRB",0,1,1,0,1,"run088"
"17706","BRR","RBB",0,2,2,1,1,"run088"
"17707","GBB","BBB",12,38,50,23,27,"run088"
"17708","GBB","BGG",0,1,1,1,0,"run088"
"17709","GBB","BRB",1,9,10,1,9,"run088"
"17710","GBB","BRR",1,3,4,0,4,"run088"
"17711","GBB","GBG",0,4,4,1,3,"run088"
"17712","GBB","GGB",0,21,21,3,18,"run088"
"17713","GBB","GGG",7,86,93,90,3,"run088"
"17714","GBB","GGR",1,3,4,3,1,"run088"
"17715","GBB","GRG",0,6,6,3,3,"run088"
"17716","GBB","GRR",0,1,1,0,1,"run088"
"17717","GBB","RBB",0,2,2,1,1,"run088"
"17718","GBB","RBG",3,9,12,6,6,"run088"
"17719","GBB","RBR",1,0,1,1,0,"run088"
"17720","GBB","RGG",1,0,1,0,1,"run088"
"17721","GBB","RGR",2,1,3,3,0,"run088"
"17722","GBB","RRG",0,2,2,0,2,"run088"
"17723","GBB","RRR",1,9,10,8,2,"run088"
"17724","GBG","BBB",0,5,5,3,2,"run088"
"17725","GBG","BBR",0,1,1,0,1,"run088"
"17726","GBG","BRB",1,4,5,4,1,"run088"
"17727","GBG","BRR",1,0,1,0,1,"run088"
"17728","GBG","GGB",0,4,4,0,4,"run088"
"17729","GBG","GGG",4,11,15,14,1,"run088"
"17730","GBG","RBB",1,0,1,1,0,"run088"
"17731","GBG","RBG",0,1,1,0,1,"run088"
"17732","GBG","RGG",0,1,1,0,1,"run088"
"17733","GBG","RGR",1,3,4,3,1,"run088"
"17734","GBG","RRG",1,3,4,3,1,"run088"
"17735","GGB","BBB",3,16,19,10,9,"run088"
"17736","GGB","BBR",1,4,5,2,3,"run088"
"17737","GGB","BGB",0,3,3,3,0,"run088"
"17738","GGB","BGG",0,4,4,3,1,"run088"
"17739","GGB","BRB",0,1,1,1,0,"run088"
"17740","GGB","BRR",1,15,16,8,8,"run088"
"17741","GGB","GBB",0,1,1,0,1,"run088"
"17742","GGB","GBG",1,0,1,1,0,"run088"
"17743","GGB","GGG",13,48,61,33,28,"run088"
"17744","GGB","GGR",0,7,7,3,4,"run088"
"17745","GGB","GRR",0,4,4,2,2,"run088"
"17746","GGB","RBB",0,5,5,3,2,"run088"
"17747","GGB","RBG",0,4,4,2,2,"run088"
"17748","GGB","RBR",0,5,5,5,0,"run088"
"17749","GGB","RGG",1,5,6,4,2,"run088"
"17750","GGB","RGR",0,2,2,2,0,"run088"
"17751","GGB","RRG",1,5,6,2,4,"run088"
"17752","GGB","RRR",1,5,6,2,4,"run088"
"17753","GGG","BBB",8,31,39,6,33,"run088"
"17754","GGG","BGB",0,2,2,2,0,"run088"
"17755","GGG","BGG",1,7,8,0,8,"run088"
"17756","GGG","BRB",1,3,4,4,0,"run088"
"17757","GGG","BRR",0,6,6,2,4,"run088"
"17758","GGG","GGB",5,1,6,3,3,"run088"
"17759","GGG","GGR",1,9,10,7,3,"run088"
"17760","GGG","GRR",0,2,2,1,1,"run088"
"17761","GGG","RBB",1,8,9,3,6,"run088"
"17762","GGG","RBG",0,6,6,2,4,"run088"
"17763","GGG","RBR",0,21,21,5,16,"run088"
"17764","GGG","RGG",0,3,3,2,1,"run088"
"17765","GGG","RGR",1,12,13,2,11,"run088"
"17766","GGG","RRG",1,23,24,12,12,"run088"
"17767","GGG","RRR",0,3,3,2,1,"run088"
"17768","GGR","BBB",0,2,2,2,0,"run088"
"17769","GGR","BBR",0,2,2,2,0,"run088"
"17770","GGR","BGG",0,1,1,0,1,"run088"
"17771","GGR","BRR",1,0,1,0,1,"run088"
"17772","GGR","GRR",1,0,1,0,1,"run088"
"17773","GGR","RBB",0,2,2,2,0,"run088"
"17774","GRG","BBB",3,8,11,7,4,"run088"
"17775","GRG","BBR",0,1,1,0,1,"run088"
"17776","GRG","BGG",0,1,1,0,1,"run088"
"17777","GRG","BRB",0,3,3,2,1,"run088"
"17778","GRG","BRR",0,1,1,0,1,"run088"
"17779","GRG","GBG",0,1,1,1,0,"run088"
"17780","GRG","GGB",2,15,17,8,9,"run088"
"17781","GRG","GGG",3,12,15,13,2,"run088"
"17782","GRG","GGR",0,5,5,0,5,"run088"
"17783","GRG","GRR",0,1,1,1,0,"run088"
"17784","GRG","RBG",0,1,1,1,0,"run088"
"17785","GRG","RBR",0,1,1,0,1,"run088"
"17786","GRG","RGR",1,2,3,0,3,"run088"
"17787","GRG","RRG",2,4,6,1,5,"run088"
"17788","GRR","BBB",0,1,1,0,1,"run088"
"17789","GRR","BBR",0,1,1,1,0,"run088"
"17790","GRR","BGB",1,2,3,1,2,"run088"
"17791","GRR","BGG",0,2,2,0,2,"run088"
"17792","GRR","BRB",0,1,1,1,0,"run088"
"17793","GRR","BRR",0,2,2,2,0,"run088"
"17794","GRR","GGG",0,1,1,1,0,"run088"
"17795","GRR","GGR",0,1,1,1,0,"run088"
"17796","RBB","BBB",0,1,1,0,1,"run088"
"17797","RBB","BBR",0,1,1,0,1,"run088"
"17798","RBB","BRB",0,1,1,0,1,"run088"
"17799","RBB","GRR",0,1,1,1,0,"run088"
"17800","RBB","RGG",0,1,1,0,1,"run088"
"17801","RBG","BBB",2,8,10,3,7,"run088"
"17802","RBG","BBG",0,1,1,1,0,"run088"
"17803","RBG","BRR",0,1,1,1,0,"run088"
"17804","RBG","GBB",0,1,1,0,1,"run088"
"17805","RBG","GRR",0,3,3,0,3,"run088"
"17806","RBG","RBB",1,1,2,2,0,"run088"
"17807","RBG","RBR",0,1,1,1,0,"run088"
"17808","RBG","RGR",0,1,1,0,1,"run088"
"17809","RBR","BBB",0,13,13,2,11,"run088"
"17810","RBR","BBR",0,1,1,1,0,"run088"
"17811","RBR","BGB",2,4,6,1,5,"run088"
"17812","RBR","BGG",0,2,2,2,0,"run088"
"17813","RBR","BRB",1,0,1,1,0,"run088"
"17814","RBR","BRR",1,4,5,3,2,"run088"
"17815","RBR","GGB",0,12,12,5,7,"run088"
"17816","RBR","GRR",4,4,8,4,4,"run088"
"17817","RBR","RBB",0,3,3,2,1,"run088"
"17818","RBR","RGG",2,9,11,10,1,"run088"
"17819","RBR","RGR",1,0,1,0,1,"run088"
"17820","RBR","RRR",0,1,1,1,0,"run088"
"17821","RGG","BBB",0,8,8,6,2,"run088"
"17822","RGG","BBR",1,2,3,3,0,"run088"
"17823","RGG","BGB",0,1,1,1,0,"run088"
"17824","RGG","BRR",0,4,4,0,4,"run088"
"17825","RGG","GGG",0,1,1,1,0,"run088"
"17826","RGG","GGR",0,3,3,3,0,"run088"
"17827","RGG","GRR",0,8,8,8,0,"run088"
"17828","RGG","RBB",0,1,1,1,0,"run088"
"17829","RGR","BBB",2,5,7,5,2,"run088"
"17830","RGR","BBR",1,1,2,1,1,"run088"
"17831","RGR","BGB",2,5,7,7,0,"run088"
"17832","RGR","BGG",2,2,4,1,3,"run088"
"17833","RGR","BRR",1,5,6,5,1,"run088"
"17834","RGR","GGB",2,12,14,8,6,"run088"
"17835","RGR","GGG",0,2,2,2,0,"run088"
"17836","RGR","GGR",0,4,4,1,3,"run088"
"17837","RGR","RBB",0,4,4,1,3,"run088"
"17838","RGR","RGG",1,1,2,1,1,"run088"
"17839","RGR","RRG",0,3,3,3,0,"run088"
"17840","RRG","BBB",2,33,35,35,0,"run088"
"17841","RRG","BBR",0,5,5,4,1,"run088"
"17842","RRG","BGB",1,10,11,7,4,"run088"
"17843","RRG","BGG",0,2,2,2,0,"run088"
"17844","RRG","BRB",2,40,42,17,25,"run088"
"17845","RRG","BRR",1,16,17,5,12,"run088"
"17846","RRG","GGG",2,14,16,16,0,"run088"
"17847","RRG","GGR",0,5,5,0,5,"run088"
"17848","RRG","GRG",1,0,1,0,1,"run088"
"17849","RRG","GRR",3,8,11,6,5,"run088"
"17850","RRG","RBB",1,1,2,1,1,"run088"
"17851","RRG","RGG",0,1,1,1,0,"run088"
"17852","RRG","RGR",0,1,1,0,1,"run088"
"17853","RRR","BBR",1,0,1,0,1,"run088"
"17854","RRR","BGB",2,1,3,2,1,"run088"
"17855","RRR","BGG",1,0,1,0,1,"run088"
"17856","RRR","BRB",1,1,2,0,2,"run088"
"17857","RRR","BRR",1,1,2,1,1,"run088"
"17858","RRR","GGR",0,1,1,0,1,"run088"
"17859","RRR","GRR",0,3,3,3,0,"run088"
"17860","RRR","RBB",1,2,3,3,0,"run088"
"17861","RRR","RBR",0,2,2,2,0,"run088"
"17862","RRR","RGG",0,1,1,0,1,"run088"
"17863","RRR","RGR",1,2,3,2,1,"run088"
"17864","RRR","RRG",2,2,4,4,0,"run088"
"17865","BBB","BRB",0,1,1,0,1,"run089"
"17866","BBB","GGG",1,2,3,2,1,"run089"
"17867","BBB","GRR",0,2,2,2,0,"run089"
"17868","BBB","RBG",0,1,1,0,1,"run089"
"17869","BBB","RRG",1,3,4,1,3,"run089"
"17870","BBB","RRR",0,2,2,1,1,"run089"
"17871","BBG","BBB",1,4,5,5,0,"run089"
"17872","BBG","BGB",0,1,1,0,1,"run089"
"17873","BBG","BGG",0,1,1,1,0,"run089"
"17874","BBG","BRB",1,16,17,10,7,"run089"
"17875","BBG","GBB",0,1,1,0,1,"run089"
"17876","BBG","GBG",2,7,9,6,3,"run089"
"17877","BBG","GGB",2,25,27,16,11,"run089"
"17878","BBG","GGG",4,38,42,21,21,"run089"
"17879","BBG","GRG",1,9,10,1,9,"run089"
"17880","BBG","GRR",0,1,1,1,0,"run089"
"17881","BBG","RBB",0,1,1,0,1,"run089"
"17882","BBG","RBG",0,4,4,0,4,"run089"
"17883","BBG","RBR",0,1,1,0,1,"run089"
"17884","BBG","RGR",0,1,1,0,1,"run089"
"17885","BBG","RRG",1,2,3,3,0,"run089"
"17886","BBG","RRR",0,7,7,4,3,"run089"
"17887","BGB","BBB",0,2,2,1,1,"run089"
"17888","BGB","RRG",0,1,1,0,1,"run089"
"17889","BGG","BBB",0,3,3,1,2,"run089"
"17890","BGG","BBR",0,1,1,1,0,"run089"
"17891","BGG","GRG",0,1,1,0,1,"run089"
"17892","BGG","RBG",1,1,2,2,0,"run089"
"17893","BGG","RGG",0,3,3,2,1,"run089"
"17894","BGG","RGR",0,1,1,0,1,"run089"
"17895","BGG","RRR",1,1,2,2,0,"run089"
"17896","BRB","BBB",0,13,13,0,13,"run089"
"17897","BRB","BBR",0,1,1,0,1,"run089"
"17898","BRB","BRR",0,3,3,1,2,"run089"
"17899","BRB","GGG",0,1,1,0,1,"run089"
"17900","BRB","GGR",0,1,1,0,1,"run089"
"17901","BRB","RBB",0,1,1,1,0,"run089"
"17902","BRB","RBG",0,1,1,1,0,"run089"
"17903","BRB","RGR",0,1,1,1,0,"run089"
"17904","BRB","RRR",0,1,1,1,0,"run089"
"17905","BRR","BBB",0,11,11,7,4,"run089"
"17906","BRR","BGB",1,1,2,1,1,"run089"
"17907","BRR","BGG",0,1,1,1,0,"run089"
"17908","BRR","BRB",0,1,1,0,1,"run089"
"17909","BRR","RBB",0,2,2,1,1,"run089"
"17910","GBB","BBB",12,38,50,36,14,"run089"
"17911","GBB","BGG",0,1,1,1,0,"run089"
"17912","GBB","BRB",1,9,10,4,6,"run089"
"17913","GBB","BRR",1,3,4,4,0,"run089"
"17914","GBB","GBG",0,4,4,4,0,"run089"
"17915","GBB","GGB",0,21,21,15,6,"run089"
"17916","GBB","GGG",7,86,93,1,92,"run089"
"17917","GBB","GGR",1,3,4,4,0,"run089"
"17918","GBB","GRG",0,6,6,1,5,"run089"
"17919","GBB","GRR",0,1,1,1,0,"run089"
"17920","GBB","RBB",0,2,2,2,0,"run089"
"17921","GBB","RBG",3,9,12,11,1,"run089"
"17922","GBB","RBR",1,0,1,1,0,"run089"
"17923","GBB","RGG",1,0,1,0,1,"run089"
"17924","GBB","RGR",2,1,3,3,0,"run089"
"17925","GBB","RRG",0,2,2,2,0,"run089"
"17926","GBB","RRR",1,9,10,0,10,"run089"
"17927","GBG","BBB",0,5,5,1,4,"run089"
"17928","GBG","BBR",0,1,1,1,0,"run089"
"17929","GBG","BRB",1,4,5,0,5,"run089"
"17930","GBG","BRR",1,0,1,1,0,"run089"
"17931","GBG","GGB",0,4,4,0,4,"run089"
"17932","GBG","GGG",4,11,15,1,14,"run089"
"17933","GBG","RBB",1,0,1,0,1,"run089"
"17934","GBG","RBG",0,1,1,0,1,"run089"
"17935","GBG","RGG",0,1,1,0,1,"run089"
"17936","GBG","RGR",1,3,4,2,2,"run089"
"17937","GBG","RRG",1,3,4,2,2,"run089"
"17938","GGB","BBB",3,16,19,4,15,"run089"
"17939","GGB","BBR",1,4,5,5,0,"run089"
"17940","GGB","BGB",0,3,3,3,0,"run089"
"17941","GGB","BGG",0,4,4,3,1,"run089"
"17942","GGB","BRB",0,1,1,0,1,"run089"
"17943","GGB","BRR",1,15,16,0,16,"run089"
"17944","GGB","GBB",0,1,1,1,0,"run089"
"17945","GGB","GBG",1,0,1,0,1,"run089"
"17946","GGB","GGG",13,48,61,32,29,"run089"
"17947","GGB","GGR",0,7,7,6,1,"run089"
"17948","GGB","GRR",0,4,4,2,2,"run089"
"17949","GGB","RBB",0,5,5,1,4,"run089"
"17950","GGB","RBG",0,4,4,4,0,"run089"
"17951","GGB","RBR",0,5,5,5,0,"run089"
"17952","GGB","RGG",1,5,6,4,2,"run089"
"17953","GGB","RGR",0,2,2,2,0,"run089"
"17954","GGB","RRG",1,5,6,0,6,"run089"
"17955","GGB","RRR",1,5,6,2,4,"run089"
"17956","GGG","BBB",8,31,39,18,21,"run089"
"17957","GGG","BGB",0,2,2,1,1,"run089"
"17958","GGG","BGG",1,7,8,1,7,"run089"
"17959","GGG","BRB",1,3,4,0,4,"run089"
"17960","GGG","BRR",0,6,6,4,2,"run089"
"17961","GGG","GGB",5,1,6,0,6,"run089"
"17962","GGG","GGR",1,9,10,2,8,"run089"
"17963","GGG","GRR",0,2,2,1,1,"run089"
"17964","GGG","RBB",1,8,9,8,1,"run089"
"17965","GGG","RBG",0,6,6,5,1,"run089"
"17966","GGG","RBR",0,21,21,0,21,"run089"
"17967","GGG","RGG",0,3,3,2,1,"run089"
"17968","GGG","RGR",1,12,13,7,6,"run089"
"17969","GGG","RRG",1,23,24,24,0,"run089"
"17970","GGG","RRR",0,3,3,0,3,"run089"
"17971","GGR","BBB",0,2,2,0,2,"run089"
"17972","GGR","BBR",0,2,2,2,0,"run089"
"17973","GGR","BGG",0,1,1,0,1,"run089"
"17974","GGR","BRR",1,0,1,0,1,"run089"
"17975","GGR","GRR",1,0,1,1,0,"run089"
"17976","GGR","RBB",0,2,2,1,1,"run089"
"17977","GRG","BBB",3,8,11,0,11,"run089"
"17978","GRG","BBR",0,1,1,0,1,"run089"
"17979","GRG","BGG",0,1,1,0,1,"run089"
"17980","GRG","BRB",0,3,3,3,0,"run089"
"17981","GRG","BRR",0,1,1,0,1,"run089"
"17982","GRG","GBG",0,1,1,1,0,"run089"
"17983","GRG","GGB",2,15,17,2,15,"run089"
"17984","GRG","GGG",3,12,15,3,12,"run089"
"17985","GRG","GGR",0,5,5,2,3,"run089"
"17986","GRG","GRR",0,1,1,0,1,"run089"
"17987","GRG","RBG",0,1,1,1,0,"run089"
"17988","GRG","RBR",0,1,1,1,0,"run089"
"17989","GRG","RGR",1,2,3,0,3,"run089"
"17990","GRG","RRG",2,4,6,6,0,"run089"
"17991","GRR","BBB",0,1,1,0,1,"run089"
"17992","GRR","BBR",0,1,1,0,1,"run089"
"17993","GRR","BGB",1,2,3,0,3,"run089"
"17994","GRR","BGG",0,2,2,0,2,"run089"
"17995","GRR","BRB",0,1,1,1,0,"run089"
"17996","GRR","BRR",0,2,2,0,2,"run089"
"17997","GRR","GGG",0,1,1,0,1,"run089"
"17998","GRR","GGR",0,1,1,0,1,"run089"
"17999","RBB","BBB",0,1,1,1,0,"run089"
"18000","RBB","BBR",0,1,1,1,0,"run089"
"18001","RBB","BRB",0,1,1,1,0,"run089"
"18002","RBB","GRR",0,1,1,1,0,"run089"
"18003","RBB","RGG",0,1,1,1,0,"run089"
"18004","RBG","BBB",2,8,10,0,10,"run089"
"18005","RBG","BBG",0,1,1,0,1,"run089"
"18006","RBG","BRR",0,1,1,1,0,"run089"
"18007","RBG","GBB",0,1,1,1,0,"run089"
"18008","RBG","GRR",0,3,3,1,2,"run089"
"18009","RBG","RBB",1,1,2,1,1,"run089"
"18010","RBG","RBR",0,1,1,0,1,"run089"
"18011","RBG","RGR",0,1,1,1,0,"run089"
"18012","RBR","BBB",0,13,13,12,1,"run089"
"18013","RBR","BBR",0,1,1,1,0,"run089"
"18014","RBR","BGB",2,4,6,5,1,"run089"
"18015","RBR","BGG",0,2,2,0,2,"run089"
"18016","RBR","BRB",1,0,1,1,0,"run089"
"18017","RBR","BRR",1,4,5,3,2,"run089"
"18018","RBR","GGB",0,12,12,9,3,"run089"
"18019","RBR","GRR",4,4,8,0,8,"run089"
"18020","RBR","RBB",0,3,3,3,0,"run089"
"18021","RBR","RGG",2,9,11,9,2,"run089"
"18022","RBR","RGR",1,0,1,1,0,"run089"
"18023","RBR","RRR",0,1,1,0,1,"run089"
"18024","RGG","BBB",0,8,8,4,4,"run089"
"18025","RGG","BBR",1,2,3,1,2,"run089"
"18026","RGG","BGB",0,1,1,0,1,"run089"
"18027","RGG","BRR",0,4,4,0,4,"run089"
"18028","RGG","GGG",0,1,1,1,0,"run089"
"18029","RGG","GGR",0,3,3,1,2,"run089"
"18030","RGG","GRR",0,8,8,6,2,"run089"
"18031","RGG","RBB",0,1,1,0,1,"run089"
"18032","RGR","BBB",2,5,7,4,3,"run089"
"18033","RGR","BBR",1,1,2,1,1,"run089"
"18034","RGR","BGB",2,5,7,1,6,"run089"
"18035","RGR","BGG",2,2,4,3,1,"run089"
"18036","RGR","BRR",1,5,6,6,0,"run089"
"18037","RGR","GGB",2,12,14,13,1,"run089"
"18038","RGR","GGG",0,2,2,1,1,"run089"
"18039","RGR","GGR",0,4,4,3,1,"run089"
"18040","RGR","RBB",0,4,4,0,4,"run089"
"18041","RGR","RGG",1,1,2,0,2,"run089"
"18042","RGR","RRG",0,3,3,1,2,"run089"
"18043","RRG","BBB",2,33,35,13,22,"run089"
"18044","RRG","BBR",0,5,5,3,2,"run089"
"18045","RRG","BGB",1,10,11,0,11,"run089"
"18046","RRG","BGG",0,2,2,2,0,"run089"
"18047","RRG","BRB",2,40,42,4,38,"run089"
"18048","RRG","BRR",1,16,17,13,4,"run089"
"18049","RRG","GGG",2,14,16,5,11,"run089"
"18050","RRG","GGR",0,5,5,1,4,"run089"
"18051","RRG","GRG",1,0,1,1,0,"run089"
"18052","RRG","GRR",3,8,11,9,2,"run089"
"18053","RRG","RBB",1,1,2,0,2,"run089"
"18054","RRG","RGG",0,1,1,0,1,"run089"
"18055","RRG","RGR",0,1,1,0,1,"run089"
"18056","RRR","BBR",1,0,1,1,0,"run089"
"18057","RRR","BGB",2,1,3,3,0,"run089"
"18058","RRR","BGG",1,0,1,1,0,"run089"
"18059","RRR","BRB",1,1,2,0,2,"run089"
"18060","RRR","BRR",1,1,2,1,1,"run089"
"18061","RRR","GGR",0,1,1,1,0,"run089"
"18062","RRR","GRR",0,3,3,3,0,"run089"
"18063","RRR","RBB",1,2,3,3,0,"run089"
"18064","RRR","RBR",0,2,2,0,2,"run089"
"18065","RRR","RGG",0,1,1,1,0,"run089"
"18066","RRR","RGR",1,2,3,2,1,"run089"
"18067","RRR","RRG",2,2,4,2,2,"run089"
"18068","BBB","BRB",0,1,1,1,0,"run090"
"18069","BBB","GGG",1,2,3,3,0,"run090"
"18070","BBB","GRR",0,2,2,1,1,"run090"
"18071","BBB","RBG",0,1,1,1,0,"run090"
"18072","BBB","RRG",1,3,4,0,4,"run090"
"18073","BBB","RRR",0,2,2,2,0,"run090"
"18074","BBG","BBB",1,4,5,4,1,"run090"
"18075","BBG","BGB",0,1,1,1,0,"run090"
"18076","BBG","BGG",0,1,1,0,1,"run090"
"18077","BBG","BRB",1,16,17,10,7,"run090"
"18078","BBG","GBB",0,1,1,1,0,"run090"
"18079","BBG","GBG",2,7,9,2,7,"run090"
"18080","BBG","GGB",2,25,27,27,0,"run090"
"18081","BBG","GGG",4,38,42,19,23,"run090"
"18082","BBG","GRG",1,9,10,10,0,"run090"
"18083","BBG","GRR",0,1,1,1,0,"run090"
"18084","BBG","RBB",0,1,1,0,1,"run090"
"18085","BBG","RBG",0,4,4,3,1,"run090"
"18086","BBG","RBR",0,1,1,0,1,"run090"
"18087","BBG","RGR",0,1,1,0,1,"run090"
"18088","BBG","RRG",1,2,3,2,1,"run090"
"18089","BBG","RRR",0,7,7,6,1,"run090"
"18090","BGB","BBB",0,2,2,0,2,"run090"
"18091","BGB","RRG",0,1,1,0,1,"run090"
"18092","BGG","BBB",0,3,3,3,0,"run090"
"18093","BGG","BBR",0,1,1,1,0,"run090"
"18094","BGG","GRG",0,1,1,1,0,"run090"
"18095","BGG","RBG",1,1,2,2,0,"run090"
"18096","BGG","RGG",0,3,3,2,1,"run090"
"18097","BGG","RGR",0,1,1,1,0,"run090"
"18098","BGG","RRR",1,1,2,0,2,"run090"
"18099","BRB","BBB",0,13,13,3,10,"run090"
"18100","BRB","BBR",0,1,1,0,1,"run090"
"18101","BRB","BRR",0,3,3,2,1,"run090"
"18102","BRB","GGG",0,1,1,0,1,"run090"
"18103","BRB","GGR",0,1,1,1,0,"run090"
"18104","BRB","RBB",0,1,1,0,1,"run090"
"18105","BRB","RBG",0,1,1,1,0,"run090"
"18106","BRB","RGR",0,1,1,0,1,"run090"
"18107","BRB","RRR",0,1,1,0,1,"run090"
"18108","BRR","BBB",0,11,11,10,1,"run090"
"18109","BRR","BGB",1,1,2,1,1,"run090"
"18110","BRR","BGG",0,1,1,1,0,"run090"
"18111","BRR","BRB",0,1,1,1,0,"run090"
"18112","BRR","RBB",0,2,2,0,2,"run090"
"18113","GBB","BBB",12,38,50,36,14,"run090"
"18114","GBB","BGG",0,1,1,1,0,"run090"
"18115","GBB","BRB",1,9,10,3,7,"run090"
"18116","GBB","BRR",1,3,4,0,4,"run090"
"18117","GBB","GBG",0,4,4,1,3,"run090"
"18118","GBB","GGB",0,21,21,1,20,"run090"
"18119","GBB","GGG",7,86,93,67,26,"run090"
"18120","GBB","GGR",1,3,4,2,2,"run090"
"18121","GBB","GRG",0,6,6,2,4,"run090"
"18122","GBB","GRR",0,1,1,1,0,"run090"
"18123","GBB","RBB",0,2,2,1,1,"run090"
"18124","GBB","RBG",3,9,12,2,10,"run090"
"18125","GBB","RBR",1,0,1,1,0,"run090"
"18126","GBB","RGG",1,0,1,1,0,"run090"
"18127","GBB","RGR",2,1,3,3,0,"run090"
"18128","GBB","RRG",0,2,2,2,0,"run090"
"18129","GBB","RRR",1,9,10,9,1,"run090"
"18130","GBG","BBB",0,5,5,1,4,"run090"
"18131","GBG","BBR",0,1,1,0,1,"run090"
"18132","GBG","BRB",1,4,5,3,2,"run090"
"18133","GBG","BRR",1,0,1,1,0,"run090"
"18134","GBG","GGB",0,4,4,3,1,"run090"
"18135","GBG","GGG",4,11,15,12,3,"run090"
"18136","GBG","RBB",1,0,1,1,0,"run090"
"18137","GBG","RBG",0,1,1,1,0,"run090"
"18138","GBG","RGG",0,1,1,1,0,"run090"
"18139","GBG","RGR",1,3,4,0,4,"run090"
"18140","GBG","RRG",1,3,4,0,4,"run090"
"18141","GGB","BBB",3,16,19,0,19,"run090"
"18142","GGB","BBR",1,4,5,5,0,"run090"
"18143","GGB","BGB",0,3,3,0,3,"run090"
"18144","GGB","BGG",0,4,4,3,1,"run090"
"18145","GGB","BRB",0,1,1,0,1,"run090"
"18146","GGB","BRR",1,15,16,9,7,"run090"
"18147","GGB","GBB",0,1,1,0,1,"run090"
"18148","GGB","GBG",1,0,1,1,0,"run090"
"18149","GGB","GGG",13,48,61,3,58,"run090"
"18150","GGB","GGR",0,7,7,6,1,"run090"
"18151","GGB","GRR",0,4,4,3,1,"run090"
"18152","GGB","RBB",0,5,5,0,5,"run090"
"18153","GGB","RBG",0,4,4,3,1,"run090"
"18154","GGB","RBR",0,5,5,3,2,"run090"
"18155","GGB","RGG",1,5,6,4,2,"run090"
"18156","GGB","RGR",0,2,2,2,0,"run090"
"18157","GGB","RRG",1,5,6,5,1,"run090"
"18158","GGB","RRR",1,5,6,4,2,"run090"
"18159","GGG","BBB",8,31,39,29,10,"run090"
"18160","GGG","BGB",0,2,2,0,2,"run090"
"18161","GGG","BGG",1,7,8,0,8,"run090"
"18162","GGG","BRB",1,3,4,0,4,"run090"
"18163","GGG","BRR",0,6,6,1,5,"run090"
"18164","GGG","GGB",5,1,6,0,6,"run090"
"18165","GGG","GGR",1,9,10,2,8,"run090"
"18166","GGG","GRR",0,2,2,0,2,"run090"
"18167","GGG","RBB",1,8,9,2,7,"run090"
"18168","GGG","RBG",0,6,6,4,2,"run090"
"18169","GGG","RBR",0,21,21,15,6,"run090"
"18170","GGG","RGG",0,3,3,1,2,"run090"
"18171","GGG","RGR",1,12,13,0,13,"run090"
"18172","GGG","RRG",1,23,24,2,22,"run090"
"18173","GGG","RRR",0,3,3,3,0,"run090"
"18174","GGR","BBB",0,2,2,2,0,"run090"
"18175","GGR","BBR",0,2,2,1,1,"run090"
"18176","GGR","BGG",0,1,1,0,1,"run090"
"18177","GGR","BRR",1,0,1,1,0,"run090"
"18178","GGR","GRR",1,0,1,0,1,"run090"
"18179","GGR","RBB",0,2,2,2,0,"run090"
"18180","GRG","BBB",3,8,11,10,1,"run090"
"18181","GRG","BBR",0,1,1,0,1,"run090"
"18182","GRG","BGG",0,1,1,0,1,"run090"
"18183","GRG","BRB",0,3,3,2,1,"run090"
"18184","GRG","BRR",0,1,1,1,0,"run090"
"18185","GRG","GBG",0,1,1,0,1,"run090"
"18186","GRG","GGB",2,15,17,17,0,"run090"
"18187","GRG","GGG",3,12,15,9,6,"run090"
"18188","GRG","GGR",0,5,5,3,2,"run090"
"18189","GRG","GRR",0,1,1,0,1,"run090"
"18190","GRG","RBG",0,1,1,1,0,"run090"
"18191","GRG","RBR",0,1,1,0,1,"run090"
"18192","GRG","RGR",1,2,3,1,2,"run090"
"18193","GRG","RRG",2,4,6,3,3,"run090"
"18194","GRR","BBB",0,1,1,0,1,"run090"
"18195","GRR","BBR",0,1,1,1,0,"run090"
"18196","GRR","BGB",1,2,3,1,2,"run090"
"18197","GRR","BGG",0,2,2,2,0,"run090"
"18198","GRR","BRB",0,1,1,0,1,"run090"
"18199","GRR","BRR",0,2,2,1,1,"run090"
"18200","GRR","GGG",0,1,1,1,0,"run090"
"18201","GRR","GGR",0,1,1,1,0,"run090"
"18202","RBB","BBB",0,1,1,0,1,"run090"
"18203","RBB","BBR",0,1,1,1,0,"run090"
"18204","RBB","BRB",0,1,1,1,0,"run090"
"18205","RBB","GRR",0,1,1,0,1,"run090"
"18206","RBB","RGG",0,1,1,0,1,"run090"
"18207","RBG","BBB",2,8,10,5,5,"run090"
"18208","RBG","BBG",0,1,1,0,1,"run090"
"18209","RBG","BRR",0,1,1,0,1,"run090"
"18210","RBG","GBB",0,1,1,0,1,"run090"
"18211","RBG","GRR",0,3,3,2,1,"run090"
"18212","RBG","RBB",1,1,2,1,1,"run090"
"18213","RBG","RBR",0,1,1,0,1,"run090"
"18214","RBG","RGR",0,1,1,1,0,"run090"
"18215","RBR","BBB",0,13,13,13,0,"run090"
"18216","RBR","BBR",0,1,1,0,1,"run090"
"18217","RBR","BGB",2,4,6,3,3,"run090"
"18218","RBR","BGG",0,2,2,1,1,"run090"
"18219","RBR","BRB",1,0,1,0,1,"run090"
"18220","RBR","BRR",1,4,5,4,1,"run090"
"18221","RBR","GGB",0,12,12,6,6,"run090"
"18222","RBR","GRR",4,4,8,0,8,"run090"
"18223","RBR","RBB",0,3,3,0,3,"run090"
"18224","RBR","RGG",2,9,11,11,0,"run090"
"18225","RBR","RGR",1,0,1,0,1,"run090"
"18226","RBR","RRR",0,1,1,1,0,"run090"
"18227","RGG","BBB",0,8,8,7,1,"run090"
"18228","RGG","BBR",1,2,3,1,2,"run090"
"18229","RGG","BGB",0,1,1,0,1,"run090"
"18230","RGG","BRR",0,4,4,1,3,"run090"
"18231","RGG","GGG",0,1,1,1,0,"run090"
"18232","RGG","GGR",0,3,3,2,1,"run090"
"18233","RGG","GRR",0,8,8,5,3,"run090"
"18234","RGG","RBB",0,1,1,1,0,"run090"
"18235","RGR","BBB",2,5,7,2,5,"run090"
"18236","RGR","BBR",1,1,2,1,1,"run090"
"18237","RGR","BGB",2,5,7,7,0,"run090"
"18238","RGR","BGG",2,2,4,2,2,"run090"
"18239","RGR","BRR",1,5,6,3,3,"run090"
"18240","RGR","GGB",2,12,14,10,4,"run090"
"18241","RGR","GGG",0,2,2,2,0,"run090"
"18242","RGR","GGR",0,4,4,2,2,"run090"
"18243","RGR","RBB",0,4,4,1,3,"run090"
"18244","RGR","RGG",1,1,2,2,0,"run090"
"18245","RGR","RRG",0,3,3,0,3,"run090"
"18246","RRG","BBB",2,33,35,13,22,"run090"
"18247","RRG","BBR",0,5,5,0,5,"run090"
"18248","RRG","BGB",1,10,11,7,4,"run090"
"18249","RRG","BGG",0,2,2,0,2,"run090"
"18250","RRG","BRB",2,40,42,24,18,"run090"
"18251","RRG","BRR",1,16,17,12,5,"run090"
"18252","RRG","GGG",2,14,16,2,14,"run090"
"18253","RRG","GGR",0,5,5,1,4,"run090"
"18254","RRG","GRG",1,0,1,1,0,"run090"
"18255","RRG","GRR",3,8,11,5,6,"run090"
"18256","RRG","RBB",1,1,2,0,2,"run090"
"18257","RRG","RGG",0,1,1,1,0,"run090"
"18258","RRG","RGR",0,1,1,1,0,"run090"
"18259","RRR","BBR",1,0,1,0,1,"run090"
"18260","RRR","BGB",2,1,3,0,3,"run090"
"18261","RRR","BGG",1,0,1,1,0,"run090"
"18262","RRR","BRB",1,1,2,1,1,"run090"
"18263","RRR","BRR",1,1,2,1,1,"run090"
"18264","RRR","GGR",0,1,1,1,0,"run090"
"18265","RRR","GRR",0,3,3,3,0,"run090"
"18266","RRR","RBB",1,2,3,3,0,"run090"
"18267","RRR","RBR",0,2,2,1,1,"run090"
"18268","RRR","RGG",0,1,1,1,0,"run090"
"18269","RRR","RGR",1,2,3,2,1,"run090"
"18270","RRR","RRG",2,2,4,0,4,"run090"
"18271","BBB","BRB",0,1,1,0,1,"run091"
"18272","BBB","GGG",1,2,3,3,0,"run091"
"18273","BBB","GRR",0,2,2,2,0,"run091"
"18274","BBB","RBG",0,1,1,1,0,"run091"
"18275","BBB","RRG",1,3,4,3,1,"run091"
"18276","BBB","RRR",0,2,2,2,0,"run091"
"18277","BBG","BBB",1,4,5,2,3,"run091"
"18278","BBG","BGB",0,1,1,0,1,"run091"
"18279","BBG","BGG",0,1,1,1,0,"run091"
"18280","BBG","BRB",1,16,17,13,4,"run091"
"18281","BBG","GBB",0,1,1,1,0,"run091"
"18282","BBG","GBG",2,7,9,6,3,"run091"
"18283","BBG","GGB",2,25,27,27,0,"run091"
"18284","BBG","GGG",4,38,42,19,23,"run091"
"18285","BBG","GRG",1,9,10,10,0,"run091"
"18286","BBG","GRR",0,1,1,0,1,"run091"
"18287","BBG","RBB",0,1,1,0,1,"run091"
"18288","BBG","RBG",0,4,4,2,2,"run091"
"18289","BBG","RBR",0,1,1,1,0,"run091"
"18290","BBG","RGR",0,1,1,0,1,"run091"
"18291","BBG","RRG",1,2,3,2,1,"run091"
"18292","BBG","RRR",0,7,7,5,2,"run091"
"18293","BGB","BBB",0,2,2,0,2,"run091"
"18294","BGB","RRG",0,1,1,0,1,"run091"
"18295","BGG","BBB",0,3,3,1,2,"run091"
"18296","BGG","BBR",0,1,1,0,1,"run091"
"18297","BGG","GRG",0,1,1,0,1,"run091"
"18298","BGG","RBG",1,1,2,0,2,"run091"
"18299","BGG","RGG",0,3,3,1,2,"run091"
"18300","BGG","RGR",0,1,1,1,0,"run091"
"18301","BGG","RRR",1,1,2,0,2,"run091"
"18302","BRB","BBB",0,13,13,3,10,"run091"
"18303","BRB","BBR",0,1,1,0,1,"run091"
"18304","BRB","BRR",0,3,3,3,0,"run091"
"18305","BRB","GGG",0,1,1,1,0,"run091"
"18306","BRB","GGR",0,1,1,0,1,"run091"
"18307","BRB","RBB",0,1,1,0,1,"run091"
"18308","BRB","RBG",0,1,1,0,1,"run091"
"18309","BRB","RGR",0,1,1,1,0,"run091"
"18310","BRB","RRR",0,1,1,1,0,"run091"
"18311","BRR","BBB",0,11,11,0,11,"run091"
"18312","BRR","BGB",1,1,2,0,2,"run091"
"18313","BRR","BGG",0,1,1,0,1,"run091"
"18314","BRR","BRB",0,1,1,0,1,"run091"
"18315","BRR","RBB",0,2,2,2,0,"run091"
"18316","GBB","BBB",12,38,50,18,32,"run091"
"18317","GBB","BGG",0,1,1,1,0,"run091"
"18318","GBB","BRB",1,9,10,9,1,"run091"
"18319","GBB","BRR",1,3,4,0,4,"run091"
"18320","GBB","GBG",0,4,4,3,1,"run091"
"18321","GBB","GGB",0,21,21,13,8,"run091"
"18322","GBB","GGG",7,86,93,54,39,"run091"
"18323","GBB","GGR",1,3,4,2,2,"run091"
"18324","GBB","GRG",0,6,6,0,6,"run091"
"18325","GBB","GRR",0,1,1,1,0,"run091"
"18326","GBB","RBB",0,2,2,1,1,"run091"
"18327","GBB","RBG",3,9,12,6,6,"run091"
"18328","GBB","RBR",1,0,1,0,1,"run091"
"18329","GBB","RGG",1,0,1,0,1,"run091"
"18330","GBB","RGR",2,1,3,1,2,"run091"
"18331","GBB","RRG",0,2,2,0,2,"run091"
"18332","GBB","RRR",1,9,10,8,2,"run091"
"18333","GBG","BBB",0,5,5,0,5,"run091"
"18334","GBG","BBR",0,1,1,1,0,"run091"
"18335","GBG","BRB",1,4,5,1,4,"run091"
"18336","GBG","BRR",1,0,1,0,1,"run091"
"18337","GBG","GGB",0,4,4,2,2,"run091"
"18338","GBG","GGG",4,11,15,6,9,"run091"
"18339","GBG","RBB",1,0,1,0,1,"run091"
"18340","GBG","RBG",0,1,1,0,1,"run091"
"18341","GBG","RGG",0,1,1,0,1,"run091"
"18342","GBG","RGR",1,3,4,3,1,"run091"
"18343","GBG","RRG",1,3,4,0,4,"run091"
"18344","GGB","BBB",3,16,19,8,11,"run091"
"18345","GGB","BBR",1,4,5,0,5,"run091"
"18346","GGB","BGB",0,3,3,1,2,"run091"
"18347","GGB","BGG",0,4,4,2,2,"run091"
"18348","GGB","BRB",0,1,1,1,0,"run091"
"18349","GGB","BRR",1,15,16,12,4,"run091"
"18350","GGB","GBB",0,1,1,0,1,"run091"
"18351","GGB","GBG",1,0,1,1,0,"run091"
"18352","GGB","GGG",13,48,61,34,27,"run091"
"18353","GGB","GGR",0,7,7,7,0,"run091"
"18354","GGB","GRR",0,4,4,2,2,"run091"
"18355","GGB","RBB",0,5,5,1,4,"run091"
"18356","GGB","RBG",0,4,4,1,3,"run091"
"18357","GGB","RBR",0,5,5,1,4,"run091"
"18358","GGB","RGG",1,5,6,0,6,"run091"
"18359","GGB","RGR",0,2,2,1,1,"run091"
"18360","GGB","RRG",1,5,6,0,6,"run091"
"18361","GGB","RRR",1,5,6,1,5,"run091"
"18362","GGG","BBB",8,31,39,10,29,"run091"
"18363","GGG","BGB",0,2,2,2,0,"run091"
"18364","GGG","BGG",1,7,8,8,0,"run091"
"18365","GGG","BRB",1,3,4,4,0,"run091"
"18366","GGG","BRR",0,6,6,4,2,"run091"
"18367","GGG","GGB",5,1,6,6,0,"run091"
"18368","GGG","GGR",1,9,10,6,4,"run091"
"18369","GGG","GRR",0,2,2,0,2,"run091"
"18370","GGG","RBB",1,8,9,8,1,"run091"
"18371","GGG","RBG",0,6,6,6,0,"run091"
"18372","GGG","RBR",0,21,21,18,3,"run091"
"18373","GGG","RGG",0,3,3,3,0,"run091"
"18374","GGG","RGR",1,12,13,7,6,"run091"
"18375","GGG","RRG",1,23,24,19,5,"run091"
"18376","GGG","RRR",0,3,3,0,3,"run091"
"18377","GGR","BBB",0,2,2,2,0,"run091"
"18378","GGR","BBR",0,2,2,2,0,"run091"
"18379","GGR","BGG",0,1,1,1,0,"run091"
"18380","GGR","BRR",1,0,1,1,0,"run091"
"18381","GGR","GRR",1,0,1,0,1,"run091"
"18382","GGR","RBB",0,2,2,1,1,"run091"
"18383","GRG","BBB",3,8,11,4,7,"run091"
"18384","GRG","BBR",0,1,1,0,1,"run091"
"18385","GRG","BGG",0,1,1,0,1,"run091"
"18386","GRG","BRB",0,3,3,1,2,"run091"
"18387","GRG","BRR",0,1,1,1,0,"run091"
"18388","GRG","GBG",0,1,1,1,0,"run091"
"18389","GRG","GGB",2,15,17,10,7,"run091"
"18390","GRG","GGG",3,12,15,8,7,"run091"
"18391","GRG","GGR",0,5,5,2,3,"run091"
"18392","GRG","GRR",0,1,1,1,0,"run091"
"18393","GRG","RBG",0,1,1,0,1,"run091"
"18394","GRG","RBR",0,1,1,0,1,"run091"
"18395","GRG","RGR",1,2,3,0,3,"run091"
"18396","GRG","RRG",2,4,6,2,4,"run091"
"18397","GRR","BBB",0,1,1,0,1,"run091"
"18398","GRR","BBR",0,1,1,0,1,"run091"
"18399","GRR","BGB",1,2,3,1,2,"run091"
"18400","GRR","BGG",0,2,2,0,2,"run091"
"18401","GRR","BRB",0,1,1,0,1,"run091"
"18402","GRR","BRR",0,2,2,0,2,"run091"
"18403","GRR","GGG",0,1,1,1,0,"run091"
"18404","GRR","GGR",0,1,1,0,1,"run091"
"18405","RBB","BBB",0,1,1,1,0,"run091"
"18406","RBB","BBR",0,1,1,0,1,"run091"
"18407","RBB","BRB",0,1,1,1,0,"run091"
"18408","RBB","GRR",0,1,1,0,1,"run091"
"18409","RBB","RGG",0,1,1,0,1,"run091"
"18410","RBG","BBB",2,8,10,5,5,"run091"
"18411","RBG","BBG",0,1,1,0,1,"run091"
"18412","RBG","BRR",0,1,1,0,1,"run091"
"18413","RBG","GBB",0,1,1,1,0,"run091"
"18414","RBG","GRR",0,3,3,3,0,"run091"
"18415","RBG","RBB",1,1,2,2,0,"run091"
"18416","RBG","RBR",0,1,1,1,0,"run091"
"18417","RBG","RGR",0,1,1,1,0,"run091"
"18418","RBR","BBB",0,13,13,4,9,"run091"
"18419","RBR","BBR",0,1,1,0,1,"run091"
"18420","RBR","BGB",2,4,6,2,4,"run091"
"18421","RBR","BGG",0,2,2,0,2,"run091"
"18422","RBR","BRB",1,0,1,1,0,"run091"
"18423","RBR","BRR",1,4,5,1,4,"run091"
"18424","RBR","GGB",0,12,12,12,0,"run091"
"18425","RBR","GRR",4,4,8,4,4,"run091"
"18426","RBR","RBB",0,3,3,0,3,"run091"
"18427","RBR","RGG",2,9,11,5,6,"run091"
"18428","RBR","RGR",1,0,1,1,0,"run091"
"18429","RBR","RRR",0,1,1,1,0,"run091"
"18430","RGG","BBB",0,8,8,1,7,"run091"
"18431","RGG","BBR",1,2,3,2,1,"run091"
"18432","RGG","BGB",0,1,1,1,0,"run091"
"18433","RGG","BRR",0,4,4,1,3,"run091"
"18434","RGG","GGG",0,1,1,1,0,"run091"
"18435","RGG","GGR",0,3,3,1,2,"run091"
"18436","RGG","GRR",0,8,8,6,2,"run091"
"18437","RGG","RBB",0,1,1,1,0,"run091"
"18438","RGR","BBB",2,5,7,2,5,"run091"
"18439","RGR","BBR",1,1,2,1,1,"run091"
"18440","RGR","BGB",2,5,7,7,0,"run091"
"18441","RGR","BGG",2,2,4,0,4,"run091"
"18442","RGR","BRR",1,5,6,0,6,"run091"
"18443","RGR","GGB",2,12,14,7,7,"run091"
"18444","RGR","GGG",0,2,2,2,0,"run091"
"18445","RGR","GGR",0,4,4,3,1,"run091"
"18446","RGR","RBB",0,4,4,1,3,"run091"
"18447","RGR","RGG",1,1,2,0,2,"run091"
"18448","RGR","RRG",0,3,3,1,2,"run091"
"18449","RRG","BBB",2,33,35,29,6,"run091"
"18450","RRG","BBR",0,5,5,1,4,"run091"
"18451","RRG","BGB",1,10,11,10,1,"run091"
"18452","RRG","BGG",0,2,2,0,2,"run091"
"18453","RRG","BRB",2,40,42,30,12,"run091"
"18454","RRG","BRR",1,16,17,8,9,"run091"
"18455","RRG","GGG",2,14,16,8,8,"run091"
"18456","RRG","GGR",0,5,5,0,5,"run091"
"18457","RRG","GRG",1,0,1,0,1,"run091"
"18458","RRG","GRR",3,8,11,5,6,"run091"
"18459","RRG","RBB",1,1,2,0,2,"run091"
"18460","RRG","RGG",0,1,1,1,0,"run091"
"18461","RRG","RGR",0,1,1,0,1,"run091"
"18462","RRR","BBR",1,0,1,0,1,"run091"
"18463","RRR","BGB",2,1,3,0,3,"run091"
"18464","RRR","BGG",1,0,1,1,0,"run091"
"18465","RRR","BRB",1,1,2,1,1,"run091"
"18466","RRR","BRR",1,1,2,1,1,"run091"
"18467","RRR","GGR",0,1,1,0,1,"run091"
"18468","RRR","GRR",0,3,3,2,1,"run091"
"18469","RRR","RBB",1,2,3,2,1,"run091"
"18470","RRR","RBR",0,2,2,2,0,"run091"
"18471","RRR","RGG",0,1,1,1,0,"run091"
"18472","RRR","RGR",1,2,3,2,1,"run091"
"18473","RRR","RRG",2,2,4,0,4,"run091"
"18474","BBB","BRB",0,1,1,1,0,"run092"
"18475","BBB","GGG",1,2,3,1,2,"run092"
"18476","BBB","GRR",0,2,2,2,0,"run092"
"18477","BBB","RBG",0,1,1,1,0,"run092"
"18478","BBB","RRG",1,3,4,3,1,"run092"
"18479","BBB","RRR",0,2,2,0,2,"run092"
"18480","BBG","BBB",1,4,5,3,2,"run092"
"18481","BBG","BGB",0,1,1,0,1,"run092"
"18482","BBG","BGG",0,1,1,0,1,"run092"
"18483","BBG","BRB",1,16,17,15,2,"run092"
"18484","BBG","GBB",0,1,1,1,0,"run092"
"18485","BBG","GBG",2,7,9,7,2,"run092"
"18486","BBG","GGB",2,25,27,19,8,"run092"
"18487","BBG","GGG",4,38,42,21,21,"run092"
"18488","BBG","GRG",1,9,10,3,7,"run092"
"18489","BBG","GRR",0,1,1,1,0,"run092"
"18490","BBG","RBB",0,1,1,1,0,"run092"
"18491","BBG","RBG",0,4,4,1,3,"run092"
"18492","BBG","RBR",0,1,1,1,0,"run092"
"18493","BBG","RGR",0,1,1,0,1,"run092"
"18494","BBG","RRG",1,2,3,3,0,"run092"
"18495","BBG","RRR",0,7,7,3,4,"run092"
"18496","BGB","BBB",0,2,2,1,1,"run092"
"18497","BGB","RRG",0,1,1,1,0,"run092"
"18498","BGG","BBB",0,3,3,2,1,"run092"
"18499","BGG","BBR",0,1,1,0,1,"run092"
"18500","BGG","GRG",0,1,1,0,1,"run092"
"18501","BGG","RBG",1,1,2,1,1,"run092"
"18502","BGG","RGG",0,3,3,1,2,"run092"
"18503","BGG","RGR",0,1,1,1,0,"run092"
"18504","BGG","RRR",1,1,2,0,2,"run092"
"18505","BRB","BBB",0,13,13,9,4,"run092"
"18506","BRB","BBR",0,1,1,1,0,"run092"
"18507","BRB","BRR",0,3,3,1,2,"run092"
"18508","BRB","GGG",0,1,1,0,1,"run092"
"18509","BRB","GGR",0,1,1,1,0,"run092"
"18510","BRB","RBB",0,1,1,0,1,"run092"
"18511","BRB","RBG",0,1,1,0,1,"run092"
"18512","BRB","RGR",0,1,1,1,0,"run092"
"18513","BRB","RRR",0,1,1,0,1,"run092"
"18514","BRR","BBB",0,11,11,5,6,"run092"
"18515","BRR","BGB",1,1,2,2,0,"run092"
"18516","BRR","BGG",0,1,1,1,0,"run092"
"18517","BRR","BRB",0,1,1,1,0,"run092"
"18518","BRR","RBB",0,2,2,2,0,"run092"
"18519","GBB","BBB",12,38,50,9,41,"run092"
"18520","GBB","BGG",0,1,1,0,1,"run092"
"18521","GBB","BRB",1,9,10,10,0,"run092"
"18522","GBB","BRR",1,3,4,3,1,"run092"
"18523","GBB","GBG",0,4,4,1,3,"run092"
"18524","GBB","GGB",0,21,21,18,3,"run092"
"18525","GBB","GGG",7,86,93,51,42,"run092"
"18526","GBB","GGR",1,3,4,4,0,"run092"
"18527","GBB","GRG",0,6,6,3,3,"run092"
"18528","GBB","GRR",0,1,1,1,0,"run092"
"18529","GBB","RBB",0,2,2,1,1,"run092"
"18530","GBB","RBG",3,9,12,6,6,"run092"
"18531","GBB","RBR",1,0,1,1,0,"run092"
"18532","GBB","RGG",1,0,1,0,1,"run092"
"18533","GBB","RGR",2,1,3,3,0,"run092"
"18534","GBB","RRG",0,2,2,0,2,"run092"
"18535","GBB","RRR",1,9,10,3,7,"run092"
"18536","GBG","BBB",0,5,5,1,4,"run092"
"18537","GBG","BBR",0,1,1,0,1,"run092"
"18538","GBG","BRB",1,4,5,2,3,"run092"
"18539","GBG","BRR",1,0,1,0,1,"run092"
"18540","GBG","GGB",0,4,4,1,3,"run092"
"18541","GBG","GGG",4,11,15,7,8,"run092"
"18542","GBG","RBB",1,0,1,1,0,"run092"
"18543","GBG","RBG",0,1,1,1,0,"run092"
"18544","GBG","RGG",0,1,1,1,0,"run092"
"18545","GBG","RGR",1,3,4,2,2,"run092"
"18546","GBG","RRG",1,3,4,1,3,"run092"
"18547","GGB","BBB",3,16,19,11,8,"run092"
"18548","GGB","BBR",1,4,5,1,4,"run092"
"18549","GGB","BGB",0,3,3,3,0,"run092"
"18550","GGB","BGG",0,4,4,1,3,"run092"
"18551","GGB","BRB",0,1,1,1,0,"run092"
"18552","GGB","BRR",1,15,16,10,6,"run092"
"18553","GGB","GBB",0,1,1,0,1,"run092"
"18554","GGB","GBG",1,0,1,1,0,"run092"
"18555","GGB","GGG",13,48,61,38,23,"run092"
"18556","GGB","GGR",0,7,7,2,5,"run092"
"18557","GGB","GRR",0,4,4,2,2,"run092"
"18558","GGB","RBB",0,5,5,5,0,"run092"
"18559","GGB","RBG",0,4,4,3,1,"run092"
"18560","GGB","RBR",0,5,5,4,1,"run092"
"18561","GGB","RGG",1,5,6,0,6,"run092"
"18562","GGB","RGR",0,2,2,1,1,"run092"
"18563","GGB","RRG",1,5,6,2,4,"run092"
"18564","GGB","RRR",1,5,6,3,3,"run092"
"18565","GGG","BBB",8,31,39,5,34,"run092"
"18566","GGG","BGB",0,2,2,2,0,"run092"
"18567","GGG","BGG",1,7,8,8,0,"run092"
"18568","GGG","BRB",1,3,4,1,3,"run092"
"18569","GGG","BRR",0,6,6,2,4,"run092"
"18570","GGG","GGB",5,1,6,5,1,"run092"
"18571","GGG","GGR",1,9,10,1,9,"run092"
"18572","GGG","GRR",0,2,2,1,1,"run092"
"18573","GGG","RBB",1,8,9,4,5,"run092"
"18574","GGG","RBG",0,6,6,6,0,"run092"
"18575","GGG","RBR",0,21,21,10,11,"run092"
"18576","GGG","RGG",0,3,3,3,0,"run092"
"18577","GGG","RGR",1,12,13,1,12,"run092"
"18578","GGG","RRG",1,23,24,11,13,"run092"
"18579","GGG","RRR",0,3,3,1,2,"run092"
"18580","GGR","BBB",0,2,2,2,0,"run092"
"18581","GGR","BBR",0,2,2,2,0,"run092"
"18582","GGR","BGG",0,1,1,1,0,"run092"
"18583","GGR","BRR",1,0,1,1,0,"run092"
"18584","GGR","GRR",1,0,1,1,0,"run092"
"18585","GGR","RBB",0,2,2,2,0,"run092"
"18586","GRG","BBB",3,8,11,5,6,"run092"
"18587","GRG","BBR",0,1,1,0,1,"run092"
"18588","GRG","BGG",0,1,1,0,1,"run092"
"18589","GRG","BRB",0,3,3,3,0,"run092"
"18590","GRG","BRR",0,1,1,0,1,"run092"
"18591","GRG","GBG",0,1,1,1,0,"run092"
"18592","GRG","GGB",2,15,17,1,16,"run092"
"18593","GRG","GGG",3,12,15,3,12,"run092"
"18594","GRG","GGR",0,5,5,3,2,"run092"
"18595","GRG","GRR",0,1,1,1,0,"run092"
"18596","GRG","RBG",0,1,1,0,1,"run092"
"18597","GRG","RBR",0,1,1,0,1,"run092"
"18598","GRG","RGR",1,2,3,2,1,"run092"
"18599","GRG","RRG",2,4,6,6,0,"run092"
"18600","GRR","BBB",0,1,1,0,1,"run092"
"18601","GRR","BBR",0,1,1,0,1,"run092"
"18602","GRR","BGB",1,2,3,0,3,"run092"
"18603","GRR","BGG",0,2,2,0,2,"run092"
"18604","GRR","BRB",0,1,1,0,1,"run092"
"18605","GRR","BRR",0,2,2,1,1,"run092"
"18606","GRR","GGG",0,1,1,1,0,"run092"
"18607","GRR","GGR",0,1,1,1,0,"run092"
"18608","RBB","BBB",0,1,1,0,1,"run092"
"18609","RBB","BBR",0,1,1,1,0,"run092"
"18610","RBB","BRB",0,1,1,0,1,"run092"
"18611","RBB","GRR",0,1,1,0,1,"run092"
"18612","RBB","RGG",0,1,1,1,0,"run092"
"18613","RBG","BBB",2,8,10,5,5,"run092"
"18614","RBG","BBG",0,1,1,0,1,"run092"
"18615","RBG","BRR",0,1,1,0,1,"run092"
"18616","RBG","GBB",0,1,1,0,1,"run092"
"18617","RBG","GRR",0,3,3,1,2,"run092"
"18618","RBG","RBB",1,1,2,2,0,"run092"
"18619","RBG","RBR",0,1,1,1,0,"run092"
"18620","RBG","RGR",0,1,1,1,0,"run092"
"18621","RBR","BBB",0,13,13,4,9,"run092"
"18622","RBR","BBR",0,1,1,0,1,"run092"
"18623","RBR","BGB",2,4,6,0,6,"run092"
"18624","RBR","BGG",0,2,2,1,1,"run092"
"18625","RBR","BRB",1,0,1,0,1,"run092"
"18626","RBR","BRR",1,4,5,2,3,"run092"
"18627","RBR","GGB",0,12,12,1,11,"run092"
"18628","RBR","GRR",4,4,8,4,4,"run092"
"18629","RBR","RBB",0,3,3,0,3,"run092"
"18630","RBR","RGG",2,9,11,4,7,"run092"
"18631","RBR","RGR",1,0,1,1,0,"run092"
"18632","RBR","RRR",0,1,1,1,0,"run092"
"18633","RGG","BBB",0,8,8,1,7,"run092"
"18634","RGG","BBR",1,2,3,2,1,"run092"
"18635","RGG","BGB",0,1,1,0,1,"run092"
"18636","RGG","BRR",0,4,4,3,1,"run092"
"18637","RGG","GGG",0,1,1,0,1,"run092"
"18638","RGG","GGR",0,3,3,3,0,"run092"
"18639","RGG","GRR",0,8,8,3,5,"run092"
"18640","RGG","RBB",0,1,1,1,0,"run092"
"18641","RGR","BBB",2,5,7,2,5,"run092"
"18642","RGR","BBR",1,1,2,0,2,"run092"
"18643","RGR","BGB",2,5,7,4,3,"run092"
"18644","RGR","BGG",2,2,4,3,1,"run092"
"18645","RGR","BRR",1,5,6,0,6,"run092"
"18646","RGR","GGB",2,12,14,10,4,"run092"
"18647","RGR","GGG",0,2,2,0,2,"run092"
"18648","RGR","GGR",0,4,4,0,4,"run092"
"18649","RGR","RBB",0,4,4,4,0,"run092"
"18650","RGR","RGG",1,1,2,0,2,"run092"
"18651","RGR","RRG",0,3,3,1,2,"run092"
"18652","RRG","BBB",2,33,35,23,12,"run092"
"18653","RRG","BBR",0,5,5,4,1,"run092"
"18654","RRG","BGB",1,10,11,9,2,"run092"
"18655","RRG","BGG",0,2,2,0,2,"run092"
"18656","RRG","BRB",2,40,42,17,25,"run092"
"18657","RRG","BRR",1,16,17,7,10,"run092"
"18658","RRG","GGG",2,14,16,15,1,"run092"
"18659","RRG","GGR",0,5,5,0,5,"run092"
"18660","RRG","GRG",1,0,1,0,1,"run092"
"18661","RRG","GRR",3,8,11,4,7,"run092"
"18662","RRG","RBB",1,1,2,2,0,"run092"
"18663","RRG","RGG",0,1,1,1,0,"run092"
"18664","RRG","RGR",0,1,1,1,0,"run092"
"18665","RRR","BBR",1,0,1,0,1,"run092"
"18666","RRR","BGB",2,1,3,0,3,"run092"
"18667","RRR","BGG",1,0,1,0,1,"run092"
"18668","RRR","BRB",1,1,2,1,1,"run092"
"18669","RRR","BRR",1,1,2,2,0,"run092"
"18670","RRR","GGR",0,1,1,1,0,"run092"
"18671","RRR","GRR",0,3,3,3,0,"run092"
"18672","RRR","RBB",1,2,3,0,3,"run092"
"18673","RRR","RBR",0,2,2,0,2,"run092"
"18674","RRR","RGG",0,1,1,0,1,"run092"
"18675","RRR","RGR",1,2,3,0,3,"run092"
"18676","RRR","RRG",2,2,4,3,1,"run092"
"18677","BBB","BRB",0,1,1,0,1,"run093"
"18678","BBB","GGG",1,2,3,0,3,"run093"
"18679","BBB","GRR",0,2,2,2,0,"run093"
"18680","BBB","RBG",0,1,1,0,1,"run093"
"18681","BBB","RRG",1,3,4,2,2,"run093"
"18682","BBB","RRR",0,2,2,1,1,"run093"
"18683","BBG","BBB",1,4,5,5,0,"run093"
"18684","BBG","BGB",0,1,1,1,0,"run093"
"18685","BBG","BGG",0,1,1,0,1,"run093"
"18686","BBG","BRB",1,16,17,6,11,"run093"
"18687","BBG","GBB",0,1,1,1,0,"run093"
"18688","BBG","GBG",2,7,9,6,3,"run093"
"18689","BBG","GGB",2,25,27,7,20,"run093"
"18690","BBG","GGG",4,38,42,11,31,"run093"
"18691","BBG","GRG",1,9,10,8,2,"run093"
"18692","BBG","GRR",0,1,1,0,1,"run093"
"18693","BBG","RBB",0,1,1,0,1,"run093"
"18694","BBG","RBG",0,4,4,0,4,"run093"
"18695","BBG","RBR",0,1,1,1,0,"run093"
"18696","BBG","RGR",0,1,1,1,0,"run093"
"18697","BBG","RRG",1,2,3,2,1,"run093"
"18698","BBG","RRR",0,7,7,3,4,"run093"
"18699","BGB","BBB",0,2,2,0,2,"run093"
"18700","BGB","RRG",0,1,1,0,1,"run093"
"18701","BGG","BBB",0,3,3,0,3,"run093"
"18702","BGG","BBR",0,1,1,0,1,"run093"
"18703","BGG","GRG",0,1,1,0,1,"run093"
"18704","BGG","RBG",1,1,2,0,2,"run093"
"18705","BGG","RGG",0,3,3,3,0,"run093"
"18706","BGG","RGR",0,1,1,1,0,"run093"
"18707","BGG","RRR",1,1,2,1,1,"run093"
"18708","BRB","BBB",0,13,13,12,1,"run093"
"18709","BRB","BBR",0,1,1,1,0,"run093"
"18710","BRB","BRR",0,3,3,3,0,"run093"
"18711","BRB","GGG",0,1,1,0,1,"run093"
"18712","BRB","GGR",0,1,1,0,1,"run093"
"18713","BRB","RBB",0,1,1,0,1,"run093"
"18714","BRB","RBG",0,1,1,0,1,"run093"
"18715","BRB","RGR",0,1,1,0,1,"run093"
"18716","BRB","RRR",0,1,1,0,1,"run093"
"18717","BRR","BBB",0,11,11,6,5,"run093"
"18718","BRR","BGB",1,1,2,0,2,"run093"
"18719","BRR","BGG",0,1,1,1,0,"run093"
"18720","BRR","BRB",0,1,1,0,1,"run093"
"18721","BRR","RBB",0,2,2,2,0,"run093"
"18722","GBB","BBB",12,38,50,41,9,"run093"
"18723","GBB","BGG",0,1,1,1,0,"run093"
"18724","GBB","BRB",1,9,10,0,10,"run093"
"18725","GBB","BRR",1,3,4,3,1,"run093"
"18726","GBB","GBG",0,4,4,4,0,"run093"
"18727","GBB","GGB",0,21,21,5,16,"run093"
"18728","GBB","GGG",7,86,93,11,82,"run093"
"18729","GBB","GGR",1,3,4,2,2,"run093"
"18730","GBB","GRG",0,6,6,2,4,"run093"
"18731","GBB","GRR",0,1,1,0,1,"run093"
"18732","GBB","RBB",0,2,2,0,2,"run093"
"18733","GBB","RBG",3,9,12,9,3,"run093"
"18734","GBB","RBR",1,0,1,0,1,"run093"
"18735","GBB","RGG",1,0,1,1,0,"run093"
"18736","GBB","RGR",2,1,3,1,2,"run093"
"18737","GBB","RRG",0,2,2,2,0,"run093"
"18738","GBB","RRR",1,9,10,1,9,"run093"
"18739","GBG","BBB",0,5,5,2,3,"run093"
"18740","GBG","BBR",0,1,1,1,0,"run093"
"18741","GBG","BRB",1,4,5,3,2,"run093"
"18742","GBG","BRR",1,0,1,0,1,"run093"
"18743","GBG","GGB",0,4,4,0,4,"run093"
"18744","GBG","GGG",4,11,15,11,4,"run093"
"18745","GBG","RBB",1,0,1,1,0,"run093"
"18746","GBG","RBG",0,1,1,0,1,"run093"
"18747","GBG","RGG",0,1,1,1,0,"run093"
"18748","GBG","RGR",1,3,4,3,1,"run093"
"18749","GBG","RRG",1,3,4,4,0,"run093"
"18750","GGB","BBB",3,16,19,16,3,"run093"
"18751","GGB","BBR",1,4,5,0,5,"run093"
"18752","GGB","BGB",0,3,3,2,1,"run093"
"18753","GGB","BGG",0,4,4,4,0,"run093"
"18754","GGB","BRB",0,1,1,0,1,"run093"
"18755","GGB","BRR",1,15,16,5,11,"run093"
"18756","GGB","GBB",0,1,1,0,1,"run093"
"18757","GGB","GBG",1,0,1,1,0,"run093"
"18758","GGB","GGG",13,48,61,3,58,"run093"
"18759","GGB","GGR",0,7,7,3,4,"run093"
"18760","GGB","GRR",0,4,4,2,2,"run093"
"18761","GGB","RBB",0,5,5,0,5,"run093"
"18762","GGB","RBG",0,4,4,2,2,"run093"
"18763","GGB","RBR",0,5,5,5,0,"run093"
"18764","GGB","RGG",1,5,6,1,5,"run093"
"18765","GGB","RGR",0,2,2,0,2,"run093"
"18766","GGB","RRG",1,5,6,5,1,"run093"
"18767","GGB","RRR",1,5,6,5,1,"run093"
"18768","GGG","BBB",8,31,39,14,25,"run093"
"18769","GGG","BGB",0,2,2,2,0,"run093"
"18770","GGG","BGG",1,7,8,0,8,"run093"
"18771","GGG","BRB",1,3,4,0,4,"run093"
"18772","GGG","BRR",0,6,6,0,6,"run093"
"18773","GGG","GGB",5,1,6,4,2,"run093"
"18774","GGG","GGR",1,9,10,8,2,"run093"
"18775","GGG","GRR",0,2,2,0,2,"run093"
"18776","GGG","RBB",1,8,9,2,7,"run093"
"18777","GGG","RBG",0,6,6,3,3,"run093"
"18778","GGG","RBR",0,21,21,8,13,"run093"
"18779","GGG","RGG",0,3,3,1,2,"run093"
"18780","GGG","RGR",1,12,13,4,9,"run093"
"18781","GGG","RRG",1,23,24,15,9,"run093"
"18782","GGG","RRR",0,3,3,0,3,"run093"
"18783","GGR","BBB",0,2,2,1,1,"run093"
"18784","GGR","BBR",0,2,2,1,1,"run093"
"18785","GGR","BGG",0,1,1,1,0,"run093"
"18786","GGR","BRR",1,0,1,1,0,"run093"
"18787","GGR","GRR",1,0,1,0,1,"run093"
"18788","GGR","RBB",0,2,2,2,0,"run093"
"18789","GRG","BBB",3,8,11,2,9,"run093"
"18790","GRG","BBR",0,1,1,1,0,"run093"
"18791","GRG","BGG",0,1,1,0,1,"run093"
"18792","GRG","BRB",0,3,3,2,1,"run093"
"18793","GRG","BRR",0,1,1,1,0,"run093"
"18794","GRG","GBG",0,1,1,1,0,"run093"
"18795","GRG","GGB",2,15,17,2,15,"run093"
"18796","GRG","GGG",3,12,15,2,13,"run093"
"18797","GRG","GGR",0,5,5,5,0,"run093"
"18798","GRG","GRR",0,1,1,0,1,"run093"
"18799","GRG","RBG",0,1,1,1,0,"run093"
"18800","GRG","RBR",0,1,1,0,1,"run093"
"18801","GRG","RGR",1,2,3,0,3,"run093"
"18802","GRG","RRG",2,4,6,5,1,"run093"
"18803","GRR","BBB",0,1,1,1,0,"run093"
"18804","GRR","BBR",0,1,1,0,1,"run093"
"18805","GRR","BGB",1,2,3,1,2,"run093"
"18806","GRR","BGG",0,2,2,0,2,"run093"
"18807","GRR","BRB",0,1,1,0,1,"run093"
"18808","GRR","BRR",0,2,2,1,1,"run093"
"18809","GRR","GGG",0,1,1,0,1,"run093"
"18810","GRR","GGR",0,1,1,0,1,"run093"
"18811","RBB","BBB",0,1,1,0,1,"run093"
"18812","RBB","BBR",0,1,1,1,0,"run093"
"18813","RBB","BRB",0,1,1,1,0,"run093"
"18814","RBB","GRR",0,1,1,1,0,"run093"
"18815","RBB","RGG",0,1,1,0,1,"run093"
"18816","RBG","BBB",2,8,10,6,4,"run093"
"18817","RBG","BBG",0,1,1,0,1,"run093"
"18818","RBG","BRR",0,1,1,0,1,"run093"
"18819","RBG","GBB",0,1,1,0,1,"run093"
"18820","RBG","GRR",0,3,3,1,2,"run093"
"18821","RBG","RBB",1,1,2,0,2,"run093"
"18822","RBG","RBR",0,1,1,0,1,"run093"
"18823","RBG","RGR",0,1,1,0,1,"run093"
"18824","RBR","BBB",0,13,13,9,4,"run093"
"18825","RBR","BBR",0,1,1,0,1,"run093"
"18826","RBR","BGB",2,4,6,5,1,"run093"
"18827","RBR","BGG",0,2,2,2,0,"run093"
"18828","RBR","BRB",1,0,1,0,1,"run093"
"18829","RBR","BRR",1,4,5,3,2,"run093"
"18830","RBR","GGB",0,12,12,0,12,"run093"
"18831","RBR","GRR",4,4,8,1,7,"run093"
"18832","RBR","RBB",0,3,3,3,0,"run093"
"18833","RBR","RGG",2,9,11,9,2,"run093"
"18834","RBR","RGR",1,0,1,1,0,"run093"
"18835","RBR","RRR",0,1,1,1,0,"run093"
"18836","RGG","BBB",0,8,8,0,8,"run093"
"18837","RGG","BBR",1,2,3,3,0,"run093"
"18838","RGG","BGB",0,1,1,1,0,"run093"
"18839","RGG","BRR",0,4,4,1,3,"run093"
"18840","RGG","GGG",0,1,1,1,0,"run093"
"18841","RGG","GGR",0,3,3,3,0,"run093"
"18842","RGG","GRR",0,8,8,6,2,"run093"
"18843","RGG","RBB",0,1,1,0,1,"run093"
"18844","RGR","BBB",2,5,7,5,2,"run093"
"18845","RGR","BBR",1,1,2,1,1,"run093"
"18846","RGR","BGB",2,5,7,0,7,"run093"
"18847","RGR","BGG",2,2,4,0,4,"run093"
"18848","RGR","BRR",1,5,6,0,6,"run093"
"18849","RGR","GGB",2,12,14,9,5,"run093"
"18850","RGR","GGG",0,2,2,2,0,"run093"
"18851","RGR","GGR",0,4,4,3,1,"run093"
"18852","RGR","RBB",0,4,4,1,3,"run093"
"18853","RGR","RGG",1,1,2,0,2,"run093"
"18854","RGR","RRG",0,3,3,3,0,"run093"
"18855","RRG","BBB",2,33,35,30,5,"run093"
"18856","RRG","BBR",0,5,5,5,0,"run093"
"18857","RRG","BGB",1,10,11,10,1,"run093"
"18858","RRG","BGG",0,2,2,1,1,"run093"
"18859","RRG","BRB",2,40,42,39,3,"run093"
"18860","RRG","BRR",1,16,17,13,4,"run093"
"18861","RRG","GGG",2,14,16,3,13,"run093"
"18862","RRG","GGR",0,5,5,4,1,"run093"
"18863","RRG","GRG",1,0,1,0,1,"run093"
"18864","RRG","GRR",3,8,11,4,7,"run093"
"18865","RRG","RBB",1,1,2,0,2,"run093"
"18866","RRG","RGG",0,1,1,0,1,"run093"
"18867","RRG","RGR",0,1,1,0,1,"run093"
"18868","RRR","BBR",1,0,1,0,1,"run093"
"18869","RRR","BGB",2,1,3,2,1,"run093"
"18870","RRR","BGG",1,0,1,0,1,"run093"
"18871","RRR","BRB",1,1,2,1,1,"run093"
"18872","RRR","BRR",1,1,2,2,0,"run093"
"18873","RRR","GGR",0,1,1,0,1,"run093"
"18874","RRR","GRR",0,3,3,0,3,"run093"
"18875","RRR","RBB",1,2,3,2,1,"run093"
"18876","RRR","RBR",0,2,2,1,1,"run093"
"18877","RRR","RGG",0,1,1,0,1,"run093"
"18878","RRR","RGR",1,2,3,0,3,"run093"
"18879","RRR","RRG",2,2,4,4,0,"run093"
"18880","BBB","BRB",0,1,1,1,0,"run094"
"18881","BBB","GGG",1,2,3,1,2,"run094"
"18882","BBB","GRR",0,2,2,1,1,"run094"
"18883","BBB","RBG",0,1,1,1,0,"run094"
"18884","BBB","RRG",1,3,4,4,0,"run094"
"18885","BBB","RRR",0,2,2,2,0,"run094"
"18886","BBG","BBB",1,4,5,5,0,"run094"
"18887","BBG","BGB",0,1,1,1,0,"run094"
"18888","BBG","BGG",0,1,1,0,1,"run094"
"18889","BBG","BRB",1,16,17,6,11,"run094"
"18890","BBG","GBB",0,1,1,1,0,"run094"
"18891","BBG","GBG",2,7,9,9,0,"run094"
"18892","BBG","GGB",2,25,27,19,8,"run094"
"18893","BBG","GGG",4,38,42,18,24,"run094"
"18894","BBG","GRG",1,9,10,6,4,"run094"
"18895","BBG","GRR",0,1,1,0,1,"run094"
"18896","BBG","RBB",0,1,1,0,1,"run094"
"18897","BBG","RBG",0,4,4,2,2,"run094"
"18898","BBG","RBR",0,1,1,1,0,"run094"
"18899","BBG","RGR",0,1,1,0,1,"run094"
"18900","BBG","RRG",1,2,3,3,0,"run094"
"18901","BBG","RRR",0,7,7,6,1,"run094"
"18902","BGB","BBB",0,2,2,1,1,"run094"
"18903","BGB","RRG",0,1,1,0,1,"run094"
"18904","BGG","BBB",0,3,3,0,3,"run094"
"18905","BGG","BBR",0,1,1,0,1,"run094"
"18906","BGG","GRG",0,1,1,0,1,"run094"
"18907","BGG","RBG",1,1,2,2,0,"run094"
"18908","BGG","RGG",0,3,3,2,1,"run094"
"18909","BGG","RGR",0,1,1,0,1,"run094"
"18910","BGG","RRR",1,1,2,2,0,"run094"
"18911","BRB","BBB",0,13,13,12,1,"run094"
"18912","BRB","BBR",0,1,1,0,1,"run094"
"18913","BRB","BRR",0,3,3,0,3,"run094"
"18914","BRB","GGG",0,1,1,1,0,"run094"
"18915","BRB","GGR",0,1,1,1,0,"run094"
"18916","BRB","RBB",0,1,1,0,1,"run094"
"18917","BRB","RBG",0,1,1,0,1,"run094"
"18918","BRB","RGR",0,1,1,1,0,"run094"
"18919","BRB","RRR",0,1,1,1,0,"run094"
"18920","BRR","BBB",0,11,11,11,0,"run094"
"18921","BRR","BGB",1,1,2,0,2,"run094"
"18922","BRR","BGG",0,1,1,1,0,"run094"
"18923","BRR","BRB",0,1,1,0,1,"run094"
"18924","BRR","RBB",0,2,2,0,2,"run094"
"18925","GBB","BBB",12,38,50,48,2,"run094"
"18926","GBB","BGG",0,1,1,1,0,"run094"
"18927","GBB","BRB",1,9,10,1,9,"run094"
"18928","GBB","BRR",1,3,4,0,4,"run094"
"18929","GBB","GBG",0,4,4,0,4,"run094"
"18930","GBB","GGB",0,21,21,13,8,"run094"
"18931","GBB","GGG",7,86,93,75,18,"run094"
"18932","GBB","GGR",1,3,4,0,4,"run094"
"18933","GBB","GRG",0,6,6,4,2,"run094"
"18934","GBB","GRR",0,1,1,1,0,"run094"
"18935","GBB","RBB",0,2,2,1,1,"run094"
"18936","GBB","RBG",3,9,12,2,10,"run094"
"18937","GBB","RBR",1,0,1,1,0,"run094"
"18938","GBB","RGG",1,0,1,0,1,"run094"
"18939","GBB","RGR",2,1,3,0,3,"run094"
"18940","GBB","RRG",0,2,2,2,0,"run094"
"18941","GBB","RRR",1,9,10,7,3,"run094"
"18942","GBG","BBB",0,5,5,1,4,"run094"
"18943","GBG","BBR",0,1,1,1,0,"run094"
"18944","GBG","BRB",1,4,5,3,2,"run094"
"18945","GBG","BRR",1,0,1,1,0,"run094"
"18946","GBG","GGB",0,4,4,3,1,"run094"
"18947","GBG","GGG",4,11,15,9,6,"run094"
"18948","GBG","RBB",1,0,1,0,1,"run094"
"18949","GBG","RBG",0,1,1,1,0,"run094"
"18950","GBG","RGG",0,1,1,0,1,"run094"
"18951","GBG","RGR",1,3,4,3,1,"run094"
"18952","GBG","RRG",1,3,4,0,4,"run094"
"18953","GGB","BBB",3,16,19,5,14,"run094"
"18954","GGB","BBR",1,4,5,4,1,"run094"
"18955","GGB","BGB",0,3,3,0,3,"run094"
"18956","GGB","BGG",0,4,4,2,2,"run094"
"18957","GGB","BRB",0,1,1,1,0,"run094"
"18958","GGB","BRR",1,15,16,11,5,"run094"
"18959","GGB","GBB",0,1,1,0,1,"run094"
"18960","GGB","GBG",1,0,1,0,1,"run094"
"18961","GGB","GGG",13,48,61,50,11,"run094"
"18962","GGB","GGR",0,7,7,4,3,"run094"
"18963","GGB","GRR",0,4,4,4,0,"run094"
"18964","GGB","RBB",0,5,5,4,1,"run094"
"18965","GGB","RBG",0,4,4,4,0,"run094"
"18966","GGB","RBR",0,5,5,1,4,"run094"
"18967","GGB","RGG",1,5,6,4,2,"run094"
"18968","GGB","RGR",0,2,2,1,1,"run094"
"18969","GGB","RRG",1,5,6,1,5,"run094"
"18970","GGB","RRR",1,5,6,3,3,"run094"
"18971","GGG","BBB",8,31,39,0,39,"run094"
"18972","GGG","BGB",0,2,2,2,0,"run094"
"18973","GGG","BGG",1,7,8,3,5,"run094"
"18974","GGG","BRB",1,3,4,1,3,"run094"
"18975","GGG","BRR",0,6,6,3,3,"run094"
"18976","GGG","GGB",5,1,6,4,2,"run094"
"18977","GGG","GGR",1,9,10,3,7,"run094"
"18978","GGG","GRR",0,2,2,1,1,"run094"
"18979","GGG","RBB",1,8,9,6,3,"run094"
"18980","GGG","RBG",0,6,6,5,1,"run094"
"18981","GGG","RBR",0,21,21,17,4,"run094"
"18982","GGG","RGG",0,3,3,0,3,"run094"
"18983","GGG","RGR",1,12,13,13,0,"run094"
"18984","GGG","RRG",1,23,24,21,3,"run094"
"18985","GGG","RRR",0,3,3,1,2,"run094"
"18986","GGR","BBB",0,2,2,0,2,"run094"
"18987","GGR","BBR",0,2,2,1,1,"run094"
"18988","GGR","BGG",0,1,1,0,1,"run094"
"18989","GGR","BRR",1,0,1,1,0,"run094"
"18990","GGR","GRR",1,0,1,0,1,"run094"
"18991","GGR","RBB",0,2,2,2,0,"run094"
"18992","GRG","BBB",3,8,11,8,3,"run094"
"18993","GRG","BBR",0,1,1,0,1,"run094"
"18994","GRG","BGG",0,1,1,0,1,"run094"
"18995","GRG","BRB",0,3,3,3,0,"run094"
"18996","GRG","BRR",0,1,1,1,0,"run094"
"18997","GRG","GBG",0,1,1,0,1,"run094"
"18998","GRG","GGB",2,15,17,3,14,"run094"
"18999","GRG","GGG",3,12,15,8,7,"run094"
"19000","GRG","GGR",0,5,5,3,2,"run094"
"19001","GRG","GRR",0,1,1,0,1,"run094"
"19002","GRG","RBG",0,1,1,1,0,"run094"
"19003","GRG","RBR",0,1,1,0,1,"run094"
"19004","GRG","RGR",1,2,3,3,0,"run094"
"19005","GRG","RRG",2,4,6,3,3,"run094"
"19006","GRR","BBB",0,1,1,0,1,"run094"
"19007","GRR","BBR",0,1,1,0,1,"run094"
"19008","GRR","BGB",1,2,3,2,1,"run094"
"19009","GRR","BGG",0,2,2,0,2,"run094"
"19010","GRR","BRB",0,1,1,0,1,"run094"
"19011","GRR","BRR",0,2,2,1,1,"run094"
"19012","GRR","GGG",0,1,1,1,0,"run094"
"19013","GRR","GGR",0,1,1,1,0,"run094"
"19014","RBB","BBB",0,1,1,1,0,"run094"
"19015","RBB","BBR",0,1,1,1,0,"run094"
"19016","RBB","BRB",0,1,1,0,1,"run094"
"19017","RBB","GRR",0,1,1,0,1,"run094"
"19018","RBB","RGG",0,1,1,1,0,"run094"
"19019","RBG","BBB",2,8,10,3,7,"run094"
"19020","RBG","BBG",0,1,1,0,1,"run094"
"19021","RBG","BRR",0,1,1,1,0,"run094"
"19022","RBG","GBB",0,1,1,0,1,"run094"
"19023","RBG","GRR",0,3,3,3,0,"run094"
"19024","RBG","RBB",1,1,2,1,1,"run094"
"19025","RBG","RBR",0,1,1,1,0,"run094"
"19026","RBG","RGR",0,1,1,0,1,"run094"
"19027","RBR","BBB",0,13,13,13,0,"run094"
"19028","RBR","BBR",0,1,1,0,1,"run094"
"19029","RBR","BGB",2,4,6,0,6,"run094"
"19030","RBR","BGG",0,2,2,0,2,"run094"
"19031","RBR","BRB",1,0,1,0,1,"run094"
"19032","RBR","BRR",1,4,5,1,4,"run094"
"19033","RBR","GGB",0,12,12,2,10,"run094"
"19034","RBR","GRR",4,4,8,5,3,"run094"
"19035","RBR","RBB",0,3,3,3,0,"run094"
"19036","RBR","RGG",2,9,11,8,3,"run094"
"19037","RBR","RGR",1,0,1,0,1,"run094"
"19038","RBR","RRR",0,1,1,0,1,"run094"
"19039","RGG","BBB",0,8,8,5,3,"run094"
"19040","RGG","BBR",1,2,3,3,0,"run094"
"19041","RGG","BGB",0,1,1,1,0,"run094"
"19042","RGG","BRR",0,4,4,1,3,"run094"
"19043","RGG","GGG",0,1,1,0,1,"run094"
"19044","RGG","GGR",0,3,3,3,0,"run094"
"19045","RGG","GRR",0,8,8,8,0,"run094"
"19046","RGG","RBB",0,1,1,1,0,"run094"
"19047","RGR","BBB",2,5,7,0,7,"run094"
"19048","RGR","BBR",1,1,2,0,2,"run094"
"19049","RGR","BGB",2,5,7,6,1,"run094"
"19050","RGR","BGG",2,2,4,4,0,"run094"
"19051","RGR","BRR",1,5,6,2,4,"run094"
"19052","RGR","GGB",2,12,14,0,14,"run094"
"19053","RGR","GGG",0,2,2,0,2,"run094"
"19054","RGR","GGR",0,4,4,4,0,"run094"
"19055","RGR","RBB",0,4,4,3,1,"run094"
"19056","RGR","RGG",1,1,2,2,0,"run094"
"19057","RGR","RRG",0,3,3,2,1,"run094"
"19058","RRG","BBB",2,33,35,27,8,"run094"
"19059","RRG","BBR",0,5,5,3,2,"run094"
"19060","RRG","BGB",1,10,11,4,7,"run094"
"19061","RRG","BGG",0,2,2,2,0,"run094"
"19062","RRG","BRB",2,40,42,8,34,"run094"
"19063","RRG","BRR",1,16,17,9,8,"run094"
"19064","RRG","GGG",2,14,16,6,10,"run094"
"19065","RRG","GGR",0,5,5,1,4,"run094"
"19066","RRG","GRG",1,0,1,1,0,"run094"
"19067","RRG","GRR",3,8,11,3,8,"run094"
"19068","RRG","RBB",1,1,2,2,0,"run094"
"19069","RRG","RGG",0,1,1,0,1,"run094"
"19070","RRG","RGR",0,1,1,1,0,"run094"
"19071","RRR","BBR",1,0,1,0,1,"run094"
"19072","RRR","BGB",2,1,3,2,1,"run094"
"19073","RRR","BGG",1,0,1,0,1,"run094"
"19074","RRR","BRB",1,1,2,1,1,"run094"
"19075","RRR","BRR",1,1,2,0,2,"run094"
"19076","RRR","GGR",0,1,1,1,0,"run094"
"19077","RRR","GRR",0,3,3,2,1,"run094"
"19078","RRR","RBB",1,2,3,2,1,"run094"
"19079","RRR","RBR",0,2,2,2,0,"run094"
"19080","RRR","RGG",0,1,1,1,0,"run094"
"19081","RRR","RGR",1,2,3,0,3,"run094"
"19082","RRR","RRG",2,2,4,3,1,"run094"
"19083","BBB","BRB",0,1,1,0,1,"run095"
"19084","BBB","GGG",1,2,3,2,1,"run095"
"19085","BBB","GRR",0,2,2,0,2,"run095"
"19086","BBB","RBG",0,1,1,1,0,"run095"
"19087","BBB","RRG",1,3,4,3,1,"run095"
"19088","BBB","RRR",0,2,2,2,0,"run095"
"19089","BBG","BBB",1,4,5,0,5,"run095"
"19090","BBG","BGB",0,1,1,0,1,"run095"
"19091","BBG","BGG",0,1,1,1,0,"run095"
"19092","BBG","BRB",1,16,17,13,4,"run095"
"19093","BBG","GBB",0,1,1,1,0,"run095"
"19094","BBG","GBG",2,7,9,6,3,"run095"
"19095","BBG","GGB",2,25,27,6,21,"run095"
"19096","BBG","GGG",4,38,42,6,36,"run095"
"19097","BBG","GRG",1,9,10,9,1,"run095"
"19098","BBG","GRR",0,1,1,1,0,"run095"
"19099","BBG","RBB",0,1,1,0,1,"run095"
"19100","BBG","RBG",0,4,4,1,3,"run095"
"19101","BBG","RBR",0,1,1,0,1,"run095"
"19102","BBG","RGR",0,1,1,0,1,"run095"
"19103","BBG","RRG",1,2,3,3,0,"run095"
"19104","BBG","RRR",0,7,7,3,4,"run095"
"19105","BGB","BBB",0,2,2,0,2,"run095"
"19106","BGB","RRG",0,1,1,1,0,"run095"
"19107","BGG","BBB",0,3,3,3,0,"run095"
"19108","BGG","BBR",0,1,1,1,0,"run095"
"19109","BGG","GRG",0,1,1,1,0,"run095"
"19110","BGG","RBG",1,1,2,1,1,"run095"
"19111","BGG","RGG",0,3,3,1,2,"run095"
"19112","BGG","RGR",0,1,1,1,0,"run095"
"19113","BGG","RRR",1,1,2,1,1,"run095"
"19114","BRB","BBB",0,13,13,10,3,"run095"
"19115","BRB","BBR",0,1,1,0,1,"run095"
"19116","BRB","BRR",0,3,3,3,0,"run095"
"19117","BRB","GGG",0,1,1,1,0,"run095"
"19118","BRB","GGR",0,1,1,0,1,"run095"
"19119","BRB","RBB",0,1,1,0,1,"run095"
"19120","BRB","RBG",0,1,1,0,1,"run095"
"19121","BRB","RGR",0,1,1,1,0,"run095"
"19122","BRB","RRR",0,1,1,0,1,"run095"
"19123","BRR","BBB",0,11,11,5,6,"run095"
"19124","BRR","BGB",1,1,2,2,0,"run095"
"19125","BRR","BGG",0,1,1,0,1,"run095"
"19126","BRR","BRB",0,1,1,0,1,"run095"
"19127","BRR","RBB",0,2,2,2,0,"run095"
"19128","GBB","BBB",12,38,50,24,26,"run095"
"19129","GBB","BGG",0,1,1,1,0,"run095"
"19130","GBB","BRB",1,9,10,9,1,"run095"
"19131","GBB","BRR",1,3,4,4,0,"run095"
"19132","GBB","GBG",0,4,4,3,1,"run095"
"19133","GBB","GGB",0,21,21,13,8,"run095"
"19134","GBB","GGG",7,86,93,44,49,"run095"
"19135","GBB","GGR",1,3,4,3,1,"run095"
"19136","GBB","GRG",0,6,6,1,5,"run095"
"19137","GBB","GRR",0,1,1,0,1,"run095"
"19138","GBB","RBB",0,2,2,1,1,"run095"
"19139","GBB","RBG",3,9,12,6,6,"run095"
"19140","GBB","RBR",1,0,1,1,0,"run095"
"19141","GBB","RGG",1,0,1,0,1,"run095"
"19142","GBB","RGR",2,1,3,2,1,"run095"
"19143","GBB","RRG",0,2,2,0,2,"run095"
"19144","GBB","RRR",1,9,10,2,8,"run095"
"19145","GBG","BBB",0,5,5,5,0,"run095"
"19146","GBG","BBR",0,1,1,0,1,"run095"
"19147","GBG","BRB",1,4,5,0,5,"run095"
"19148","GBG","BRR",1,0,1,0,1,"run095"
"19149","GBG","GGB",0,4,4,3,1,"run095"
"19150","GBG","GGG",4,11,15,15,0,"run095"
"19151","GBG","RBB",1,0,1,0,1,"run095"
"19152","GBG","RBG",0,1,1,0,1,"run095"
"19153","GBG","RGG",0,1,1,1,0,"run095"
"19154","GBG","RGR",1,3,4,2,2,"run095"
"19155","GBG","RRG",1,3,4,0,4,"run095"
"19156","GGB","BBB",3,16,19,15,4,"run095"
"19157","GGB","BBR",1,4,5,5,0,"run095"
"19158","GGB","BGB",0,3,3,1,2,"run095"
"19159","GGB","BGG",0,4,4,0,4,"run095"
"19160","GGB","BRB",0,1,1,0,1,"run095"
"19161","GGB","BRR",1,15,16,8,8,"run095"
"19162","GGB","GBB",0,1,1,0,1,"run095"
"19163","GGB","GBG",1,0,1,0,1,"run095"
"19164","GGB","GGG",13,48,61,55,6,"run095"
"19165","GGB","GGR",0,7,7,5,2,"run095"
"19166","GGB","GRR",0,4,4,3,1,"run095"
"19167","GGB","RBB",0,5,5,1,4,"run095"
"19168","GGB","RBG",0,4,4,0,4,"run095"
"19169","GGB","RBR",0,5,5,5,0,"run095"
"19170","GGB","RGG",1,5,6,3,3,"run095"
"19171","GGB","RGR",0,2,2,2,0,"run095"
"19172","GGB","RRG",1,5,6,4,2,"run095"
"19173","GGB","RRR",1,5,6,4,2,"run095"
"19174","GGG","BBB",8,31,39,28,11,"run095"
"19175","GGG","BGB",0,2,2,1,1,"run095"
"19176","GGG","BGG",1,7,8,6,2,"run095"
"19177","GGG","BRB",1,3,4,4,0,"run095"
"19178","GGG","BRR",0,6,6,0,6,"run095"
"19179","GGG","GGB",5,1,6,2,4,"run095"
"19180","GGG","GGR",1,9,10,6,4,"run095"
"19181","GGG","GRR",0,2,2,2,0,"run095"
"19182","GGG","RBB",1,8,9,0,9,"run095"
"19183","GGG","RBG",0,6,6,6,0,"run095"
"19184","GGG","RBR",0,21,21,21,0,"run095"
"19185","GGG","RGG",0,3,3,0,3,"run095"
"19186","GGG","RGR",1,12,13,4,9,"run095"
"19187","GGG","RRG",1,23,24,19,5,"run095"
"19188","GGG","RRR",0,3,3,0,3,"run095"
"19189","GGR","BBB",0,2,2,0,2,"run095"
"19190","GGR","BBR",0,2,2,1,1,"run095"
"19191","GGR","BGG",0,1,1,0,1,"run095"
"19192","GGR","BRR",1,0,1,1,0,"run095"
"19193","GGR","GRR",1,0,1,1,0,"run095"
"19194","GGR","RBB",0,2,2,0,2,"run095"
"19195","GRG","BBB",3,8,11,8,3,"run095"
"19196","GRG","BBR",0,1,1,1,0,"run095"
"19197","GRG","BGG",0,1,1,1,0,"run095"
"19198","GRG","BRB",0,3,3,1,2,"run095"
"19199","GRG","BRR",0,1,1,0,1,"run095"
"19200","GRG","GBG",0,1,1,1,0,"run095"
"19201","GRG","GGB",2,15,17,1,16,"run095"
"19202","GRG","GGG",3,12,15,0,15,"run095"
"19203","GRG","GGR",0,5,5,0,5,"run095"
"19204","GRG","GRR",0,1,1,1,0,"run095"
"19205","GRG","RBG",0,1,1,0,1,"run095"
"19206","GRG","RBR",0,1,1,0,1,"run095"
"19207","GRG","RGR",1,2,3,3,0,"run095"
"19208","GRG","RRG",2,4,6,2,4,"run095"
"19209","GRR","BBB",0,1,1,0,1,"run095"
"19210","GRR","BBR",0,1,1,1,0,"run095"
"19211","GRR","BGB",1,2,3,3,0,"run095"
"19212","GRR","BGG",0,2,2,0,2,"run095"
"19213","GRR","BRB",0,1,1,0,1,"run095"
"19214","GRR","BRR",0,2,2,1,1,"run095"
"19215","GRR","GGG",0,1,1,1,0,"run095"
"19216","GRR","GGR",0,1,1,1,0,"run095"
"19217","RBB","BBB",0,1,1,0,1,"run095"
"19218","RBB","BBR",0,1,1,1,0,"run095"
"19219","RBB","BRB",0,1,1,1,0,"run095"
"19220","RBB","GRR",0,1,1,0,1,"run095"
"19221","RBB","RGG",0,1,1,1,0,"run095"
"19222","RBG","BBB",2,8,10,1,9,"run095"
"19223","RBG","BBG",0,1,1,0,1,"run095"
"19224","RBG","BRR",0,1,1,1,0,"run095"
"19225","RBG","GBB",0,1,1,1,0,"run095"
"19226","RBG","GRR",0,3,3,0,3,"run095"
"19227","RBG","RBB",1,1,2,0,2,"run095"
"19228","RBG","RBR",0,1,1,0,1,"run095"
"19229","RBG","RGR",0,1,1,0,1,"run095"
"19230","RBR","BBB",0,13,13,7,6,"run095"
"19231","RBR","BBR",0,1,1,0,1,"run095"
"19232","RBR","BGB",2,4,6,3,3,"run095"
"19233","RBR","BGG",0,2,2,1,1,"run095"
"19234","RBR","BRB",1,0,1,1,0,"run095"
"19235","RBR","BRR",1,4,5,0,5,"run095"
"19236","RBR","GGB",0,12,12,7,5,"run095"
"19237","RBR","GRR",4,4,8,1,7,"run095"
"19238","RBR","RBB",0,3,3,0,3,"run095"
"19239","RBR","RGG",2,9,11,4,7,"run095"
"19240","RBR","RGR",1,0,1,0,1,"run095"
"19241","RBR","RRR",0,1,1,1,0,"run095"
"19242","RGG","BBB",0,8,8,8,0,"run095"
"19243","RGG","BBR",1,2,3,0,3,"run095"
"19244","RGG","BGB",0,1,1,1,0,"run095"
"19245","RGG","BRR",0,4,4,1,3,"run095"
"19246","RGG","GGG",0,1,1,0,1,"run095"
"19247","RGG","GGR",0,3,3,0,3,"run095"
"19248","RGG","GRR",0,8,8,7,1,"run095"
"19249","RGG","RBB",0,1,1,1,0,"run095"
"19250","RGR","BBB",2,5,7,5,2,"run095"
"19251","RGR","BBR",1,1,2,1,1,"run095"
"19252","RGR","BGB",2,5,7,3,4,"run095"
"19253","RGR","BGG",2,2,4,4,0,"run095"
"19254","RGR","BRR",1,5,6,4,2,"run095"
"19255","RGR","GGB",2,12,14,4,10,"run095"
"19256","RGR","GGG",0,2,2,1,1,"run095"
"19257","RGR","GGR",0,4,4,0,4,"run095"
"19258","RGR","RBB",0,4,4,2,2,"run095"
"19259","RGR","RGG",1,1,2,0,2,"run095"
"19260","RGR","RRG",0,3,3,1,2,"run095"
"19261","RRG","BBB",2,33,35,20,15,"run095"
"19262","RRG","BBR",0,5,5,1,4,"run095"
"19263","RRG","BGB",1,10,11,4,7,"run095"
"19264","RRG","BGG",0,2,2,1,1,"run095"
"19265","RRG","BRB",2,40,42,23,19,"run095"
"19266","RRG","BRR",1,16,17,14,3,"run095"
"19267","RRG","GGG",2,14,16,9,7,"run095"
"19268","RRG","GGR",0,5,5,4,1,"run095"
"19269","RRG","GRG",1,0,1,0,1,"run095"
"19270","RRG","GRR",3,8,11,10,1,"run095"
"19271","RRG","RBB",1,1,2,1,1,"run095"
"19272","RRG","RGG",0,1,1,1,0,"run095"
"19273","RRG","RGR",0,1,1,1,0,"run095"
"19274","RRR","BBR",1,0,1,0,1,"run095"
"19275","RRR","BGB",2,1,3,1,2,"run095"
"19276","RRR","BGG",1,0,1,0,1,"run095"
"19277","RRR","BRB",1,1,2,2,0,"run095"
"19278","RRR","BRR",1,1,2,2,0,"run095"
"19279","RRR","GGR",0,1,1,0,1,"run095"
"19280","RRR","GRR",0,3,3,2,1,"run095"
"19281","RRR","RBB",1,2,3,0,3,"run095"
"19282","RRR","RBR",0,2,2,1,1,"run095"
"19283","RRR","RGG",0,1,1,0,1,"run095"
"19284","RRR","RGR",1,2,3,1,2,"run095"
"19285","RRR","RRG",2,2,4,0,4,"run095"
"19286","BBB","BRB",0,1,1,0,1,"run096"
"19287","BBB","GGG",1,2,3,0,3,"run096"
"19288","BBB","GRR",0,2,2,2,0,"run096"
"19289","BBB","RBG",0,1,1,0,1,"run096"
"19290","BBB","RRG",1,3,4,4,0,"run096"
"19291","BBB","RRR",0,2,2,0,2,"run096"
"19292","BBG","BBB",1,4,5,3,2,"run096"
"19293","BBG","BGB",0,1,1,0,1,"run096"
"19294","BBG","BGG",0,1,1,0,1,"run096"
"19295","BBG","BRB",1,16,17,8,9,"run096"
"19296","BBG","GBB",0,1,1,1,0,"run096"
"19297","BBG","GBG",2,7,9,2,7,"run096"
"19298","BBG","GGB",2,25,27,9,18,"run096"
"19299","BBG","GGG",4,38,42,39,3,"run096"
"19300","BBG","GRG",1,9,10,3,7,"run096"
"19301","BBG","GRR",0,1,1,1,0,"run096"
"19302","BBG","RBB",0,1,1,0,1,"run096"
"19303","BBG","RBG",0,4,4,3,1,"run096"
"19304","BBG","RBR",0,1,1,0,1,"run096"
"19305","BBG","RGR",0,1,1,0,1,"run096"
"19306","BBG","RRG",1,2,3,3,0,"run096"
"19307","BBG","RRR",0,7,7,1,6,"run096"
"19308","BGB","BBB",0,2,2,1,1,"run096"
"19309","BGB","RRG",0,1,1,0,1,"run096"
"19310","BGG","BBB",0,3,3,1,2,"run096"
"19311","BGG","BBR",0,1,1,0,1,"run096"
"19312","BGG","GRG",0,1,1,0,1,"run096"
"19313","BGG","RBG",1,1,2,2,0,"run096"
"19314","BGG","RGG",0,3,3,0,3,"run096"
"19315","BGG","RGR",0,1,1,1,0,"run096"
"19316","BGG","RRR",1,1,2,0,2,"run096"
"19317","BRB","BBB",0,13,13,9,4,"run096"
"19318","BRB","BBR",0,1,1,1,0,"run096"
"19319","BRB","BRR",0,3,3,1,2,"run096"
"19320","BRB","GGG",0,1,1,1,0,"run096"
"19321","BRB","GGR",0,1,1,1,0,"run096"
"19322","BRB","RBB",0,1,1,1,0,"run096"
"19323","BRB","RBG",0,1,1,0,1,"run096"
"19324","BRB","RGR",0,1,1,0,1,"run096"
"19325","BRB","RRR",0,1,1,0,1,"run096"
"19326","BRR","BBB",0,11,11,11,0,"run096"
"19327","BRR","BGB",1,1,2,0,2,"run096"
"19328","BRR","BGG",0,1,1,1,0,"run096"
"19329","BRR","BRB",0,1,1,1,0,"run096"
"19330","BRR","RBB",0,2,2,2,0,"run096"
"19331","GBB","BBB",12,38,50,28,22,"run096"
"19332","GBB","BGG",0,1,1,0,1,"run096"
"19333","GBB","BRB",1,9,10,10,0,"run096"
"19334","GBB","BRR",1,3,4,1,3,"run096"
"19335","GBB","GBG",0,4,4,1,3,"run096"
"19336","GBB","GGB",0,21,21,10,11,"run096"
"19337","GBB","GGG",7,86,93,47,46,"run096"
"19338","GBB","GGR",1,3,4,2,2,"run096"
"19339","GBB","GRG",0,6,6,3,3,"run096"
"19340","GBB","GRR",0,1,1,1,0,"run096"
"19341","GBB","RBB",0,2,2,1,1,"run096"
"19342","GBB","RBG",3,9,12,12,0,"run096"
"19343","GBB","RBR",1,0,1,1,0,"run096"
"19344","GBB","RGG",1,0,1,1,0,"run096"
"19345","GBB","RGR",2,1,3,3,0,"run096"
"19346","GBB","RRG",0,2,2,2,0,"run096"
"19347","GBB","RRR",1,9,10,6,4,"run096"
"19348","GBG","BBB",0,5,5,0,5,"run096"
"19349","GBG","BBR",0,1,1,1,0,"run096"
"19350","GBG","BRB",1,4,5,0,5,"run096"
"19351","GBG","BRR",1,0,1,0,1,"run096"
"19352","GBG","GGB",0,4,4,0,4,"run096"
"19353","GBG","GGG",4,11,15,12,3,"run096"
"19354","GBG","RBB",1,0,1,0,1,"run096"
"19355","GBG","RBG",0,1,1,0,1,"run096"
"19356","GBG","RGG",0,1,1,1,0,"run096"
"19357","GBG","RGR",1,3,4,0,4,"run096"
"19358","GBG","RRG",1,3,4,2,2,"run096"
"19359","GGB","BBB",3,16,19,12,7,"run096"
"19360","GGB","BBR",1,4,5,0,5,"run096"
"19361","GGB","BGB",0,3,3,3,0,"run096"
"19362","GGB","BGG",0,4,4,3,1,"run096"
"19363","GGB","BRB",0,1,1,0,1,"run096"
"19364","GGB","BRR",1,15,16,3,13,"run096"
"19365","GGB","GBB",0,1,1,1,0,"run096"
"19366","GGB","GBG",1,0,1,1,0,"run096"
"19367","GGB","GGG",13,48,61,48,13,"run096"
"19368","GGB","GGR",0,7,7,7,0,"run096"
"19369","GGB","GRR",0,4,4,1,3,"run096"
"19370","GGB","RBB",0,5,5,3,2,"run096"
"19371","GGB","RBG",0,4,4,1,3,"run096"
"19372","GGB","RBR",0,5,5,4,1,"run096"
"19373","GGB","RGG",1,5,6,6,0,"run096"
"19374","GGB","RGR",0,2,2,1,1,"run096"
"19375","GGB","RRG",1,5,6,4,2,"run096"
"19376","GGB","RRR",1,5,6,1,5,"run096"
"19377","GGG","BBB",8,31,39,29,10,"run096"
"19378","GGG","BGB",0,2,2,2,0,"run096"
"19379","GGG","BGG",1,7,8,8,0,"run096"
"19380","GGG","BRB",1,3,4,1,3,"run096"
"19381","GGG","BRR",0,6,6,6,0,"run096"
"19382","GGG","GGB",5,1,6,0,6,"run096"
"19383","GGG","GGR",1,9,10,8,2,"run096"
"19384","GGG","GRR",0,2,2,2,0,"run096"
"19385","GGG","RBB",1,8,9,2,7,"run096"
"19386","GGG","RBG",0,6,6,0,6,"run096"
"19387","GGG","RBR",0,21,21,11,10,"run096"
"19388","GGG","RGG",0,3,3,0,3,"run096"
"19389","GGG","RGR",1,12,13,8,5,"run096"
"19390","GGG","RRG",1,23,24,14,10,"run096"
"19391","GGG","RRR",0,3,3,3,0,"run096"
"19392","GGR","BBB",0,2,2,2,0,"run096"
"19393","GGR","BBR",0,2,2,1,1,"run096"
"19394","GGR","BGG",0,1,1,1,0,"run096"
"19395","GGR","BRR",1,0,1,1,0,"run096"
"19396","GGR","GRR",1,0,1,1,0,"run096"
"19397","GGR","RBB",0,2,2,2,0,"run096"
"19398","GRG","BBB",3,8,11,9,2,"run096"
"19399","GRG","BBR",0,1,1,0,1,"run096"
"19400","GRG","BGG",0,1,1,1,0,"run096"
"19401","GRG","BRB",0,3,3,0,3,"run096"
"19402","GRG","BRR",0,1,1,1,0,"run096"
"19403","GRG","GBG",0,1,1,0,1,"run096"
"19404","GRG","GGB",2,15,17,11,6,"run096"
"19405","GRG","GGG",3,12,15,0,15,"run096"
"19406","GRG","GGR",0,5,5,3,2,"run096"
"19407","GRG","GRR",0,1,1,0,1,"run096"
"19408","GRG","RBG",0,1,1,0,1,"run096"
"19409","GRG","RBR",0,1,1,1,0,"run096"
"19410","GRG","RGR",1,2,3,3,0,"run096"
"19411","GRG","RRG",2,4,6,6,0,"run096"
"19412","GRR","BBB",0,1,1,1,0,"run096"
"19413","GRR","BBR",0,1,1,1,0,"run096"
"19414","GRR","BGB",1,2,3,3,0,"run096"
"19415","GRR","BGG",0,2,2,1,1,"run096"
"19416","GRR","BRB",0,1,1,1,0,"run096"
"19417","GRR","BRR",0,2,2,1,1,"run096"
"19418","GRR","GGG",0,1,1,1,0,"run096"
"19419","GRR","GGR",0,1,1,0,1,"run096"
"19420","RBB","BBB",0,1,1,0,1,"run096"
"19421","RBB","BBR",0,1,1,1,0,"run096"
"19422","RBB","BRB",0,1,1,0,1,"run096"
"19423","RBB","GRR",0,1,1,1,0,"run096"
"19424","RBB","RGG",0,1,1,0,1,"run096"
"19425","RBG","BBB",2,8,10,2,8,"run096"
"19426","RBG","BBG",0,1,1,1,0,"run096"
"19427","RBG","BRR",0,1,1,1,0,"run096"
"19428","RBG","GBB",0,1,1,0,1,"run096"
"19429","RBG","GRR",0,3,3,2,1,"run096"
"19430","RBG","RBB",1,1,2,1,1,"run096"
"19431","RBG","RBR",0,1,1,1,0,"run096"
"19432","RBG","RGR",0,1,1,1,0,"run096"
"19433","RBR","BBB",0,13,13,4,9,"run096"
"19434","RBR","BBR",0,1,1,1,0,"run096"
"19435","RBR","BGB",2,4,6,3,3,"run096"
"19436","RBR","BGG",0,2,2,1,1,"run096"
"19437","RBR","BRB",1,0,1,0,1,"run096"
"19438","RBR","BRR",1,4,5,0,5,"run096"
"19439","RBR","GGB",0,12,12,0,12,"run096"
"19440","RBR","GRR",4,4,8,3,5,"run096"
"19441","RBR","RBB",0,3,3,1,2,"run096"
"19442","RBR","RGG",2,9,11,5,6,"run096"
"19443","RBR","RGR",1,0,1,0,1,"run096"
"19444","RBR","RRR",0,1,1,1,0,"run096"
"19445","RGG","BBB",0,8,8,3,5,"run096"
"19446","RGG","BBR",1,2,3,0,3,"run096"
"19447","RGG","BGB",0,1,1,1,0,"run096"
"19448","RGG","BRR",0,4,4,1,3,"run096"
"19449","RGG","GGG",0,1,1,0,1,"run096"
"19450","RGG","GGR",0,3,3,3,0,"run096"
"19451","RGG","GRR",0,8,8,8,0,"run096"
"19452","RGG","RBB",0,1,1,0,1,"run096"
"19453","RGR","BBB",2,5,7,3,4,"run096"
"19454","RGR","BBR",1,1,2,2,0,"run096"
"19455","RGR","BGB",2,5,7,0,7,"run096"
"19456","RGR","BGG",2,2,4,4,0,"run096"
"19457","RGR","BRR",1,5,6,4,2,"run096"
"19458","RGR","GGB",2,12,14,0,14,"run096"
"19459","RGR","GGG",0,2,2,2,0,"run096"
"19460","RGR","GGR",0,4,4,2,2,"run096"
"19461","RGR","RBB",0,4,4,0,4,"run096"
"19462","RGR","RGG",1,1,2,2,0,"run096"
"19463","RGR","RRG",0,3,3,3,0,"run096"
"19464","RRG","BBB",2,33,35,20,15,"run096"
"19465","RRG","BBR",0,5,5,3,2,"run096"
"19466","RRG","BGB",1,10,11,6,5,"run096"
"19467","RRG","BGG",0,2,2,2,0,"run096"
"19468","RRG","BRB",2,40,42,32,10,"run096"
"19469","RRG","BRR",1,16,17,13,4,"run096"
"19470","RRG","GGG",2,14,16,5,11,"run096"
"19471","RRG","GGR",0,5,5,5,0,"run096"
"19472","RRG","GRG",1,0,1,1,0,"run096"
"19473","RRG","GRR",3,8,11,1,10,"run096"
"19474","RRG","RBB",1,1,2,0,2,"run096"
"19475","RRG","RGG",0,1,1,0,1,"run096"
"19476","RRG","RGR",0,1,1,1,0,"run096"
"19477","RRR","BBR",1,0,1,1,0,"run096"
"19478","RRR","BGB",2,1,3,2,1,"run096"
"19479","RRR","BGG",1,0,1,1,0,"run096"
"19480","RRR","BRB",1,1,2,2,0,"run096"
"19481","RRR","BRR",1,1,2,2,0,"run096"
"19482","RRR","GGR",0,1,1,1,0,"run096"
"19483","RRR","GRR",0,3,3,3,0,"run096"
"19484","RRR","RBB",1,2,3,3,0,"run096"
"19485","RRR","RBR",0,2,2,2,0,"run096"
"19486","RRR","RGG",0,1,1,0,1,"run096"
"19487","RRR","RGR",1,2,3,0,3,"run096"
"19488","RRR","RRG",2,2,4,2,2,"run096"
"19489","BBB","BRB",0,1,1,1,0,"run097"
"19490","BBB","GGG",1,2,3,0,3,"run097"
"19491","BBB","GRR",0,2,2,0,2,"run097"
"19492","BBB","RBG",0,1,1,0,1,"run097"
"19493","BBB","RRG",1,3,4,0,4,"run097"
"19494","BBB","RRR",0,2,2,1,1,"run097"
"19495","BBG","BBB",1,4,5,4,1,"run097"
"19496","BBG","BGB",0,1,1,0,1,"run097"
"19497","BBG","BGG",0,1,1,0,1,"run097"
"19498","BBG","BRB",1,16,17,0,17,"run097"
"19499","BBG","GBB",0,1,1,0,1,"run097"
"19500","BBG","GBG",2,7,9,7,2,"run097"
"19501","BBG","GGB",2,25,27,11,16,"run097"
"19502","BBG","GGG",4,38,42,27,15,"run097"
"19503","BBG","GRG",1,9,10,1,9,"run097"
"19504","BBG","GRR",0,1,1,1,0,"run097"
"19505","BBG","RBB",0,1,1,1,0,"run097"
"19506","BBG","RBG",0,4,4,1,3,"run097"
"19507","BBG","RBR",0,1,1,0,1,"run097"
"19508","BBG","RGR",0,1,1,0,1,"run097"
"19509","BBG","RRG",1,2,3,2,1,"run097"
"19510","BBG","RRR",0,7,7,0,7,"run097"
"19511","BGB","BBB",0,2,2,2,0,"run097"
"19512","BGB","RRG",0,1,1,0,1,"run097"
"19513","BGG","BBB",0,3,3,0,3,"run097"
"19514","BGG","BBR",0,1,1,1,0,"run097"
"19515","BGG","GRG",0,1,1,1,0,"run097"
"19516","BGG","RBG",1,1,2,1,1,"run097"
"19517","BGG","RGG",0,3,3,0,3,"run097"
"19518","BGG","RGR",0,1,1,0,1,"run097"
"19519","BGG","RRR",1,1,2,0,2,"run097"
"19520","BRB","BBB",0,13,13,3,10,"run097"
"19521","BRB","BBR",0,1,1,1,0,"run097"
"19522","BRB","BRR",0,3,3,1,2,"run097"
"19523","BRB","GGG",0,1,1,0,1,"run097"
"19524","BRB","GGR",0,1,1,1,0,"run097"
"19525","BRB","RBB",0,1,1,1,0,"run097"
"19526","BRB","RBG",0,1,1,1,0,"run097"
"19527","BRB","RGR",0,1,1,1,0,"run097"
"19528","BRB","RRR",0,1,1,0,1,"run097"
"19529","BRR","BBB",0,11,11,11,0,"run097"
"19530","BRR","BGB",1,1,2,0,2,"run097"
"19531","BRR","BGG",0,1,1,1,0,"run097"
"19532","BRR","BRB",0,1,1,0,1,"run097"
"19533","BRR","RBB",0,2,2,0,2,"run097"
"19534","GBB","BBB",12,38,50,26,24,"run097"
"19535","GBB","BGG",0,1,1,0,1,"run097"
"19536","GBB","BRB",1,9,10,7,3,"run097"
"19537","GBB","BRR",1,3,4,4,0,"run097"
"19538","GBB","GBG",0,4,4,4,0,"run097"
"19539","GBB","GGB",0,21,21,7,14,"run097"
"19540","GBB","GGG",7,86,93,8,85,"run097"
"19541","GBB","GGR",1,3,4,4,0,"run097"
"19542","GBB","GRG",0,6,6,1,5,"run097"
"19543","GBB","GRR",0,1,1,0,1,"run097"
"19544","GBB","RBB",0,2,2,0,2,"run097"
"19545","GBB","RBG",3,9,12,3,9,"run097"
"19546","GBB","RBR",1,0,1,0,1,"run097"
"19547","GBB","RGG",1,0,1,0,1,"run097"
"19548","GBB","RGR",2,1,3,3,0,"run097"
"19549","GBB","RRG",0,2,2,0,2,"run097"
"19550","GBB","RRR",1,9,10,1,9,"run097"
"19551","GBG","BBB",0,5,5,3,2,"run097"
"19552","GBG","BBR",0,1,1,0,1,"run097"
"19553","GBG","BRB",1,4,5,4,1,"run097"
"19554","GBG","BRR",1,0,1,1,0,"run097"
"19555","GBG","GGB",0,4,4,4,0,"run097"
"19556","GBG","GGG",4,11,15,15,0,"run097"
"19557","GBG","RBB",1,0,1,1,0,"run097"
"19558","GBG","RBG",0,1,1,0,1,"run097"
"19559","GBG","RGG",0,1,1,1,0,"run097"
"19560","GBG","RGR",1,3,4,3,1,"run097"
"19561","GBG","RRG",1,3,4,1,3,"run097"
"19562","GGB","BBB",3,16,19,18,1,"run097"
"19563","GGB","BBR",1,4,5,3,2,"run097"
"19564","GGB","BGB",0,3,3,0,3,"run097"
"19565","GGB","BGG",0,4,4,1,3,"run097"
"19566","GGB","BRB",0,1,1,0,1,"run097"
"19567","GGB","BRR",1,15,16,6,10,"run097"
"19568","GGB","GBB",0,1,1,1,0,"run097"
"19569","GGB","GBG",1,0,1,1,0,"run097"
"19570","GGB","GGG",13,48,61,26,35,"run097"
"19571","GGB","GGR",0,7,7,3,4,"run097"
"19572","GGB","GRR",0,4,4,1,3,"run097"
"19573","GGB","RBB",0,5,5,1,4,"run097"
"19574","GGB","RBG",0,4,4,0,4,"run097"
"19575","GGB","RBR",0,5,5,3,2,"run097"
"19576","GGB","RGG",1,5,6,6,0,"run097"
"19577","GGB","RGR",0,2,2,1,1,"run097"
"19578","GGB","RRG",1,5,6,6,0,"run097"
"19579","GGB","RRR",1,5,6,1,5,"run097"
"19580","GGG","BBB",8,31,39,30,9,"run097"
"19581","GGG","BGB",0,2,2,0,2,"run097"
"19582","GGG","BGG",1,7,8,0,8,"run097"
"19583","GGG","BRB",1,3,4,1,3,"run097"
"19584","GGG","BRR",0,6,6,5,1,"run097"
"19585","GGG","GGB",5,1,6,3,3,"run097"
"19586","GGG","GGR",1,9,10,5,5,"run097"
"19587","GGG","GRR",0,2,2,2,0,"run097"
"19588","GGG","RBB",1,8,9,7,2,"run097"
"19589","GGG","RBG",0,6,6,2,4,"run097"
"19590","GGG","RBR",0,21,21,5,16,"run097"
"19591","GGG","RGG",0,3,3,0,3,"run097"
"19592","GGG","RGR",1,12,13,1,12,"run097"
"19593","GGG","RRG",1,23,24,1,23,"run097"
"19594","GGG","RRR",0,3,3,2,1,"run097"
"19595","GGR","BBB",0,2,2,2,0,"run097"
"19596","GGR","BBR",0,2,2,1,1,"run097"
"19597","GGR","BGG",0,1,1,1,0,"run097"
"19598","GGR","BRR",1,0,1,1,0,"run097"
"19599","GGR","GRR",1,0,1,1,0,"run097"
"19600","GGR","RBB",0,2,2,0,2,"run097"
"19601","GRG","BBB",3,8,11,6,5,"run097"
"19602","GRG","BBR",0,1,1,1,0,"run097"
"19603","GRG","BGG",0,1,1,1,0,"run097"
"19604","GRG","BRB",0,3,3,2,1,"run097"
"19605","GRG","BRR",0,1,1,0,1,"run097"
"19606","GRG","GBG",0,1,1,1,0,"run097"
"19607","GRG","GGB",2,15,17,13,4,"run097"
"19608","GRG","GGG",3,12,15,6,9,"run097"
"19609","GRG","GGR",0,5,5,2,3,"run097"
"19610","GRG","GRR",0,1,1,0,1,"run097"
"19611","GRG","RBG",0,1,1,0,1,"run097"
"19612","GRG","RBR",0,1,1,1,0,"run097"
"19613","GRG","RGR",1,2,3,1,2,"run097"
"19614","GRG","RRG",2,4,6,3,3,"run097"
"19615","GRR","BBB",0,1,1,1,0,"run097"
"19616","GRR","BBR",0,1,1,1,0,"run097"
"19617","GRR","BGB",1,2,3,0,3,"run097"
"19618","GRR","BGG",0,2,2,0,2,"run097"
"19619","GRR","BRB",0,1,1,1,0,"run097"
"19620","GRR","BRR",0,2,2,1,1,"run097"
"19621","GRR","GGG",0,1,1,0,1,"run097"
"19622","GRR","GGR",0,1,1,0,1,"run097"
"19623","RBB","BBB",0,1,1,0,1,"run097"
"19624","RBB","BBR",0,1,1,1,0,"run097"
"19625","RBB","BRB",0,1,1,1,0,"run097"
"19626","RBB","GRR",0,1,1,0,1,"run097"
"19627","RBB","RGG",0,1,1,1,0,"run097"
"19628","RBG","BBB",2,8,10,7,3,"run097"
"19629","RBG","BBG",0,1,1,1,0,"run097"
"19630","RBG","BRR",0,1,1,1,0,"run097"
"19631","RBG","GBB",0,1,1,1,0,"run097"
"19632","RBG","GRR",0,3,3,2,1,"run097"
"19633","RBG","RBB",1,1,2,2,0,"run097"
"19634","RBG","RBR",0,1,1,1,0,"run097"
"19635","RBG","RGR",0,1,1,0,1,"run097"
"19636","RBR","BBB",0,13,13,13,0,"run097"
"19637","RBR","BBR",0,1,1,1,0,"run097"
"19638","RBR","BGB",2,4,6,1,5,"run097"
"19639","RBR","BGG",0,2,2,0,2,"run097"
"19640","RBR","BRB",1,0,1,0,1,"run097"
"19641","RBR","BRR",1,4,5,4,1,"run097"
"19642","RBR","GGB",0,12,12,0,12,"run097"
"19643","RBR","GRR",4,4,8,2,6,"run097"
"19644","RBR","RBB",0,3,3,1,2,"run097"
"19645","RBR","RGG",2,9,11,5,6,"run097"
"19646","RBR","RGR",1,0,1,0,1,"run097"
"19647","RBR","RRR",0,1,1,0,1,"run097"
"19648","RGG","BBB",0,8,8,8,0,"run097"
"19649","RGG","BBR",1,2,3,1,2,"run097"
"19650","RGG","BGB",0,1,1,1,0,"run097"
"19651","RGG","BRR",0,4,4,3,1,"run097"
"19652","RGG","GGG",0,1,1,1,0,"run097"
"19653","RGG","GGR",0,3,3,0,3,"run097"
"19654","RGG","GRR",0,8,8,7,1,"run097"
"19655","RGG","RBB",0,1,1,1,0,"run097"
"19656","RGR","BBB",2,5,7,1,6,"run097"
"19657","RGR","BBR",1,1,2,1,1,"run097"
"19658","RGR","BGB",2,5,7,6,1,"run097"
"19659","RGR","BGG",2,2,4,0,4,"run097"
"19660","RGR","BRR",1,5,6,2,4,"run097"
"19661","RGR","GGB",2,12,14,10,4,"run097"
"19662","RGR","GGG",0,2,2,2,0,"run097"
"19663","RGR","GGR",0,4,4,0,4,"run097"
"19664","RGR","RBB",0,4,4,0,4,"run097"
"19665","RGR","RGG",1,1,2,0,2,"run097"
"19666","RGR","RRG",0,3,3,2,1,"run097"
"19667","RRG","BBB",2,33,35,6,29,"run097"
"19668","RRG","BBR",0,5,5,5,0,"run097"
"19669","RRG","BGB",1,10,11,1,10,"run097"
"19670","RRG","BGG",0,2,2,1,1,"run097"
"19671","RRG","BRB",2,40,42,18,24,"run097"
"19672","RRG","BRR",1,16,17,14,3,"run097"
"19673","RRG","GGG",2,14,16,12,4,"run097"
"19674","RRG","GGR",0,5,5,1,4,"run097"
"19675","RRG","GRG",1,0,1,1,0,"run097"
"19676","RRG","GRR",3,8,11,10,1,"run097"
"19677","RRG","RBB",1,1,2,0,2,"run097"
"19678","RRG","RGG",0,1,1,0,1,"run097"
"19679","RRG","RGR",0,1,1,1,0,"run097"
"19680","RRR","BBR",1,0,1,1,0,"run097"
"19681","RRR","BGB",2,1,3,0,3,"run097"
"19682","RRR","BGG",1,0,1,0,1,"run097"
"19683","RRR","BRB",1,1,2,0,2,"run097"
"19684","RRR","BRR",1,1,2,1,1,"run097"
"19685","RRR","GGR",0,1,1,0,1,"run097"
"19686","RRR","GRR",0,3,3,0,3,"run097"
"19687","RRR","RBB",1,2,3,1,2,"run097"
"19688","RRR","RBR",0,2,2,1,1,"run097"
"19689","RRR","RGG",0,1,1,1,0,"run097"
"19690","RRR","RGR",1,2,3,2,1,"run097"
"19691","RRR","RRG",2,2,4,2,2,"run097"
"19692","BBB","BRB",0,1,1,1,0,"run098"
"19693","BBB","GGG",1,2,3,1,2,"run098"
"19694","BBB","GRR",0,2,2,1,1,"run098"
"19695","BBB","RBG",0,1,1,0,1,"run098"
"19696","BBB","RRG",1,3,4,4,0,"run098"
"19697","BBB","RRR",0,2,2,2,0,"run098"
"19698","BBG","BBB",1,4,5,4,1,"run098"
"19699","BBG","BGB",0,1,1,0,1,"run098"
"19700","BBG","BGG",0,1,1,1,0,"run098"
"19701","BBG","BRB",1,16,17,16,1,"run098"
"19702","BBG","GBB",0,1,1,1,0,"run098"
"19703","BBG","GBG",2,7,9,3,6,"run098"
"19704","BBG","GGB",2,25,27,20,7,"run098"
"19705","BBG","GGG",4,38,42,13,29,"run098"
"19706","BBG","GRG",1,9,10,5,5,"run098"
"19707","BBG","GRR",0,1,1,0,1,"run098"
"19708","BBG","RBB",0,1,1,1,0,"run098"
"19709","BBG","RBG",0,4,4,1,3,"run098"
"19710","BBG","RBR",0,1,1,0,1,"run098"
"19711","BBG","RGR",0,1,1,1,0,"run098"
"19712","BBG","RRG",1,2,3,1,2,"run098"
"19713","BBG","RRR",0,7,7,5,2,"run098"
"19714","BGB","BBB",0,2,2,2,0,"run098"
"19715","BGB","RRG",0,1,1,0,1,"run098"
"19716","BGG","BBB",0,3,3,3,0,"run098"
"19717","BGG","BBR",0,1,1,0,1,"run098"
"19718","BGG","GRG",0,1,1,1,0,"run098"
"19719","BGG","RBG",1,1,2,1,1,"run098"
"19720","BGG","RGG",0,3,3,1,2,"run098"
"19721","BGG","RGR",0,1,1,1,0,"run098"
"19722","BGG","RRR",1,1,2,0,2,"run098"
"19723","BRB","BBB",0,13,13,7,6,"run098"
"19724","BRB","BBR",0,1,1,1,0,"run098"
"19725","BRB","BRR",0,3,3,0,3,"run098"
"19726","BRB","GGG",0,1,1,1,0,"run098"
"19727","BRB","GGR",0,1,1,1,0,"run098"
"19728","BRB","RBB",0,1,1,0,1,"run098"
"19729","BRB","RBG",0,1,1,1,0,"run098"
"19730","BRB","RGR",0,1,1,0,1,"run098"
"19731","BRB","RRR",0,1,1,1,0,"run098"
"19732","BRR","BBB",0,11,11,1,10,"run098"
"19733","BRR","BGB",1,1,2,0,2,"run098"
"19734","BRR","BGG",0,1,1,1,0,"run098"
"19735","BRR","BRB",0,1,1,0,1,"run098"
"19736","BRR","RBB",0,2,2,2,0,"run098"
"19737","GBB","BBB",12,38,50,13,37,"run098"
"19738","GBB","BGG",0,1,1,1,0,"run098"
"19739","GBB","BRB",1,9,10,7,3,"run098"
"19740","GBB","BRR",1,3,4,4,0,"run098"
"19741","GBB","GBG",0,4,4,1,3,"run098"
"19742","GBB","GGB",0,21,21,3,18,"run098"
"19743","GBB","GGG",7,86,93,27,66,"run098"
"19744","GBB","GGR",1,3,4,2,2,"run098"
"19745","GBB","GRG",0,6,6,3,3,"run098"
"19746","GBB","GRR",0,1,1,1,0,"run098"
"19747","GBB","RBB",0,2,2,2,0,"run098"
"19748","GBB","RBG",3,9,12,1,11,"run098"
"19749","GBB","RBR",1,0,1,0,1,"run098"
"19750","GBB","RGG",1,0,1,0,1,"run098"
"19751","GBB","RGR",2,1,3,1,2,"run098"
"19752","GBB","RRG",0,2,2,2,0,"run098"
"19753","GBB","RRR",1,9,10,6,4,"run098"
"19754","GBG","BBB",0,5,5,4,1,"run098"
"19755","GBG","BBR",0,1,1,1,0,"run098"
"19756","GBG","BRB",1,4,5,1,4,"run098"
"19757","GBG","BRR",1,0,1,0,1,"run098"
"19758","GBG","GGB",0,4,4,2,2,"run098"
"19759","GBG","GGG",4,11,15,6,9,"run098"
"19760","GBG","RBB",1,0,1,1,0,"run098"
"19761","GBG","RBG",0,1,1,0,1,"run098"
"19762","GBG","RGG",0,1,1,0,1,"run098"
"19763","GBG","RGR",1,3,4,2,2,"run098"
"19764","GBG","RRG",1,3,4,3,1,"run098"
"19765","GGB","BBB",3,16,19,16,3,"run098"
"19766","GGB","BBR",1,4,5,4,1,"run098"
"19767","GGB","BGB",0,3,3,1,2,"run098"
"19768","GGB","BGG",0,4,4,2,2,"run098"
"19769","GGB","BRB",0,1,1,0,1,"run098"
"19770","GGB","BRR",1,15,16,12,4,"run098"
"19771","GGB","GBB",0,1,1,1,0,"run098"
"19772","GGB","GBG",1,0,1,1,0,"run098"
"19773","GGB","GGG",13,48,61,32,29,"run098"
"19774","GGB","GGR",0,7,7,0,7,"run098"
"19775","GGB","GRR",0,4,4,4,0,"run098"
"19776","GGB","RBB",0,5,5,1,4,"run098"
"19777","GGB","RBG",0,4,4,1,3,"run098"
"19778","GGB","RBR",0,5,5,1,4,"run098"
"19779","GGB","RGG",1,5,6,5,1,"run098"
"19780","GGB","RGR",0,2,2,1,1,"run098"
"19781","GGB","RRG",1,5,6,3,3,"run098"
"19782","GGB","RRR",1,5,6,4,2,"run098"
"19783","GGG","BBB",8,31,39,33,6,"run098"
"19784","GGG","BGB",0,2,2,1,1,"run098"
"19785","GGG","BGG",1,7,8,7,1,"run098"
"19786","GGG","BRB",1,3,4,2,2,"run098"
"19787","GGG","BRR",0,6,6,4,2,"run098"
"19788","GGG","GGB",5,1,6,0,6,"run098"
"19789","GGG","GGR",1,9,10,9,1,"run098"
"19790","GGG","GRR",0,2,2,1,1,"run098"
"19791","GGG","RBB",1,8,9,3,6,"run098"
"19792","GGG","RBG",0,6,6,4,2,"run098"
"19793","GGG","RBR",0,21,21,18,3,"run098"
"19794","GGG","RGG",0,3,3,3,0,"run098"
"19795","GGG","RGR",1,12,13,3,10,"run098"
"19796","GGG","RRG",1,23,24,24,0,"run098"
"19797","GGG","RRR",0,3,3,2,1,"run098"
"19798","GGR","BBB",0,2,2,0,2,"run098"
"19799","GGR","BBR",0,2,2,2,0,"run098"
"19800","GGR","BGG",0,1,1,1,0,"run098"
"19801","GGR","BRR",1,0,1,1,0,"run098"
"19802","GGR","GRR",1,0,1,1,0,"run098"
"19803","GGR","RBB",0,2,2,1,1,"run098"
"19804","GRG","BBB",3,8,11,5,6,"run098"
"19805","GRG","BBR",0,1,1,1,0,"run098"
"19806","GRG","BGG",0,1,1,1,0,"run098"
"19807","GRG","BRB",0,3,3,1,2,"run098"
"19808","GRG","BRR",0,1,1,0,1,"run098"
"19809","GRG","GBG",0,1,1,1,0,"run098"
"19810","GRG","GGB",2,15,17,14,3,"run098"
"19811","GRG","GGG",3,12,15,15,0,"run098"
"19812","GRG","GGR",0,5,5,5,0,"run098"
"19813","GRG","GRR",0,1,1,1,0,"run098"
"19814","GRG","RBG",0,1,1,1,0,"run098"
"19815","GRG","RBR",0,1,1,1,0,"run098"
"19816","GRG","RGR",1,2,3,1,2,"run098"
"19817","GRG","RRG",2,4,6,2,4,"run098"
"19818","GRR","BBB",0,1,1,1,0,"run098"
"19819","GRR","BBR",0,1,1,0,1,"run098"
"19820","GRR","BGB",1,2,3,1,2,"run098"
"19821","GRR","BGG",0,2,2,1,1,"run098"
"19822","GRR","BRB",0,1,1,1,0,"run098"
"19823","GRR","BRR",0,2,2,0,2,"run098"
"19824","GRR","GGG",0,1,1,0,1,"run098"
"19825","GRR","GGR",0,1,1,1,0,"run098"
"19826","RBB","BBB",0,1,1,0,1,"run098"
"19827","RBB","BBR",0,1,1,1,0,"run098"
"19828","RBB","BRB",0,1,1,0,1,"run098"
"19829","RBB","GRR",0,1,1,0,1,"run098"
"19830","RBB","RGG",0,1,1,0,1,"run098"
"19831","RBG","BBB",2,8,10,1,9,"run098"
"19832","RBG","BBG",0,1,1,1,0,"run098"
"19833","RBG","BRR",0,1,1,1,0,"run098"
"19834","RBG","GBB",0,1,1,0,1,"run098"
"19835","RBG","GRR",0,3,3,2,1,"run098"
"19836","RBG","RBB",1,1,2,1,1,"run098"
"19837","RBG","RBR",0,1,1,0,1,"run098"
"19838","RBG","RGR",0,1,1,0,1,"run098"
"19839","RBR","BBB",0,13,13,13,0,"run098"
"19840","RBR","BBR",0,1,1,1,0,"run098"
"19841","RBR","BGB",2,4,6,2,4,"run098"
"19842","RBR","BGG",0,2,2,0,2,"run098"
"19843","RBR","BRB",1,0,1,0,1,"run098"
"19844","RBR","BRR",1,4,5,4,1,"run098"
"19845","RBR","GGB",0,12,12,11,1,"run098"
"19846","RBR","GRR",4,4,8,3,5,"run098"
"19847","RBR","RBB",0,3,3,1,2,"run098"
"19848","RBR","RGG",2,9,11,9,2,"run098"
"19849","RBR","RGR",1,0,1,1,0,"run098"
"19850","RBR","RRR",0,1,1,0,1,"run098"
"19851","RGG","BBB",0,8,8,3,5,"run098"
"19852","RGG","BBR",1,2,3,3,0,"run098"
"19853","RGG","BGB",0,1,1,0,1,"run098"
"19854","RGG","BRR",0,4,4,1,3,"run098"
"19855","RGG","GGG",0,1,1,0,1,"run098"
"19856","RGG","GGR",0,3,3,3,0,"run098"
"19857","RGG","GRR",0,8,8,6,2,"run098"
"19858","RGG","RBB",0,1,1,1,0,"run098"
"19859","RGR","BBB",2,5,7,3,4,"run098"
"19860","RGR","BBR",1,1,2,0,2,"run098"
"19861","RGR","BGB",2,5,7,0,7,"run098"
"19862","RGR","BGG",2,2,4,2,2,"run098"
"19863","RGR","BRR",1,5,6,0,6,"run098"
"19864","RGR","GGB",2,12,14,7,7,"run098"
"19865","RGR","GGG",0,2,2,2,0,"run098"
"19866","RGR","GGR",0,4,4,3,1,"run098"
"19867","RGR","RBB",0,4,4,4,0,"run098"
"19868","RGR","RGG",1,1,2,1,1,"run098"
"19869","RGR","RRG",0,3,3,0,3,"run098"
"19870","RRG","BBB",2,33,35,5,30,"run098"
"19871","RRG","BBR",0,5,5,1,4,"run098"
"19872","RRG","BGB",1,10,11,4,7,"run098"
"19873","RRG","BGG",0,2,2,0,2,"run098"
"19874","RRG","BRB",2,40,42,19,23,"run098"
"19875","RRG","BRR",1,16,17,15,2,"run098"
"19876","RRG","GGG",2,14,16,0,16,"run098"
"19877","RRG","GGR",0,5,5,0,5,"run098"
"19878","RRG","GRG",1,0,1,0,1,"run098"
"19879","RRG","GRR",3,8,11,9,2,"run098"
"19880","RRG","RBB",1,1,2,0,2,"run098"
"19881","RRG","RGG",0,1,1,1,0,"run098"
"19882","RRG","RGR",0,1,1,0,1,"run098"
"19883","RRR","BBR",1,0,1,0,1,"run098"
"19884","RRR","BGB",2,1,3,3,0,"run098"
"19885","RRR","BGG",1,0,1,1,0,"run098"
"19886","RRR","BRB",1,1,2,1,1,"run098"
"19887","RRR","BRR",1,1,2,0,2,"run098"
"19888","RRR","GGR",0,1,1,1,0,"run098"
"19889","RRR","GRR",0,3,3,3,0,"run098"
"19890","RRR","RBB",1,2,3,1,2,"run098"
"19891","RRR","RBR",0,2,2,0,2,"run098"
"19892","RRR","RGG",0,1,1,1,0,"run098"
"19893","RRR","RGR",1,2,3,3,0,"run098"
"19894","RRR","RRG",2,2,4,3,1,"run098"
"19895","BBB","BRB",0,1,1,1,0,"run099"
"19896","BBB","GGG",1,2,3,0,3,"run099"
"19897","BBB","GRR",0,2,2,1,1,"run099"
"19898","BBB","RBG",0,1,1,1,0,"run099"
"19899","BBB","RRG",1,3,4,4,0,"run099"
"19900","BBB","RRR",0,2,2,2,0,"run099"
"19901","BBG","BBB",1,4,5,1,4,"run099"
"19902","BBG","BGB",0,1,1,1,0,"run099"
"19903","BBG","BGG",0,1,1,1,0,"run099"
"19904","BBG","BRB",1,16,17,5,12,"run099"
"19905","BBG","GBB",0,1,1,1,0,"run099"
"19906","BBG","GBG",2,7,9,3,6,"run099"
"19907","BBG","GGB",2,25,27,3,24,"run099"
"19908","BBG","GGG",4,38,42,30,12,"run099"
"19909","BBG","GRG",1,9,10,3,7,"run099"
"19910","BBG","GRR",0,1,1,0,1,"run099"
"19911","BBG","RBB",0,1,1,1,0,"run099"
"19912","BBG","RBG",0,4,4,3,1,"run099"
"19913","BBG","RBR",0,1,1,0,1,"run099"
"19914","BBG","RGR",0,1,1,1,0,"run099"
"19915","BBG","RRG",1,2,3,1,2,"run099"
"19916","BBG","RRR",0,7,7,3,4,"run099"
"19917","BGB","BBB",0,2,2,1,1,"run099"
"19918","BGB","RRG",0,1,1,0,1,"run099"
"19919","BGG","BBB",0,3,3,2,1,"run099"
"19920","BGG","BBR",0,1,1,1,0,"run099"
"19921","BGG","GRG",0,1,1,0,1,"run099"
"19922","BGG","RBG",1,1,2,1,1,"run099"
"19923","BGG","RGG",0,3,3,1,2,"run099"
"19924","BGG","RGR",0,1,1,1,0,"run099"
"19925","BGG","RRR",1,1,2,0,2,"run099"
"19926","BRB","BBB",0,13,13,7,6,"run099"
"19927","BRB","BBR",0,1,1,0,1,"run099"
"19928","BRB","BRR",0,3,3,1,2,"run099"
"19929","BRB","GGG",0,1,1,1,0,"run099"
"19930","BRB","GGR",0,1,1,0,1,"run099"
"19931","BRB","RBB",0,1,1,1,0,"run099"
"19932","BRB","RBG",0,1,1,1,0,"run099"
"19933","BRB","RGR",0,1,1,1,0,"run099"
"19934","BRB","RRR",0,1,1,1,0,"run099"
"19935","BRR","BBB",0,11,11,0,11,"run099"
"19936","BRR","BGB",1,1,2,1,1,"run099"
"19937","BRR","BGG",0,1,1,1,0,"run099"
"19938","BRR","BRB",0,1,1,0,1,"run099"
"19939","BRR","RBB",0,2,2,1,1,"run099"
"19940","GBB","BBB",12,38,50,37,13,"run099"
"19941","GBB","BGG",0,1,1,0,1,"run099"
"19942","GBB","BRB",1,9,10,3,7,"run099"
"19943","GBB","BRR",1,3,4,4,0,"run099"
"19944","GBB","GBG",0,4,4,0,4,"run099"
"19945","GBB","GGB",0,21,21,21,0,"run099"
"19946","GBB","GGG",7,86,93,28,65,"run099"
"19947","GBB","GGR",1,3,4,4,0,"run099"
"19948","GBB","GRG",0,6,6,3,3,"run099"
"19949","GBB","GRR",0,1,1,0,1,"run099"
"19950","GBB","RBB",0,2,2,0,2,"run099"
"19951","GBB","RBG",3,9,12,2,10,"run099"
"19952","GBB","RBR",1,0,1,0,1,"run099"
"19953","GBB","RGG",1,0,1,1,0,"run099"
"19954","GBB","RGR",2,1,3,2,1,"run099"
"19955","GBB","RRG",0,2,2,2,0,"run099"
"19956","GBB","RRR",1,9,10,5,5,"run099"
"19957","GBG","BBB",0,5,5,2,3,"run099"
"19958","GBG","BBR",0,1,1,1,0,"run099"
"19959","GBG","BRB",1,4,5,2,3,"run099"
"19960","GBG","BRR",1,0,1,0,1,"run099"
"19961","GBG","GGB",0,4,4,2,2,"run099"
"19962","GBG","GGG",4,11,15,1,14,"run099"
"19963","GBG","RBB",1,0,1,0,1,"run099"
"19964","GBG","RBG",0,1,1,1,0,"run099"
"19965","GBG","RGG",0,1,1,0,1,"run099"
"19966","GBG","RGR",1,3,4,4,0,"run099"
"19967","GBG","RRG",1,3,4,2,2,"run099"
"19968","GGB","BBB",3,16,19,17,2,"run099"
"19969","GGB","BBR",1,4,5,1,4,"run099"
"19970","GGB","BGB",0,3,3,3,0,"run099"
"19971","GGB","BGG",0,4,4,2,2,"run099"
"19972","GGB","BRB",0,1,1,0,1,"run099"
"19973","GGB","BRR",1,15,16,9,7,"run099"
"19974","GGB","GBB",0,1,1,0,1,"run099"
"19975","GGB","GBG",1,0,1,1,0,"run099"
"19976","GGB","GGG",13,48,61,20,41,"run099"
"19977","GGB","GGR",0,7,7,3,4,"run099"
"19978","GGB","GRR",0,4,4,3,1,"run099"
"19979","GGB","RBB",0,5,5,0,5,"run099"
"19980","GGB","RBG",0,4,4,2,2,"run099"
"19981","GGB","RBR",0,5,5,0,5,"run099"
"19982","GGB","RGG",1,5,6,2,4,"run099"
"19983","GGB","RGR",0,2,2,2,0,"run099"
"19984","GGB","RRG",1,5,6,4,2,"run099"
"19985","GGB","RRR",1,5,6,4,2,"run099"
"19986","GGG","BBB",8,31,39,3,36,"run099"
"19987","GGG","BGB",0,2,2,1,1,"run099"
"19988","GGG","BGG",1,7,8,2,6,"run099"
"19989","GGG","BRB",1,3,4,4,0,"run099"
"19990","GGG","BRR",0,6,6,4,2,"run099"
"19991","GGG","GGB",5,1,6,6,0,"run099"
"19992","GGG","GGR",1,9,10,10,0,"run099"
"19993","GGG","GRR",0,2,2,1,1,"run099"
"19994","GGG","RBB",1,8,9,9,0,"run099"
"19995","GGG","RBG",0,6,6,2,4,"run099"
"19996","GGG","RBR",0,21,21,7,14,"run099"
"19997","GGG","RGG",0,3,3,2,1,"run099"
"19998","GGG","RGR",1,12,13,10,3,"run099"
"19999","GGG","RRG",1,23,24,16,8,"run099"
"20000","GGG","RRR",0,3,3,2,1,"run099"
"20001","GGR","BBB",0,2,2,2,0,"run099"
"20002","GGR","BBR",0,2,2,1,1,"run099"
"20003","GGR","BGG",0,1,1,1,0,"run099"
"20004","GGR","BRR",1,0,1,0,1,"run099"
"20005","GGR","GRR",1,0,1,1,0,"run099"
"20006","GGR","RBB",0,2,2,1,1,"run099"
"20007","GRG","BBB",3,8,11,0,11,"run099"
"20008","GRG","BBR",0,1,1,1,0,"run099"
"20009","GRG","BGG",0,1,1,0,1,"run099"
"20010","GRG","BRB",0,3,3,1,2,"run099"
"20011","GRG","BRR",0,1,1,0,1,"run099"
"20012","GRG","GBG",0,1,1,0,1,"run099"
"20013","GRG","GGB",2,15,17,5,12,"run099"
"20014","GRG","GGG",3,12,15,3,12,"run099"
"20015","GRG","GGR",0,5,5,4,1,"run099"
"20016","GRG","GRR",0,1,1,1,0,"run099"
"20017","GRG","RBG",0,1,1,1,0,"run099"
"20018","GRG","RBR",0,1,1,1,0,"run099"
"20019","GRG","RGR",1,2,3,3,0,"run099"
"20020","GRG","RRG",2,4,6,3,3,"run099"
"20021","GRR","BBB",0,1,1,1,0,"run099"
"20022","GRR","BBR",0,1,1,1,0,"run099"
"20023","GRR","BGB",1,2,3,0,3,"run099"
"20024","GRR","BGG",0,2,2,0,2,"run099"
"20025","GRR","BRB",0,1,1,0,1,"run099"
"20026","GRR","BRR",0,2,2,1,1,"run099"
"20027","GRR","GGG",0,1,1,0,1,"run099"
"20028","GRR","GGR",0,1,1,0,1,"run099"
"20029","RBB","BBB",0,1,1,1,0,"run099"
"20030","RBB","BBR",0,1,1,1,0,"run099"
"20031","RBB","BRB",0,1,1,0,1,"run099"
"20032","RBB","GRR",0,1,1,0,1,"run099"
"20033","RBB","RGG",0,1,1,0,1,"run099"
"20034","RBG","BBB",2,8,10,9,1,"run099"
"20035","RBG","BBG",0,1,1,0,1,"run099"
"20036","RBG","BRR",0,1,1,0,1,"run099"
"20037","RBG","GBB",0,1,1,0,1,"run099"
"20038","RBG","GRR",0,3,3,3,0,"run099"
"20039","RBG","RBB",1,1,2,0,2,"run099"
"20040","RBG","RBR",0,1,1,1,0,"run099"
"20041","RBG","RGR",0,1,1,0,1,"run099"
"20042","RBR","BBB",0,13,13,4,9,"run099"
"20043","RBR","BBR",0,1,1,1,0,"run099"
"20044","RBR","BGB",2,4,6,0,6,"run099"
"20045","RBR","BGG",0,2,2,2,0,"run099"
"20046","RBR","BRB",1,0,1,0,1,"run099"
"20047","RBR","BRR",1,4,5,5,0,"run099"
"20048","RBR","GGB",0,12,12,9,3,"run099"
"20049","RBR","GRR",4,4,8,4,4,"run099"
"20050","RBR","RBB",0,3,3,1,2,"run099"
"20051","RBR","RGG",2,9,11,3,8,"run099"
"20052","RBR","RGR",1,0,1,1,0,"run099"
"20053","RBR","RRR",0,1,1,1,0,"run099"
"20054","RGG","BBB",0,8,8,1,7,"run099"
"20055","RGG","BBR",1,2,3,2,1,"run099"
"20056","RGG","BGB",0,1,1,1,0,"run099"
"20057","RGG","BRR",0,4,4,4,0,"run099"
"20058","RGG","GGG",0,1,1,1,0,"run099"
"20059","RGG","GGR",0,3,3,3,0,"run099"
"20060","RGG","GRR",0,8,8,5,3,"run099"
"20061","RGG","RBB",0,1,1,0,1,"run099"
"20062","RGR","BBB",2,5,7,6,1,"run099"
"20063","RGR","BBR",1,1,2,0,2,"run099"
"20064","RGR","BGB",2,5,7,6,1,"run099"
"20065","RGR","BGG",2,2,4,3,1,"run099"
"20066","RGR","BRR",1,5,6,1,5,"run099"
"20067","RGR","GGB",2,12,14,3,11,"run099"
"20068","RGR","GGG",0,2,2,0,2,"run099"
"20069","RGR","GGR",0,4,4,1,3,"run099"
"20070","RGR","RBB",0,4,4,0,4,"run099"
"20071","RGR","RGG",1,1,2,1,1,"run099"
"20072","RGR","RRG",0,3,3,3,0,"run099"
"20073","RRG","BBB",2,33,35,21,14,"run099"
"20074","RRG","BBR",0,5,5,4,1,"run099"
"20075","RRG","BGB",1,10,11,6,5,"run099"
"20076","RRG","BGG",0,2,2,2,0,"run099"
"20077","RRG","BRB",2,40,42,25,17,"run099"
"20078","RRG","BRR",1,16,17,9,8,"run099"
"20079","RRG","GGG",2,14,16,13,3,"run099"
"20080","RRG","GGR",0,5,5,0,5,"run099"
"20081","RRG","GRG",1,0,1,0,1,"run099"
"20082","RRG","GRR",3,8,11,4,7,"run099"
"20083","RRG","RBB",1,1,2,0,2,"run099"
"20084","RRG","RGG",0,1,1,0,1,"run099"
"20085","RRG","RGR",0,1,1,0,1,"run099"
"20086","RRR","BBR",1,0,1,0,1,"run099"
"20087","RRR","BGB",2,1,3,1,2,"run099"
"20088","RRR","BGG",1,0,1,1,0,"run099"
"20089","RRR","BRB",1,1,2,2,0,"run099"
"20090","RRR","BRR",1,1,2,2,0,"run099"
"20091","RRR","GGR",0,1,1,0,1,"run099"
"20092","RRR","GRR",0,3,3,1,2,"run099"
"20093","RRR","RBB",1,2,3,1,2,"run099"
"20094","RRR","RBR",0,2,2,1,1,"run099"
"20095","RRR","RGG",0,1,1,1,0,"run099"
"20096","RRR","RGR",1,2,3,3,0,"run099"
"20097","RRR","RRG",2,2,4,1,3,"run099"
"20098","BBB","BRB",0,1,1,1,0,"run100"
"20099","BBB","GGG",1,2,3,2,1,"run100"
"20100","BBB","GRR",0,2,2,1,1,"run100"
"20101","BBB","RBG",0,1,1,1,0,"run100"
"20102","BBB","RRG",1,3,4,2,2,"run100"
"20103","BBB","RRR",0,2,2,0,2,"run100"
"20104","BBG","BBB",1,4,5,1,4,"run100"
"20105","BBG","BGB",0,1,1,1,0,"run100"
"20106","BBG","BGG",0,1,1,1,0,"run100"
"20107","BBG","BRB",1,16,17,5,12,"run100"
"20108","BBG","GBB",0,1,1,1,0,"run100"
"20109","BBG","GBG",2,7,9,6,3,"run100"
"20110","BBG","GGB",2,25,27,5,22,"run100"
"20111","BBG","GGG",4,38,42,33,9,"run100"
"20112","BBG","GRG",1,9,10,6,4,"run100"
"20113","BBG","GRR",0,1,1,0,1,"run100"
"20114","BBG","RBB",0,1,1,0,1,"run100"
"20115","BBG","RBG",0,4,4,2,2,"run100"
"20116","BBG","RBR",0,1,1,1,0,"run100"
"20117","BBG","RGR",0,1,1,1,0,"run100"
"20118","BBG","RRG",1,2,3,0,3,"run100"
"20119","BBG","RRR",0,7,7,3,4,"run100"
"20120","BGB","BBB",0,2,2,2,0,"run100"
"20121","BGB","RRG",0,1,1,0,1,"run100"
"20122","BGG","BBB",0,3,3,3,0,"run100"
"20123","BGG","BBR",0,1,1,1,0,"run100"
"20124","BGG","GRG",0,1,1,0,1,"run100"
"20125","BGG","RBG",1,1,2,1,1,"run100"
"20126","BGG","RGG",0,3,3,2,1,"run100"
"20127","BGG","RGR",0,1,1,1,0,"run100"
"20128","BGG","RRR",1,1,2,1,1,"run100"
"20129","BRB","BBB",0,13,13,3,10,"run100"
"20130","BRB","BBR",0,1,1,1,0,"run100"
"20131","BRB","BRR",0,3,3,3,0,"run100"
"20132","BRB","GGG",0,1,1,0,1,"run100"
"20133","BRB","GGR",0,1,1,0,1,"run100"
"20134","BRB","RBB",0,1,1,0,1,"run100"
"20135","BRB","RBG",0,1,1,0,1,"run100"
"20136","BRB","RGR",0,1,1,1,0,"run100"
"20137","BRB","RRR",0,1,1,0,1,"run100"
"20138","BRR","BBB",0,11,11,3,8,"run100"
"20139","BRR","BGB",1,1,2,1,1,"run100"
"20140","BRR","BGG",0,1,1,1,0,"run100"
"20141","BRR","BRB",0,1,1,0,1,"run100"
"20142","BRR","RBB",0,2,2,0,2,"run100"
"20143","GBB","BBB",12,38,50,29,21,"run100"
"20144","GBB","BGG",0,1,1,1,0,"run100"
"20145","GBB","BRB",1,9,10,6,4,"run100"
"20146","GBB","BRR",1,3,4,0,4,"run100"
"20147","GBB","GBG",0,4,4,4,0,"run100"
"20148","GBB","GGB",0,21,21,21,0,"run100"
"20149","GBB","GGG",7,86,93,40,53,"run100"
"20150","GBB","GGR",1,3,4,0,4,"run100"
"20151","GBB","GRG",0,6,6,0,6,"run100"
"20152","GBB","GRR",0,1,1,1,0,"run100"
"20153","GBB","RBB",0,2,2,2,0,"run100"
"20154","GBB","RBG",3,9,12,6,6,"run100"
"20155","GBB","RBR",1,0,1,0,1,"run100"
"20156","GBB","RGG",1,0,1,0,1,"run100"
"20157","GBB","RGR",2,1,3,0,3,"run100"
"20158","GBB","RRG",0,2,2,1,1,"run100"
"20159","GBB","RRR",1,9,10,3,7,"run100"
"20160","GBG","BBB",0,5,5,5,0,"run100"
"20161","GBG","BBR",0,1,1,0,1,"run100"
"20162","GBG","BRB",1,4,5,4,1,"run100"
"20163","GBG","BRR",1,0,1,1,0,"run100"
"20164","GBG","GGB",0,4,4,2,2,"run100"
"20165","GBG","GGG",4,11,15,13,2,"run100"
"20166","GBG","RBB",1,0,1,1,0,"run100"
"20167","GBG","RBG",0,1,1,0,1,"run100"
"20168","GBG","RGG",0,1,1,0,1,"run100"
"20169","GBG","RGR",1,3,4,2,2,"run100"
"20170","GBG","RRG",1,3,4,3,1,"run100"
"20171","GGB","BBB",3,16,19,13,6,"run100"
"20172","GGB","BBR",1,4,5,5,0,"run100"
"20173","GGB","BGB",0,3,3,0,3,"run100"
"20174","GGB","BGG",0,4,4,3,1,"run100"
"20175","GGB","BRB",0,1,1,1,0,"run100"
"20176","GGB","BRR",1,15,16,15,1,"run100"
"20177","GGB","GBB",0,1,1,1,0,"run100"
"20178","GGB","GBG",1,0,1,1,0,"run100"
"20179","GGB","GGG",13,48,61,17,44,"run100"
"20180","GGB","GGR",0,7,7,4,3,"run100"
"20181","GGB","GRR",0,4,4,2,2,"run100"
"20182","GGB","RBB",0,5,5,4,1,"run100"
"20183","GGB","RBG",0,4,4,3,1,"run100"
"20184","GGB","RBR",0,5,5,4,1,"run100"
"20185","GGB","RGG",1,5,6,3,3,"run100"
"20186","GGB","RGR",0,2,2,0,2,"run100"
"20187","GGB","RRG",1,5,6,0,6,"run100"
"20188","GGB","RRR",1,5,6,1,5,"run100"
"20189","GGG","BBB",8,31,39,14,25,"run100"
"20190","GGG","BGB",0,2,2,0,2,"run100"
"20191","GGG","BGG",1,7,8,4,4,"run100"
"20192","GGG","BRB",1,3,4,1,3,"run100"
"20193","GGG","BRR",0,6,6,1,5,"run100"
"20194","GGG","GGB",5,1,6,6,0,"run100"
"20195","GGG","GGR",1,9,10,7,3,"run100"
"20196","GGG","GRR",0,2,2,0,2,"run100"
"20197","GGG","RBB",1,8,9,9,0,"run100"
"20198","GGG","RBG",0,6,6,2,4,"run100"
"20199","GGG","RBR",0,21,21,10,11,"run100"
"20200","GGG","RGG",0,3,3,2,1,"run100"
"20201","GGG","RGR",1,12,13,2,11,"run100"
"20202","GGG","RRG",1,23,24,8,16,"run100"
"20203","GGG","RRR",0,3,3,3,0,"run100"
"20204","GGR","BBB",0,2,2,2,0,"run100"
"20205","GGR","BBR",0,2,2,1,1,"run100"
"20206","GGR","BGG",0,1,1,0,1,"run100"
"20207","GGR","BRR",1,0,1,1,0,"run100"
"20208","GGR","GRR",1,0,1,0,1,"run100"
"20209","GGR","RBB",0,2,2,1,1,"run100"
"20210","GRG","BBB",3,8,11,7,4,"run100"
"20211","GRG","BBR",0,1,1,0,1,"run100"
"20212","GRG","BGG",0,1,1,1,0,"run100"
"20213","GRG","BRB",0,3,3,1,2,"run100"
"20214","GRG","BRR",0,1,1,0,1,"run100"
"20215","GRG","GBG",0,1,1,0,1,"run100"
"20216","GRG","GGB",2,15,17,11,6,"run100"
"20217","GRG","GGG",3,12,15,9,6,"run100"
"20218","GRG","GGR",0,5,5,4,1,"run100"
"20219","GRG","GRR",0,1,1,0,1,"run100"
"20220","GRG","RBG",0,1,1,1,0,"run100"
"20221","GRG","RBR",0,1,1,1,0,"run100"
"20222","GRG","RGR",1,2,3,2,1,"run100"
"20223","GRG","RRG",2,4,6,0,6,"run100"
"20224","GRR","BBB",0,1,1,1,0,"run100"
"20225","GRR","BBR",0,1,1,1,0,"run100"
"20226","GRR","BGB",1,2,3,3,0,"run100"
"20227","GRR","BGG",0,2,2,2,0,"run100"
"20228","GRR","BRB",0,1,1,1,0,"run100"
"20229","GRR","BRR",0,2,2,1,1,"run100"
"20230","GRR","GGG",0,1,1,0,1,"run100"
"20231","GRR","GGR",0,1,1,1,0,"run100"
"20232","RBB","BBB",0,1,1,1,0,"run100"
"20233","RBB","BBR",0,1,1,1,0,"run100"
"20234","RBB","BRB",0,1,1,1,0,"run100"
"20235","RBB","GRR",0,1,1,1,0,"run100"
"20236","RBB","RGG",0,1,1,0,1,"run100"
"20237","RBG","BBB",2,8,10,2,8,"run100"
"20238","RBG","BBG",0,1,1,1,0,"run100"
"20239","RBG","BRR",0,1,1,0,1,"run100"
"20240","RBG","GBB",0,1,1,1,0,"run100"
"20241","RBG","GRR",0,3,3,1,2,"run100"
"20242","RBG","RBB",1,1,2,1,1,"run100"
"20243","RBG","RBR",0,1,1,1,0,"run100"
"20244","RBG","RGR",0,1,1,0,1,"run100"
"20245","RBR","BBB",0,13,13,11,2,"run100"
"20246","RBR","BBR",0,1,1,0,1,"run100"
"20247","RBR","BGB",2,4,6,3,3,"run100"
"20248","RBR","BGG",0,2,2,0,2,"run100"
"20249","RBR","BRB",1,0,1,1,0,"run100"
"20250","RBR","BRR",1,4,5,3,2,"run100"
"20251","RBR","GGB",0,12,12,3,9,"run100"
"20252","RBR","GRR",4,4,8,8,0,"run100"
"20253","RBR","RBB",0,3,3,1,2,"run100"
"20254","RBR","RGG",2,9,11,10,1,"run100"
"20255","RBR","RGR",1,0,1,0,1,"run100"
"20256","RBR","RRR",0,1,1,1,0,"run100"
"20257","RGG","BBB",0,8,8,6,2,"run100"
"20258","RGG","BBR",1,2,3,0,3,"run100"
"20259","RGG","BGB",0,1,1,0,1,"run100"
"20260","RGG","BRR",0,4,4,0,4,"run100"
"20261","RGG","GGG",0,1,1,1,0,"run100"
"20262","RGG","GGR",0,3,3,0,3,"run100"
"20263","RGG","GRR",0,8,8,1,7,"run100"
"20264","RGG","RBB",0,1,1,1,0,"run100"
"20265","RGR","BBB",2,5,7,1,6,"run100"
"20266","RGR","BBR",1,1,2,0,2,"run100"
"20267","RGR","BGB",2,5,7,6,1,"run100"
"20268","RGR","BGG",2,2,4,1,3,"run100"
"20269","RGR","BRR",1,5,6,0,6,"run100"
"20270","RGR","GGB",2,12,14,6,8,"run100"
"20271","RGR","GGG",0,2,2,1,1,"run100"
"20272","RGR","GGR",0,4,4,0,4,"run100"
"20273","RGR","RBB",0,4,4,3,1,"run100"
"20274","RGR","RGG",1,1,2,1,1,"run100"
"20275","RGR","RRG",0,3,3,2,1,"run100"
"20276","RRG","BBB",2,33,35,0,35,"run100"
"20277","RRG","BBR",0,5,5,1,4,"run100"
"20278","RRG","BGB",1,10,11,8,3,"run100"
"20279","RRG","BGG",0,2,2,0,2,"run100"
"20280","RRG","BRB",2,40,42,12,30,"run100"
"20281","RRG","BRR",1,16,17,10,7,"run100"
"20282","RRG","GGG",2,14,16,3,13,"run100"
"20283","RRG","GGR",0,5,5,1,4,"run100"
"20284","RRG","GRG",1,0,1,1,0,"run100"
"20285","RRG","GRR",3,8,11,9,2,"run100"
"20286","RRG","RBB",1,1,2,1,1,"run100"
"20287","RRG","RGG",0,1,1,1,0,"run100"
"20288","RRG","RGR",0,1,1,1,0,"run100"
"20289","RRR","BBR",1,0,1,0,1,"run100"
"20290","RRR","BGB",2,1,3,2,1,"run100"
"20291","RRR","BGG",1,0,1,1,0,"run100"
"20292","RRR","BRB",1,1,2,1,1,"run100"
"20293","RRR","BRR",1,1,2,0,2,"run100"
"20294","RRR","GGR",0,1,1,0,1,"run100"
"20295","RRR","GRR",0,3,3,2,1,"run100"
"20296","RRR","RBB",1,2,3,1,2,"run100"
"20297","RRR","RBR",0,2,2,1,1,"run100"
"20298","RRR","RGG",0,1,1,1,0,"run100"
"20299","RRR","RGR",1,2,3,0,3,"run100"
"20300","RRR","RRG",2,2,4,4,0,"run100"
